"state","county","year","births","deaths","domesticmig","gqestimates","internationalmig","naturalinc","netmig","npopchg_","popestimate","rbirth","rdeath","rdomesticmig","residual","rinternationalmig","rnaturalinc","rnetmig"
1,0,2001,62358,45163,-8850,116446,4806,17195,-4044,11145,4462832,13.990210801,10.132459194,-1.985524962,-2006,1.0782410133,3.8577516072,-0.907283949
1,0,2002,59529,45754,-8616,115651,3871,13775,-4745,7074,4469906,13.32827628,10.244115522,-1.929083781,-1956,0.8666995495,3.0841607579,-1.062384232
1,0,2003,58571,45883,4821,118109,2080,12688,6901,16692,4486598,13.078987069,10.245738739,1.0765361128,-2897,0.4644669393,2.8332483299,1.5410030521
1,0,2004,59547,46913,5123,116744,4483,12634,9606,19976,4506574,13.242713472,10.4330263,1.1393088001,-2264,0.9969785967,2.8096871716,2.1362873967
1,0,2005,60076,46549,16248,117725,3558,13527,19806,30725,4537299,13.285458564,10.29404106,3.5931508547,-2608,0.7868310402,2.9914175044,4.3799818949
1,0,2006,61332,47004,32945,119152,4286,14328,37231,50265,4587564,13.442831964,10.302401252,7.2209303307,-1294,0.9394113643,3.1404307111,8.160341695
1,0,2007,63046,46516,18496,120244,3366,16530,21862,39031,4626595,13.68459129,10.096634972,4.0146908687,639,0.7306146985,3.5879563181,4.7453055672
1,0,2008,62940,47057,15118,120244,3460,15883,18578,35305,4661900,13.552249315,10.132319606,3.2552098052,844,0.7450076681,3.4199297087,4.0002174733
1,1,2001,635,354,318,260,5,281,323,563,44437,14.38099444,8.0171213099,7.2018208377,-41,0.1132361767,6.3638731302,7.3150570144
1,1,2002,593,367,549,260,-24,226,525,723,45160,13.237050348,8.1922385794,12.254874605,-28,-0.535732223,5.0448117683,11.719142382
1,1,2003,613,401,499,260,-72,212,427,606,45766,13.48349207,8.8203594131,10.975958472,-33,-1.583705431,4.6631326573,9.3922530409
1,1,2004,635,396,956,260,39,239,995,1175,46941,13.699073425,8.5430442146,20.624116841,-59,0.8413604151,5.1560292103,21.465477256
1,1,2005,674,407,723,260,-5,267,718,941,47882,14.215960263,8.5844151735,15.249464792,-44,-0.105459646,5.6315450893,15.144005146
1,1,2006,646,455,970,260,22,191,992,1157,49039,13.330444383,9.3890900837,20.016301937,-26,0.4539779821,3.9413542989,20.470279919
1,1,2007,661,445,561,260,0,216,561,791,49830,13.371228595,9.0018104765,11.348349837,14,0,4.3694181189,11.348349837
1,1,2008,718,448,245,260,5,270,250,534,50364,14.332195541,8.9426512566,4.8905124059,14,0.0998063756,5.3895442841,4.9903187816
1,3,2001,1890,1340,2818,2331,179,550,2997,3582,144936,13.203395159,9.3611373083,19.686332041,35,1.2504802822,3.8422578504,20.936812323
1,3,2002,1753,1446,2595,2335,163,307,2758,3095,148031,11.967218151,9.8714189653,17.715305819,30,1.1127533135,2.0957991856,18.828059133
1,3,2003,1795,1472,2931,2359,109,323,3040,3471,151502,11.985323821,9.8286332391,19.57046469,108,0.7277996081,2.1566905817,20.298264298
1,3,2004,1846,1553,4392,2198,138,293,4530,4774,156276,11.995659209,10.091689464,28.540051596,-49,0.8967502551,1.9039697444,29.436801851
1,3,2005,2025,1529,5185,2186,129,496,5314,5873,162149,12.718850593,9.6035173118,32.566538431,63,0.8102378896,3.115333281,33.376776321
1,3,2006,2199,1630,5304,2166,139,569,5443,6005,168154,13.315047093,9.8697256761,32.115966249,-7,0.8416514534,3.445321417,32.957617703
1,3,2007,2199,1653,2932,2333,117,546,3049,3594,171748,12.939023601,9.7263328842,17.252031468,-1,0.688433725,3.2126907167,17.940465193
1,3,2008,2267,1672,2055,2333,119,595,2174,2691,174439,13.096967824,9.6595192772,11.872196241,-78,0.6874897093,3.4374485466,12.55968595
1,5,2001,429,323,-205,2701,44,106,-161,178,29210,14.731636963,11.091652072,-7.039593421,233,1.5109371244,3.6399848906,-5.528656296
1,5,2002,377,334,-212,2893,41,43,-171,56,29266,12.894178808,11.423489979,-7.250837951,184,1.402284698,1.4706888296,-5.848553253
1,5,2003,360,296,-92,3149,33,64,-59,175,29441,12.26429557,10.083976357,-3.134208868,170,1.1242270939,2.1803192124,-2.009981774
1,5,2004,313,284,-290,3162,35,29,-255,-39,29402,10.638478664,9.6528049216,-9.85673742,187,1.1896062403,0.985673742,-8.66713118
1,5,2005,369,301,-318,3162,33,68,-285,-30,29372,12.556572634,10.24262429,-10.82111138,187,1.1229455201,2.3139483445,-9.698165856
1,5,2006,363,308,-229,3167,35,55,-194,48,29420,12.34861886,10.477616002,-7.790175534,187,1.1906381821,1.8710028575,-6.599537352
1,5,2007,396,299,-266,3148,30,97,-236,40,29460,13.451086957,10.15625,-9.035326087,179,1.0190217391,3.2948369565,-8.016304348
1,5,2008,329,299,-203,3148,30,30,-173,-151,29309,11.196379043,10.175432626,-6.908404091,-8,1.0209464173,1.0209464173,-5.887457673
1,7,2001,272,193,918,1198,6,79,924,1005,20942,13.307566232,9.4425010397,44.913036033,2,0.2935492551,3.8650651924,45.206585288
1,7,2002,296,214,-24,1234,4,82,-20,41,20983,14.12045319,10.208706023,-1.14490161,-21,0.190816935,3.9117471676,-0.954084675
1,7,2003,247,221,54,1217,2,26,56,55,21038,11.756026749,10.518550249,2.5701434997,-27,0.0951905,1.2374764998,2.6653339997
1,7,2004,275,235,141,1297,7,40,148,171,21209,13.018675882,11.125050299,6.6750301797,-17,0.331384477,1.8936255829,7.0064146567
1,7,2005,251,219,148,1299,5,32,153,166,21375,11.788465151,10.285553259,6.9509674995,-19,0.2348299831,1.5029118918,7.1857974826
1,7,2006,268,233,-101,1300,7,35,-94,-68,21307,12.557986973,10.917951361,-4.732674195,-9,0.3280071224,1.6400356122,-4.404667073
1,7,2007,252,217,133,1297,5,35,138,176,21483,11.77845291,10.142556672,6.2164057023,3,0.2336994625,1.6358962374,6.4501051648
1,7,2008,257,218,92,1297,5,39,97,146,21629,11.922434589,10.113193542,4.2679532381,10,0.2319539803,1.8092410466,4.4999072184
1,9,2001,687,480,536,610,97,207,633,802,51979,13.319632401,9.3062933809,10.392027609,-38,1.8806467874,4.0133390205,12.272674396
1,9,2002,677,511,535,610,94,166,629,758,52737,12.930211238,9.7597310822,10.218113755,-37,1.7953321364,3.1704801559,12.013445892
1,9,2003,661,556,767,610,75,105,842,923,53660,12.425162364,10.451422503,14.417699747,-24,1.4098141865,1.9737398611,15.827513934
1,9,2004,689,514,517,610,79,175,596,721,54381,12.754417305,9.5149063781,9.5704408512,-50,1.4624077896,3.2395109264,11.032848641
1,9,2005,685,542,362,610,80,143,442,534,54915,12.53476797,9.9180207876,6.624213146,-51,1.4639145074,2.616747182,8.0881276533
1,9,2006,675,546,609,610,83,129,692,793,55708,12.203610461,9.871364906,11.010368549,-28,1.5005921011,2.3322455547,12.51096065
1,9,2007,724,534,509,610,74,190,583,794,56502,12.904375724,9.5178682827,9.0722751983,21,1.3189555298,3.3865074414,10.391230728
1,9,2008,729,554,668,610,74,175,742,939,57441,12.79587162,9.7241603258,11.725160826,22,1.2988950616,3.0717112942,13.024055888
1,11,2001,167,137,-289,1504,40,30,-249,-226,11377,14.53437772,11.923411662,-25.15230635,-7,3.4812880766,2.6109660574,-21.67101828
1,11,2002,147,147,-156,1541,36,0,-120,-126,11251,12.992752342,12.992752342,-13.78822698,-6,3.1818985328,0,-10.60632844
1,11,2003,140,129,12,1642,32,11,44,40,11291,12.421258096,11.445302103,1.0646792654,-15,2.8391447077,0.9759559933,3.903823973
1,11,2004,144,129,-306,1523,33,15,-273,-273,11018,12.909588059,11.564839303,-27.43287462,-15,2.9584472634,1.3447487561,-24.47442736
1,11,2005,165,134,-132,1608,32,31,-100,-75,10943,15.026638131,12.203451573,-12.0213105,-6,2.9142570921,2.823186558,-9.107053413
1,11,2006,205,131,-326,1485,32,74,-294,-224,10719,18.927153541,12.09491275,-30.09879051,-4,2.9544825039,6.8322407903,-27.144308
1,11,2007,171,112,115,1632,30,59,145,194,10913,15.809911243,10.355029586,10.63239645,-10,2.7736686391,5.4548816568,13.406065089
1,11,2008,155,114,-176,1632,29,41,-147,-117,10796,14.279791791,10.502556543,-16.21447326,-11,2.6717029803,3.7772352481,-13.54277028
1,13,2001,293,259,-301,265,3,34,-298,-278,21036,13.837072019,12.231404959,-14.21487603,-14,0.1416765053,1.6056670602,-14.07319953
1,13,2002,264,322,-360,265,2,-58,-358,-429,20607,12.679201787,15.464783997,-17.28982062,-13,0.096054559,-2.785582211,-17.19376606
1,13,2003,270,291,-23,265,-1,-21,-24,-71,20536,13.124954427,14.145784216,-1.118051673,-26,-0.048610942,-1.020829789,-1.166662616
1,13,2004,274,294,-31,265,5,-20,-26,-60,20476,13.361942846,14.337267141,-1.511752658,-14,0.2438310738,-0.975324295,-1.267921584
1,13,2005,244,292,-78,265,2,-48,-76,-140,20336,11.95726747,14.309516809,-3.822405175,-16,0.0980103891,-2.352249338,-3.724394786
1,13,2006,281,291,-122,265,4,-10,-118,-138,20198,13.864903538,14.358316475,-6.019637835,-10,0.1973651749,-0.493412937,-5.82227266
1,13,2007,300,269,-45,265,0,31,-45,-21,20177,14.860681115,13.325077399,-2.229102167,-7,0,1.5356037152,-2.229102167
1,13,2008,287,283,-86,265,0,4,-86,-87,20090,14.254848884,14.056175032,-4.271487819,-5,0,0.198673852,-4.271487819
1,15,2001,1561,1388,-481,2418,60,173,-421,-345,111001,14.041115913,12.484989678,-4.326570631,-97,0.5396969602,1.5561262351,-3.78687367
1,15,2002,1492,1321,-311,2379,49,171,-262,-187,110814,13.452651985,11.91082659,-2.804138584,-96,0.4418096161,1.541825395,-2.362328968
1,15,2003,1413,1213,400,2489,27,200,427,494,111308,12.722737955,10.921925789,3.6016243326,-133,0.2431096424,1.8008121663,3.844733975
1,15,2004,1521,1313,24,2713,55,208,79,212,111520,13.651785233,11.784874432,0.2154127847,-75,0.4936542984,1.8669108012,0.7090670831
1,15,2005,1514,1345,322,2791,43,169,365,433,111953,13.549735315,12.037248348,2.8817799018,-101,0.384833962,1.5124869671,3.2666138639
1,15,2006,1490,1371,511,2779,53,119,564,628,112581,13.27193209,12.211958991,4.5516491934,-55,0.4720888596,1.0599730998,5.023738053
1,15,2007,1505,1296,3,2701,44,209,47,275,112856,13.351845527,11.497668972,0.0266149745,19,0.3903529589,1.8541765549,0.4169679334
1,15,2008,1544,1317,228,2701,45,227,273,563,113419,13.647110816,11.640702685,2.015246934,63,0.3977461054,2.0064081317,2.4129930394
1,17,2001,460,508,-250,518,17,-48,-233,-311,36251,12.635106368,13.95355225,-6.866905635,-30,0.4669495832,-1.318445882,-6.399956052
1,17,2002,429,467,-279,518,16,-38,-263,-329,35922,11.888102199,12.941127568,-7.731423108,-28,0.443379103,-1.05302537,-7.288044005
1,17,2003,446,460,-292,518,14,-14,-278,-328,35594,12.472733374,12.864254153,-8.16600481,-36,0.3915207786,-0.391520779,-7.774484032
1,17,2004,436,451,-216,518,18,-15,-198,-241,35353,12.290865012,12.713715872,-6.089052391,-28,0.5074210326,-0.422850861,-5.581631359
1,17,2005,415,480,-136,518,16,-65,-120,-217,35136,11.774886862,13.61914625,-3.858758104,-32,0.4539715417,-1.844259388,-3.404786562
1,17,2006,395,487,-282,518,19,-92,-263,-369,34767,11.301374762,13.933593694,-8.068323248,-14,0.5436104316,-2.632218932,-7.524712816
1,17,2007,414,445,-43,518,15,-31,-28,-54,34713,11.917098446,12.809441566,-1.237766264,5,0.4317789292,-0.89234312,-0.805987334
1,17,2008,424,462,-285,518,15,-38,-270,-289,34424,12.26550183,13.364768503,-8.244500051,19,0.4339210553,-1.099266673,-7.810578995
1,19,2001,286,237,-17,360,15,49,-2,21,24073,11.885714286,9.8493506494,-0.706493506,-26,0.6233766234,2.0363636364,-0.083116883
1,19,2002,268,292,92,360,12,-24,104,60,24133,11.118947849,12.114674522,3.8169522466,-20,0.4978633365,-0.995726673,4.3148155831
1,19,2003,262,276,43,360,9,-14,52,9,24142,10.854479544,11.434489902,1.7814603832,-29,0.3728638011,-0.580010357,2.1543241844
1,19,2004,267,304,175,360,13,-37,188,129,24271,11.030095222,12.558610291,7.2294631607,-22,0.5370458348,-1.528515068,7.7665089955
1,19,2005,253,271,0,360,11,-18,11,-29,24242,10.430193969,11.172263105,0,-22,0.4534866943,-0.742069136,0.4534866943
1,19,2006,262,266,247,360,13,-4,260,243,24485,10.753791532,10.917971556,10.138116445,-13,0.533585076,-0.164180023,10.671701521
1,19,2007,264,297,47,360,11,-33,58,29,24514,10.775730117,12.122696382,1.9184064981,4,0.4489887549,-1.346966265,2.367395253
1,19,2008,254,297,45,360,11,-43,56,31,24545,10.354878819,12.107870116,1.8345257751,18,0.4484396339,-1.752991296,2.282965409
1,21,2001,556,377,60,351,48,179,108,246,40024,13.934487857,9.4483847523,1.5037217112,-41,1.202977369,4.4861031052,2.7066990802
1,21,2002,505,408,310,351,47,97,357,425,40449,12.550793434,10.140046972,7.7044474544,-29,1.1680936463,2.4107464615,8.8725411007
1,21,2003,554,437,195,351,28,117,223,294,40743,13.646664696,10.76460735,4.8034289093,-46,0.6897231254,2.8820573456,5.4931520347
1,21,2004,530,457,306,351,31,73,337,374,41117,12.94893721,11.165404349,7.4761788419,-36,0.757390667,1.783532861,8.2335695089
1,21,2005,558,468,234,351,30,90,264,314,41431,13.519406891,11.338857392,5.669428696,-40,0.7268498328,2.1805494985,6.3962785289
1,21,2006,537,443,134,351,32,94,166,241,41672,12.923721165,10.661468298,3.2249136614,-19,0.7701286355,2.2622528669,3.9950422969
1,21,2007,566,446,376,351,25,120,401,524,42196,13.497400677,10.635760958,8.9664711213,3,0.5961749416,2.8616397196,9.5626460629
1,21,2008,573,424,77,351,25,149,102,248,42444,13.539697543,10.018903592,1.8194706994,-3,0.5907372401,3.5207939509,2.4102079395
1,23,2001,195,162,-225,133,4,33,-221,-201,15650,12.380559347,10.285387765,-14.28526079,-13,0.2539601917,2.0951715819,-14.03130059
1,23,2002,204,184,-327,133,3,20,-324,-317,15333,13.168511765,11.877481199,-21.10834974,-13,0.1936545848,1.2910305651,-20.91469516
1,23,2003,193,168,-198,133,-2,25,-200,-186,15147,12.664041995,11.023622047,-12.99212598,-11,-0.131233596,1.6404199475,-13.12335958
1,23,2004,166,176,-264,133,3,-10,-261,-286,14861,11.063716342,11.730205279,-17.59530792,-15,0.1999466809,-0.666488936,-17.39536124
1,23,2005,181,184,-394,133,1,-3,-393,-404,14457,12.347363395,12.552015826,-26.87768606,-8,0.0682174773,-0.204652432,-26.80946859
1,23,2006,169,155,-117,133,3,14,-114,-108,14349,11.733666597,10.761646879,-8.123307644,-8,0.2082899396,0.9720197181,-7.915017705
1,23,2007,161,187,-161,133,0,-26,-161,-182,14167,11.291906298,13.115443961,-11.2919063,5,0,-1.823537663,-11.2919063
1,23,2008,160,192,-78,133,0,-32,-78,-112,14055,11.338671958,13.60640635,-5.52760258,-2,0,-2.267734392,-5.52760258
1,25,2001,432,295,-319,387,0,137,-319,-205,27627,15.579076435,10.638489695,-11.50399394,-23,0,4.9405867398,-11.50399394
1,25,2002,363,305,-410,387,0,58,-410,-366,27261,13.226934849,11.1135403,-14.93951319,-14,0,2.1133945489,-14.93951319
1,25,2003,351,257,-270,387,-1,94,-271,-200,27061,12.922940982,9.4620963882,-9.940723832,-23,-0.036817496,3.4608445934,-9.977541328
1,25,2004,351,293,-169,387,0,58,-169,-132,26929,13.002407853,10.853861826,-6.260418596,-21,0,2.148546027,-6.260418596
1,25,2005,349,269,-261,387,0,80,-261,-206,26723,13.009766644,10.027585179,-9.729367032,-25,0,2.9821814657,-9.729367032
1,25,2006,316,305,8,387,0,11,8,6,26729,11.823692285,11.41210806,0.2993339819,-13,0,0.4115842251,0.2993339819
1,25,2007,318,259,-322,387,0,59,-322,-260,26469,11.955336667,9.7372081657,-12.10571826,3,0,2.2181285011,-12.10571826
1,25,2008,329,289,-203,387,-1,40,-204,-165,26304,12.468497148,10.952570443,-7.693328028,-1,-0.037898168,1.5159267049,-7.731226195
1,27,2001,190,169,-20,266,4,21,-16,-8,14256,13.32398317,11.851332398,-1.402524544,-13,0.2805049088,1.4726507714,-1.122019635
1,27,2002,164,170,-72,266,3,-6,-69,-88,14168,11.539544047,11.961722488,-5.066141289,-13,0.2110892204,-0.422178441,-4.855052069
1,27,2003,130,172,-54,266,1,-42,-53,-110,14058,9.2113654078,12.187345001,-3.826259477,-15,0.070856657,-2.975979593,-3.75540282
1,27,2004,159,193,-89,266,4,-34,-85,-131,13927,11.363230302,13.793103448,-6.360550295,-12,0.285867429,-2.429873146,-6.074682866
1,27,2005,125,173,-37,266,2,-48,-35,-96,13831,9.0064125657,12.464874991,-2.665898119,-13,0.1441026011,-3.458462425,-2.521795518
1,27,2006,167,180,-43,266,3,-13,-40,-59,13772,12.100134043,13.042060646,-3.115603376,-6,0.2173676774,-0.941926602,-2.898235699
1,27,2007,154,166,26,266,2,-12,28,22,13794,11.173184358,12.0438221,1.8863817746,6,0.1451062904,-0.870637742,2.031488065
1,27,2008,140,158,26,266,1,-18,27,15,13809,10.143824947,11.448031011,1.8838532044,6,0.0724558925,-1.304206065,1.9563090968
1,29,2001,188,141,-7,113,14,47,7,39,14194,13.263254436,9.9474408268,-0.49384458,-15,0.9876891601,3.3158136089,0.4938445801
1,29,2002,161,158,173,113,11,3,184,178,14372,11.272141707,11.062101799,12.112301337,-9,0.7701463278,0.2100399076,12.882447665
1,29,2003,154,194,48,113,10,-40,58,2,14374,10.714534196,13.497530091,3.3395950741,-16,0.6957489738,-2.782995895,4.0353440479
1,29,2004,170,176,-105,113,11,-6,-94,-114,14260,11.873995949,12.293078159,-7.333938674,-14,0.7683173849,-0.41908221,-6.565621289
1,29,2005,175,167,5,113,11,8,16,13,14273,12.26649844,11.705744226,0.350471384,-11,0.7710370448,0.5607542144,1.1215084288
1,29,2006,179,153,164,113,11,26,175,194,14467,12.456506611,10.647181628,11.412665275,-7,0.7654836465,1.8093249826,12.178148921
1,29,2007,182,168,210,113,11,14,221,235,14702,12.47900168,11.519078474,14.398848092,0,0.7542253763,0.9599232061,15.153073468
1,29,2008,186,185,89,113,10,1,99,97,14799,12.609742043,12.541947731,6.0336937731,-3,0.6779431206,0.0677943121,6.7116368937
1,31,2001,540,444,-60,779,41,96,-19,36,43579,12.396409632,10.192603476,-1.377378848,-41,0.9412088795,2.2038061569,-0.436169969
1,31,2002,525,433,150,778,-29,92,121,175,43754,12.022946652,9.9160683819,3.435127615,-38,-0.664124672,2.1068782705,2.7710029428
1,31,2003,556,452,486,772,-145,104,341,423,44177,12.646279469,10.280788345,11.054121982,-22,-3.298040509,2.3654911237,7.756081473
1,31,2004,565,497,377,681,114,68,491,517,44694,12.715058906,11.184750931,8.4842074467,-42,2.5655163102,1.5303079745,11.049723757
1,31,2005,589,457,335,705,12,132,347,439,45133,13.114097098,10.175114387,7.4587818807,-40,0.2671802465,2.9389827112,7.7259621272
1,31,2006,582,476,293,754,78,106,371,455,45588,12.830546401,10.493711489,6.459364425,-22,1.719557765,2.3368349114,8.17892219
1,31,2007,636,474,964,780,24,162,988,1165,46753,13.77502951,10.266295578,20.87913278,15,0.5198124343,3.5087339318,21.398945214
1,31,2008,642,485,801,780,36,157,837,1000,47753,13.586438956,10.263898588,16.951304679,6,0.7618563901,3.3225403678,17.713161069
1,33,2001,612,654,-105,592,15,-42,-90,-188,54837,11.141249932,11.905845515,-1.911488959,-56,0.2730698513,-0.764595584,-1.638419108
1,33,2002,648,586,-273,592,13,62,-260,-251,54586,11.843945057,10.710728092,-4.989810186,-53,0.2376100089,1.1332169654,-4.752200177
1,33,2003,605,646,-170,592,5,-41,-165,-280,54306,11.111927414,11.864967123,-3.122359769,-74,0.0918341109,-0.753039709,-3.030525658
1,33,2004,560,596,171,592,13,-36,184,105,54411,10.301976692,10.964246622,3.1457821684,-43,0.2391530303,-0.66226993,3.3849351987
1,33,2005,630,633,9,592,10,-3,19,-36,54375,11.582372732,11.637526888,0.1654624676,-52,0.1838471862,-0.055154156,0.3493096538
1,33,2006,598,636,108,592,13,-38,121,57,54432,10.991939857,11.690424329,1.9851663955,-26,0.2389552143,-0.698484473,2.2241216098
1,33,2007,633,654,90,592,11,-21,101,87,54519,11.619902525,12.005396922,1.6521188424,7,0.2019256363,-0.385494397,1.8540444787
1,33,2008,625,640,146,592,11,-15,157,144,54663,11.448773607,11.723544174,2.6744335147,2,0.2014984155,-0.274770567,2.8759319302
1,35,2001,199,159,-178,79,3,40,-175,-146,13894,14.247869979,11.383976516,-12.74432591,-11,0.2147920097,2.8638934632,-12.5295339
1,35,2002,162,164,-187,79,3,-2,-184,-195,13699,11.742108506,11.887072808,-13.55416229,-9,0.2174464538,-0.144964303,-13.33671583
1,35,2003,172,174,-260,79,3,-2,-257,-263,13436,12.677353971,12.824765064,-19.16344205,-4,0.221116639,-0.147411093,-18.94232541
1,35,2004,153,187,-154,79,2,-34,-152,-198,13238,11.471845243,14.021144185,-11.54682462,-12,0.1499587613,-2.549298943,-11.39686586
1,35,2005,148,179,-23,79,3,-31,-20,-61,13177,11.205754306,13.552905546,-1.741434791,-10,0.2271436684,-2.34715124,-1.514291122
1,35,2006,175,153,112,79,4,22,116,132,13309,13.21452843,11.553273427,8.4572981953,-6,0.3020463641,1.6612550026,8.7593445594
1,35,2007,171,161,-173,79,5,10,-168,-159,13150,12.925658566,12.1697721,-13.07683586,-1,0.3779432329,0.7558864659,-12.69889263
1,35,2008,160,175,-70,79,4,-15,-66,-84,13066,12.206286237,13.350625572,-5.340250229,-3,0.3051571559,-1.144339335,-5.035093073
1,37,2001,112,113,-86,75,1,-1,-85,-97,11765,9.4806788843,9.5653278029,-7.279807,-11,0.0846489186,-0.084648919,-7.195158082
1,37,2002,121,119,-201,76,0,2,-201,-207,11558,10.376023668,10.204519144,-17.2362046,-8,0,0.1715045234,-17.2362046
1,37,2003,121,125,-96,75,-1,-4,-97,-114,11444,10.520824276,10.86862012,-8.347100252,-13,-0.086948961,-0.347795844,-8.434049213
1,37,2004,134,143,-244,75,2,-9,-242,-264,11180,11.84582744,12.641442716,-21.57001414,-13,0.1768033946,-0.795615276,-21.39321075
1,37,2005,94,152,-123,75,0,-58,-123,-191,10989,8.4803103433,13.712842257,-11.0965763,-10,0,-5.232531914,-11.0965763
1,37,2006,89,131,-64,75,1,-42,-63,-109,10880,8.1393753715,11.980428918,-5.853033975,-4,0.0914536559,-3.841053546,-5.761580319
1,37,2007,110,120,-31,79,1,-10,-30,-42,10838,10.129846211,11.050741321,-2.854774841,-2,0.092089511,-0.92089511,-2.76268533
1,37,2008,105,124,-2,79,0,-19,-2,-24,10814,9.6988730833,11.45390726,-0.18474044,-3,0,-1.755034177,-0.18474044
1,39,2001,433,484,-489,523,17,-51,-472,-551,36939,11.635249701,13.005683269,-13.1400395,-28,0.4568111892,-1.370433568,-12.68322831
1,39,2002,425,493,-191,523,14,-68,-177,-279,36660,11.54906996,13.396921154,-5.190287912,-34,0.3804399516,-1.847851194,-4.80984796
1,39,2003,464,517,-67,523,5,-53,-62,-169,36491,12.686087682,14.135145111,-1.831827316,-54,0.1367035311,-1.449057429,-1.695123785
1,39,2004,455,503,-119,523,18,-48,-101,-174,36317,12.498626525,13.817162949,-3.268871553,-25,0.4944511592,-1.318536425,-2.774420393
1,39,2005,465,495,322,523,12,-30,334,269,36586,12.75667668,13.579688079,8.8336556795,-35,0.3292045595,-0.823011399,9.1628602389
1,39,2006,467,558,287,523,16,-91,303,195,36781,12.730519171,15.211198495,7.8236809465,-17,0.4361633977,-2.480679324,8.2598443442
1,39,2007,464,488,169,523,9,-24,178,161,36942,12.587659211,13.238745032,4.5847293246,7,0.244157183,-0.651085821,4.8288865076
1,39,2008,479,502,-87,523,9,-23,-78,-86,36856,12.981381609,13.604704735,-2.357787474,15,0.243909049,-0.623323125,-2.113878425
1,41,2001,171,167,13,160,0,4,13,5,13701,12.48311859,12.191115816,0.9490090156,-12,0,0.292002774,0.9490090156
1,41,2002,179,189,-95,160,-1,-10,-96,-119,13582,13.121724151,13.854781366,-6.964043544,-13,-0.073305722,-0.733057215,-7.037349265
1,41,2003,164,196,35,160,-2,-32,33,-16,13566,12.08192132,14.439369383,2.5784588183,-17,-0.147340504,-2.357448062,2.4311183144
1,41,2004,184,174,39,160,2,10,41,41,13607,13.54285504,12.806830309,2.8704964487,-10,0.1472049461,0.7360247304,3.0177013948
1,41,2005,159,168,-39,160,0,-9,-39,-58,13549,11.710119311,12.372956253,-2.872293416,-10,0,-0.662836942,-2.872293416
1,41,2006,156,183,170,160,2,-27,172,139,13688,11.455006058,13.43760326,12.483019422,-6,0.146859052,-1.982597202,12.629878474
1,41,2007,178,157,63,160,0,21,63,78,13766,12.967145043,11.437313324,4.5894951555,-6,0,1.5298317185,4.5894951555
1,41,2008,188,159,-35,160,0,29,-35,-12,13754,13.662790698,11.555232558,-2.543604651,-6,0,2.1075581395,-2.543604651
1,43,2001,993,860,-76,998,96,133,20,74,77652,12.793918701,11.08033241,-0.979192166,-79,1.2368743155,1.7135862913,0.2576821491
1,43,2002,966,927,81,998,90,39,171,138,77790,12.429073223,11.927278342,1.0421893697,-72,1.1579881885,0.5017948817,2.2001775582
1,43,2003,932,886,262,998,71,46,333,272,78062,11.960064677,11.369761055,3.3621641044,-107,0.9111208069,0.5903036214,4.2732849113
1,43,2004,998,890,451,998,73,108,524,569,78631,12.738284416,11.359792716,5.7564792301,-63,0.9317582789,1.3784917003,6.688237509
1,43,2005,933,908,608,998,75,25,683,637,79268,11.817680923,11.501022806,7.7011254029,-71,0.9499743507,0.3166581169,8.6510997536
1,43,2006,998,894,288,998,77,104,365,429,79697,12.556223068,11.247758941,3.6234391218,-40,0.9687667097,1.3084641273,4.5922058315
1,43,2007,1001,937,568,998,65,64,633,710,80407,12.504372158,11.70489182,7.0953879978,13,0.8119722181,0.7994803378,7.9073602159
1,43,2008,1010,905,701,998,65,105,766,917,81324,12.489875163,11.191422795,8.668715336,46,0.8038038471,1.2984523684,9.4725191831
1,45,2001,799,442,-420,1665,24,357,-396,-80,48990,16.296145217,9.0148888436,-8.566183969,-41,0.4894962268,7.2812563736,-8.076687742
1,45,2002,726,442,-46,1665,-130,284,-176,60,49050,14.810281518,9.0167278662,-0.938392493,-48,-2.651978784,5.7935536516,-3.590371277
1,45,2003,756,469,123,1665,-386,287,-263,-40,49010,15.419131144,9.5655720987,2.5086681623,-64,-7.872730981,5.8535590455,-5.364062819
1,45,2004,744,464,-797,1665,195,280,-602,-377,48633,15.239187653,9.504009504,-16.32477495,-55,3.9941419252,5.735178149,-12.33063302
1,45,2005,777,426,-674,1665,-39,351,-713,-398,48235,16.042449519,8.7954742536,-13.91584424,-36,-0.805219474,7.2469752653,-14.72106372
1,45,2006,758,495,-592,1665,108,263,-484,-242,47993,15.754250322,10.288065844,-12.30411107,-21,2.2446689113,5.4661844785,-10.05944216
1,45,2007,736,426,-133,1665,-9,310,-142,153,48146,15.311164044,8.8621683188,-2.766827198,-15,-0.187228908,6.4489957249,-2.954056106
1,45,2008,717,464,-115,1665,18,253,-97,146,48292,14.869657189,9.6227628113,-2.38495199,-10,0.3732968332,5.2468943777,-2.011655157
1,47,2001,812,542,-506,568,2,270,-504,-272,45922,17.629944852,11.767771071,-10.9861479,-38,0.0434235095,5.8621737809,-10.94272439
1,47,2002,705,571,-1087,546,1,134,-1086,-967,44955,15.515476963,12.566435952,-23.92244462,-15,0.0220077687,2.9490410115,-23.90043685
1,47,2003,706,522,-592,546,-1,184,-593,-438,44517,15.781473534,11.668454936,-13.23319027,-29,-0.022353362,4.113018598,-13.25554363
1,47,2004,708,589,-650,546,3,119,-647,-572,43945,16.006873008,13.316452262,-14.6955755,-44,0.0678257331,2.6904207456,-14.62774977
1,47,2005,654,565,-619,546,1,89,-618,-566,43379,14.978700014,12.940314232,-14.17708763,-37,0.022903211,2.0383857817,-14.15418442
1,47,2006,660,570,-243,546,3,90,-240,-169,43210,15.244430586,13.165644597,-5.61272217,-19,0.0692928663,2.078785989,-5.543429304
1,47,2007,667,566,-335,546,1,101,-334,-219,42991,15.475458521,13.132098236,-7.772531641,14,0.023201587,2.3433602858,-7.749330054
1,47,2008,672,556,-270,546,1,116,-269,-124,42867,15.653753873,12.951617788,-6.289454681,29,0.0232942766,2.7021360852,-6.266160404
1,49,2001,942,698,483,864,187,244,670,861,65488,14.479498905,10.728970526,7.4242016678,-53,2.8743803558,3.7505283787,10.298582024
1,49,2002,932,630,-442,864,172,302,-270,-18,65470,14.233571069,9.6214053361,-6.750255807,-50,2.6267963775,4.6121657325,-4.12345943
1,49,2003,919,666,106,864,148,253,254,416,65886,13.992508907,10.140381863,1.6139346509,-91,2.2534181918,3.8521270441,3.8673528427
1,49,2004,1002,706,116,864,141,296,257,507,66393,15.14979702,10.67440788,1.7538687169,-46,2.1318576645,4.4753891396,3.8857263814
1,49,2005,992,696,-118,864,147,296,29,264,66657,14.911687336,10.462232244,-1.77376926,-61,2.2096956032,4.4494550921,0.4359263435
1,49,2006,978,754,114,864,149,224,263,454,67111,14.6223312,11.273249208,1.7044435141,-33,2.2277375755,3.3490819927,3.9321810896
1,49,2007,982,685,269,864,132,297,401,713,67824,14.555156186,10.153036647,3.9871049024,15,1.9564975729,4.402119539,5.9436024753
1,49,2008,1003,694,213,864,132,309,345,691,68515,14.713324874,10.180505945,3.1245645047,37,1.9363498339,4.5328189293,5.0609143385
1,51,2001,1022,528,881,5745,10,494,891,1338,67570,15.276303792,7.8922587106,13.168711977,-47,0.1494745968,7.3840450815,13.318186574
1,51,2002,897,491,910,5880,-23,406,887,1256,68826,13.152878384,7.1996246224,13.343499809,-37,-0.337253292,5.9532537611,13.006246517
1,51,2003,925,619,1118,5960,-76,306,1042,1331,70157,13.31098048,8.9075642345,16.088298569,-17,-1.093658937,4.4034162452,14.994639632
1,51,2004,948,626,831,6036,46,322,877,1129,71286,13.404693057,8.8516222082,11.750316382,-70,0.6504386926,4.5530708483,12.400755074
1,51,2005,994,628,1669,6023,-3,366,1666,1968,73254,13.753978138,8.6896360869,23.093953231,-64,-0.041511,5.0643420506,23.052442231
1,51,2006,998,603,1746,6042,28,395,1774,2128,75382,13.428779031,8.1137813181,23.493635458,-41,0.3767593315,5.3149977125,23.87039479
1,51,2007,1039,634,1530,6024,4,405,1534,1976,77358,13.604818646,8.301689145,20.034044782,37,0.0523765877,5.3031295011,20.08642137
1,51,2008,1110,660,256,6024,9,450,265,748,78106,14.279833273,8.490711676,3.2933669531,33,0.1157824319,5.7891215973,3.4091493851
1,53,2001,532,393,-81,3134,11,139,-70,30,38432,13.848036026,10.229846162,-2.108441575,-39,0.286331572,3.6181898639,-1.822110003
1,53,2002,507,430,-161,3151,10,77,-151,-109,38323,13.210865742,11.204481793,-4.195166439,-35,0.260569344,2.0063839489,-3.934597095
1,53,2003,495,434,-323,3228,6,61,-317,-291,38032,12.965752079,11.367952328,-8.46048065,-35,0.1571606313,1.5977997512,-8.303320018
1,53,2004,489,409,-200,3140,10,80,-190,-139,37893,12.881132697,10.773789924,-5.268356931,-29,0.2634178466,2.1073427725,-5.004939085
1,53,2005,484,493,-211,3213,8,-9,-203,-245,37648,12.81423333,13.052514529,-5.586370315,-33,0.2118055096,-0.238281198,-5.374564806
1,53,2006,487,421,-177,3231,10,66,-167,-118,37530,12.955917955,11.200085131,-4.70882439,-17,0.2660352763,1.7558328234,-4.442789114
1,53,2007,515,404,-70,3202,6,111,-64,27,37557,13.717421125,10.760850746,-1.864503842,-20,0.159814615,2.9565703784,-1.704689227
1,53,2008,485,419,-120,3202,6,66,-114,-67,37490,12.92523352,11.166335763,-3.197995923,-19,0.1598997961,1.7588977574,-3.038096126
1,55,2001,1365,1351,-441,2040,92,14,-349,-426,102882,13.240215335,13.104418255,-4.277608031,-91,0.8923808138,0.1357970804,-3.385227218
1,55,2002,1310,1299,-132,2038,84,11,-48,-133,102749,12.741269556,12.634281796,-1.283853116,-96,0.8169974372,0.1069877596,-0.466855678
1,55,2003,1215,1330,41,2047,68,-115,109,-152,102597,11.833685584,12.95374636,0.3993260156,-146,0.6622968064,-1.120060775,1.061622822
1,55,2004,1240,1347,31,2060,71,-107,102,-72,102525,12.090365734,13.133647293,0.3022591433,-67,0.6922709412,-1.043281559,0.9945300845
1,55,2005,1228,1362,68,2050,72,-134,140,-92,102433,11.982942847,13.290527815,0.6635505811,-98,0.7025829682,-1.307584969,1.3661335493
1,55,2006,1259,1383,416,2062,74,-124,490,318,102751,12.27191204,13.480583281,4.054897068,-48,0.7213038054,-1.208671241,4.7762008734
1,55,2007,1329,1341,249,2067,66,-12,315,329,103080,12.913506712,13.030107224,2.4194606255,26,0.6413028164,-0.116600512,3.0607634419
1,55,2008,1283,1326,128,2067,66,-43,194,223,103303,12.433194595,12.849895582,1.2404122433,72,0.6395875629,-0.416700988,1.8799998062
1,57,2001,231,208,-127,340,6,23,-121,-115,18342,12.554688986,11.304655018,-6.902361477,-17,0.3260958178,1.2500339683,-6.576265659
1,57,2002,193,236,-39,340,5,-43,-34,-95,18247,10.549618738,12.900051928,-2.131788242,-18,0.2733061849,-2.35043319,-1.858482057
1,57,2003,194,205,-69,340,3,-11,-66,-100,18147,10.661097983,11.26559323,-3.791833819,-23,0.1648623399,-0.604495246,-3.626971479
1,57,2004,192,243,-87,340,6,-51,-81,-144,18003,10.622406639,13.443983402,-4.813278008,-12,0.3319502075,-2.821576763,-4.481327801
1,57,2005,184,240,82,340,4,-56,86,13,18016,10.216830006,13.326300008,4.5531525028,-17,0.2221050001,-3.109470002,4.775257503
1,57,2006,165,211,-204,340,5,-46,-199,-251,17765,9.2227718622,11.793968866,-11.40269976,-6,0.2794779352,-2.571197004,-11.12322182
1,57,2007,181,217,-132,340,5,-36,-127,-154,17611,10.232926278,12.268204432,-7.462686567,9,0.2826775215,-2.035278155,-7.180009046
1,57,2008,178,197,92,340,4,-19,96,80,17691,10.084414481,11.160840746,5.2121692822,3,0.2266160557,-1.076426265,5.4387853379
1,59,2001,469,349,-343,402,123,120,-220,-121,31084,15.058838639,11.205830885,-11.0131805,-21,3.949332948,3.8530077542,-7.063847549
1,59,2002,404,381,-509,402,121,23,-388,-377,30707,13.076337978,12.331892994,-16.47489117,-12,3.9164279588,0.7444449839,-12.55846321
1,59,2003,448,385,-262,402,106,63,-156,-120,30587,14.618070284,12.56240415,-8.548960747,-27,3.458739844,2.0556661337,-5.090220903
1,59,2004,393,389,-270,402,98,4,-172,-194,30393,12.889471958,12.758281404,-8.855362414,-26,3.2141685799,0.1311905543,-5.641193834
1,59,2005,442,358,-81,402,103,84,22,78,30471,14.524185068,11.763932702,-2.661671924,-28,3.384595163,2.7602523659,0.7229232387
1,59,2006,486,371,-111,402,104,115,-7,94,30565,15.925027852,12.156759945,-3.637197719,-14,3.4078248902,3.7682679075,-0.229372829
1,59,2007,464,356,-393,402,93,108,-300,-189,30376,15.227843324,11.683431516,-12.89772075,3,3.0521323903,3.5444118081,-9.845588356
1,59,2008,441,363,261,402,92,78,353,425,30801,14.417182928,11.867204995,8.5326184677,-6,3.0076662798,2.5499779329,11.540284748
1,61,2001,335,308,-279,274,8,27,-271,-262,25527,13.056356692,12.004053317,-10.87380154,-18,0.3117935926,1.0523033752,-10.56200795
1,61,2002,283,320,-17,274,6,-37,-11,-72,25455,11.101957554,12.553450237,-0.666902044,-24,0.235377192,-1.451492684,-0.431524852
1,61,2003,284,282,53,274,0,2,53,23,25478,11.151905444,11.073370899,2.0811654527,-32,0,0.0785345454,2.0811654527
1,61,2004,306,318,-2,274,11,-12,9,-20,25458,12.015077745,12.486257264,-0.07852992,-17,0.4319145594,-0.471179519,0.3533846395
1,61,2005,281,337,202,274,6,-56,208,126,25584,11.010540339,13.204811724,7.9150503507,-26,0.2351005055,-2.194271384,8.1501508562
1,61,2006,326,353,195,274,9,-27,204,165,25749,12.701381178,13.753336061,7.5974519315,-12,0.3506516276,-1.051954883,7.9481035591
1,61,2007,299,320,-37,274,3,-21,-34,-55,25694,11.624516455,12.440954066,-1.438485314,0,0.1166339444,-0.816437611,-1.321851369
1,61,2008,297,297,186,274,3,0,189,188,25882,11.516984644,11.516984644,7.2126570498,-1,0.1163331782,0,7.328990228
1,63,2001,142,99,-118,78,1,43,-117,-81,9861,14.341261425,9.998485078,-11.91738625,-7,0.1009947988,4.342776347,-11.81639146
1,63,2002,146,111,-49,78,1,35,-48,-23,9838,14.823087466,11.269607594,-4.974871821,-10,0.1015279963,3.5534798721,-4.873343825
1,63,2003,131,125,-143,78,1,6,-142,-142,9696,13.412511518,12.798198014,-14.64113853,-6,0.1023855841,0.6143135047,-14.53875294
1,63,2004,150,118,-183,78,0,32,-183,-163,9533,15.601435332,12.273129128,-19.03375111,-12,0,3.3283062042,-19.03375111
1,63,2005,97,106,-46,78,1,-9,-45,-61,9472,10.207840042,11.154959221,-4.84083136,-7,0.1052354644,-0.947119179,-4.735595896
1,63,2006,130,106,-341,78,0,24,-341,-319,9153,13.959731544,11.382550336,-36.61744966,-2,0,2.5771812081,-36.61744966
1,63,2007,124,102,34,78,1,22,35,51,9204,13.509832761,11.112926949,3.7043089829,-6,0.1089502642,2.3969058125,3.8132592472
1,63,2008,113,114,-25,78,0,-1,-25,-32,9172,12.298650414,12.407488028,-2.720940357,-6,0,-0.108837614,-2.720940357
1,65,2001,271,192,-81,1363,1,79,-80,-18,18256,14.837120175,10.511908021,-4.434711196,-17,0.0547495209,4.3252121544,-4.379961675
1,65,2002,236,193,-257,1363,1,43,-256,-225,18031,13.007413123,10.637418359,-14.16485243,-12,0.0551161573,2.369994764,-14.10973627
1,65,2003,232,210,-31,1363,1,22,-30,-34,17997,12.878871988,11.657599645,-1.720883757,-26,0.0555123793,1.2212723437,-1.665371378
1,65,2004,188,199,-112,1362,0,-11,-112,-138,17859,10.486390004,11.099955377,-6.247211066,-15,0,-0.613565373,-6.247211066
1,65,2005,234,198,24,1353,1,36,25,45,17904,13.086150491,11.072896569,1.3421692811,-16,0.05592372,2.0132539217,1.3980930011
1,65,2006,186,176,-23,1350,0,10,-23,-21,17883,10.394836114,9.835973957,-1.28538296,-8,0,0.5588621566,-1.28538296
1,65,2007,210,156,140,1352,1,54,141,200,18083,11.677695601,8.6748595896,7.7851304009,5,0.0556080743,3.0028360118,7.8407384752
1,65,2008,227,216,46,1352,0,11,46,62,18145,12.531743403,11.924478304,2.5394722314,5,0,0.6072650988,2.5394722314
1,67,2001,209,189,-58,179,10,20,-48,-43,16303,12.802842354,11.577689975,-3.552941897,-15,0.6125761892,1.2251523783,-2.940365708
1,67,2002,216,208,25,179,9,8,34,25,16328,13.238944562,12.748613282,1.5322852502,-17,0.5516226901,0.4903312801,2.0839079403
1,67,2003,211,214,58,179,8,-3,66,42,16370,12.905988134,13.089485595,3.5476175913,-21,0.4893265643,-0.183497462,4.0369441556
1,67,2004,205,223,86,179,7,-18,93,62,16432,12.499237851,13.596731907,5.2435827084,-13,0.4268032437,-1.097494055,5.6703859521
1,67,2005,188,202,13,179,8,-14,21,-7,16425,11.443528015,12.295705634,0.7913077883,-14,0.486958639,-0.852177618,1.2782664272
1,67,2006,189,217,109,179,7,-28,116,80,16505,11.478894625,13.179471606,6.6201032493,-8,0.4251442454,-1.700576981,7.0452474947
1,67,2007,184,217,94,179,7,-33,101,74,16579,11.123201548,13.118123564,5.6825051384,6,0.4231652763,-1.994922017,6.1056704147
1,67,2008,203,212,5,179,6,-9,11,12,16591,12.239975882,12.782634911,0.3014772385,10,0.3617726862,-0.542659029,0.6632499246
1,69,2001,1342,894,89,1148,56,448,145,504,89426,15.049229596,10.02534371,0.9980487586,-89,0.6279857358,5.023885886,1.6260344944
1,69,2002,1196,880,132,1148,49,316,181,401,89827,13.344267599,9.8185246551,1.4727786983,-96,0.5467133047,3.5257429443,2.0194920029
1,69,2003,1296,849,880,1148,26,447,906,1283,91110,14.325428188,9.3844818915,9.7271425966,-70,0.2873928494,4.9409462962,10.014535446
1,69,2004,1345,890,786,1148,49,455,835,1207,92317,14.665234671,9.7041329793,8.5701668784,-83,0.5342724899,4.9611016917,9.1044393683
1,69,2005,1249,929,927,1148,41,320,968,1220,93537,13.440657721,9.9970944935,9.9755722234,-68,0.4412065385,3.443563227,10.416778762
1,69,2006,1335,903,1241,1148,47,432,1288,1667,95204,14.146369893,9.5686681749,13.150295908,-53,0.4980369925,4.5777017182,13.648332901
1,69,2007,1369,942,1431,1148,38,427,1469,1859,97063,14.240613314,9.7988734416,14.885549782,-37,0.395283642,4.4417398722,15.280833424
1,69,2008,1396,918,937,1148,39,478,976,1425,98488,14.277605331,9.3888550813,9.5831777899,-29,0.3988729283,4.8887502493,9.9820507182
1,71,2001,632,559,-83,579,13,73,-70,-54,53975,11.703270249,10.351468464,-1.536980112,-57,0.2407318247,1.3518017851,-1.296248287
1,71,2002,673,601,-363,579,12,72,-351,-322,53653,12.506039321,11.168097521,-6.745456573,-43,0.2229902999,1.3379417995,-6.522466273
1,71,2003,615,614,-102,579,8,1,-94,-162,53491,11.479877548,11.46121108,-1.903979691,-69,0.1493317405,0.0186664676,-1.75464795
1,71,2004,654,598,-293,579,11,56,-282,-266,53225,12.256831216,11.207316616,-5.491210315,-40,0.2061546535,1.0495145995,-5.285055662
1,71,2005,631,602,-281,579,9,29,-272,-291,52934,11.887828634,11.341478349,-5.293945874,-48,0.1695569853,0.5463502859,-5.124388888
1,71,2006,594,596,86,579,10,-2,96,69,53003,11.21421222,11.251970511,1.6236064831,-25,0.1887914515,-0.03775829,1.8123979346
1,71,2007,611,626,-54,579,7,-15,-47,-61,52942,11.534286658,11.817452452,-1.019396857,1,0.132144037,-0.283165794,-0.88725282
1,71,2008,615,610,189,579,6,5,195,192,53134,11.595459859,11.501187828,3.5634827859,-8,0.1131264376,0.0942720314,3.6766092236
1,73,2001,9407,7215,-4340,15983,1001,2192,-3339,-883,661309,14.215327378,10.902900716,-6.558363008,264,1.5126546939,3.3124266623,-5.045708315
1,73,2002,9009,7314,-4794,15539,918,1695,-3876,-1992,659317,13.643529659,11.076565205,-7.260193272,189,1.3902497755,2.5669644547,-5.869943496
1,73,2003,8937,7291,-1881,16430,769,1646,-1112,424,659741,13.550579277,11.054858846,-2.852035316,-110,1.1659836035,2.4957204308,-1.686051713
1,73,2004,9035,7267,-3468,16211,767,1768,-2701,-834,658907,13.703429573,11.021895153,-5.259932901,99,1.1633127264,2.6815344201,-4.096620175
1,73,2005,9107,7200,-3395,16226,777,1907,-2618,-793,658114,13.829695958,10.933766432,-5.155574588,-82,1.1799356275,2.8959295258,-3.975638961
1,73,2006,9285,7099,-1700,16431,796,2186,-904,1289,659403,14.094694793,10.776331539,-2.580611863,7,1.2083335547,3.3183632545,-1.372278308
1,73,2007,9459,7039,-3821,16527,703,2420,-3118,-588,658815,14.351192291,10.679568933,-5.797220187,110,1.0665914136,3.6716233582,-4.730628773
1,73,2008,9164,7052,-2356,16527,707,2112,-1649,688,659503,13.902563721,10.698480943,-3.574251433,225,1.0725788467,3.2040827782,-2.501672586
1,75,2001,178,198,-328,199,10,-20,-318,-346,15560,11.313799021,12.585012394,-20.84789932,-8,0.6356066866,-1.271213373,-20.21229263
1,75,2002,171,226,-191,199,9,-55,-182,-247,15313,11.077640657,14.640624494,-12.37327114,-10,0.5830337188,-3.562983837,-11.79023742
1,75,2003,157,195,-213,199,8,-38,-205,-251,15062,10.33744856,12.839506173,-14.02469136,-8,0.5267489712,-2.502057613,-13.49794239
1,75,2004,170,183,-218,199,8,-13,-210,-239,14823,11.376944956,12.246946629,-14.58925883,-16,0.535385645,-0.870001673,-14.05387318
1,75,2005,159,182,-96,199,9,-23,-87,-121,14702,10.770533446,12.32853514,-6.50296359,-11,0.6096528366,-1.558001693,-5.893310754
1,75,2006,189,184,-271,199,10,5,-261,-261,14441,12.970524654,12.627389081,-18.59794805,-5,0.6862711457,0.3431355729,-17.9116769
1,75,2007,174,168,13,199,7,6,20,13,14454,12.04360616,11.628309396,0.8998096556,-13,0.4845128915,0.4152967641,1.3843225472
1,75,2008,161,179,-130,199,6,-18,-124,-159,14295,11.200389579,12.452607047,-9.043792828,-17,0.4174058228,-1.252217468,-8.626387005
1,77,2001,1021,949,-639,1741,45,72,-594,-598,87387,11.643819994,10.8227083,-7.287366284,-76,0.5131948087,0.821111694,-6.774171475
1,77,2002,947,919,-525,1793,41,28,-484,-530,86857,10.869814743,10.548426345,-6.02603246,-74,0.4706044398,0.3213883979,-5.55542802
1,77,2003,952,883,93,1958,35,69,128,73,86930,10.955940318,10.161864812,1.0702756823,-124,0.4027919234,0.7940755062,1.4730676057
1,77,2004,1007,918,188,1958,40,89,228,255,87185,11.567067743,10.544754903,2.1594922896,-62,0.4594664446,1.0223128392,2.6189587342
1,77,2005,872,972,371,2165,41,-100,412,230,87415,9.9885452463,11.134020619,4.2497136312,-82,0.4696449026,-1.145475372,4.7193585338
1,77,2006,983,961,503,2215,45,22,548,528,87943,11.211350494,10.960435224,5.7368355022,-42,0.5132357805,0.2509152705,6.2500712827
1,77,2007,1006,944,420,2215,35,62,455,545,88488,11.403891606,10.701067273,4.7610680663,28,0.3967556722,0.7028243336,5.1578237385
1,77,2008,1005,976,524,2215,35,29,559,640,89128,11.316548059,10.990000901,5.9003693361,52,0.3941086389,0.3265471579,6.294477975
1,79,2001,450,356,-92,231,11,94,-81,-20,34837,12.91359371,10.216087468,-2.640112492,-33,0.315665624,2.6975062416,-2.324446868
1,79,2002,399,341,-231,231,10,58,-221,-192,34645,11.484988918,9.815491782,-6.64920411,-29,0.2878443338,1.6694971359,-6.361359777
1,79,2003,391,338,-281,231,8,53,-273,-254,34391,11.327423373,9.7919925836,-8.140680225,-34,0.2317631381,1.5354307897,-7.908917087
1,79,2004,386,346,-210,231,8,40,-202,-188,34203,11.254628685,10.088345919,-6.122984518,-26,0.2332565531,1.1662827653,-5.889727965
1,79,2005,407,339,43,231,8,68,51,86,34289,11.884599661,9.8989663026,1.2556210944,-33,0.2336039245,1.9856333586,1.489225019
1,79,2006,404,368,-410,231,9,36,-401,-378,33911,11.847507331,10.791788856,-12.02346041,-13,0.2639296188,1.0557184751,-11.75953079
1,79,2007,409,349,218,231,8,60,226,295,34206,12.008749651,10.247074886,6.4007516479,9,0.2348899687,1.7616747655,6.6356416166
1,79,2008,405,338,-124,231,7,67,-117,-40,34166,11.846954894,9.8870882818,-3.627215819,10,0.2047621833,1.9598666121,-3.422453636
1,81,2001,1377,784,548,4507,180,593,728,1208,116738,11.856992784,6.7508223259,4.7186870339,-113,1.5499336973,5.1061704583,6.2686207312
1,81,2002,1355,776,757,4590,153,579,910,1389,118127,11.538543419,6.6080514338,6.44625636,-100,1.3028761203,4.9304919848,7.7491324804
1,81,2003,1393,773,790,4182,111,620,901,1393,119520,11.723270229,6.5054471548,6.6485164972,-128,0.9341586471,5.2178230737,7.5826751442
1,81,2004,1419,826,1381,4284,166,593,1547,2022,121542,11.772904896,6.8530087695,11.457633306,-118,1.3772390505,4.9198961263,12.834872356
1,81,2005,1475,776,2844,4302,146,699,2990,3590,125132,11.959103919,6.2917048412,23.058773928,-99,1.1837485913,5.6673990773,24.24252252
1,81,2006,1568,852,1983,4022,166,716,2149,2793,127925,12.392464939,6.7336607958,15.672358401,-72,1.3119573851,5.6588041429,16.984315787
1,81,2007,1638,843,1675,4092,143,795,1818,2596,130521,12.675762055,6.5236064787,12.962088792,-17,1.1066141476,6.152155576,14.06870294
1,81,2008,1658,865,1557,4092,146,793,1703,2489,133010,12.582959879,6.5646925789,11.816446642,-7,1.1080290364,6.0182673006,12.924475678
1,83,2001,923,557,355,2684,42,366,397,707,66619,13.928816654,8.4055805811,5.3572371747,-56,0.6338139756,5.5232360731,5.9910511503
1,83,2002,834,546,196,2698,36,288,232,460,67079,12.475878472,8.1676614459,2.9319810319,-60,0.5385271283,4.3082170264,3.4705081602
1,83,2003,792,625,446,2779,27,167,473,574,67653,11.756672505,9.2776771665,6.620550426,-66,0.4007956536,2.4789953389,7.0213460796
1,83,2004,808,593,529,2597,37,215,566,720,68373,11.880081749,8.7189213827,7.7779248085,-61,0.5440136445,3.1611603664,8.3219384529
1,83,2005,889,589,1115,2639,34,300,1149,1386,69759,12.871745866,8.5280745953,16.143978224,-63,0.492282744,4.343671271,16.636260968
1,83,2006,877,617,1710,2648,39,260,1749,1971,71730,12.39672342,8.721526055,24.171490363,-38,0.5512796048,3.6751973652,24.722769968
1,83,2007,944,620,1750,2665,31,324,1781,2146,73876,12.966498633,8.516132577,24.037470983,41,0.4258066288,4.4503660563,24.463277612
1,83,2008,948,659,1897,2665,31,289,1928,2259,76135,12.639073135,8.7860223584,25.291478625,42,0.4133030244,3.8530507763,25.704781649
1,85,2001,234,135,-123,47,0,99,-123,-35,13452,17.372582501,10.022643751,-9.131742084,-11,0,7.3499387505,-9.131742084
1,85,2002,209,151,-37,47,-1,58,-38,8,13460,15.532104637,11.22175981,-2.749702735,-12,-0.07431629,4.3103448276,-2.824019025
1,85,2003,183,141,-171,47,-3,42,-174,-141,13319,13.667425968,10.53063968,-12.77120131,-9,-0.224056163,3.1367862878,-12.99525748
1,85,2004,182,134,-314,47,1,48,-313,-281,13038,13.810372956,10.168076792,-23.82668741,-16,0.0758811701,3.6422961642,-23.75080624
1,85,2005,176,161,-137,47,-1,15,-138,-135,12903,13.569253306,12.412782853,-10.56243013,-12,-0.07709803,1.1564704522,-10.63952816
1,85,2006,170,150,-178,47,0,20,-178,-163,12740,13.258979059,11.699099169,-13.88293101,-5,0,1.5598798892,-13.88293101
1,85,2007,200,126,-112,47,-1,74,-113,-41,12699,15.723888518,9.9060497661,-8.80537757,-2,-0.078619443,5.8178387515,-8.883997012
1,85,2008,176,155,-81,47,-1,21,-82,-55,12644,13.889436925,12.232174565,-6.392297676,6,-0.078917255,1.6572623604,-6.471214931
1,87,2001,302,329,-63,2421,17,-27,-46,-95,23981,12.568408348,13.692073995,-2.62188651,-22,0.7074931852,-1.123665647,-1.914393325
1,87,2002,258,263,-325,2402,16,-5,-309,-327,23654,10.832371156,11.042300829,-13.64542878,-13,0.6717749554,-0.209929674,-12.97365383
1,87,2003,238,257,-149,2408,14,-19,-135,-179,23475,10.099938467,10.906236075,-6.323070721,-25,0.5941140275,-0.806297609,-5.728956693
1,87,2004,227,275,-373,2422,15,-48,-358,-430,23045,9.7592433362,11.822871883,-16.0361135,-24,0.6448839209,-2.063628547,-15.39122958
1,87,2005,245,254,-293,2407,15,-9,-278,-306,22739,10.702428796,11.095579242,-12.79923117,-19,0.6552507426,-0.393150446,-12.14398043
1,87,2006,268,282,-185,2358,16,-14,-169,-192,22547,11.835887471,12.4541801,-8.170295456,-9,0.7066201475,-0.618292629,-7.463675308
1,87,2007,249,270,-240,2348,13,-21,-227,-238,22309,11.102193686,12.038523274,-10.70090958,10,0.5796326021,-0.936329588,-10.12127698
1,87,2008,252,277,-14,2348,13,-25,-1,-19,22290,11.300701809,12.421803179,-0.627816767,7,0.5829727124,-1.12110137,-0.044844055
1,89,2001,3705,2202,1191,7147,495,1503,1686,3280,281135,13.256051092,7.878495143,4.2612569098,91,1.7710513605,5.3775559491,6.0323082703
1,89,2002,3484,2138,2770,7317,413,1346,3183,4629,285764,12.291431101,7.5427898091,9.772463878,100,1.4570496685,4.7486412924,11.229513547
1,89,2003,3603,2229,2825,7710,256,1374,3081,4567,290331,12.508353657,7.7383070501,9.8074102362,112,0.8887423081,4.7700466069,10.696152544
1,89,2004,3599,2354,2017,7551,454,1245,2471,3859,294190,12.314356542,8.0544582658,6.9013773671,143,1.5534086885,4.2598982757,8.4547860556
1,89,2005,3787,2324,3384,7553,380,1463,3764,5219,299409,12.759455457,7.8302018703,11.401636458,-8,1.280325607,4.929253587,12.681962065
1,89,2006,3870,2290,4573,7529,448,1580,5021,6608,306017,12.784386531,7.564921229,15.106718245,7,1.4799496553,5.2194653021,16.5866679
1,89,2007,4119,2429,4229,7484,363,1690,4592,6429,312446,13.320117776,7.8549565617,13.675838328,147,1.1738778229,5.4651612142,14.849716151
1,89,2008,4148,2453,4867,7484,374,1695,5241,7064,319510,13.127496218,7.7631987037,15.402971093,128,1.1836267082,5.3642975144,16.586597801
1,91,2001,338,249,-484,193,18,89,-466,-389,22178,15.107833277,11.129735166,-21.63370209,-12,0.8045591686,3.9780981115,-20.82914292
1,91,2002,320,260,-79,193,17,60,-62,-22,22156,14.435873145,11.72914693,-3.563856183,-20,0.7669057608,2.7067262146,-2.796950422
1,91,2003,294,253,-266,193,10,41,-256,-236,21920,13.34059352,11.480170614,-12.0700608,-21,0.4537616844,1.8604229059,-11.61629912
1,91,2004,287,261,-306,193,17,26,-289,-283,21637,13.178134399,11.984296439,-14.05055445,-20,0.7805863581,1.1938379595,-13.26996809
1,91,2005,278,256,-268,193,14,22,-254,-250,21387,12.92301971,11.900334697,-12.45816289,-18,0.6507995537,1.022685013,-11.80736333
1,91,2006,268,252,-163,193,16,16,-147,-141,21246,12.572420425,11.821828161,-7.646658692,-10,0.7505922642,0.7505922642,-6.896066427
1,91,2007,283,273,-45,193,12,10,-33,-18,21228,13.325799313,12.854923012,-2.118943354,5,0.565051561,0.4708763008,-1.553891793
1,91,2008,291,256,-226,193,12,35,-214,-173,21055,13.764397039,12.108885368,-10.68987536,6,0.5676040016,1.6555116714,-10.12227136
1,93,2001,330,396,-485,934,12,-66,-473,-561,30590,10.689817139,12.827780567,-15.71079186,-22,0.3887206232,-2.137963428,-15.32207123
1,93,2002,361,349,-358,935,11,12,-347,-355,30235,11.870119194,11.475544595,-11.77147554,-20,0.3616933827,0.3945745993,-11.40978216
1,93,2003,339,377,-204,919,10,-38,-194,-262,29973,11.260961998,12.523252724,-6.776508105,-30,0.3321817699,-1.262290725,-6.444326335
1,93,2004,358,399,-207,814,11,-41,-196,-261,29712,11.996313982,13.370193516,-6.936416185,-24,0.3686018263,-1.373879534,-6.567814359
1,93,2005,346,396,-157,813,11,-50,-146,-222,29490,11.688794297,13.377926421,-5.303874869,-26,0.3716090673,-1.689132124,-4.932265802
1,93,2006,362,401,205,881,11,-39,216,164,29654,12.241309347,13.560124442,6.9322331936,-13,0.3719734884,-1.318815095,7.304206682
1,93,2007,345,384,-56,916,8,-39,-48,-89,29565,11.65166585,12.968810686,-1.891284892,-2,0.270183556,-1.317144835,-1.621101336
1,93,2008,342,360,-85,916,7,-18,-78,-100,29465,11.587328477,12.197187871,-2.879891581,-4,0.2371675419,-0.609859394,-2.642724039
1,95,2001,1190,913,-648,972,268,277,-380,-173,82151,14.470284238,11.101991184,-7.879616963,-70,3.2588539292,3.3682930537,-4.620763034
1,95,2002,1251,936,178,972,253,315,431,668,82819,15.16639389,11.34751773,2.1579681154,-78,3.0672243438,3.8188761593,5.2251924592
1,95,2003,1304,936,114,972,218,368,332,588,83407,15.689482993,11.261776136,1.3716265807,-112,2.6229350402,4.4277068569,3.9945616209
1,95,2004,1408,951,-136,972,206,457,70,471,83878,16.833547539,11.369817975,-1.62596766,-56,2.4628627791,5.4637295633,0.8368951191
1,95,2005,1451,988,415,972,213,463,628,1014,84892,17.194999111,11.708241986,4.9179356521,-77,2.5241452865,5.4867571251,7.4420809386
1,95,2006,1449,980,714,972,216,469,930,1355,86247,16.933603679,11.452678817,8.3440945664,-44,2.5242639024,5.4809248622,10.868358469
1,95,2007,1497,975,455,972,191,522,646,1180,87427,17.239195274,11.227932794,5.2397019704,12,2.1995232447,6.0112624803,7.4392252151
1,95,2008,1456,962,317,972,191,494,508,1057,88484,16.553825514,10.937349,3.6040952527,55,2.1715526602,5.6164765137,5.7756479129
1,97,2001,6090,3899,-2360,8000,480,2191,-1880,-31,399997,15.224524234,9.7471954001,-5.899815631,-342,1.1999625012,5.4773288335,-4.69985313
1,97,2002,5963,3917,-3954,7842,404,2046,-3550,-1769,398228,14.940649566,9.8142754236,-9.906981114,-265,1.0122459206,5.1263741426,-8.894735194
1,97,2003,5752,3888,-2488,7850,260,1864,-2228,-786,397442,14.458255307,9.7728957985,-6.253848957,-422,0.6535372705,4.6853595083,-5.600311687
1,97,2004,5780,4038,-2134,7897,435,1742,-1699,-268,397174,14.547907417,10.16339968,-5.371147825,-311,1.0948684648,4.3845077371,-4.27627936
1,97,2005,5792,3929,-1125,8000,370,1863,-755,735,397909,14.569548085,9.8832448939,-2.829893231,-373,0.9307204405,4.686303191,-1.899172791
1,97,2006,5901,3988,1579,8071,423,1913,2002,3720,401629,14.761024492,9.975761002,3.9497809985,-195,1.0581110591,4.7852634897,5.0078920577
1,97,2007,6114,3870,29,8156,346,2244,375,2468,404097,15.176375095,9.6062433135,0.071984769,-151,0.8588527614,5.5701317818,0.9308375304
1,97,2008,6044,3926,-111,8156,356,2118,245,2212,406309,14.915980385,9.6889707134,-0.273936767,-151,0.878571975,5.2270096717,0.6046352075
1,99,2001,325,249,-334,241,1,76,-333,-275,24006,13.461180028,10.313334852,-13.83395117,-18,0.0414190155,3.1478451757,-13.79253215
1,99,2002,336,235,-284,241,0,101,-284,-198,23808,14.054461037,9.8297569749,-11.87936588,-15,0,4.2247040616,-11.87936588
1,99,2003,289,258,-279,241,-3,31,-282,-270,23538,12.208000676,10.898491953,-11.78557851,-19,-0.126726651,1.309508723,-11.91230516
1,99,2004,291,239,-210,241,1,52,-209,-178,23360,12.40991087,10.192332296,-8.955605783,-21,0.0426457418,2.2175785748,-8.912960041
1,99,2005,306,283,-182,241,-1,23,-183,-179,23181,13.149695967,12.161320126,-7.821061,-19,-0.042972863,0.9883758407,-7.864033863
1,99,2006,283,250,-236,241,1,33,-235,-213,22968,12.264621119,10.834470953,-10.22774058,-11,0.0433378838,1.4301501658,-10.1844027
1,99,2007,267,241,-290,241,-1,26,-291,-266,22702,11.692577184,10.553974162,-12.69980293,-1,-0.043792424,1.1386030217,-12.74359536
1,99,2008,291,250,-183,241,-1,41,-184,-149,22553,12.860457408,11.048502928,-8.087504143,-6,-0.044194012,1.8119544802,-8.131698155
1,101,2001,3570,2029,-2065,12155,162,1541,-1903,-535,222877,15.998601803,9.0927627613,-9.2540932,-173,0.7259869726,6.9058390415,-8.528106227
1,101,2002,3391,2094,-1092,12306,10,1297,-1082,18,222895,15.214055616,9.3949373222,-4.899365595,-197,0.0448659853,5.8191182937,-4.85449961
1,101,2003,3237,2030,-1152,12683,-258,1207,-1410,-480,222415,14.538186881,9.117244167,-5.173923783,-277,-1.158743347,5.4209427141,-6.332667131
1,101,2004,3196,2063,-1668,12108,288,1133,-1380,-430,221985,14.383438344,9.2844284428,-7.506750675,-183,1.296129613,5.099009901,-6.210621062
1,101,2005,3277,2102,-948,11854,68,1175,-880,86,222071,14.759399715,9.4672743978,-4.269731746,-209,0.306267678,5.2921253175,-3.963464068
1,101,2006,3395,2082,1808,12034,206,1313,2014,3215,225286,15.178034545,9.3080023337,8.0830298844,-112,0.9209646882,5.8700322114,9.0039945726
1,101,2007,3470,2049,-724,12498,90,1421,-634,803,226089,15.375242315,9.0789255054,-3.20797563,16,0.398781501,6.2963168097,-2.809194129
1,101,2008,3421,2038,-2853,12498,116,1383,-2737,-1279,224810,15.174129905,9.0397184292,-12.65471868,75,0.5145276437,6.1344114757,-12.14019104
1,103,2001,1529,1042,-324,1736,191,487,-133,251,111434,13.736596936,9.361369527,-2.910828912,-103,1.715951612,4.3752274085,-1.1948773
1,103,2002,1437,1067,-608,1735,180,370,-428,-147,111287,12.904036889,9.581494336,-5.459745601,-89,1.6163720529,3.3225425532,-3.843373548
1,103,2003,1508,1007,334,1724,147,501,481,838,112125,13.499722486,9.0147351082,2.9899915851,-144,1.3159543802,4.4849873776,4.3059459653
1,103,2004,1510,1092,-607,1599,148,418,-459,-132,111993,13.475044396,9.7448665435,-5.41678937,-91,1.3207328282,3.7301778527,-4.096056542
1,103,2005,1492,1069,197,1643,147,423,344,667,112660,13.282707108,9.516899396,1.7538158849,-100,1.3086849497,3.7658077123,3.0625008346
1,103,2006,1505,1107,723,1691,153,398,876,1215,113875,13.287130024,9.7733242104,6.3831196062,-59,1.350784647,3.5138058137,7.7339042532
1,103,2007,1529,1194,468,1730,142,335,610,914,114789,13.3733338,10.443270475,4.0933421964,-31,1.2419969912,2.9300633244,5.3353391876
1,103,2008,1574,1144,560,1730,142,430,702,1170,115959,13.642588451,9.9155788999,4.8537798811,38,1.2307798984,3.7270095515,6.0845597795
1,105,2001,216,152,-234,511,0,64,-234,-176,11632,18.43003413,12.969283276,-19.96587031,-6,0,5.4607508532,-19.96587031
1,105,2002,195,175,-122,593,0,20,-122,-110,11522,16.843741902,15.11617863,-10.53813596,-8,0,1.727563272,-10.53813596
1,105,2003,183,170,-294,475,-1,13,-295,-278,11244,16.076605464,14.934551524,-25.82798911,4,-0.087850303,1.1420539401,-25.91583941
1,105,2004,195,137,-207,476,0,58,-207,-161,11083,17.467640077,12.272136875,-18.54257177,-12,0,5.1955032024,-18.54257177
1,105,2005,142,126,-300,470,0,16,-300,-291,10792,12.982857143,11.52,-27.42857143,-7,0,1.4628571429,-27.42857143
1,105,2006,145,149,-203,426,0,-4,-203,-211,10581,13.568521031,13.94282506,-18.99592944,-4,0,-0.374304028,-18.99592944
1,105,2007,165,139,129,628,0,26,129,156,10737,15.479876161,13.040622948,12.102448635,1,0,2.4392532132,12.102448635
1,105,2008,152,167,-81,628,-1,-15,-82,-94,10643,14.218896165,15.622076707,-7.57717493,3,-0.09354537,-1.403180543,-7.670720299
1,107,2001,294,259,-97,211,0,35,-97,-79,20825,14.090919984,12.413429509,-4.649045029,-17,0,1.6774904743,-4.649045029
1,107,2002,301,274,-120,211,-1,27,-121,-115,20710,14.493800409,13.193692067,-5.778259299,-21,-0.048152161,1.3001083424,-5.82641146
1,107,2003,235,267,-353,211,-1,-32,-354,-390,20320,11.455032903,13.01486717,-17.20692176,-4,-0.048744821,-1.559834268,-17.25566659
1,107,2004,248,265,-184,211,0,-17,-184,-218,20102,12.270545742,13.111671862,-9.103953293,-17,0,-0.841126119,-9.103953293
1,107,2005,254,254,-242,211,-1,0,-243,-260,19842,12.717804927,12.717804927,-12.11696375,-17,-0.050070098,0,-12.16703385
1,107,2006,215,262,-53,211,1,-47,-52,-107,19735,10.864896278,13.240013139,-2.678323269,-8,0.0505344013,-2.375116861,-2.627788867
1,107,2007,245,253,-104,211,0,-8,-104,-108,19627,12.448554443,12.855037854,-5.284284335,4,0,-0.40648341,-5.284284335
1,107,2008,243,274,-76,211,-1,-31,-77,-103,19524,12.413476029,13.997088197,-3.882404025,5,-0.051084263,-1.583612168,-3.933488289
1,109,2001,445,321,-235,1248,30,124,-205,-105,29629,14.992503748,10.81481731,-7.91738962,-24,1.0107305898,4.1776864377,-6.90665903
1,109,2002,398,343,-418,934,22,55,-396,-357,29272,13.514201796,11.646661347,-14.19330741,-16,0.7470161797,1.8675404492,-13.44629123
1,109,2003,392,316,82,1133,11,76,93,134,29406,13.361055251,10.77064658,2.7949146188,-35,0.3749275708,2.5904086711,3.1698421896
1,109,2004,412,303,203,1294,30,109,233,316,29722,13.935867948,10.248951427,6.8664592071,-26,1.0147476661,3.6869165201,7.8812068732
1,109,2005,381,305,-120,1120,22,76,-98,-50,29672,12.829578745,10.270397683,-4.040812203,-28,0.7408155706,2.5591810621,-3.299996633
1,109,2006,381,349,240,1151,28,32,268,285,29957,12.779016921,11.705713663,8.0497744386,-15,0.9391403512,1.0733032585,8.9889147898
1,109,2007,421,314,107,1456,21,107,128,241,30198,13.997173967,10.439697448,3.557476519,6,0.6981963262,3.557476519,4.2556728452
1,109,2008,422,335,56,1456,22,87,78,183,30381,13.932220737,11.059938262,1.8488255006,18,0.7263243038,2.8722824741,2.5751498044
1,111,2001,285,272,54,579,7,13,61,53,22468,12.69968585,12.120401934,2.4062562663,-21,0.3119221086,0.579283916,2.7181783749
1,111,2002,264,285,-7,586,7,-21,0,-44,22424,11.76156108,12.697139802,-0.311859574,-23,0.3118595741,-0.935578722,0
1,111,2003,277,267,-156,586,5,10,-151,-163,22261,12.397896386,11.950318899,-6.982208795,-22,0.2237887434,0.4475774869,-6.758420051
1,111,2004,262,279,158,586,4,-17,162,126,22387,11.736247984,12.497760258,7.0775846622,-19,0.1791793585,-0.761512274,7.2567640208
1,111,2005,276,287,103,586,5,-11,108,76,22463,12.307692308,12.798216276,4.5930880713,-21,0.2229654404,-0.490523969,4.8160535117
1,111,2006,266,272,7,586,4,-6,11,-6,22457,11.843276937,12.110418522,0.3116651825,-11,0.17809439,-0.267141585,0.4897595726
1,111,2007,269,253,-86,586,5,16,-81,-67,22390,11.996343122,11.282805985,-3.835262113,-2,0.2229803554,0.7135371374,-3.612281758
1,111,2008,268,273,227,586,4,-5,231,230,22620,11.908464786,12.130637636,10.086647412,4,0.1777382804,-0.22217285,10.264385692
1,113,2001,658,595,-362,687,48,63,-314,-290,49370,13.288902353,12.016560638,-7.310915884,-39,0.9694032111,1.2723417146,-6.341512673
1,113,2002,636,564,-286,687,26,72,-260,-229,49141,12.912263605,11.450497914,-5.806458162,-41,0.5278598329,1.4617656911,-5.278598329
1,113,2003,601,530,-528,687,-16,71,-544,-513,48628,12.29428551,10.841882396,-10.80096963,-40,-0.32730211,1.4524031135,-11.12827174
1,113,2004,610,576,225,687,68,34,293,289,48917,12.507048029,11.809933877,4.6132554206,-38,1.3942283049,0.6971141524,6.0074837255
1,113,2005,702,533,-53,687,34,169,-19,102,49019,14.335892828,10.884659369,-1.082339487,-48,0.6943309917,3.4512334586,-0.388008495
1,113,2006,747,597,441,687,56,150,497,623,49642,15.142761578,12.102046401,8.9397026181,-24,1.1352003325,3.0407151762,10.074902951
1,113,2007,734,594,362,687,35,140,397,545,50187,14.705145799,11.900349598,7.2524016067,8,0.7011990504,2.8047962015,7.9536006571
1,113,2008,706,561,105,687,39,145,144,317,50504,14.023100376,11.143001857,2.0855885829,28,0.7746471879,2.8800985192,2.8602357708
1,115,2001,866,590,687,1901,18,276,705,931,66010,13.212397684,9.0015180526,10.481428648,-50,0.2746225847,4.2108796314,10.756051232
1,115,2002,839,569,830,1916,16,270,846,1072,67082,12.607820154,8.5504763622,12.472575361,-44,0.2404351877,4.0573437923,12.713010549
1,115,2003,799,743,1147,2105,5,56,1152,1192,68274,11.80590443,10.97845681,16.947900352,-16,0.0738792518,0.8274476196,17.021779603
1,115,2004,819,719,1644,2104,15,100,1659,1666,69940,11.851187289,10.404155874,23.789196463,-93,0.2170547123,1.4470314151,24.006251176
1,115,2005,940,701,1835,2110,11,239,1846,2029,71969,13.247926488,9.8795707108,25.861643729,-56,0.155028927,3.3683557773,26.016672656
1,115,2006,983,724,2737,2105,14,259,2751,2965,74934,13.382980606,9.8568443122,37.262683539,-45,0.1906019618,3.526136294,37.453285501
1,115,2007,1035,765,2810,2106,9,270,2819,3102,78036,13.532065111,10.001961169,36.739229914,13,0.1176701314,3.5301039419,36.856900046
1,115,2008,1058,783,1527,2106,9,275,1536,1801,79837,13.403178504,9.919365566,19.344663115,-10,0.1140156962,3.4838129382,19.458678811
1,117,2001,2357,926,2986,1667,182,1431,3168,4711,149230,16.047714205,6.3047023139,20.330281975,112,1.2391531546,9.7430118911,21.56943513
1,117,2002,2446,929,2794,1643,160,1517,2954,4579,153809,16.143136692,6.1312240339,18.439870776,108,1.0559696937,10.011912658,19.495840469
1,117,2003,2380,961,3835,1707,120,1419,3955,5634,159443,15.195433708,6.1356352074,24.485079106,260,0.7661563214,9.0597985009,25.251235427
1,117,2004,2572,1086,4406,1653,155,1486,4561,6054,165497,15.830614883,6.6843109497,27.118852711,7,0.954022281,9.146303933,28.072874992
1,117,2005,2548,1006,4090,1653,141,1542,4231,5877,171374,15.127452348,5.9726126618,24.282292035,104,0.8371156912,9.1548396864,25.119407726
1,117,2006,2636,1077,5103,1579,155,1559,5258,6915,178289,15.077374501,6.1602171233,29.188103974,98,0.886567924,8.9171573772,30.074671898
1,117,2007,2654,1092,2865,1605,133,1562,2998,4680,182969,14.693100222,6.04554086,15.861240443,120,0.736315874,8.647559362,16.597556317
1,117,2008,2816,1119,2931,1605,135,1697,3066,4815,187784,15.190706481,6.0363638325,15.811065588,52,0.7282476474,9.1543426486,16.539313235
1,119,2001,198,156,-226,286,0,42,-226,-192,14556,13.513513514,10.647010647,-15.42451542,-8,0,2.8665028665,-15.42451542
1,119,2002,160,144,-425,237,-1,16,-426,-415,14141,11.150991393,10.035892254,-29.61982089,-5,-0.069693696,1.1150991393,-29.68951458
1,119,2003,188,173,-151,253,-1,15,-152,-149,13992,13.365087264,12.298723919,-10.73472435,-12,-0.07109089,1.0663633455,-10.80581523
1,119,2004,195,168,-143,237,0,27,-143,-128,13864,14.000574383,12.062033314,-10.26708788,-12,0,1.9385410684,-10.26708788
1,119,2005,144,167,-199,296,-1,-23,-200,-233,13631,10.474631751,12.147663211,-14.47535916,-10,-0.072740498,-1.67303146,-14.54809965
1,119,2006,164,125,-161,316,0,39,-161,-127,13504,12.0877096,9.2131932928,-11.86659296,-5,0,2.8745163074,-11.86659296
1,119,2007,159,140,-198,343,0,19,-198,-169,13335,11.848429524,10.432579455,-14.75464809,10,0,1.4158500689,-14.75464809
1,119,2008,168,166,-75,343,-1,2,-76,-69,13266,12.631104094,12.480733807,-5.638885756,5,-0.075185143,0.1503702868,-5.7140709
1,121,2001,1097,853,-248,3816,24,244,-224,-53,80287,13.658973896,10.620879429,-3.087899295,-73,0.298828964,3.0380944673,-2.789070331
1,121,2002,1109,938,-161,3744,23,171,-138,-47,80240,13.816990288,11.686507566,-2.00589309,-80,0.2865561557,2.1304827225,-1.719336934
1,121,2003,986,889,-511,3721,15,97,-496,-481,79759,12.325077032,11.112569454,-6.387539922,-82,0.1875011719,1.2125075782,-6.20003875
1,121,2004,984,878,-107,3614,18,106,-89,-35,79724,12.339873215,11.01057793,-1.341835807,-52,0.2257293881,1.3292952854,-1.116106419
1,121,2005,992,893,108,3660,16,99,124,145,79869,12.431622941,11.190967022,1.3534428202,-78,0.2005100474,1.2406559185,1.5539528676
1,121,2006,993,880,110,3681,17,113,127,203,80072,12.417078798,11.004057746,1.3755072183,-37,0.2125783883,1.4130210515,1.5880856066
1,121,2007,1011,902,-32,3698,15,109,-17,105,80177,12.61786345,11.257480546,-0.399378467,13,0.1872086565,1.3603829041,-0.212169811
1,121,2008,1008,894,-53,3698,15,114,-38,102,80279,12.564192053,11.143241761,-0.660617241,26,0.1869671436,1.4209502917,-0.473650097
1,123,2001,530,560,-299,1176,5,-30,-294,-356,41366,12.757558251,13.47968419,-7.197188523,-32,0.1203543231,-0.722125939,-7.0768342
1,123,2002,472,605,-287,1176,2,-133,-285,-448,40918,11.472461232,14.705167469,-6.975839774,-30,0.0486121239,-3.232706237,-6.927227651
1,123,2003,473,498,-183,1176,-3,-25,-186,-256,40662,11.595979407,12.208874724,-4.486393724,-45,-0.073547438,-0.612895317,-4.559941162
1,123,2004,457,538,10,1179,8,-81,18,-88,40574,11.251169432,13.2453592,0.2461962677,-25,0.1969570141,-1.994189768,0.4431532818
1,123,2005,450,550,-34,1176,3,-100,-31,-161,40413,11.112894662,13.582426809,-0.83964093,-30,0.0740859644,-2.469532147,-0.765554966
1,123,2006,514,544,333,1176,7,-30,340,288,40701,12.673521217,13.413220899,8.2106664694,-22,0.1725965925,-0.739699682,8.3832630619
1,123,2007,487,503,75,1176,3,-16,78,51,40752,11.957816164,12.350680761,1.8415527973,-11,0.0736621119,-0.392864597,1.9152149092
1,123,2008,479,548,98,1176,3,-69,101,21,40773,11.750996627,13.443728918,2.4041704998,-11,0.0735970561,-1.692732291,2.477767556
1,125,2001,2259,1464,-206,8613,245,795,39,672,165864,13.64723793,8.8444251124,-1.244502441,-162,1.480112126,4.8028128172,0.2356096854
1,125,2002,2253,1509,-554,7969,225,744,-329,271,166135,13.572330037,9.0903888265,-3.33735945,-144,1.3554257694,4.4819412107,-1.981933681
1,125,2003,2120,1543,106,7989,187,577,293,628,166763,12.736634044,9.2701067594,0.6368317022,-242,1.1234672482,3.4665272846,1.7602989504
1,125,2004,2175,1536,573,7893,196,639,769,1287,168050,12.99232706,9.1752709722,3.4228061634,-121,1.1708028063,3.817056088,4.5936089698
1,125,2005,2228,1464,1905,8567,194,764,2099,2709,170759,13.15195287,8.642037254,11.245273886,-154,1.1451879968,4.5099156162,12.390461883
1,125,2006,2297,1512,3687,9821,202,785,3889,4580,175339,13.273697045,8.7374096354,21.306104051,-94,1.1672994354,4.5362874099,22.473403487
1,125,2007,2399,1492,777,9380,183,907,960,1872,177211,13.609417104,8.4640476528,4.4078854063,5,1.0381506169,5.1453694511,5.4460360233
1,125,2008,2482,1538,1053,9380,184,944,1237,2237,179448,13.918056183,8.6244844515,5.9047998228,56,1.0317978798,5.293571731,6.9365977026
1,127,2001,990,907,-153,1021,38,83,-115,-101,70582,14.016210668,12.841114218,-2.166141649,-69,0.537995965,1.1750964499,-1.628145684
1,127,2002,854,897,-415,1021,37,-43,-378,-479,70103,12.140597789,12.751892526,-5.899705015,-58,0.5259977965,-0.611294736,-5.373707218
1,127,2003,873,953,-449,1021,23,-80,-426,-587,69516,12.505461291,13.651437125,-6.43178937,-81,0.3294680523,-1.145975834,-6.102321317
1,127,2004,876,1009,-205,1021,25,-133,-180,-361,69155,12.634220565,14.552429852,-2.956638374,-48,0.3605656554,-1.918209287,-2.596072719
1,127,2005,864,954,99,1021,26,-90,125,-30,69125,12.496384148,13.79809083,1.4318773503,-65,0.376048597,-1.301706682,1.8079259474
1,127,2006,814,946,-16,1021,27,-132,11,-152,68973,11.788729743,13.700415647,-0.231719504,-31,0.3910266622,-1.911685904,0.1593071587
1,127,2007,912,926,-307,1021,22,-14,-285,-302,68671,13.251576531,13.454999855,-4.460782889,-3,0.3196652233,-0.203423324,-4.141117666
1,127,2008,843,927,363,1021,22,-84,385,299,68970,12.249257125,13.469823672,5.2745911465,-2,0.3196721907,-1.220566546,5.5942633372
1,129,2001,244,176,-277,84,0,68,-277,-222,17891,13.55404955,9.7766914787,-15.3871792,-13,0,3.7773580713,-15.3871792
1,129,2002,247,172,-156,84,-1,75,-157,-94,17797,13.84218785,9.6390943735,-8.742434432,-12,-0.056041246,4.2030934768,-8.798475678
1,129,2003,225,165,-89,84,-2,60,-91,-51,17746,12.660720817,9.2845285992,-5.008018457,-20,-0.112539741,3.3761922179,-5.120558197
1,129,2004,189,172,-164,84,1,17,-163,-162,17584,10.699122559,9.7367676196,-9.283894707,-16,0.0566091141,0.9623549391,-9.227285593
1,129,2005,197,169,-179,84,-1,28,-180,-168,17416,11.257142857,9.6571428571,-10.22857143,-16,-0.057142857,1.6,-10.28571429
1,129,2006,185,151,-59,84,0,34,-59,-32,17384,10.632183908,8.6781609195,-3.390804598,-7,0,1.9540229885,-3.390804598
1,129,2007,201,144,-243,84,-1,57,-244,-178,17206,11.621856028,8.3261058109,-14.05030356,9,-0.057820179,3.2957502168,-14.10812374
1,129,2008,187,160,-37,84,-1,27,-38,-2,17204,10.86893345,9.2996222028,-2.150537634,9,-0.058122639,1.5693112467,-2.208660273
1,131,2001,243,143,-163,149,1,100,-162,-70,12910,18.771726535,11.046736192,-12.59173426,-8,0.0772499034,7.7249903438,-12.51448436
1,131,2002,210,146,-30,146,0,64,-30,21,12931,16.253240974,11.299872296,-2.321891568,-13,0,4.9533686777,-2.321891568
1,131,2003,201,171,-168,138,-1,30,-169,-148,12783,15.633507039,13.300147779,-13.06681185,-9,-0.077778642,2.3333592595,-13.1445905
1,131,2004,223,147,-125,138,0,76,-125,-60,12723,17.486081706,11.5266996,-9.801615306,-11,0,5.9593821062,-9.801615306
1,131,2005,174,129,-113,138,-1,45,-114,-80,12643,13.71915162,10.171095167,-8.909563983,-11,-0.078845699,3.5480564535,-8.988409682
1,131,2006,179,129,-67,138,0,50,-67,-22,12621,14.170360988,10.212159595,-5.303989867,-5,0,3.9582013933,-5.303989867
1,131,2007,192,147,104,138,0,45,104,141,12762,15.128235433,11.582555254,8.1944608596,-8,0,3.5456801796,8.1944608596
1,131,2008,200,170,20,138,-1,30,19,41,12803,15.646391551,13.299432818,1.5646391551,-8,-0.078231958,2.3469587326,1.4864071973
1,133,2001,303,291,-357,306,22,12,-335,-339,24543,12.261001517,11.775417299,-14.4461305,-16,0.8902377339,0.4855842185,-13.55589277
1,133,2002,277,322,-34,306,21,-45,-13,-81,24462,11.304968881,13.141516172,-1.387613509,-23,0.8570554025,-1.836547291,-0.530558106
1,133,2003,239,293,-52,306,18,-54,-34,-121,24341,9.7944798476,12.007458558,-2.131016536,-33,0.7376595701,-2.21297871,-1.393356966
1,133,2004,278,284,-43,306,18,-6,-25,-48,24293,11.432331291,11.679072254,-1.768310236,-17,0.7402228893,-0.246740963,-1.028087346
1,133,2005,289,276,-87,306,18,13,-69,-77,24216,11.915314684,11.37933167,-3.586963244,-21,0.7421303263,0.5359830135,-2.844832918
1,133,2006,268,280,54,306,19,-12,73,51,24267,11.055421488,11.550440361,2.2275849267,-10,0.7837798816,-0.495018873,3.0113648083
1,133,2007,289,302,-50,306,17,-13,-33,-48,24219,11.920966877,12.457204141,-2.062451017,-2,0.7012333457,-0.536237264,-1.361217671
1,133,2008,271,304,-230,306,16,-33,-214,-245,23974,11.246446579,12.615940074,-9.544954661,2,0.663996846,-1.369493495,-8.880957815
2,0,2001,9974,2989,-2891,19395,888,6985,-2003,5732,633160,15.82436133,4.7422314031,-4.586748406,750,1.4088663386,11.082129927,-3.177882068
2,0,2002,9853,3075,1916,19056,-102,6778,1814,9231,642391,15.449009879,4.8214457909,3.0041919139,639,-0.159930885,10.627564088,2.8442610292
2,0,2003,9980,3099,2619,20003,-2138,6881,481,8035,650426,15.439153415,4.7941820072,4.0516175143,673,-3.307506012,10.644971407,0.7441115022
2,0,2004,10300,3051,629,21739,2049,7249,2678,10549,660975,15.708391255,4.6530390018,0.9592794271,622,3.1249022991,11.055352253,4.0841817263
2,0,2005,10390,3162,-868,23030,618,7228,-250,7650,668625,15.628760529,4.7563176895,-1.305655836,672,0.9296028881,10.87244284,-0.376052948
2,0,2006,10663,3144,-1981,22377,1379,7519,-602,7676,676301,15.856634491,4.675350168,-2.945886986,759,2.0506704458,11.181284323,-0.89521654
2,0,2007,11203,2953,-3909,21416,443,8250,-3466,4810,681111,16.506410729,4.3509266162,-5.759489381,26,0.652712662,12.155484112,-5.106776719
2,0,2008,11266,2870,-3732,21416,810,8396,-2922,5182,686293,16.477939219,4.1977352706,-5.458518477,-292,1.1847266792,12.280203949,-4.273791798
2,13,2001,14,8,-235,1156,2,6,-233,-223,2463,5.4379491163,3.107399495,-91.27986017,4,0.7768498738,2.3305496213,-90.50301029
2,13,2002,23,5,159,1355,2,18,161,180,2643,9.009009009,1.9584802193,62.279670975,1,0.7833920877,7.0505287897,63.063063063
2,13,2003,19,7,27,1384,1,12,28,38,2681,7.1374906086,2.6296018032,10.142749812,-2,0.3756574005,4.5078888054,10.518407213
2,13,2004,14,6,-44,1370,0,8,-44,-39,2642,5.2601916213,2.2543678377,-16.53203081,-3,0,3.0058237836,-16.53203081
2,13,2005,21,8,-13,1358,1,13,-12,0,2642,7.9485238456,3.028009084,-4.920514762,-1,0.3785011355,4.9205147615,-4.542013626
2,13,2006,21,11,-40,1357,0,10,-40,-32,2610,7.9969535415,4.1888804265,-15.23229246,-2,0,3.808073115,-15.23229246
2,13,2007,16,0,175,1560,1,16,176,194,2804,5.9106021426,0,64.647210935,2,0.3694126339,5.9106021426,65.016623569
2,13,2008,19,0,-8,1560,0,19,-8,6,2810,6.768792305,0,-2.850017813,-5,0,6.768792305,-2.850017813
2,16,2001,32,10,-127,2258,9,22,-118,-99,5336,5.9418809767,1.8568378052,-23.58184013,-3,1.6711540247,4.0850431715,-21.9106861
2,16,2002,35,9,-215,2062,5,26,-210,-182,5154,6.6730219256,1.7159199237,-40.9914204,2,0.9532888465,4.9571020019,-40.03813155
2,16,2003,26,14,237,2317,-8,12,229,254,5408,4.9233099792,2.6510130657,44.877864041,13,-1.514864609,2.2722969135,43.362999432
2,16,2004,35,18,-14,2379,9,17,-5,9,5417,6.4665127021,3.3256351039,-2.586605081,-3,1.662817552,3.1408775982,-0.923787529
2,16,2005,48,9,-106,2339,3,39,-103,-68,5349,8.9169608025,1.6719301505,-19.69162177,-4,0.5573100502,7.2450306521,-19.13431172
2,16,2006,39,13,-443,2069,6,26,-437,-410,4939,7.5816485226,2.5272161742,-86.11975117,1,1.166407465,5.0544323484,-84.9533437
2,16,2007,40,6,-309,1857,2,34,-307,-269,4670,8.3255281507,1.2488292226,-64.31470496,4,0.4162764075,7.0766989281,-63.89842856
2,16,2008,27,0,-168,1857,5,27,-163,-141,4529,5.870203283,0,-36.52570932,-5,1.087074682,5.870203283,-35.43863463
2,20,2001,4150,1119,-45,7125,515,3031,470,3220,263746,15.831476791,4.268776513,-0.171666616,-281,1.9646290475,11.562700278,1.7929624317
2,20,2002,4095,1288,1491,6792,12,2807,1503,4088,267834,15.406900184,4.8459309982,5.609691862,-222,0.0451484254,10.560969186,5.6548402874
2,20,2003,4186,1218,1622,7865,-978,2968,644,3341,271175,15.532208182,4.5194050563,6.0184523821,-271,-3.628881893,11.012803126,2.3895704895
2,20,2004,4403,1138,-1010,8675,1082,3265,72,3142,274317,16.143224832,4.1723801632,-3.703079055,-195,3.9670609285,11.970844669,0.2639818732
2,20,2005,4312,1224,-1385,9794,383,3088,-1002,1847,276164,15.666299109,4.4470199698,-5.031962956,-239,1.3915103337,11.21927914,-3.640452622
2,20,2006,4404,1208,-618,9463,763,3196,145,3198,279362,15.855243499,4.3490313685,-2.224918366,-143,2.7469461375,11.50621213,0.5220277719
2,20,2007,4626,1219,-5556,8005,296,3407,-5260,-1820,277542,16.613276256,4.3777742663,-19.95316967,33,1.0630198382,12.23550199,-18.89014983
2,20,2008,4505,1303,-1840,8005,474,3202,-1366,1701,279243,16.182188816,4.6804421815,-6.609373457,-135,1.7026320752,11.501746635,-4.906741381
2,50,2001,425,86,-185,267,9,339,-176,151,16253,26.271055478,5.3160253438,-11.43563591,-12,0.5563282337,20.955030134,-10.87930768
2,50,2002,428,97,-21,292,8,331,-13,300,16553,26.092787905,5.913552399,-1.280253612,-18,0.4877156618,20.179235506,-0.79253795
2,50,2003,408,92,-137,327,2,316,-135,164,16717,24.526600541,5.5305079651,-8.235647731,-17,0.120228434,18.996092576,-8.115419297
2,50,2004,418,89,-182,315,9,329,-173,140,16857,24.900220409,5.3017215703,-10.84172276,-16,0.5361291476,19.598498838,-10.30559361
2,50,2005,424,98,-150,293,6,326,-144,167,17024,25.028777191,5.7849532186,-8.854520233,-15,0.3541808093,19.243823972,-8.500339423
2,50,2006,435,92,-271,294,8,343,-263,73,17097,25.497494212,5.3925734885,-15.88464582,-7,0.4689194338,20.104920723,-15.41572639
2,50,2007,418,75,-316,262,5,343,-311,34,17131,24.42444782,4.3823770013,-18.4644151,2,0.2921584668,20.042070819,-18.17225663
2,50,2008,444,77,-267,262,7,367,-260,105,17236,25.838740652,4.4810428609,-15.53816161,-2,0.4073675328,21.357697791,-15.13079408
2,60,2001,19,7,-61,0,1,12,-60,-49,1181,15.761094981,5.8067192036,-50.6014102,-1,0.8295313148,9.9543757777,-49.77187889
2,60,2002,15,5,-56,0,1,10,-55,-45,1136,12.947777298,4.3159257661,-48.33836858,0,0.8631851532,8.6318515322,-47.47518343
2,60,2003,9,4,-42,0,1,5,-41,-35,1101,8.0464908359,3.5762181493,-37.55029057,1,0.8940545373,4.4702726866,-36.65623603
2,60,2004,13,5,-15,0,0,8,-15,-8,1093,11.850501367,4.5578851413,-13.67365542,-1,0,7.2926162261,-13.67365542
2,60,2005,12,2,0,0,1,10,1,12,1105,10.919017288,1.8198362147,0,1,0.9099181074,9.0991810737,0.9099181074
2,60,2006,11,9,-77,0,0,2,-77,-75,1030,10.304449649,8.4309133489,-72.13114754,0,0,1.8735362998,-72.13114754
2,60,2007,12,3,-50,0,1,9,-49,-42,988,11.89296333,2.9732408325,-49.55401388,-2,0.9910802775,8.9197224975,-48.5629336
2,60,2008,10,0,-39,0,0,10,-39,-35,953,10.303967027,0,-40.18547141,-6,0,10.303967027,-40.18547141
2,68,2001,18,0,-68,81,0,18,-68,-51,1841,9.6437181891,0,-36.43182427,-1,0,9.6437181891,-36.43182427
2,68,2002,24,0,4,70,-6,24,-2,21,1862,12.962462868,0,2.160410478,-1,-3.240615717,12.962462868,-1.080205239
2,68,2003,26,3,4,82,-20,23,-16,3,1865,13.952240408,1.6098738932,2.1464985243,-4,-10.73249262,12.342366515,-8.585994097
2,68,2004,22,6,10,57,9,16,19,34,1899,11.689691817,3.1880977683,5.3134962806,-1,4.7821466525,8.5015940489,10.095642933
2,68,2005,22,7,-75,24,-1,15,-76,-62,1837,11.777301927,3.7473233405,-40.14989293,-1,-0.535331906,8.0299785867,-40.68522484
2,68,2006,12,2,-1,6,4,10,3,12,1849,6.5111231687,1.0851871948,-0.542593597,-1,2.1703743896,5.425935974,1.6277807922
2,68,2007,18,2,-29,1,-3,16,-32,-18,1831,9.7826086957,1.0869565217,-15.76086957,-2,-1.630434783,8.6956521739,-17.39130435
2,68,2008,18,1,0,1,1,17,1,17,1848,9.7852677358,0.5436259853,0,-1,0.5436259853,9.2416417505,0.5436259853
2,70,2001,87,33,-106,34,-1,54,-107,-56,4866,17.776869636,6.7429505517,-21.6591745,-3,-0.204331835,11.033919085,-21.86350633
2,70,2002,79,27,37,41,-1,52,36,84,4950,16.096169519,5.5012224939,7.5387123064,-4,-0.203748981,10.594947025,7.3349633252
2,70,2003,101,34,-142,26,-2,67,-144,-74,4876,20.55770405,6.9204152249,-28.90291065,3,-0.407083249,13.637288826,-29.30999389
2,70,2004,87,31,-10,32,1,56,-9,44,4920,17.76235198,6.3291139241,-2.041649653,-3,0.2041649653,11.433238056,-1.837484688
2,70,2005,90,22,-47,42,-1,68,-48,16,4936,18.262987013,4.4642857143,-9.537337662,-4,-0.202922078,13.798701299,-9.74025974
2,70,2006,83,28,-47,39,0,55,-47,6,4942,16.805021259,5.6691637983,-9.516096376,-2,0,11.135857461,-9.516096376
2,70,2007,93,15,-56,34,-1,78,-57,22,4964,18.776499091,3.0284675954,-11.30627902,1,-0.20189784,15.748031496,-11.50817686
2,70,2008,95,8,-122,34,1,87,-121,-31,4933,19.197736688,1.6166515106,-24.65393554,3,0.2020814388,17.581085177,-24.4518541
2,90,2001,1547,350,81,3129,42,1197,123,2524,85293,18.409872547,4.1651295355,0.9639299782,1204,0.4998155443,14.244743012,1.4637455225
2,90,2002,1492,310,240,3162,-308,1182,-68,2119,87412,17.278017429,3.5899365971,2.7793057526,1005,-3.566775716,13.688080831,-0.787469963
2,90,2003,1578,329,606,2950,-1002,1249,-396,1882,89294,17.860174527,3.7236992519,6.8588502937,1029,-11.34087128,14.136475275,-4.482020984
2,90,2004,1566,345,190,3900,541,1221,731,3120,92414,17.236445286,3.7973011645,2.091267308,1168,5.9546084927,13.439144121,8.0458758007
2,90,2005,1583,374,-204,4140,8,1209,-196,2147,94561,16.932745019,4.0005348309,-2.182109908,1134,0.0855729376,12.932210189,-2.09653697
2,90,2006,1525,346,-2269,4173,286,1179,-1983,242,94803,16.106546123,3.6543376777,-23.9644283,1046,3.0206375024,12.452208445,-20.94379079
2,90,2007,1702,335,1827,4611,-27,1367,1800,3183,97986,17.656609039,3.4753020141,18.953363522,16,-0.280098968,14.181307025,18.673264553
2,90,2008,1825,326,-1610,4611,103,1499,-1507,-16,97970,18.626630468,3.3272775521,-16.4322603,-8,1.0512564045,15.299352916,-15.3810039
2,100,2001,19,16,-82,5,1,3,-81,-79,2318,8.0593849417,6.7868504772,-34.7826087,-1,0.4241781548,1.2725344645,-34.35843054
2,100,2002,15,14,-22,5,1,1,-21,-22,2296,6.5019505852,6.0684872128,-9.536194192,-2,0.4334633723,0.4334633723,-9.102730819
2,100,2003,17,17,8,5,1,0,9,5,2301,7.3961279095,7.3961279095,3.4805307809,-4,0.4350663476,0,3.9155971286
2,100,2004,17,15,-68,5,0,2,-68,-69,2232,7.5005515111,6.6181336863,-30.00220604,-3,0,0.8824178248,-30.00220604
2,100,2005,19,12,-21,5,1,7,-20,-14,2218,8.5393258427,5.393258427,-9.438202247,-1,0.4494382022,3.1460674157,-8.988764045
2,100,2006,19,27,4,5,0,-8,4,-6,2212,8.5778781038,12.189616253,1.8058690745,-2,0,-3.611738149,1.8058690745
2,100,2007,23,12,50,5,1,11,51,59,2271,10.260985947,5.3535578853,22.306491189,-3,0.4461298238,4.9074280616,22.752621013
2,100,2008,22,3,-10,5,0,19,-10,0,2271,9.6873623954,1.321003963,-4.403346543,-9,0,8.3663584324,-4.403346543
2,105,2001,18,24,-29,20,0,-6,-29,-36,2525,7.0782540307,9.4376720409,-11.40385372,-1,0,-2.35941801,-11.40385372
2,105,2002,17,11,-69,23,-1,6,-70,-67,2458,6.8231988762,4.4150110375,-27.69416014,-3,-0.40136464,2.4081878387,-28.09552478
2,105,2003,19,14,-119,24,-1,5,-120,-109,2349,7.9051383399,5.8248387768,-49.5111296,6,-0.416059913,2.0802995631,-49.92718952
2,105,2004,23,10,-69,14,0,13,-69,-59,2290,9.9159301574,4.3112739815,-29.74779047,-3,0,5.6046561759,-29.74779047
2,105,2005,25,20,-26,14,0,5,-26,-23,2267,10.972130788,8.7777046302,-11.41101602,-2,0,2.1944261576,-11.41101602
2,105,2006,25,15,-61,22,0,10,-61,-52,2215,11.155734047,6.6934404284,-27.21999108,-1,0,4.4622936189,-27.21999108
2,105,2007,24,7,-14,30,0,17,-14,1,2216,10.832769127,3.1595576619,-6.319115324,-2,0,7.6732114647,-6.319115324
2,105,2008,21,0,-55,30,0,21,-55,-42,2174,9.5671981777,0,-25.05694761,-8,0,9.5671981777,-25.05694761
2,110,2001,412,146,-489,678,48,266,-441,-195,30475,13.476163219,4.7755335677,-15.99476654,-20,1.5700384332,8.7006296508,-14.42472811
2,110,2002,403,142,-37,706,38,261,1,231,30706,13.174024615,4.6419640084,-1.209525833,-31,1.2422157206,8.5320606071,0.0326898874
2,110,2003,385,129,-46,590,11,256,-35,172,30878,12.503247597,4.1893998441,-1.493894518,-49,0.3572356456,8.3138477527,-1.136658872
2,110,2004,382,133,-193,617,48,249,-145,79,30957,12.355462117,4.3017708418,-6.242419342,-25,1.5525188,8.0536912752,-4.689900542
2,110,2005,383,139,-368,655,35,244,-333,-114,30843,12.394822006,4.498381877,-11.90938511,-25,1.1326860841,7.8964401294,-10.77669903
2,110,2006,395,140,-451,609,43,255,-408,-166,30677,12.841352406,4.5513654096,-14.66189857,-13,1.3979193758,8.2899869961,-13.26397919
2,110,2007,402,147,-442,644,31,255,-411,-147,30530,13.135752447,4.8033721633,-14.44279249,9,1.0129560344,8.3323802833,-13.42983646
2,110,2008,392,118,162,644,35,274,197,458,30988,12.744237459,3.8362755616,5.2667511948,-13,1.1378783445,8.9079618973,6.4046295393
2,122,2001,622,278,81,1359,22,344,103,392,50040,12.478934275,5.5774014927,1.6250702191,-55,0.4413770965,6.9015327823,2.0664473156
2,122,2002,615,293,487,1358,15,322,502,788,50828,12.194154737,5.8095729072,9.6561843201,-36,0.2974184082,6.3845818297,9.9536027283
2,122,2003,643,317,-149,1366,-4,326,-153,100,50928,12.638075396,6.2305908251,-2.928574236,-73,-0.078619443,6.4074845709,-3.007193679
2,122,2004,620,312,96,1341,26,308,122,397,51325,12.126783566,6.1025104398,1.8776955199,-33,0.5085425366,6.0242731265,2.3862380566
2,122,2005,616,294,-86,1394,16,322,-70,204,51529,11.978143777,5.7168413479,-1.672273319,-48,0.3111206176,6.2613024287,-1.361152702
2,122,2006,642,295,245,1370,22,347,267,588,52117,12.388321788,5.6924531579,4.7276305887,-26,0.4245219304,6.6958686298,5.1521525192
2,122,2007,675,303,576,1437,11,372,587,967,53084,12.832577637,5.7604015171,10.95046625,8,0.2091234874,7.07217612,11.159589738
2,122,2008,708,301,-88,1437,15,407,-73,325,53409,13.296648606,5.6529537153,-1.652690787,-9,0.2817086569,7.6436948907,-1.37098213
2,130,2001,170,106,-296,208,16,64,-280,-223,13762,12.253576963,7.6404656359,-21.33563989,-7,1.1532778318,4.6131113274,-20.18236206
2,130,2002,185,88,-298,238,6,97,-292,-200,13562,13.541209193,6.4412238325,-21.81232616,-5,0.4391743522,7.0999853609,-21.37315181
2,130,2003,173,76,-370,236,-16,97,-386,-282,13280,12.890246628,5.662767305,-27.56873556,7,-1.192161538,7.2274793234,-28.7608971
2,130,2004,173,96,-230,225,27,77,-203,-139,13141,13.095643617,7.2669467469,-17.41039325,-13,2.0438287726,5.8286968699,-15.36656448
2,130,2005,190,72,-86,227,12,118,-74,32,13173,14.440981987,5.4723721213,-6.536444478,-12,0.9120620202,8.9686098655,-5.624382458
2,130,2006,191,83,20,273,20,108,40,142,13315,14.421624887,6.2669888251,1.5101177892,-6,1.5101177892,8.1546360616,3.0202355784
2,130,2007,184,52,-294,240,9,132,-285,-153,13162,13.898855611,3.9279374551,-22.20795407,0,0.6798353288,9.9709181554,-21.52811874
2,130,2008,190,85,-137,240,14,105,-123,-20,13142,14.446472019,6.4628953771,-10.41666667,-2,1.0644768856,7.9835766423,-9.352189781
2,150,2001,232,50,-523,334,83,182,-440,-262,13693,16.782407407,3.6168981481,-37.83275463,-4,6.0040509259,13.165509259,-31.8287037
2,150,2002,214,43,-300,304,39,171,-261,-96,13597,15.683400513,3.1513374863,-21.98607549,-6,2.8581898131,12.532063027,-19.12788567
2,150,2003,232,53,-465,262,-67,179,-532,-343,13254,17.28054821,3.9477114446,-34.63558154,10,-4.990503147,13.332836766,-39.62608469
2,150,2004,191,54,-385,247,127,137,-258,-140,13114,14.487257282,4.0958737864,-29.20206311,-19,9.6328883495,10.391383495,-19.56917476
2,150,2005,209,44,-365,231,59,165,-306,-150,12964,16.028836567,3.3744919089,-27.99294424,-9,4.5248868778,12.654344658,-23.46805737
2,150,2006,214,65,-209,215,94,149,-115,28,12992,16.489443674,5.0084758823,-16.1041763,-6,7.2430266605,11.480967792,-8.861149638
2,150,2007,222,31,-245,228,49,191,-196,-11,12981,17.09467524,2.3870942902,-18.8657452,-6,3.7731490394,14.707580949,-15.09259616
2,150,2008,211,17,-171,228,66,194,-105,68,13049,16.212063004,1.306185171,-13.13868613,-21,5.0710718402,14.905877833,-8.067614291
2,164,2001,21,15,-124,0,2,6,-122,-116,1693,11.993146773,8.5665334095,-70.81667619,0,1.1422044546,3.4266133638,-69.67447173
2,164,2002,23,20,-114,0,2,3,-112,-108,1585,14.032946919,12.202562538,-69.55460647,1,1.2202562538,1.8303843807,-68.33435021
2,164,2003,21,13,-19,0,1,8,-18,-12,1573,13.299556681,8.233058898,-12.03293224,-2,0.6333122229,5.0664977834,-11.39962001
2,164,2004,27,9,-16,0,0,18,-16,2,1575,17.153748412,5.7179161372,-10.16518424,0,0,11.435832274,-10.16518424
2,164,2005,29,12,-38,0,1,17,-37,-21,1554,18.53627357,7.6701821668,-24.28891019,-1,0.6391818472,10.866091403,-23.64972835
2,164,2006,33,14,-51,0,0,19,-51,-33,1521,21.463414634,9.1056910569,-33.17073171,-1,0,12.357723577,-33.17073171
2,164,2007,26,11,-19,0,1,15,-18,-6,1515,17.127799736,7.2463768116,-12.51646904,-3,0.6587615283,9.8814229249,-11.85770751
2,164,2008,25,0,-46,0,0,25,-46,-27,1488,16.65001665,0,-30.63603064,-6,0,16.65001665,-30.63603064
2,170,2001,842,295,1506,1038,38,547,1544,2054,61902,13.831622177,4.8459958932,24.739219713,-37,0.6242299795,8.9856262834,25.363449692
2,170,2002,864,306,2048,1011,17,558,2065,2621,64523,13.668182717,4.8408147123,32.398655329,-2,0.2689341507,8.8273680047,32.66758948
2,170,2003,823,317,2419,991,-30,506,2389,2967,67490,12.468469014,4.8025573239,36.647905888,72,-0.454500693,7.6659116905,36.193405195
2,170,2004,1032,322,3064,971,62,710,3126,3691,71181,14.884150255,4.6440856416,44.190926726,-145,0.8942028254,10.240064613,45.085129551
2,170,2005,1052,379,3133,1070,30,673,3163,3783,74964,14.396660851,5.1866297171,42.875226658,-53,0.4105511649,9.2100311335,43.285777823
2,170,2006,1197,383,3676,1026,47,814,3723,4486,79450,15.503775564,4.9606900929,47.612263137,-51,0.6087530923,10.543085472,48.221016229
2,170,2007,1277,405,2207,1054,27,872,2234,3097,82547,15.765724057,5.0000925943,27.247418162,-9,0.3333395063,10.765631462,27.580757668
2,170,2008,1337,391,1926,1054,36,946,1962,2911,85458,15.91619297,4.6546233743,22.927889051,3,0.4285586738,11.261569596,23.356447725
2,180,2001,202,54,-131,222,10,148,-121,20,9191,22.001960571,5.8817122318,-14.26859819,-7,1.0892059688,16.120248339,-13.17939222
2,180,2002,196,62,-135,218,9,134,-126,-1,9190,21.326369621,6.7460965127,-14.68908112,-9,0.9792720744,14.580273108,-13.70980904
2,180,2003,208,65,-60,247,2,143,-58,75,9265,22.541316716,7.0441614739,-6.502302899,-10,0.21674343,15.497155242,-6.285559469
2,180,2004,197,63,0,261,10,134,10,137,9402,21.106765951,6.7498794664,0,-7,1.0714094391,14.356886484,1.0714094391
2,180,2005,241,69,-196,218,7,172,-189,-22,9380,25.662868704,7.3474603344,-20.87104675,-5,0.7453945267,18.31540837,-20.12565222
2,180,2006,228,51,-302,230,9,177,-293,-118,9262,24.460894754,5.4715159318,-32.39995709,-2,0.965561635,18.989378822,-31.43439545
2,180,2007,222,37,-153,234,-1,185,-154,23,9285,23.939181539,3.9898635898,-16.49862511,-8,-0.107834151,19.949317949,-16.60645927
2,180,2008,233,29,-213,234,1,204,-212,-24,9261,25.126711959,3.1273589992,-22.96991265,-16,0.1078399655,21.99935296,-22.86207268
2,185,2001,151,41,-280,82,13,110,-267,-158,7211,20.713305898,5.6241426612,-38.40877915,-1,1.7832647462,15.089163237,-36.6255144
2,185,2002,177,24,-236,71,12,153,-224,-71,7140,24.667270573,3.344714654,-32.8896941,0,1.672357327,21.322555919,-31.21733677
2,185,2003,153,31,-159,69,5,122,-154,-33,7107,21.478205938,4.35179336,-22.32048852,-1,0.7019021548,17.126412578,-21.61858637
2,185,2004,173,42,-316,55,6,131,-310,-193,6914,24.67726981,5.9910134798,-45.07524428,-14,0.8558590685,18.68625633,-44.21938521
2,185,2005,173,38,-296,34,6,135,-290,-158,6756,25.310899781,5.559619605,-43.30651061,-3,0.8778346745,19.751280176,-42.42867593
2,185,2006,184,28,-312,41,6,156,-306,-152,6604,27.54491018,4.1916167665,-46.70658683,-2,0.8982035928,23.353293413,-45.80838323
2,185,2007,172,29,-208,34,4,143,-204,-64,6540,26.171637249,4.4126597687,-31.64942179,-3,0.6086427267,21.75897748,-31.04077906
2,185,2008,165,9,-72,34,4,156,-68,75,6615,25.085518814,1.3683010262,-10.94640821,-13,0.6081337894,23.717217788,-10.33827442
2,188,2001,159,34,-94,325,2,125,-92,26,7246,21.982579842,4.7006774506,-12.9959906,-7,0.2765104383,17.281902392,-12.71948016
2,188,2002,168,43,-131,318,1,125,-130,-7,7239,23.196410079,5.9371763894,-18.08767691,-2,0.1380738695,17.25923369,-17.94960304
2,188,2003,165,46,-70,297,-1,119,-71,42,7281,22.727272727,6.3360881543,-9.641873278,-6,-0.137741047,16.391184573,-9.779614325
2,188,2004,171,43,-34,301,0,128,-34,87,7368,23.346303502,5.8707078982,-4.641955082,-7,0,17.475595604,-4.641955082
2,188,2005,170,35,-119,291,0,135,-119,11,7379,23.055536719,4.7467281481,-16.1388757,-5,0,18.308808571,-16.1388757
2,188,2006,199,49,-76,292,0,150,-76,70,7449,26.841111411,6.6091178851,-10.25087672,-4,0,20.231993526,-10.25087672
2,188,2007,202,26,-160,303,0,176,-160,18,7467,27.085009386,3.4861893269,-21.45347278,2,0,23.598820059,-21.45347278
2,188,2008,186,20,-134,303,0,166,-134,35,7502,24.851359476,2.672189191,-17.90366758,3,0,22.179170285,-17.90366758
2,201,2001,84,22,-294,87,1,62,-293,-230,5896,13.974380303,3.659956746,-48.91033106,1,0.1663616703,10.314423557,-48.74396939
2,201,2002,68,29,-241,88,1,39,-240,-199,5697,11.731217114,5.0030190632,-41.57681359,2,0.1725178987,6.7281980505,-41.4042957
2,201,2003,60,30,-33,89,1,30,-32,-8,5689,10.539258739,5.2696293694,-5.796592306,-6,0.1756543123,5.2696293694,-5.620937994
2,201,2004,47,23,-47,95,0,24,-47,-28,5661,8.281938326,4.0528634361,-8.281938326,-5,0,4.2290748899,-8.281938326
2,201,2005,63,40,-96,89,1,23,-95,-76,5585,11.203983639,7.1136404055,-17.07273697,-4,0.1778410101,4.0903432331,-16.89489596
2,201,2006,76,25,2,94,0,51,2,50,5635,13.547237077,4.4563279857,0.3565062389,-3,0,9.0909090909,0.3565062389
2,201,2007,67,18,-160,94,1,49,-159,-112,5523,12.009320667,3.2263846567,-28.67897473,-2,0.179243592,8.78293601,-28.49973113
2,201,2008,71,7,-47,94,0,64,-47,10,5533,12.843704776,1.2662807525,-8.502170767,-7,0,11.577424023,-8.502170767
2,220,2001,116,52,-181,276,14,64,-167,-107,8726,13.212597528,5.9228885472,-20.61620821,-4,1.5946238396,7.2897089811,-19.02158437
2,220,2002,131,38,37,259,2,93,39,124,8850,14.906690942,4.3240782886,4.2102867547,-8,0.2275830678,10.582612654,4.4378698225
2,220,2003,112,46,-21,244,-24,66,-45,10,8860,12.648221344,5.1948051948,-2.371541502,-11,-2.710333145,7.4534161491,-5.081874647
2,220,2004,114,49,-73,252,30,65,-43,13,8873,12.857384537,5.5264196695,-8.233237467,-9,3.3835222467,7.3309648678,-4.84971522
2,220,2005,122,57,15,248,11,65,26,83,8956,13.685568456,6.3940770655,1.6826518593,-8,1.2339446968,7.2914913904,2.9165965562
2,220,2006,113,61,-44,230,21,52,-23,25,8981,12.599654346,6.8015833194,-4.906060099,-4,2.3415286837,5.7980710264,-2.564531416
2,220,2007,129,42,-245,213,9,87,-236,-144,8837,14.479739589,4.7143338197,-27.50028062,5,1.0102143899,9.7654057694,-26.49006623
2,220,2008,126,32,-58,213,15,94,-43,52,8889,14.21640528,3.6105156268,-6.544059574,1,1.6924292,10.605889654,-4.851630373
2,230,2001,5,2,-9,0,0,3,-9,-8,860,5.787037037,2.3148148148,-10.41666667,-2,0,3.4722222222,-10.41666667
2,230,2002,5,0,-14,0,-1,5,-15,-10,850,5.8479532164,0,-16.37426901,0,-1.169590643,5.8479532164,-17.54385965
2,230,2003,5,0,16,0,-1,5,15,20,870,5.8139534884,0,18.604651163,0,-1.162790698,5.8139534884,17.441860465
2,230,2004,6,0,27,0,0,6,27,32,902,6.7720090293,0,30.474040632,-1,0,6.7720090293,30.474040632
2,230,2005,8,1,-1,0,0,7,-1,4,906,8.8495575221,1.1061946903,-1.10619469,-2,0,7.7433628319,-1.10619469
2,230,2006,7,0,-20,0,0,7,-20,-13,893,7.7821011673,0,-22.23457476,0,0,7.7821011673,-22.23457476
2,230,2007,7,2,1,0,0,5,1,5,898,7.8168620882,2.2333891681,1.116694584,-1,0,5.5834729202,1.116694584
2,230,2008,8,4,-10,0,0,4,-10,-6,892,8.938547486,4.469273743,-11.17318436,0,0,4.469273743,-11.17318436
2,240,2001,93,26,-591,253,33,67,-558,-482,5688,15.685613088,4.3852251644,-99.67954124,9,5.5658627087,11.300387924,-94.11367853
2,240,2002,86,34,-163,248,23,52,-140,-89,5599,15.238770267,6.0246301054,-28.88278551,-1,4.0754850713,9.2141401612,-24.80730043
2,240,2003,96,45,39,207,-8,51,31,80,5679,17.024295088,7.9801383224,6.9161198794,-2,-1.418691257,9.0441567654,5.4974286221
2,240,2004,79,52,208,215,37,27,245,262,5941,13.597246127,8.9500860585,35.800344234,-10,6.3683304647,4.6471600688,42.168674699
2,240,2005,105,32,396,200,21,73,417,486,6427,16.979301423,5.1746442432,64.03622251,-4,3.3958602846,11.80465718,67.432082794
2,240,2006,114,32,159,205,29,82,188,267,6694,17.376724335,4.8776770063,24.235957625,-3,4.420394787,12.499047329,28.656352412
2,240,2007,123,19,-13,194,15,104,2,96,6790,18.243844557,2.8181548502,-1.928211213,-10,2.2248590923,15.425689706,0.296647879
2,240,2008,112,33,-124,194,20,79,-104,-37,6753,16.539909917,4.8733663147,-18.31204312,-12,2.9535553422,11.666543602,-15.35848778
2,261,2001,128,53,-210,165,17,75,-193,-125,10095,12.601525966,5.2178193453,-20.67437854,-7,1.6736401674,7.3837066207,-19.00073837
2,261,2002,130,49,-138,164,11,81,-127,-56,10039,12.913479686,4.8673884971,-13.70815536,-10,1.0926790504,8.046091189,-12.61547631
2,261,2003,126,55,-157,161,-7,71,-164,-98,9941,12.612612613,5.5055055055,-15.71571572,-5,-0.700700701,7.1071071071,-16.41641642
2,261,2004,112,42,-129,140,19,70,-110,-50,9891,11.294876967,4.2355788624,-13.00927793,-10,1.9160951997,7.0592981041,-11.09318273
2,261,2005,119,50,-158,146,10,69,-148,-86,9805,12.083671812,5.0771730301,-16.04386677,-7,1.015434606,7.0064987815,-15.02843217
2,261,2006,119,47,-173,149,15,72,-158,-89,9716,12.191998361,4.8153270837,-17.72450182,-3,1.5368065161,7.3766712771,-16.1876953
2,261,2007,132,35,-340,158,8,97,-332,-230,9486,13.748567858,3.6454535986,-35.41297781,5,0.8332465368,10.103114259,-34.57973128
2,261,2008,118,35,-214,158,11,83,-203,-124,9362,12.521222411,3.7139219015,-22.70797963,-4,1.1672325976,8.8073005093,-21.54074703
2,270,2001,217,44,-123,12,1,173,-122,46,7088,30.714791224,6.2278839349,-17.40976645,-5,0.1415428167,24.486907289,-17.26822364
2,270,2002,197,33,-88,10,1,164,-87,72,7160,27.65300393,4.6322290848,-12.35261089,-5,0.1403705783,23.020774846,-12.21224031
2,270,2003,229,38,-58,10,1,191,-57,124,7284,31.708667959,5.26170036,-8.031016339,-10,0.1384657989,26.446967599,-7.89255054
2,270,2004,215,44,-5,10,0,171,-5,161,7445,29.194106864,5.9746079164,-0.678932718,-5,0,23.219498948,-0.678932718
2,270,2005,238,42,-184,10,1,196,-183,10,7455,31.946308725,5.6375838926,-24.69798658,-3,0.1342281879,26.308724832,-24.56375839
2,270,2006,223,37,-165,10,0,186,-165,18,7473,29.876741693,4.9571275456,-22.10610932,-3,0,24.919614148,-22.10610932
2,270,2007,226,45,-60,10,1,181,-59,115,7588,30.011287431,5.9756988248,-7.967598433,-7,0.1327933072,24.035588606,-7.834805126
2,270,2008,246,33,-75,10,0,213,-75,129,7717,32.1463574,4.3123162365,-9.800718719,-9,0,27.834041163,-9.800718719
2,280,2001,82,41,-137,76,9,41,-128,-91,6588,12.361498455,6.1807492274,-20.65274742,-4,1.3567498304,6.1807492274,-19.29599759
2,280,2002,62,51,-201,54,9,11,-192,-183,6405,9.5436004002,7.8503809744,-30.93973678,-2,1.3853613484,1.6932194258,-29.55437543
2,280,2003,55,59,-167,47,5,-4,-162,-163,6242,8.6977148731,9.3302759548,-26.40942516,3,0.7907013521,-0.632561082,-25.61872381
2,280,2004,72,55,-46,55,6,17,-40,-29,6213,11.561621839,8.8317944601,-7.38659173,-6,0.9634684866,2.7298273786,-6.423123244
2,280,2005,48,42,-126,56,6,6,-120,-118,6095,7.7998050049,6.8248293793,-20.47448814,-4,0.9749756256,0.9749756256,-19.49951251
2,280,2006,69,38,-148,53,6,31,-142,-113,5982,11.426678811,6.2929535481,-24.50939803,-2,0.9936242444,5.1337252629,-23.51577378
2,280,2007,62,36,-35,56,2,26,-33,-5,5977,10.36875993,6.0205702818,-5.853332218,2,0.3344761268,4.348189648,-5.518856092
2,280,2008,60,28,-98,56,2,32,-96,-67,5910,10.095061832,4.7110288551,-16.48860099,-3,0.3365020611,5.3840329772,-16.15209893
2,282,2001,8,9,-2,137,1,-1,-1,-3,799,9.9937539038,11.242973142,-2.498438476,-1,1.249219238,-1.249219238,-1.249219238
2,282,2002,5,3,-53,139,1,2,-52,-50,749,6.4599483204,3.8759689922,-68.4754522,0,1.2919896641,2.5839793282,-67.18346253
2,282,2003,7,5,-25,139,1,2,-24,-20,729,9.4722598106,6.7658998647,-33.82949932,2,1.3531799729,2.7063599459,-32.47631935
2,282,2004,6,4,-18,139,0,2,-18,-18,711,8.3333333333,5.5555555556,-25,-2,0,2.7777777778,-25
2,282,2005,6,3,-36,84,1,3,-35,-33,678,8.6393088553,4.3196544276,-51.83585313,-1,1.4398848092,4.3196544276,-50.39596832
2,282,2006,9,6,-17,84,0,3,-17,-13,665,13.402829486,8.9352196575,-25.3164557,1,0,4.4676098287,-25.3164557
2,282,2007,10,2,8,84,1,8,9,16,681,14.85884101,2.9717682021,11.887072808,-1,1.485884101,11.887072808,13.372956909
2,282,2008,6,1,-30,84,0,5,-30,-24,657,8.9686098655,1.4947683109,-44.84304933,1,0,7.4738415546,-44.84304933
2,290,2001,101,68,-137,68,0,33,-137,-108,6385,15.685665476,10.560646063,-21.27659574,-4,0,5.125019413,-21.27659574
2,290,2002,101,51,-55,68,-1,50,-56,-11,6374,15.831961752,7.9943569245,-8.621365311,-5,-0.156752097,7.837604828,-8.778117407
2,290,2003,98,42,-120,68,-1,56,-121,-65,6309,15.453756998,6.6230387132,-18.92296775,0,-0.157691398,8.8307182843,-19.08065915
2,290,2004,85,45,-62,68,0,40,-62,-29,6280,13.50385257,7.1490984193,-9.849868933,-7,0,6.3547541504,-9.849868933
2,290,2005,62,37,-230,68,0,25,-230,-207,6073,10.038047438,5.9904476645,-37.23791791,-2,0,4.0475997733,-37.23791791
2,290,2006,76,39,-292,68,0,37,-292,-257,5816,12.784927244,6.5606863487,-49.12103625,-2,0,6.2242408949,-49.12103625
2,290,2007,93,39,-49,68,0,54,-49,1,5817,15.988996819,6.7050631823,-8.424310152,-4,0,9.2839336371,-8.424310152
2,290,2008,86,9,-184,68,0,77,-184,-116,5701,14.933148116,1.5627713145,-31.94999132,-9,0,13.370376802,-31.94999132
4,0,2001,85466,40694,56868,110864,32113,44772,88981,136822,5303632,16.325194295,7.7731197976,10.862578676,3069,6.1340294899,8.552074497,16.996608166
4,0,2002,86188,42540,69983,112832,29310,43648,99293,145563,5449195,16.030761027,7.9123378438,13.016669942,2622,5.4515896145,8.118423183,18.468259556
4,0,2003,89484,42444,63038,113617,23481,47040,86519,136317,5585512,16.218645407,7.6928186675,11.425405314,2758,4.2558447633,8.5258267392,15.681250078
4,0,2004,92044,43580,90745,112261,25546,48464,116291,164963,5750475,16.239256449,7.6887879282,16.010074817,208,4.5070623317,8.5504685212,20.517137149
4,0,2005,95084,44279,132123,113497,25341,50805,157464,210764,5961239,16.237418366,7.5614892918,22.562538669,2495,4.3274622314,8.6759290741,26.8900009
4,0,2006,98557,46649,137697,115883,26023,51908,163720,217012,6178251,16.237420188,7.6854958487,22.68579652,1384,4.2873300279,8.5519243395,26.973126548
4,0,2007,104378,43432,87245,118116,22873,60946,110118,175170,6353421,16.658271937,6.9315570979,13.923920128,4106,3.6504306847,9.726714839,17.574350813
4,0,2008,106737,45850,62980,119162,23318,60887,86298,146759,6500180,16.608108498,7.1341875323,9.7995884577,-426,3.628243945,9.4739209658,13.427832403
4,1,2001,1206,481,-2387,1319,19,725,-2368,-1656,67861,17.557396381,7.0025768318,-34.75083347,-13,0.276609064,10.554819549,-34.4742244
4,1,2002,1160,496,-1243,1325,19,664,-1224,-591,67270,17.168525357,7.3410246354,-18.39696295,-31,0.281208605,9.8275007215,-18.11575434
4,1,2003,1228,470,5,1309,14,758,19,674,67944,18.163799607,6.9519428462,0.0739568388,-103,0.2070791486,11.21185676,0.2810359874
4,1,2004,1329,504,-776,1262,16,825,-760,1,67945,19.560082126,7.4178189552,-11.42108633,-64,0.235486316,12.142263171,-11.18560001
4,1,2005,1303,504,-437,1315,15,799,-422,316,68261,19.132784165,7.4005550416,-6.416751098,-61,0.2202546143,11.732229124,-6.196496483
4,1,2006,1230,538,378,1296,15,692,393,1049,69310,17.881675644,7.8214158507,5.4953442223,-36,0.2180692152,10.060259793,5.7134134374
4,1,2007,1200,476,-382,1357,14,724,-368,356,69666,17.269168777,6.850103615,-5.497352061,0,0.2014736357,10.419065162,-5.295878425
4,1,2008,1312,495,-281,1345,16,817,-265,541,70207,18.759875029,7.0778491918,-4.017930551,-11,0.2287789638,11.682025838,-3.789151588
4,3,2001,1677,1080,-245,5579,282,597,37,522,118535,14.178940426,9.131339094,-2.071461183,-112,2.3842940968,5.0476013325,0.3128329134
4,3,2002,1704,1122,670,5612,2,582,672,1152,119687,14.305983494,9.4197849065,5.6250052472,-102,0.0167910604,4.8861985879,5.6417963076
4,3,2003,1748,1080,1391,5615,-590,668,801,1398,121085,14.519960793,8.9711428239,11.554499693,-71,-4.900902098,5.5488179689,6.6535975944
4,3,2004,1791,1134,871,5560,617,657,1488,2035,123120,14.668004341,9.2872791302,7.133351078,-110,5.0531315903,5.3807252104,12.186482668
4,3,2005,1830,1102,1552,5857,212,728,1764,2378,125498,14.721379787,8.8650057518,12.485017175,-114,1.7054276038,5.8563740357,14.190444779
4,3,2006,1773,1196,277,5884,421,577,698,1210,126708,14.059935132,9.4843104446,2.1966170511,-65,3.3385407167,4.5756246878,5.5351577679
4,3,2007,1851,972,157,6083,163,879,320,1223,127931,14.53822863,7.6343372382,1.2331182576,24,1.2802437961,6.9038913913,2.5133620537
4,3,2008,1920,1062,-115,6196,274,858,159,1075,129006,14.945297875,8.2666178869,-0.895161071,58,2.1328185509,6.6786799877,1.2376574802
4,5,2001,1847,526,-357,3090,220,1321,-137,1068,117771,15.754412003,4.4866381774,-3.045113744,-116,1.8765406825,11.267773826,-1.168573061
4,5,2002,1921,604,1121,3090,210,1317,1331,2562,120333,16.135806202,5.0734132984,9.4160534892,-86,1.7639350872,11.062392904,11.179988576
4,5,2003,1903,579,-179,3177,174,1324,-5,1127,121460,15.740736911,4.7892205316,-1.480605311,-192,1.4392476209,10.95151638,-0.04135769
4,5,2004,1946,649,409,3172,161,1297,570,1775,123235,15.905515029,5.3045628231,3.3429371258,-92,1.3159239053,10.600952206,4.6588610311
4,5,2005,2111,633,-121,3171,172,1478,51,1418,124653,17.031885368,5.1071451623,-0.976247338,-111,1.387723488,11.924740205,0.4114761505
4,5,2006,2029,647,-179,3132,173,1382,-6,1313,125966,16.191908834,5.1632158775,-1.428463125,-63,1.3805816798,11.028692956,-0.047881446
4,5,2007,2131,577,-261,3090,152,1554,-109,1384,127350,16.824835383,4.5555748551,-2.060667309,-61,1.2000821109,12.269260528,-0.860585198
4,5,2008,2174,648,-406,3090,154,1526,-252,1208,128558,16.990480954,5.06431999,-3.173015302,-66,1.2035575285,11.926160964,-1.969457774
4,7,2001,684,624,-264,993,58,60,-206,-191,51168,13.342826768,12.172403367,-5.149862963,-45,1.1314092873,1.1704234007,-4.018453676
4,7,2002,637,629,43,994,55,8,98,58,51226,12.442135281,12.285876126,0.8398929625,-48,1.0742816962,0.1562591558,1.9141746587
4,7,2003,721,632,-401,1000,40,89,-361,-327,50899,14.11995104,12.376988984,-7.853121175,-55,0.7833537332,1.7429620563,-7.069767442
4,7,2004,700,652,-112,988,37,48,-75,-63,50836,13.761242444,12.81761439,-2.201798791,-36,0.7273799577,0.9436280533,-1.474418833
4,7,2005,667,707,109,999,40,-40,149,58,50894,13.113142632,13.899537993,2.1429273567,-51,0.7863953603,-0.78639536,2.929322717
4,7,2006,653,678,553,1007,38,-25,591,541,51435,12.762755426,13.251375465,10.808275269,-25,0.7427024597,-0.488620039,11.550977729
4,7,2007,680,583,378,1033,36,97,414,502,51937,13.156367295,11.279650195,7.313392408,-9,0.6965135627,1.8767170994,8.0099059707
4,7,2008,746,644,88,1031,35,102,123,229,52166,14.331959694,12.372361988,1.6906333151,4,0.6724109776,1.9595977061,2.3630442927
4,9,2001,474,249,-454,3091,16,225,-438,-240,33302,14.182275148,7.4501825145,-13.58386691,-27,0.4787265873,6.7320926336,-13.10514033
4,9,2002,453,272,-365,3257,16,181,-349,-190,33112,13.641702051,8.191044057,-10.99165839,-22,0.481826121,5.4506579938,-10.50983226
4,9,2003,460,259,-540,3240,13,201,-527,-339,32773,13.963724672,7.8621841087,-16.39219853,-13,0.3946270016,6.1015405631,-15.99757153
4,9,2004,439,258,-504,3121,16,181,-488,-343,32430,13.465638084,7.9137463,-15.45941138,-36,0.4907749643,5.5518917841,-14.96863641
4,9,2005,453,293,41,3069,15,160,56,187,32617,13.928390241,9.008870509,1.2606269313,-29,0.4612049749,4.9195197319,1.7218319062
4,9,2006,492,280,546,3257,15,212,561,755,33372,14.911576172,8.486262862,16.548212581,-18,0.4546212247,6.4253133098,17.002833806
4,9,2007,581,281,1270,3365,10,300,1280,1605,34977,17.000980263,8.2225050842,37.162211591,25,0.2926158393,8.7784751789,37.45482743
4,9,2008,578,271,1136,3310,12,307,1148,1475,36452,16.183902897,7.5879544723,31.807809153,20,0.335997984,8.5959484243,32.143807137
4,11,2001,106,54,-323,27,11,52,-312,-260,8281,12.602544287,6.4201640709,-38.4020925,0,1.3078111996,6.1823802164,-37.0942813
4,11,2002,85,56,-625,27,11,29,-614,-575,7706,10.633639832,7.0056921249,-78.18852818,10,1.376118096,3.6279477075,-76.81241008
4,11,2003,100,56,-392,27,7,44,-385,-326,7380,13.257324672,7.4241018163,-51.96871271,15,0.928012727,5.8332228556,-51.04069999
4,11,2004,82,51,-102,27,6,31,-96,-73,7307,11.166337577,6.9449172738,-13.88983455,-8,0.817049091,4.2214203037,-13.07278546
4,11,2005,100,62,-57,27,7,38,-50,-16,7291,13.700506919,8.4943142896,-7.809288944,-4,0.9590354843,5.2061926291,-6.850253459
4,11,2006,111,56,100,27,6,55,106,157,7448,15.062080195,7.5988873058,13.569441617,-4,0.814166497,7.4631928896,14.383608115
4,11,2007,126,48,217,27,6,78,223,291,7739,16.593138869,6.3211957595,28.577072496,-10,0.7901494699,10.271943109,29.367221966
4,11,2008,135,43,185,27,5,92,190,263,8002,17.152658662,5.4634394257,23.505495204,-19,0.6352836542,11.689219236,24.140778858
4,12,2001,191,172,-176,280,63,19,-113,-110,19534,9.7503701057,8.7804380009,-8.984634233,-16,3.2160906631,0.9699321048,-5.76854357
4,12,2002,216,233,-228,280,60,-17,-168,-203,19331,11.11539946,11.990222565,-11.73292165,-18,3.087610961,-0.874823106,-8.645310691
4,12,2003,219,193,93,280,43,26,136,144,19475,11.286914395,9.9469154254,4.7930732361,-18,2.2161521414,1.3399989692,7.0092253775
4,12,2004,244,227,113,280,41,17,154,155,19630,12.479222606,11.609768572,5.7793121084,-16,2.0969185526,0.869454034,7.876230661
4,12,2005,230,238,258,280,44,-8,302,276,19906,11.634965601,12.039660057,13.051396196,-18,2.2258195063,-0.404694456,15.277215702
4,12,2006,242,215,-10,280,44,27,34,52,19958,12.141280353,10.786674694,-0.5017058,-9,2.2075055188,1.3546056592,1.705799719
4,12,2007,234,197,56,280,34,37,90,133,20091,11.685685036,9.8379485131,2.7965741966,6,1.6979200479,1.8477365228,4.4944942446
4,12,2008,237,211,-87,280,34,26,-53,-5,20086,11.797794758,10.503521916,-4.33083605,22,1.6925106404,1.2942728427,-2.63832541
4,13,2001,55460,22826,46130,46011,25297,32634,71427,101940,3199440,17.614905017,7.2498705721,14.651560917,-2121,8.0346962175,10.365034445,22.686257134
4,13,2002,55726,23706,43709,46983,23625,32020,67334,97350,3296790,17.156412258,7.2983869106,13.456727979,-2004,7.2734493699,9.858025347,20.730177349
4,13,2003,58113,23369,37576,47596,20163,34744,57739,90057,3386847,17.389633818,6.9928992254,11.244177384,-2426,6.0335413189,10.396734592,17.277718703
4,13,2004,59393,23849,57740,47356,19365,35544,77105,108606,3495453,17.25963704,6.9305319443,16.77927437,-4043,5.6274791857,10.329105096,22.406753556
4,13,2005,61672,24298,86397,47925,20028,37374,106425,140797,3636250,17.295167788,6.8140807322,24.228995515,-3002,5.6166107871,10.481087056,29.845606302
4,13,2006,64212,25688,73799,48561,20144,38524,93943,130211,3766461,17.348239044,6.9401601656,19.938371226,-2256,5.4423305192,10.408078878,25.380701746
4,13,2007,67128,23984,37883,49085,18135,43144,56018,98587,3865048,17.59232676,6.285519679,9.9280496164,-575,4.7526642503,11.306807081,14.680713867
4,13,2008,68176,25097,28463,49384,18261,43079,46724,89550,3954598,17.437106488,6.4189606537,7.279869191,-253,4.6705439095,11.018145834,11.950413101
4,15,2001,1769,1932,3552,1231,327,-163,3879,3642,159822,11.19613167,12.22777071,22.480870374,-74,2.0696071544,-1.03163904,24.550477529
4,15,2002,1981,2032,5085,1231,314,-51,5399,5329,165151,12.191782087,12.505654316,31.294907577,-19,1.9324682358,-0.313872229,33.227375813
4,15,2003,2174,2249,5500,1231,262,-75,5762,5820,170971,12.935779271,13.382045805,32.726212506,133,1.5589577594,-0.446266534,34.285170266
4,15,2004,2309,2333,7402,1231,246,-24,7648,7273,178244,13.223945134,13.361396275,42.392222556,-351,1.4088741893,-0.13745114,43.801096746
4,15,2005,2300,2445,7651,2067,259,-145,7910,7599,185843,12.634342891,13.430855812,42.028416285,-166,1.4227368733,-0.796512921,43.451153158
4,15,2006,2332,2431,6672,2612,258,-99,6930,6724,192567,12.325255675,12.848497661,35.263338707,-107,1.3636003277,-0.523241986,36.626939034
4,15,2007,2562,2186,2602,2739,235,376,2837,3306,195873,13.191226444,11.25527752,13.397178457,93,1.2099680774,1.9359489239,14.607146535
4,15,2008,2579,2295,-185,2754,237,284,52,408,196281,13.152996017,11.704585443,-0.943506888,72,1.2087088236,1.4484105734,0.265201936
4,17,2001,1635,713,-223,2238,73,922,-150,678,98551,16.647660164,7.2598053191,-2.270598298,-94,0.7432900257,9.3878548446,-1.527308272
4,17,2002,1636,657,1810,2281,71,979,1881,2813,101364,16.366955956,6.5727934372,18.107695771,-47,0.7103018783,9.7941625191,18.817997649
4,17,2003,1643,757,998,2238,49,886,1047,1853,103217,16.062097653,7.4004917368,9.7565267547,-80,0.4790278667,8.6616059165,10.235554621
4,17,2004,1767,814,886,2232,56,953,942,1801,105018,16.971210411,7.8180901385,8.509616539,-94,0.537853867,9.1531202728,9.047470406
4,17,2005,1882,812,920,2333,54,1070,974,1948,106966,17.756057061,7.6609555438,8.6799003698,-96,0.509472413,10.095101517,9.1893727829
4,17,2006,1878,849,945,2219,56,1029,1001,1973,108939,17.396540145,7.8645700655,8.7538500729,-57,0.518746671,9.5319700794,9.2725967439
4,17,2007,1982,805,892,2332,46,1177,938,2140,111079,18.016707724,7.3175831068,8.1084274923,25,0.4181476061,10.699124617,8.5265750984
4,17,2008,2089,830,330,2326,48,1259,378,1678,112757,18.665451491,7.4161439625,2.9485873586,41,0.428885434,11.249307529,3.3774727926
4,19,2001,12383,7409,4573,21722,3405,4974,7978,17111,865660,14.447479858,8.6442201622,5.3354054261,4159,3.9726777773,5.8032596959,9.3080832034
4,19,2002,12287,7739,9135,21980,2916,4548,12051,20137,885797,14.030604234,8.8372138168,10.431315185,3538,3.329799133,5.1933904172,13.761114318
4,19,2003,12627,7716,6614,21952,1962,4911,8576,16976,902773,14.11965984,8.6281219074,7.3958525526,3489,2.1939314648,5.4915379325,9.5897840174
4,19,2004,12988,7817,8526,21634,2955,5171,11481,20554,923327,14.224850775,8.5614150375,9.3379333005,3902,3.2364054542,5.6634357374,12.574338755
4,19,2005,12999,7797,12168,21419,2660,5202,14828,24206,947533,13.896282993,8.3352041307,13.007921491,4176,2.8436120287,5.5610788621,15.851533519
4,19,2006,13325,8077,14200,21980,2876,5248,17076,26588,974121,13.868261404,8.4062999895,14.77893523,4264,2.9932547691,5.4619614145,17.772189999
4,19,2007,14223,7746,9480,21834,2393,6477,11873,22472,996593,14.434362368,7.8611102372,9.6208785242,4122,2.4285614249,6.573252131,12.049439949
4,19,2008,14337,8151,7021,22111,2509,6186,9530,15425,1012018,14.275536677,8.1160563195,6.9909006771,-291,2.4982438113,6.1594803573,9.4891444884
4,21,2001,2568,1542,3688,15456,579,1026,4267,7074,188350,13.895126425,8.3435689048,19.955306174,1781,3.1328964954,5.5515575203,23.08820267
4,21,2002,2678,1620,6137,15860,538,1058,6675,9414,197764,13.871550889,8.3913041226,31.788539136,1681,2.7867417395,5.4802467665,34.575280876
4,21,2003,2794,1659,7097,16199,462,1135,7559,10877,208641,13.749830834,8.1642696325,34.925751406,2183,2.2735940749,5.5855612013,37.19934548
4,21,2004,3022,1741,8491,16112,437,1281,8928,11878,220519,14.083325566,8.1135240936,39.570323422,1669,2.0365364899,5.9698014726,41.606859912
4,21,2005,3323,1746,12302,15366,456,1577,12758,16635,237154,14.521284847,7.6299016984,53.758906468,2300,1.9926891034,6.8913831491,55.751595572
4,21,2006,3962,2043,29155,16139,458,1919,29613,31561,268715,15.664134391,8.0771899444,115.266996,29,1.8107454697,7.5869444461,117.07774147
4,21,2007,5097,1886,28066,17152,407,3211,28473,32158,300873,17.89714671,6.6223305266,98.548424475,474,1.4291031412,11.274816183,99.977527616
4,21,2008,5562,2153,22614,17545,410,3409,23024,26428,327301,17.708469309,6.8547886414,71.999159469,-5,1.3053708049,10.853680668,73.304530273
4,23,2001,747,218,-429,205,283,529,-146,352,38874,19.303323169,5.6333660654,-11.08584423,-31,7.3130394336,13.669957104,-3.772804796
4,23,2002,796,219,-465,205,265,577,-200,347,39221,20.385428004,5.6085536846,-11.90857289,-30,6.7866060567,14.77687432,-5.121966835
4,23,2003,702,239,-420,205,231,463,-189,241,39462,17.84375278,6.0750098496,-10.67574953,-33,5.8716622396,11.76874293,-4.804087287
4,23,2004,845,208,-194,205,212,637,18,623,40085,21.24530152,5.2296126818,-4.877619521,-32,5.3301821565,16.015688838,0.4525626359
4,23,2005,782,233,182,205,222,549,404,912,40997,19.289114723,5.7472681976,4.4892824548,-41,5.4759379394,13.541846526,9.9652203942
4,23,2006,794,261,108,205,223,533,331,841,41838,19.17064043,6.3016840707,2.6075934086,-23,5.3841975011,12.868956359,7.9917909096
4,23,2007,757,249,-71,205,204,508,133,637,42475,17.956898699,5.9065624518,-1.684200538,-4,4.8391114063,12.050336247,3.1549108678
4,23,2008,826,279,-302,205,206,547,-96,448,42923,19.344715333,6.5341108691,-7.07276517,-3,4.8244689571,12.810604464,-2.248296213
4,25,2001,1756,1866,4196,3758,361,-110,4557,4387,173265,10.264713877,10.907719872,24.527755938,-60,2.110228764,-0.643005995,26.637984702
4,25,2002,1809,2053,5031,3778,338,-244,5369,5081,178346,10.289780468,11.677677888,28.616852146,-44,1.922579214,-1.387897421,30.53943136
4,25,2003,1919,2048,4725,3769,275,-129,5000,4967,183313,10.612206526,11.325585704,26.129586157,96,1.5207695647,-0.713379178,27.650355722
4,25,2004,1934,2149,6354,3773,272,-215,6626,6098,189411,10.377652096,11.531320763,34.094933516,-313,1.4595250105,-1.153668666,35.554458527
4,25,2005,2026,2222,8002,3771,277,-196,8279,7956,197367,10.476293895,11.48979518,41.377741237,-127,1.4323462038,-1.013501285,42.81008744
4,25,2006,2221,2396,8964,3763,281,-175,9245,8933,206300,11.004119732,11.871171039,44.412845241,-137,1.3922366703,-0.867051307,45.805081912
4,25,2007,2502,2286,5446,3723,257,216,5703,5879,212179,11.95758927,10.925279405,26.027590393,-40,1.2282575709,1.032309865,27.255847964
4,25,2008,2513,2380,3018,3723,260,133,3278,3324,215503,11.751722074,11.129764638,14.113289781,-87,1.2158566411,0.6219574357,15.329146422
4,27,2001,2963,1002,-413,5864,1119,1961,706,2505,163218,18.294019405,6.1865026811,-2.549925756,-162,6.9088787427,12.107516724,4.3589529869
4,27,2002,3099,1102,168,5929,870,1997,1038,2879,166097,18.820885778,6.6926802605,1.020299713,-156,5.2836949425,12.128205518,6.3039946556
4,27,2003,3133,1138,971,5779,376,1995,1347,3175,169272,18.683897438,6.7865545116,5.7906365824,-167,2.2423062358,11.897342927,8.0329428182
4,27,2004,3255,1194,1641,5308,1109,2061,2750,4643,173915,18.969250001,6.9583055302,9.5632993091,-168,6.4629487714,12.010944471,16.02624808
4,27,2005,3406,1187,3156,5693,880,2219,4036,6094,180009,19.247069992,6.7076547507,17.834337315,-161,4.9728190233,12.539415242,22.807156339
4,27,2006,3303,1294,2189,5521,1015,2009,3204,5104,185113,18.092582753,7.0880418052,11.99051276,-109,5.5597854964,11.004540948,17.550298256
4,27,2007,3324,1156,1512,5811,781,2168,2293,4497,189610,17.741104763,6.169890826,8.0699610112,36,4.1684124006,11.571213937,12.238373412
4,27,2008,3553,1291,1501,5835,857,2262,2358,4712,194322,18.508485878,6.7251492452,7.8190929644,92,4.4643322255,11.783336633,12.28342519
5,0,2001,37334,28421,-318,74986,4189,8913,3871,11384,2689601,13.910307689,10.589405229,-0.118483898,-1400,1.5607831711,3.3209024598,1.4422992732
5,0,2002,37469,27847,341,75950,3667,9622,4008,12288,2701889,13.899311693,10.329982992,0.1264956441,-1342,1.3602918674,3.5693287013,1.4867875114
5,0,2003,37388,27763,5175,76824,2519,9625,7694,16020,2717909,13.796824162,10.245031272,1.909665268,-1299,0.9295549391,3.5517928897,2.8392202071
5,0,2004,37996,28428,10961,77672,3529,9568,14490,22282,2740191,13.922793646,10.416811711,4.0164159689,-1776,1.2931239809,3.5059819351,5.3095399498
5,0,2005,38977,27975,15405,78247,3187,11002,18592,28727,2768918,14.15001954,10.155907244,5.5925558924,-867,1.1569929003,3.9941122966,6.7495487927
5,0,2006,39572,27694,21361,80069,3481,11878,24842,35281,2804199,14.201029693,9.9384240453,7.6657281733,-1439,1.2492111685,4.2626056478,8.9149393418
5,0,2007,42026,26764,7946,80558,2897,15262,10843,26358,2830557,14.916706242,9.4996127605,2.8203528245,253,1.0282610285,5.417093482,3.848613853
5,0,2008,41627,26878,6934,80558,2919,14749,9853,24833,2855390,14.642064022,9.4541859078,2.4389956502,231,1.0267418954,5.1878781142,3.4657375456
5,1,2001,273,285,-140,363,1,-12,-139,-168,20506,13.258863526,13.841670714,-6.799417193,-17,0.0485672657,-0.582807188,-6.750849927
5,1,2002,283,271,-235,363,1,12,-234,-235,20271,13.88037374,13.291806656,-11.5261054,-13,0.049047257,0.5885670844,-11.47705815
5,1,2003,237,294,-311,363,-3,-57,-314,-379,19892,11.801907228,14.640340612,-15.48689092,-8,-0.149391231,-2.838433384,-15.63628215
5,1,2004,262,272,4,363,1,-10,5,-17,19875,13.176754596,13.67968416,0.2011718259,-12,0.0502929565,-0.502929565,0.2514647824
5,1,2005,253,284,24,363,-1,-31,23,-27,19848,12.738212119,14.299020718,1.208367948,-19,-0.050348665,-1.5608086,1.1580192835
5,1,2006,240,219,-198,363,1,21,-197,-185,19663,12.148515603,11.085520488,-10.02252537,-9,0.050618815,1.0629951153,-9.971906558
5,1,2007,265,238,-344,363,-1,27,-345,-308,19355,13.583474294,12.199497668,-17.63288739,10,-0.051258394,1.3839766262,-17.68414578
5,1,2008,248,239,-137,363,-1,9,-138,-119,19236,12.852737685,12.386307688,-7.10010106,10,-0.051825555,0.4664299966,-7.151926615
5,3,2001,296,311,-321,240,21,-15,-300,-333,23827,12.336674516,12.961843833,-13.37862338,-18,0.8752370434,-0.625169317,-12.50338633
5,3,2002,332,256,-132,240,20,76,-112,-57,23770,13.950459063,10.756980482,-5.546568061,-21,0.8403891002,3.1934785806,-4.706178961
5,3,2003,314,242,-348,240,11,72,-337,-276,23494,13.287068382,10.240352065,-14.72579553,-11,0.4654705484,3.0467163169,-14.26032498
5,3,2004,280,264,-307,240,12,16,-295,-301,23193,11.994773706,11.309358065,-13.1514126,-22,0.5140617302,0.6854156403,-12.63735087
5,3,2005,277,249,-409,240,12,28,-397,-386,22807,12.043478261,10.826086957,-17.7826087,-17,0.5217391304,1.2173913043,-17.26086957
5,3,2006,277,234,-301,240,12,43,-289,-256,22551,12.213942414,10.317915252,-13.27219013,-10,0.5291238591,1.8960271617,-12.74306627
5,3,2007,297,252,-324,240,9,45,-315,-269,22282,13.249169139,11.241719269,-14.45363906,1,0.4014899739,2.0074498695,-14.05214909
5,3,2008,293,247,-93,240,8,46,-85,-49,22233,13.164101988,11.097382905,-4.178366843,-10,0.3594294058,2.0667190835,-3.818937437
5,5,2001,344,632,265,710,4,-288,269,-47,38418,8.948662253,16.440565535,6.8935915612,-28,0.1040542122,-7.491903282,6.9976457734
5,5,2002,344,616,515,710,4,-272,519,227,38645,8.9277604038,15.986919793,13.365687814,-20,0.1038111675,-7.059159389,13.469498981
5,5,2003,357,618,577,710,-2,-261,575,303,38948,9.2018609926,15.92927197,14.87247561,-11,-0.051551042,-6.727410978,14.820924568
5,5,2004,354,698,1003,710,2,-344,1005,605,39553,9.0189933886,17.783212953,25.553814601,-56,0.0509547649,-8.764219564,25.604769366
5,5,2005,386,692,1027,710,0,-306,1027,695,40248,9.6740642348,17.343141063,25.739025827,-26,0,-7.669076829,25.739025827
5,5,2006,411,638,1102,710,1,-227,1103,851,41099,10.104859429,15.685888847,27.093808008,-25,0.0245860327,-5.581029417,27.11839404
5,5,2007,407,642,1007,710,0,-235,1007,773,41872,9.8106567355,15.475286546,24.273541358,1,0,-5.66462981,24.273541358
5,5,2008,425,676,513,710,0,-251,513,243,42115,10.120613905,16.097729411,12.216176313,-19,0,-5.977115506,12.216176313
5,7,2001,2403,1281,2882,2197,541,1122,3423,4477,159255,15.304124089,8.1583782596,18.354758895,-68,3.4454977662,7.1457458293,21.800256661
5,7,2002,2509,1256,3823,2279,502,1253,4325,5566,164821,15.484022266,7.751268221,23.593231217,-12,3.0980387317,7.7327540453,26.691269949
5,7,2003,2644,1318,4674,2291,430,1326,5104,6608,171429,15.726394052,7.8394052045,27.800743494,178,2.5576208178,7.8869888476,30.358364312
5,7,2004,2768,1295,5533,2268,404,1473,5937,7169,178598,15.815922772,7.3994291869,31.614704009,-241,2.3083933525,8.4164935848,33.923097361
5,7,2005,2999,1240,5468,2227,421,1759,5889,8155,186753,16.41708932,6.7879929164,29.932859086,507,2.3046330789,9.6290964032,32.237492165
5,7,2006,3086,1290,6420,2270,426,1796,6846,7905,194658,16.182018872,6.7643565602,33.664472184,-737,2.2338107711,9.4176623118,35.898282955
5,7,2007,3406,1299,5435,2345,385,2107,5820,7981,202639,17.14586317,6.5391885667,27.359884419,54,1.9380966884,10.606674604,29.297981107
5,7,2008,3488,1313,4644,2345,385,2175,5029,7152,209791,16.914385471,6.3671410906,22.520185244,-52,1.8669834881,10.547244381,24.387168732
5,9,2001,409,388,198,600,11,21,209,200,34251,11.976223244,11.361307136,5.7977804457,-30,0.3220989136,0.6149161079,6.1198793593
5,9,2002,431,375,138,600,10,56,148,176,34427,12.55132648,10.92052768,4.0187541862,-28,0.2912140715,1.6307988002,4.3099682577
5,9,2003,417,397,92,600,6,20,98,71,34498,12.100108814,11.519767864,2.6695683714,-47,0.1741022851,0.5803409503,2.8436706565
5,9,2004,422,381,312,600,9,41,321,330,34828,12.174364596,10.991547183,9.0009520238,-32,0.2596428468,1.1828174134,9.2605948706
5,9,2005,437,388,534,600,7,49,541,557,35385,12.447837295,11.052084372,15.210858388,-33,0.1993932747,1.3957529232,15.410251663
5,9,2006,447,418,519,600,8,29,527,537,35922,12.53733855,11.72395417,14.556775632,-19,0.224381898,0.8133843802,14.78115753
5,9,2007,469,375,601,600,7,94,608,722,36644,12.926163768,10.335418791,16.564231183,20,0.1929278174,2.590744977,16.757159
5,9,2008,484,395,112,600,7,89,119,237,36881,13.165589935,10.744644679,3.046582795,29,0.1904114247,2.4209452567,3.2369942197
5,11,2001,150,213,-65,753,19,-63,-46,-121,12482,11.95933825,16.982260315,-5.182379908,-12,1.5148495117,-5.022922065,-3.667530397
5,11,2002,161,178,-41,746,18,-17,-23,-50,12432,12.924460143,14.289154692,-3.291322148,-10,1.4449706992,-1.364694549,-1.846351449
5,11,2003,167,167,-46,746,12,0,-34,-50,12382,13.460143467,13.460143467,-3.707584428,-16,0.9671959378,0,-2.74038849
5,11,2004,166,166,-133,747,16,0,-117,-129,12253,13.476760706,13.476760706,-10.79764563,-12,1.2989648874,0,-9.498680739
5,11,2005,163,141,-106,750,15,22,-91,-80,12173,13.346434128,11.54507492,-8.679276181,-11,1.2281994596,1.8013592074,-7.451076722
5,11,2006,165,156,-230,754,17,9,-213,-210,11963,13.672522373,12.926748426,-19.05866755,-6,1.4086841233,0.7457739476,-17.64998343
5,11,2007,183,128,-70,753,13,55,-57,-1,11962,15.297805643,10.700104493,-5.851619645,1,1.0867293626,4.5977011494,-4.764890282
5,11,2008,174,136,-111,753,13,38,-98,-56,11906,14.580191051,11.396011396,-9.30115636,4,1.0893246187,3.1841796548,-8.211831741
5,13,2001,55,83,-110,117,6,-28,-104,-138,5579,9.7379603399,14.695467422,-19.47592068,-6,1.0623229462,-4.957507082,-18.41359773
5,13,2002,53,65,37,117,6,-12,43,25,5604,9.4786729858,11.624787624,6.6171868014,-6,1.0730573191,-2.146114638,7.6902441205
5,13,2003,54,71,-22,117,6,-17,-16,-41,5563,9.6713530939,12.716038327,-3.94018089,-8,1.0745947882,-3.044685233,-2.865586102
5,13,2004,66,61,-85,117,5,5,-80,-80,5483,11.950027159,11.044722071,-15.39018649,-5,0.9053050878,0.9053050878,-14.48488141
5,13,2005,35,38,53,117,6,-3,59,50,5533,6.3543936093,6.8990559187,9.6223674655,-6,1.0893246187,-0.544662309,10.711692084
5,13,2006,65,56,9,117,5,9,14,20,5553,11.726501894,10.102832401,1.6236694931,-3,0.9020386073,1.6236694931,2.5257081003
5,13,2007,67,43,-61,117,6,24,-55,-31,5522,12.099322799,7.7652370203,-11.01580135,0,1.0835214447,4.3340857788,-9.93227991
5,13,2008,62,50,-104,117,5,12,-99,-87,5435,11.316966323,9.1265857443,-18.98329835,0,0.9126585744,2.1903805786,-18.07063977
5,15,2001,352,236,14,235,159,116,173,262,25665,13.785540847,9.2425785228,0.5482885564,-27,6.2269914624,4.5429623247,6.7752800188
5,15,2002,335,251,92,235,149,84,241,302,25967,12.976448714,9.7226526185,3.5636814379,-23,5.7716145026,3.2537960954,9.3352959405
5,15,2003,326,251,108,235,124,75,232,277,26244,12.487789929,9.6148321235,4.1370592404,-30,4.7499569056,2.8729578058,8.887016146
5,15,2004,346,255,-108,235,113,91,5,77,26321,13.164653286,9.7022733758,-4.109198136,-19,4.2994387901,3.4623799106,0.1902406544
5,15,2005,358,268,250,235,122,90,372,435,26756,13.489835522,10.098536089,9.4202762025,-27,4.5970947868,3.3912994329,14.017370989
5,15,2006,349,275,119,235,120,74,239,300,27056,12.971084516,10.220768602,4.4228053222,-13,4.4599717535,2.7503159147,8.8827770757
5,15,2007,374,265,6,235,107,109,113,228,27284,13.765182186,9.7534044902,0.2208317998,6,3.9381670961,4.011777696,4.1589988958
5,15,2008,363,253,36,235,106,110,142,273,27557,13.238270637,9.2266734742,1.3128863442,21,3.8657209022,4.0115971627,5.1786072464
5,17,2001,203,194,-330,713,14,9,-316,-315,13769,14.576526766,13.93027681,-23.69583169,-8,1.005277708,0.6462499551,-22.69055398
5,17,2002,205,188,-406,720,13,17,-393,-376,13393,15.09461748,13.842868714,-29.89470584,0,0.9572196451,1.2517487667,-28.93748619
5,17,2003,161,164,-213,739,10,-3,-203,-210,13183,12.116195063,12.341962673,-16.0295003,-4,0.7525586996,-0.22576761,-15.2769416
5,17,2004,156,176,-292,720,10,-20,-282,-320,12863,11.978806727,13.514551179,-22.421869,-18,0.7678722261,-1.535744452,-21.65399677
5,17,2005,196,181,-149,741,11,15,-138,-134,12729,15.317286652,14.145045327,-11.64426383,-11,0.8596436386,1.1722413254,-10.78462019
5,17,2006,166,148,-253,745,10,18,-243,-230,12499,13.159980974,11.732995085,-20.05707944,-5,0.7927699382,1.4269858887,-19.2643095
5,17,2007,200,133,-250,753,9,67,-241,-171,12328,16.111491521,10.714141862,-20.1393644,3,0.7250171185,5.3973496596,-19.41434728
5,17,2008,170,170,-351,753,8,0,-343,-335,11993,13.979688335,13.979688335,-28.86394474,8,0.6578676864,0,-28.20607705
5,19,2001,292,273,112,2433,31,19,143,140,23651,12.3828506,11.577117171,4.7495865315,-22,1.3146177007,0.8057334295,6.0642042322
5,19,2002,252,228,-152,2456,31,24,-121,-114,23537,10.680681529,9.6634737645,-6.442315843,-17,1.3138933627,1.0172077647,-5.12842248
5,19,2003,279,283,-267,2141,22,-4,-245,-263,23274,11.920275149,12.091175151,-11.40757514,-14,0.9399500117,-0.170900002,-10.46762513
5,19,2004,274,251,-97,2067,25,23,-72,-66,23208,11.789509918,10.799879523,-4.173658621,-17,1.0756852115,0.9896303946,-3.097973409
5,19,2005,288,243,-89,2026,24,45,-65,-36,23172,12.419146184,10.478654592,-3.837861147,-16,1.0349288486,1.9404915912,-2.802932298
5,19,2006,286,253,197,2175,27,33,224,244,23416,12.277839787,10.861165965,8.4571134198,-13,1.1590967631,1.4166738216,9.6162101829
5,19,2007,312,210,263,2442,24,102,287,380,23796,13.216978734,8.8960433788,11.141235279,-9,1.0166906719,4.3209353554,12.157925951
5,19,2008,307,221,-1,2442,24,86,23,92,23888,12.876436541,9.2693565976,-0.04194279,-17,1.0066269608,3.607079943,0.9646841708
5,21,2001,207,288,-196,179,4,-81,-192,-286,17256,11.897235473,16.552675441,-11.26501523,-13,0.22989827,-4.655439968,-11.03511696
5,21,2002,189,259,-206,179,4,-70,-202,-287,16969,11.044558072,15.135135135,-12.03798393,-15,0.2337472608,-4.090577064,-11.80423667
5,21,2003,170,236,-120,179,4,-66,-116,-204,16765,10.078852197,13.991818344,-7.114483903,-22,0.2371494634,-3.912966147,-6.87733444
5,21,2004,203,249,-126,179,3,-46,-123,-181,16584,12.174278089,14.932981499,-7.556448469,-12,0.1799154397,-2.758703409,-7.376533029
5,21,2005,190,208,-77,179,4,-18,-73,-106,16478,11.493557559,12.582420906,-4.657915432,-15,0.2419696328,-1.088863348,-4.415945799
5,21,2006,188,230,-96,179,3,-42,-93,-142,16336,11.458523801,14.018406778,-5.85116109,-7,0.1828487841,-2.559882977,-5.668312306
5,21,2007,176,211,-206,179,4,-35,-202,-234,16102,10.851470498,13.009433381,-12.70115297,3,0.2466243295,-2.157962883,-12.45452864
5,21,2008,155,228,-194,179,3,-73,-191,-257,15845,9.7035715404,14.273640717,-12.14511535,7,0.1878110621,-4.570069177,-11.95730429
5,23,2001,257,281,109,268,14,-24,123,77,24190,10.641161004,11.634888102,4.5131772354,-22,0.5796741403,-0.993727098,5.0928513757
5,23,2002,247,318,213,268,13,-71,226,138,24328,10.181788202,13.108537038,8.7802465065,-17,0.5358835896,-2.926748835,9.316130096
5,23,2003,238,305,348,268,5,-67,353,282,24610,9.7265928317,12.464751318,14.222076914,-4,0.2043401855,-2.738158486,14.426417099
5,23,2004,245,314,346,268,12,-69,358,262,24872,9.9025908411,12.691483772,13.984883392,-27,0.4850248575,-2.788892931,14.469908249
5,23,2005,262,308,261,268,9,-46,270,200,25072,10.491750761,12.333813872,10.451705911,-24,0.3604036521,-1.842063111,10.812109563
5,23,2006,266,313,151,268,11,-47,162,102,25174,10.587907495,12.45870318,6.0104286908,-13,0.4378457987,-1.870795685,6.4482744895
5,23,2007,285,320,204,268,9,-35,213,181,25355,11.280650715,12.665993786,8.0745710384,3,0.3562310752,-1.38534307,8.4308021136
5,23,2008,263,332,103,268,9,-69,112,42,25397,10.364123581,13.083228247,4.0589533417,-1,0.354665826,-2.719104666,4.4136191677
5,25,2001,109,87,55,69,7,22,62,76,8620,12.701002097,10.137497087,6.4087625262,-8,0.8156606852,2.5635050105,7.2244232114
5,25,2002,126,77,-73,69,6,49,-67,-24,8596,14.637546468,8.9451672862,-8.480483271,-6,0.6970260223,5.6923791822,-7.783457249
5,25,2003,82,79,37,69,0,3,37,29,8625,9.5232564892,9.1748446664,4.2970791476,-11,0,0.3484118228,4.2970791476
5,25,2004,116,99,8,69,3,17,11,22,8647,13.432144511,11.463640574,0.9263547939,-6,0.3473830477,1.968503937,1.2737378416
5,25,2005,111,92,75,69,1,19,76,86,8733,12.773302647,10.586881473,8.6306098964,-9,0.1150747986,2.1864211738,8.7456846951
5,25,2006,106,91,-72,69,2,15,-70,-58,8675,12.178308824,10.454963235,-8.272058824,-3,0.2297794118,1.7233455882,-8.042279412
5,25,2007,110,88,52,69,0,22,52,76,8751,12.624813497,10.099850798,5.9680936532,2,0,2.5249626994,5.9680936532
5,25,2008,114,87,-115,69,0,27,-115,-86,8665,13.091410198,9.9908130455,-13.20624713,2,0,3.100597152,-13.20624713
5,27,2001,300,290,-259,1152,15,10,-244,-252,25314,11.79245283,11.399371069,-10.18081761,-18,0.5896226415,0.393081761,-9.591194969
5,27,2002,303,318,-117,1154,14,-15,-103,-140,25174,12.002852163,12.597052765,-4.634764697,-22,0.5545872286,-0.594200602,-4.080177468
5,27,2003,282,300,-326,1071,9,-18,-317,-353,24821,11.281128113,12.00120012,-13.04130413,-18,0.3600360036,-0.720072007,-12.68126813
5,27,2004,306,314,-11,1162,12,-8,1,-22,24799,12.333736397,12.656187021,-0.443369609,-15,0.4836759371,-0.322450625,0.0403063281
5,27,2005,343,305,-246,1162,10,38,-236,-218,24581,13.892264075,12.353179425,-9.963547995,-20,0.4050222762,1.5390846497,-9.558525719
5,27,2006,299,283,-1,1215,11,16,10,14,24595,12.160403449,11.509679518,-0.040670246,-12,0.4473727021,0.6507239304,0.4067024565
5,27,2007,330,247,-326,1260,9,83,-317,-234,24361,13.481493586,10.090693684,-13.31808154,0,0.3676770978,3.390799902,-12.95040444
5,27,2008,319,260,-283,1260,8,59,-275,-215,24146,13.152740842,10.720102253,-11.66841899,1,0.3298493001,2.4326385882,-11.33856969
5,29,2001,228,212,-4,349,22,16,18,14,20335,11.216056671,10.428964974,-0.196772924,-20,1.0822510823,0.7870916962,0.8854781582
5,29,2002,248,215,-74,349,21,33,-53,-43,20292,12.208629729,10.584094322,-3.64289758,-23,1.0337952593,1.6245354075,-2.609102321
5,29,2003,248,245,41,349,18,3,59,34,20326,12.211334876,12.063617116,2.0188093948,-28,0.8863065636,0.1477177606,2.9051159584
5,29,2004,268,221,-46,349,19,47,-27,6,20332,13.18313739,10.871169266,-2.262777313,-14,0.934625412,2.3119681244,-1.328151901
5,29,2005,255,215,64,349,18,40,82,104,20436,12.509811617,10.547488226,3.1397174254,-18,0.8830455259,1.9623233909,4.0227629513
5,29,2006,249,270,53,349,19,-21,72,41,20477,12.172170215,13.198738787,2.5908635397,-10,0.9288001369,-1.026568572,3.5196636766
5,29,2007,274,230,166,349,17,44,183,228,20705,13.306784518,11.16992861,8.0617745617,1,0.825603419,2.1368559079,8.8873779807
5,29,2008,287,226,-31,349,16,61,-15,50,20755,13.844669561,10.902074288,-1.49541727,4,0.7718282682,2.9425952726,-0.723589001
5,31,2001,1196,732,252,2682,118,464,370,753,83273,14.427629635,8.8302883716,3.0399353411,-81,1.4234617867,5.5973412629,4.4633971277
5,31,2002,1161,833,332,2621,113,328,445,697,83970,13.883989165,9.9615529499,3.9702708036,-76,1.3513271109,3.9224362156,5.3215979144
5,31,2003,1183,788,570,2583,101,395,671,970,84940,14.007459594,9.3304126458,6.7491563555,-96,1.1959031437,4.6770469481,7.9450594991
5,31,2004,1263,842,900,2447,94,421,994,1334,86274,14.753466422,9.8356442814,10.513158971,-81,1.098041048,4.9178221407,11.611200019
5,31,2005,1295,847,658,2540,98,448,756,1134,87408,14.912311005,9.7534574682,7.5770661324,-70,1.1284992112,5.1588535369,8.7055653436
5,31,2006,1229,783,1660,3003,98,446,1758,2155,89563,13.889281295,8.8489074481,18.760135841,-49,1.1075260918,5.0403738466,19.867661933
5,31,2007,1382,781,485,2337,90,601,575,1164,90727,15.330855843,8.6638194021,5.3802207554,-12,0.9983914804,6.6670364413,6.3786122358
5,31,2008,1427,795,1190,2337,90,632,1280,1913,92640,15.564414535,8.671134937,12.979434686,1,0.9816379174,6.8932795977,13.961072603
5,33,2001,799,493,435,457,29,306,464,723,54101,14.86802073,9.173885131,8.0946045274,-47,0.5396403018,5.6941355986,8.6342448292
5,33,2002,756,482,345,457,27,274,372,597,54698,13.897186555,8.8603755549,6.3419700549,-49,0.4963280913,5.0368110001,6.8382981461
5,33,2003,746,497,406,457,17,249,423,616,55314,13.562156856,9.0353779588,7.3810129804,-56,0.3090571938,4.5267788968,7.6900701742
5,33,2004,734,489,613,457,23,245,636,829,56143,13.170998681,8.7746844074,10.999757754,-52,0.4127152175,4.3963142737,11.412472972
5,33,2005,775,545,554,457,21,230,575,760,56903,13.711232596,9.6420925995,9.8013198167,-45,0.3715301736,4.0691399961,10.17284999
5,33,2006,800,540,878,457,23,260,901,1129,58032,13.92091182,9.3966154783,15.278200722,-32,0.4002262148,4.5242963414,15.678426937
5,33,2007,860,490,515,457,18,370,533,907,58939,14.704499406,8.3781450103,8.8056013884,4,0.3077685922,6.3263543955,9.1133699806
5,33,2008,844,517,385,457,18,327,403,743,59682,14.230195328,8.7168376594,6.4912620868,13,0.3034875781,5.5133576685,6.7947496649
5,35,2001,875,515,-182,628,31,360,-151,246,51223,17.123287671,10.078277886,-3.561643836,37,0.6066536204,7.0450097847,-2.954990215
5,35,2002,912,538,-519,628,30,374,-489,-77,51146,17.817894089,10.510994539,-10.13978841,38,0.5861149371,7.3068995497,-9.553673475
5,35,2003,874,518,-585,628,25,356,-560,-171,50975,17.116949501,10.144828194,-11.45699709,33,0.4896152603,6.9721213071,-10.96738183
5,35,2004,891,488,-212,628,25,403,-187,264,51239,17.434010997,9.548594126,-4.148159743,48,0.489169781,7.8854168705,-3.658989962
5,35,2005,882,492,-248,628,25,390,-223,201,51440,17.17975438,9.5832643481,-4.830588533,34,0.4869544892,7.596490032,-4.343634044
5,35,2006,815,465,-72,628,25,350,-47,341,51781,15.791360285,9.0097945186,-1.395064958,38,0.4843975548,6.7815657667,-0.910667403
5,35,2007,942,458,-181,628,23,484,-158,329,52110,18.134390852,8.8169331318,-3.484421172,3,0.4427717512,9.3174577201,-3.041649421
5,35,2008,917,487,-21,628,23,430,2,444,52554,17.522739433,9.3059695788,-0.401284109,12,0.4395016434,8.216769854,0.0382175342
5,37,2001,275,235,-29,300,4,40,-25,-5,19471,14.121755206,12.067681721,-1.489203276,-20,0.2054073484,2.0540734845,-1.283795928
5,37,2002,232,237,-197,300,3,-5,-194,-213,19258,11.980686307,12.238890754,-10.17325518,-14,0.1549226678,-0.258204446,-10.01833252
5,37,2003,247,230,-159,300,1,17,-158,-157,19101,12.878333637,11.991970594,-8.29010141,-16,0.0521390026,0.8863630439,-8.237962408
5,37,2004,273,187,-121,300,2,86,-119,-48,19053,14.310426168,9.8023798291,-6.34271636,-15,0.1048382869,4.5080463385,-6.237878073
5,37,2005,268,204,115,300,2,64,117,163,19216,14.00611461,10.661370822,6.010086493,-18,0.1045232434,3.3447437874,6.1146097363
5,37,2006,232,208,-309,300,2,24,-307,-290,18926,12.16506738,10.906612134,-16.20261129,-7,0.1048712705,1.2584552462,-16.09774002
5,37,2007,242,206,-319,300,1,36,-318,-275,18651,12.880219283,10.964153605,-16.97847087,7,0.0532240466,1.9160656785,-16.92524683
5,37,2008,251,203,110,300,0,48,110,157,18808,13.401318775,10.838516778,5.8730879094,-1,0,2.5628019968,5.8730879094
5,39,2001,116,149,-133,486,5,-33,-128,-167,8991,12.783073448,16.419637446,-14.6564549,-6,0.5509945452,-3.636563998,-14.10546036
5,39,2002,94,116,-184,486,4,-22,-180,-204,8787,10.574867814,13.049836877,-20.69974125,-2,0.4499943751,-2.474969063,-20.24974688
5,39,2003,86,133,-58,486,0,-47,-58,-113,8674,9.850524025,15.233949946,-6.643376668,-8,0,-5.383425921,-6.643376668
5,39,2004,105,115,-13,486,3,-10,-10,-27,8647,12.124011316,13.27867906,-1.501068068,-7,0.3464003233,-1.154667744,-1.154667744
5,39,2005,93,103,-162,486,1,-10,-161,-176,8471,10.865755345,12.034116135,-18.92744479,-5,0.116836079,-1.16836079,-18.81060872
5,39,2006,95,134,-92,486,2,-39,-90,-133,8338,11.30346838,15.94383961,-10.94651675,-4,0.2379677554,-4.64037123,-10.70854899
5,39,2007,108,120,-115,486,1,-12,-114,-120,8218,13.046629621,14.496255134,-13.8922445,6,0.1208021261,-1.449625513,-13.77144238
5,39,2008,106,113,-72,486,0,-7,-72,-74,8144,12.956851241,13.81249236,-8.800880088,5,0,-0.85564112,-8.800880088
5,41,2001,221,188,-348,135,10,33,-338,-312,14995,14.586495941,12.408421886,-22.96878094,-7,0.6600224408,2.1780740545,-22.3087585
5,41,2002,238,184,-407,135,10,54,-397,-345,14650,16.056670602,12.413560466,-27.45825603,-2,0.6746500253,3.6431101366,-26.783606
5,41,2003,224,166,-224,135,7,58,-217,-163,14487,15.375639222,11.394446923,-15.37563922,-4,0.4804887257,3.9811922985,-14.8951505
5,41,2004,218,161,-156,135,6,57,-150,-107,14380,15.103751689,11.154605605,-10.80818928,-14,0.4156995878,3.9491460838,-10.39248969
5,41,2005,188,158,-288,135,6,30,-282,-263,14117,13.194371337,11.088886549,-20.21265396,-11,0.4210969576,2.1054847879,-19.79155701
5,41,2006,220,165,-129,135,6,55,-123,-74,14043,15.625,11.71875,-9.161931818,-6,0.4261363636,3.90625,-8.735795455
5,41,2007,233,148,-361,135,6,85,-355,-258,13785,16.745723731,10.636768722,-25.94509127,12,0.4312203536,6.1089550093,-25.51387092
5,41,2008,202,152,-310,135,5,50,-305,-247,13538,14.786077664,11.12615745,-22.69150533,8,0.3659920214,3.6599202137,-22.3255133
5,43,2001,231,205,2,629,5,26,7,12,18715,12.346998771,10.957293281,0.1069004223,-21,0.2672510556,1.3897054893,0.3741514779
5,43,2002,231,201,-256,534,4,30,-252,-231,18484,12.419688701,10.806742117,-13.76381086,-9,0.2150595446,1.6129465846,-13.54875131
5,43,2003,227,188,109,680,4,39,113,133,18617,12.236866931,10.134497722,5.8758524029,-19,0.2156276111,2.1023692084,6.091480014
5,43,2004,227,159,12,726,5,68,17,73,18690,12.169297987,8.5238695151,0.6433109068,-12,0.2680462112,3.6454284719,0.911357118
5,43,2005,240,176,-32,686,4,64,-28,21,18711,12.833881447,9.4115130611,-1.711184193,-15,0.2138980241,3.4223683859,-1.497286169
5,43,2006,247,163,-53,804,5,84,-48,27,18738,13.191273465,8.7051723678,-2.830516169,-9,0.2670298272,4.4861010975,-2.563486341
5,43,2007,285,170,-211,724,5,115,-206,-92,18646,15.247164562,9.0947999144,-11.28825166,-1,0.2674941151,6.152364648,-11.02075754
5,43,2008,260,179,-57,724,4,81,-53,24,18670,13.935041269,9.5937399507,-3.054989817,-4,0.2143852503,4.3413013185,-2.840604566
5,45,2001,1263,610,1496,4332,97,653,1593,2238,88696,14.421594711,6.9652991082,17.0821106,-8,1.1075967434,7.4562956027,18.189707343
5,45,2002,1277,657,986,4577,87,620,1073,1669,90365,14.263295748,7.3382813678,11.013006741,-24,0.9717358889,6.9250143806,11.98474263
5,45,2003,1298,659,2103,5252,60,639,2163,2876,93241,14.138971493,7.1784146488,22.907748113,74,0.6535734126,6.9605568445,23.561321525
5,45,2004,1312,705,1753,5363,72,607,1825,2390,95631,13.893006904,7.4653733746,18.562836207,-42,0.7624211106,6.4276335296,19.325257317
5,45,2005,1410,704,2172,5835,69,706,2241,2933,98564,14.521486135,7.2504441412,22.369268004,-14,0.7106259172,7.2710419939,23.079893921
5,45,2006,1431,708,2650,6180,71,723,2721,3447,102011,14.268976692,7.0597033529,26.424030911,3,0.7079646018,7.2092733391,27.131995513
5,45,2007,1562,725,1376,5812,63,837,1439,2283,104294,15.142628632,7.0284287826,13.33947311,7,0.6107462252,8.1141998497,13.950219335
5,45,2008,1563,708,1581,5812,64,855,1645,2529,106823,14.806955385,6.707181326,14.977476944,29,0.6062988769,8.0997740589,15.583775821
5,47,2001,224,195,54,483,12,29,66,78,17825,12.594175194,10.963679298,3.0360958057,-17,0.6746879568,1.6304958956,3.7107837625
5,47,2002,225,170,-42,483,11,55,-31,6,17831,12.620596814,9.5355620372,-2.355844739,-18,0.6170069554,3.0850347768,-1.738837783
5,47,2003,222,209,30,483,7,13,37,28,17859,12.440459512,11.711964136,1.6811431774,-22,0.3922667414,0.7284953769,2.0734099187
5,47,2004,213,208,25,483,8,5,33,26,17885,11.918084154,11.63831692,1.3988361683,-12,0.4476275739,0.2797672337,1.8464637422
5,47,2005,203,187,90,483,8,16,98,97,17982,11.319597402,10.427412385,5.0185407199,-17,0.4460925084,0.8921850169,5.4646332283
5,47,2006,230,191,20,483,8,39,28,59,18041,12.76961941,10.604336119,1.1104016878,-8,0.4441606751,2.1652832912,1.5545623629
5,47,2007,229,200,70,483,8,29,78,111,18152,12.654380681,11.051860857,3.8681513,4,0.4420744343,1.6025198243,4.3102257343
5,47,2008,234,193,-22,483,7,41,-15,33,18185,12.879434186,10.622781187,-1.210886975,7,0.3852822192,2.2566529983,-0.825604755
5,49,2001,91,157,24,130,1,-66,25,-52,11604,7.8245915735,13.499570077,2.0636285469,-11,0.0859845228,-5.674978504,2.1496130696
5,49,2002,122,149,23,130,1,-27,24,-14,11590,10.519962059,12.848150384,1.9832715357,-11,0.0862291972,-2.328188325,2.0695007329
5,49,2003,109,128,43,130,-1,-19,42,10,11600,9.4006037085,11.039241052,3.708495041,-13,-0.086244071,-1.638637344,3.6222509702
5,49,2004,114,167,234,130,0,-53,234,167,11767,9.7573501091,14.293662002,20.028244961,-14,0,-4.536311893,20.028244961
5,49,2005,104,159,30,130,0,-55,30,-32,11735,8.8503106119,13.530763339,2.552974215,-7,0,-4.680452727,2.552974215
5,49,2006,114,170,-59,130,0,-56,-59,-120,11615,9.7644539615,14.561027837,-5.053533191,-5,0,-4.796573876,-5.053533191
5,49,2007,118,168,180,130,0,-50,180,118,11733,10.107932157,14.390954257,15.418879561,-12,0,-4.2830221,15.418879561
5,49,2008,117,152,18,130,-1,-35,17,-45,11688,9.9910336877,12.979804449,1.5370821058,-27,-0.08539345,-2.988770761,1.4516886555
5,51,2001,992,1218,1161,1861,70,-226,1231,950,89298,11.168278486,13.712664513,13.070938833,-55,0.7880841674,-2.544386026,13.859023001
5,51,2002,1018,1330,1121,1861,63,-312,1184,826,90124,11.347549353,14.825383732,12.495680574,-46,0.7022550189,-3.477834379,13.197935593
5,51,2003,1086,1290,1220,1861,45,-204,1265,1037,91161,11.981134677,14.231734562,13.459469895,-24,0.4964558568,-2.250599884,13.955925752
5,51,2004,1114,1281,1026,1861,61,-167,1087,826,91987,12.165025007,13.988686745,11.204053552,-94,0.6661279402,-1.823661738,11.870181493
5,51,2005,1090,1319,1466,1861,55,-229,1521,1210,93197,11.772075341,14.24529117,15.832901331,-82,0.5940038016,-2.473215829,16.426905132
5,51,2006,1158,1185,1948,1861,59,-27,2007,1930,95127,12.297954589,12.584694463,20.687750897,-50,0.6265797243,-0.286739874,21.314330622
5,51,2007,1220,1224,1033,1861,51,-4,1084,1118,96245,12.750036578,12.791839977,10.795727693,38,0.5329933324,-0.041803399,11.328721025
5,51,2008,1215,1285,1174,1861,52,-70,1226,1220,97465,12.544525321,13.267255175,12.121212121,64,0.5368850343,-0.722729854,12.658097156
5,53,2001,199,171,123,181,2,28,125,140,16628,12.018359705,10.327334219,7.4284333857,-13,0.1207875347,1.6910254862,7.5492209204
5,53,2002,185,162,22,181,2,23,24,30,16658,11.115784414,9.7338220273,1.3218770654,-17,0.1201706423,1.3819623866,1.4420477077
5,53,2003,165,164,108,181,-3,1,105,89,16747,9.8787606646,9.8188893878,6.4660978895,-17,-0.17961383,0.0598712768,6.2864840593
5,53,2004,163,170,326,181,1,-7,327,299,17046,9.646968307,10.06125529,19.293936614,-21,0.0591838546,-0.414286983,19.353120469
5,53,2005,194,171,209,181,-1,23,208,214,17260,11.309974931,9.9691016149,12.184457529,-17,-0.05829884,1.3408733166,12.126158689
5,53,2006,221,142,83,181,1,79,84,156,17416,12.746568232,8.1901026647,4.7871726843,-7,0.0576767793,4.556465567,4.8448494636
5,53,2007,215,165,-16,181,-1,50,-17,34,17450,12.332931796,9.4648081225,-0.917799576,1,-0.057362473,2.8681236735,-0.975162049
5,53,2008,200,155,194,181,-1,45,193,240,17690,11.383039271,8.8218554354,11.041548093,2,-0.056915196,2.5611838361,10.984632897
5,55,2001,542,405,187,588,10,137,197,302,37807,14.393456554,10.755258126,4.9660080731,-32,0.265561929,3.6381984279,5.2315700021
5,55,2002,553,391,84,588,9,162,93,221,38028,14.584294851,10.311861278,2.2153359267,-34,0.2373574207,4.2724335729,2.4526933474
5,55,2003,550,388,153,588,6,162,159,273,38301,14.411298458,10.166516003,4.0089612074,-48,0.157214165,4.2447824549,4.1661753724
5,55,2004,505,395,282,588,10,110,292,367,38668,13.122166067,10.263872468,7.3276254076,-35,0.2598448726,2.8582935987,7.5874702802
5,55,2005,571,435,352,588,8,136,360,461,39129,14.679229276,11.182950499,9.0491921282,-35,0.2056634575,3.4962787768,9.2548555857
5,55,2006,555,382,600,588,10,173,610,763,39892,14.046898926,9.6683160173,15.185836676,-20,0.2530972779,4.3785829083,15.438933954
5,55,2007,565,403,276,588,8,162,284,460,40352,14.082049748,10.044364688,6.8790189921,14,0.1993918548,4.0376850606,7.0784108469
5,55,2008,566,394,138,588,8,172,146,332,40684,13.969100153,9.7240732514,3.4058936769,14,0.1974431117,4.2450269016,3.6033367886
5,57,2001,341,261,-439,271,118,80,-321,-259,23298,14.555543699,11.140753388,-18.73866183,-18,5.036815708,3.4147903105,-13.70184612
5,57,2002,327,275,-229,271,115,52,-114,-77,23221,14.058771685,11.823126035,-9.845439498,-15,4.9442163417,2.2356456502,-4.901223156
5,57,2003,342,270,-235,271,105,72,-130,-79,23142,14.753143671,11.647218687,-10.13739404,-21,4.529473934,3.1059249833,-5.607920109
5,57,2004,274,251,-201,271,92,23,-109,-105,23037,11.866865891,10.870742112,-8.705255636,-19,3.9844951168,0.9961237792,-4.720760519
5,57,2005,326,247,-193,271,97,79,-96,-38,22999,14.16282909,10.73073247,-8.384742376,-21,4.2140933183,3.43209662,-4.170649057
5,57,2006,347,218,-150,271,95,129,-55,63,23062,15.066976401,9.465708517,-6.513102191,-11,4.1249647207,5.6012678839,-2.38813747
5,57,2007,390,227,-171,271,85,163,-86,81,23143,16.881289904,9.8257764311,-7.401796342,4,3.6792554918,7.0555134726,-3.722540851
5,57,2008,344,213,-464,271,84,131,-380,-243,22900,14.9425537,9.2522207502,-20.15507243,6,3.6487631127,5.6903329496,-16.50630932
5,59,2001,343,351,-39,356,26,-8,-13,-53,30331,11.298690604,11.562216915,-1.284690768,-32,0.8564605122,-0.263526311,-0.428230256
5,59,2002,378,325,24,356,24,53,48,72,30403,12.447722857,10.702407218,0.79033161,-29,0.79033161,1.7453156387,1.5806632199
5,59,2003,337,334,50,463,17,3,67,31,30434,11.078784292,10.9801601,1.6437365419,-39,0.5588704242,0.0986241925,2.2026069662
5,59,2004,352,302,147,655,17,50,164,188,30622,11.530398323,9.892557652,4.8152515723,-26,0.5568658281,1.6378406709,5.3721174004
5,59,2005,382,340,362,925,17,42,379,394,31016,12.394951166,11.032155488,11.746000844,-27,0.5516077744,1.362795678,12.297608618
5,59,2006,373,371,578,1261,18,2,596,582,31598,11.914268374,11.850384898,18.46232472,-16,0.5749512888,0.0638834765,19.037276009
5,59,2007,404,321,152,1291,13,83,165,247,31845,12.735841622,10.119319704,4.7917027883,-1,0.4098166858,2.6165219173,5.2015194742
5,59,2008,428,316,-54,1291,12,112,-42,64,31909,13.426608527,9.9131034915,-1.694011356,-6,0.376446968,3.513505035,-1.317564388
5,61,2001,208,165,-122,371,62,43,-60,-28,14224,14.60879337,11.588706279,-8.568619188,-11,4.3545441776,3.0200870909,-4.214075011
5,61,2002,220,164,-122,371,59,56,-63,-18,14206,15.476609216,11.537108688,-8.582483292,-11,4.1505451987,3.9395005276,-4.431938094
5,61,2003,214,189,20,371,47,25,67,71,14277,15.026507039,13.271073974,1.4043464523,-21,3.3002141628,1.7554330653,4.7045606151
5,61,2004,212,194,-104,371,43,18,-61,-56,14221,14.878237069,13.614990526,-7.298757808,-13,3.017755632,1.2632465436,-4.281002176
5,61,2005,219,166,-11,371,47,53,36,76,14297,15.358720808,11.64177011,-0.771442598,-13,3.2961638264,3.7169506978,2.5247212287
5,61,2006,203,162,-262,371,46,41,-216,-180,14117,14.288730907,11.402829591,-18.44161329,-5,3.2378405012,2.8859013163,-15.20377279
5,61,2007,197,150,-226,371,38,47,-188,-139,13978,14.02384766,10.678056594,-16.08827193,2,2.7051076704,3.345791066,-13.38316426
5,61,2008,219,141,57,371,37,78,94,165,14143,15.575548522,10.028092884,4.0539098894,-7,2.6314853668,5.5474556381,6.6853952562
5,63,2001,397,388,-110,975,20,9,-90,-112,34157,11.603776342,11.34071844,-3.215152135,-31,0.5845731155,0.263057902,-2.63057902
5,63,2002,452,377,-87,968,19,75,-68,-27,34130,13.238244468,11.041633107,-2.548069179,-34,0.5564748781,2.1966113609,-1.991594301
5,63,2003,451,385,-49,967,14,66,-35,-21,34109,13.21824763,11.283869928,-1.4361289,-52,0.4103225428,1.9343777019,-1.025806357
5,63,2004,497,397,55,937,20,100,75,154,34263,14.538115018,11.61294097,1.6088457263,-21,0.5850348096,2.9251740479,2.1938805359
5,63,2005,494,372,-101,918,18,122,-83,7,34270,14.416412531,10.85608393,-2.947485153,-32,0.5252943837,3.5603286008,-2.422190769
5,63,2006,463,390,47,928,20,73,67,123,34393,13.486157028,11.359829894,1.3690051411,-17,0.5825553792,2.126327134,1.9515605202
5,63,2007,495,360,-6,952,17,135,11,154,34547,14.360313316,10.44386423,-0.174064404,8,0.4931824775,3.9164490862,0.3191180737
5,63,2008,494,377,-60,952,17,117,-43,94,34641,14.279932936,10.897843557,-1.73440481,20,0.4914146962,3.3820893797,-1.242990114
5,65,2001,104,189,19,776,3,-85,22,-77,13199,7.8564683664,14.277620397,1.4353163362,-14,0.2266288952,-6.42115203,1.6619452314
5,65,2002,125,181,-22,776,3,-56,-19,-91,13108,9.5031740601,13.760596039,-1.672558635,-16,0.2280761774,-4.257421979,-1.444482457
5,65,2003,142,179,154,786,3,-37,157,113,13221,10.786585134,13.597174219,11.69812754,-7,0.2278856014,-2.810589084,11.926013141
5,65,2004,147,198,23,779,2,-51,25,-37,13184,11.134254876,14.997159629,1.7420943003,-11,0.1514864609,-3.862904753,1.8935807612
5,65,2005,147,179,-22,764,3,-32,-19,-58,13126,11.174458381,13.606993539,-1.672367921,-7,0.228050171,-2.432535158,-1.44431775
5,65,2006,142,198,16,758,2,-56,18,-44,13082,10.836385836,15.10989011,1.221001221,-6,0.1526251526,-4.273504274,1.3736263736
5,65,2007,125,185,-74,758,3,-60,-71,-147,12935,9.6091017412,14.221470577,-5.688588231,-16,0.2306184418,-4.612368836,-5.457969789
5,65,2008,139,181,119,758,2,-42,121,57,12992,10.722412929,13.962278706,9.1796197015,-22,0.1542793227,-3.239865777,9.3338990242
5,67,2001,212,281,-458,1649,1,-69,-457,-541,17810,11.725339454,15.541605597,-25.33115788,-15,0.055308205,-3.816266143,-25.27584967
5,67,2002,208,257,-54,1709,1,-49,-53,-122,17688,11.718970083,14.479688997,-3.042424925,-20,0.0563412023,-2.760718914,-2.986083723
5,67,2003,204,238,-269,1690,0,-34,-269,-314,17374,11.636529576,13.575951172,-15.34424733,-11,0,-1.939421596,-15.34424733
5,67,2004,223,240,246,2093,1,-17,247,209,17583,12.758531911,13.73115542,14.074434305,-21,0.0572131476,-0.972623509,14.131647453
5,67,2005,265,232,-89,2056,1,33,-88,-71,17512,15.101866363,13.221256589,-5.071947571,-16,0.056988175,1.8806097735,-5.014959396
5,67,2006,209,237,-189,2065,1,-28,-188,-222,17290,12.010803977,13.619906902,-10.86144474,-6,0.0574679616,-1.609102925,-10.80397678
5,67,2007,209,212,-112,2058,1,-3,-111,-117,17173,12.128949888,12.303049647,-6.499724342,-3,0.0580332531,-0.174099759,-6.441691089
5,67,2008,232,206,-260,2058,0,26,-260,-237,16936,13.60344777,12.078923451,-15.24524319,-3,0,1.5245243191,-15.24524319
5,69,2001,1242,896,-1127,5379,66,346,-1061,-781,83438,14.815963545,10.688488998,-13.44411507,-66,0.7873217343,4.1274745462,-12.65679333
5,69,2002,1181,895,-760,5443,58,286,-702,-476,82962,14.194711538,10.757211538,-9.134615385,-60,0.6971153846,3.4375,-8.4375
5,69,2003,1136,917,-723,5510,37,219,-686,-538,82424,13.737559406,11.089209486,-8.743182615,-71,0.4474381145,2.6483499208,-8.295744501
5,69,2004,1162,896,-954,5442,55,266,-899,-709,81715,14.158731319,10.917575957,-11.62429404,-76,0.6701637027,3.2411553622,-10.95413034
5,69,2005,1165,894,-1176,5281,50,271,-1126,-912,80803,14.336873454,11.001858256,-14.47224307,-57,0.6153164573,3.3350151983,-13.85692662
5,69,2006,1173,815,-940,5348,55,358,-885,-564,80239,14.567628321,10.121583189,-11.67397325,-37,0.6830516263,4.4460451311,-10.99092162
5,69,2007,1144,845,-1421,5578,45,299,-1376,-1083,79156,14.35427711,10.602591047,-17.82991938,-6,0.5646350262,3.7516860629,-17.26528436
5,69,2008,1137,826,-1088,5578,46,311,-1042,-783,78373,14.435437285,10.486957957,-13.81332961,-52,0.5840194504,3.9484793276,-13.22931016
5,71,2001,331,252,-35,606,102,79,67,121,22916,14.482290915,11.025792479,-1.531360067,-25,4.4628207652,3.4564984358,2.9314606987
5,71,2002,348,235,91,655,96,113,187,280,23196,15.093684941,10.192574601,3.9469118668,-20,4.1637751561,4.90111034,8.1106870229
5,71,2003,378,241,37,666,84,137,121,228,23424,16.216216216,10.338910339,1.5873015873,-30,3.6036036036,5.8773058773,5.1909051909
5,71,2004,358,251,48,702,78,107,126,215,23639,15.213649789,10.666553343,2.0398189661,-18,3.3147058199,4.5470964452,5.3545247859
5,71,2005,358,229,16,603,82,129,98,204,23843,15.079398509,9.6457604987,0.6739395982,-23,3.4539404406,5.4336380102,4.1278800388
5,71,2006,357,257,199,609,85,100,284,371,24214,14.857356889,10.69563227,8.2818319912,-13,3.5374659259,4.1617246187,11.819297917
5,71,2007,382,234,220,618,69,148,289,442,24656,15.633312871,9.576427256,9.0034786167,5,2.8238182934,6.0568856149,11.82729691
5,71,2008,394,238,-45,618,69,156,24,195,24851,15.916941039,9.6148019472,-1.817924738,15,2.7874845981,6.3021390914,0.9695598602
5,73,2001,106,103,-179,121,9,3,-170,-173,8354,12.558497719,12.203068539,-21.20727445,-6,1.0662875422,0.3554291807,-20.14098691
5,73,2002,109,116,-151,121,9,-7,-142,-154,8200,13.169022593,14.01473964,-18.24332488,-5,1.0873504893,-0.845717047,-17.15597439
5,73,2003,86,113,20,129,3,-27,23,-13,8187,10.496124977,13.791420028,2.440959297,-9,0.3661438946,-3.295295051,2.8071031916
5,73,2004,99,115,-97,125,2,-16,-95,-118,8069,12.18011811,14.148622047,-11.93405512,-7,0.2460629921,-1.968503937,-11.68799213
5,73,2005,68,107,-91,126,3,-39,-88,-135,7934,8.4984065488,13.372492658,-11.37286759,-8,0.3749297007,-4.874086109,-10.99793789
5,73,2006,91,107,-145,125,2,-16,-143,-162,7772,11.58792818,13.625366102,-18.46428117,-3,0.2546797402,-2.037437922,-18.20960143
5,73,2007,93,67,-45,121,3,26,-42,-22,7750,11.982991882,8.6329081304,-5.798221879,-6,0.3865481252,3.3500837521,-5.411673753
5,73,2008,93,73,-62,121,2,20,-60,-45,7705,12.034940149,9.446780977,-8.023293433,-5,0.2588159172,2.5881591718,-7.764477515
5,75,2001,241,222,13,589,6,19,19,21,17699,13.624671397,12.550527179,0.7349407807,-17,0.3392034373,1.074144218,1.074144218
5,75,2002,181,234,-61,570,5,-53,-56,-124,17575,10.262516301,13.267562511,-3.45863809,-15,0.2834949254,-3.00504621,-3.175143165
5,75,2003,224,229,-133,578,4,-5,-129,-152,17423,12.80073147,13.086462084,-7.600434311,-18,0.2285844905,-0.285730613,-7.37184982
5,75,2004,224,230,-121,579,5,-6,-116,-135,17288,12.906571404,13.252283138,-6.971853303,-13,0.2880931117,-0.345711734,-6.683760191
5,75,2005,219,207,-263,591,5,12,-258,-258,17030,12.762981526,12.063640072,-15.32723352,-12,0.2913922723,0.6993414535,-15.03584125
5,75,2006,208,204,-235,596,5,4,-230,-233,16797,12.297868567,12.061371094,-13.89422651,-7,0.2956218405,0.2364974724,-13.59860466
5,75,2007,216,201,22,592,3,15,25,29,16826,12.848347857,11.956101478,1.3086280225,-11,0.1784492758,0.892246379,1.4870772983
5,75,2008,198,213,60,592,2,-15,62,35,16861,11.755276516,12.645827767,3.5622050049,-12,0.1187401668,-0.890551251,3.6809451717
5,77,2001,167,156,-177,1760,2,11,-175,-173,12355,13.422818792,12.538681027,-14.2265804,-9,0.1607523209,0.8841377647,-14.06582808
5,77,2002,158,131,-254,1763,1,27,-253,-234,12121,12.910606308,10.704363458,-20.75502533,-8,0.0817126982,2.2062428501,-20.67331263
5,77,2003,147,122,-473,1758,-1,25,-474,-435,11686,12.349309027,10.249086403,-39.73621204,14,-0.084008905,2.1002226236,-39.82022094
5,77,2004,112,138,-227,1736,3,-26,-224,-263,11423,9.6931931282,11.943398676,-19.64602536,-13,0.2596391016,-2.250205548,-19.38638626
5,77,2005,130,136,-146,1750,1,-6,-145,-160,11263,11.460812836,11.989773429,-12.87137442,-9,0.0881600987,-0.528960592,-12.78321432
5,77,2006,126,121,-257,1768,2,5,-255,-253,11010,11.314147174,10.86517308,-23.07726844,-3,0.1795896377,0.4489740942,-22.8976788
5,77,2007,132,85,-254,1733,1,47,-253,-204,10806,12.101210121,7.7924459113,-23.2856619,2,0.0916758343,4.3087642098,-23.19398607
5,77,2008,127,129,-27,1733,1,-2,-26,-24,10782,11.765795812,11.951083936,-2.501389661,4,0.0926440615,-0.185288123,-2.408745599
5,79,2001,154,130,-49,3448,1,24,-48,-38,14436,10.653753027,8.9934278796,-3.389830508,-14,0.0691802145,1.660325147,-3.320650294
5,79,2002,150,120,-24,3665,1,30,-23,-8,14428,10.393569845,8.3148558758,-1.662971175,-15,0.0692904656,2.078713969,-1.59368071
5,79,2003,146,120,-85,3759,-1,26,-86,-78,14350,10.146639794,8.3397039405,-5.907290291,-18,-0.069497533,1.8069358538,-5.976787824
5,79,2004,144,127,-209,3715,0,17,-209,-206,14144,10.10739103,8.9141573665,-14.66975504,-14,0,1.1932336632,-14.66975504
5,79,2005,139,139,-32,3726,0,0,-32,-44,14100,9.8427984705,9.8427984705,-2.265967993,-12,0,0,-2.265967993
5,79,2006,144,128,-296,3546,0,16,-296,-286,13814,10.317403453,9.171025292,-21.20799599,-6,0,1.1463781615,-21.20799599
5,79,2007,141,122,-128,3558,0,19,-128,-113,13701,10.248955115,8.8678902417,-9.304015991,-4,0,1.3810648737,-9.304015991
5,79,2008,146,102,-123,3558,-1,44,-124,-92,13609,10.692054193,7.4697912852,-9.007689491,-12,-0.073233248,3.2222629074,-9.080922739
5,81,2001,148,185,-266,176,5,-37,-261,-307,13304,10.99758499,13.746981237,-19.76592978,-9,0.3715400334,-2.749396247,-19.39438975
5,81,2002,151,147,52,176,5,4,57,49,13353,11.329106801,11.028998012,3.9014142627,-12,0.3751359868,0.3001087894,4.2765502495
5,81,2003,159,141,-97,176,1,18,-96,-91,13262,11.94814954,10.595528837,-7.289122675,-13,0.0751455946,1.3526207026,-7.213977081
5,81,2004,134,141,-196,176,2,-7,-194,-214,13048,10.186240973,10.718358039,-14.89927784,-13,0.1520334474,-0.532117066,-14.74724439
5,81,2005,120,160,-48,176,2,-40,-46,-98,12950,9.2314793446,12.308639126,-3.692591738,-12,0.1538579891,-3.077159782,-3.538733749
5,81,2006,147,162,-23,176,2,-15,-21,-42,12908,11.369788847,12.529971382,-1.778946554,-6,0.1546910047,-1.160182535,-1.62425555
5,81,2007,161,106,-128,176,1,55,-127,-85,12823,12.514088065,8.2390890366,-9.949088648,-13,0.0777272551,4.2749990284,-9.871361393
5,81,2008,151,108,-40,176,0,43,-40,-16,12807,11.783066719,8.4276238783,-3.121342177,-19,0,3.3554428404,-3.121342177
5,83,2001,294,263,-146,484,10,31,-136,-123,22381,13.100144815,11.718837028,-6.505514092,-18,0.445583157,1.3813077866,-6.059930935
5,83,2002,285,256,24,473,10,29,34,43,22424,12.721794443,11.427296061,1.0713090057,-20,0.4463787524,1.2944983819,1.5176877581
5,83,2003,292,251,201,473,6,41,207,228,22652,12.955896708,11.136746828,8.9182713639,-20,0.2662170556,1.8191498802,9.1844884196
5,83,2004,257,291,3,473,10,-34,13,-36,22616,11.354599275,12.85676416,0.1325439604,-15,0.4418132014,-1.502164885,0.5743571618
5,83,2005,258,267,-18,473,8,-9,-10,-41,22575,11.418202739,11.816512137,-0.796618796,-22,0.3540527981,-0.398309398,-0.442565998
5,83,2006,262,268,-30,473,10,-6,-20,-36,22539,11.615019728,11.881012546,-1.329964091,-10,0.4433213637,-0.265992818,-0.886642727
5,83,2007,309,264,2,475,8,45,10,55,22594,13.692863315,11.698757007,0.088626947,0,0.3545077881,1.994106308,0.4431347351
5,83,2008,289,256,-70,475,8,33,-62,-27,22567,12.798653706,11.337215739,-3.100019929,2,0.3542879919,1.4614379664,-2.745731937
5,85,2001,717,463,597,621,11,254,608,784,53909,13.397611974,8.6514565465,11.155333819,-78,0.2055421642,4.7461554272,11.360875983
5,85,2002,706,436,874,621,-25,270,849,1066,54975,12.967929172,8.0085228316,16.053782007,-53,-0.459204291,4.9594063407,15.594577716
5,85,2003,768,465,1039,621,-88,303,951,1223,56198,13.816304318,8.3653405053,18.691588785,-31,-1.583118203,5.4509638132,17.108470582
5,85,2004,858,494,1531,621,55,364,1586,1849,58047,15.020351,8.6480808788,26.80204823,-101,0.9628430128,6.3722701212,27.764891243
5,85,2005,822,504,1408,621,0,318,1408,1656,59703,13.961783439,8.5605095541,23.91507431,-70,0,5.4012738854,23.91507431
5,85,2006,914,483,1765,621,33,431,1798,2146,61849,15.038831118,7.9472160063,29.041068843,-83,0.5429774911,7.0916151112,29.584046334
5,85,2007,934,490,1145,621,4,444,1149,1619,63468,14.906197882,7.8201680538,18.273658003,26,0.0638381066,7.0860298284,18.33749611
5,85,2008,992,485,1211,621,12,507,1223,1765,65233,15.415575637,7.5368489755,18.818812597,35,0.1864787375,7.878726661,19.005291334
5,87,2001,174,153,-15,83,17,21,2,8,14303,12.168683125,10.700048954,-1.049024407,-15,1.1888943283,1.4686341702,0.139869921
5,87,2002,188,147,-135,83,17,41,-118,-92,14211,13.186504875,10.310724556,-9.469032756,-15,1.1923967174,2.8757803184,-8.276636038
5,87,2003,164,155,64,83,9,9,73,62,14273,11.515236624,10.883302907,4.4937508777,-20,0.6319337172,0.6319337172,5.1256845949
5,87,2004,177,137,243,83,9,40,252,275,14548,12.282710524,9.5069567329,16.862704278,-17,0.6245446029,2.7757537906,17.487248881
5,87,2005,174,140,262,83,9,34,271,295,14843,11.840359294,9.5267258685,17.828586982,-10,0.6124323773,2.3136334252,18.44101936
5,87,2006,191,163,299,83,9,28,308,327,15170,12.727817946,10.861959817,19.924699297,-9,0.5997401126,1.8658581281,20.52443941
5,87,2007,219,154,158,83,6,65,164,219,15389,14.332929742,10.078863837,10.340652508,-10,0.3926830066,4.2540659053,10.733335515
5,87,2008,217,142,189,83,5,75,194,262,15651,13.981958763,9.1494845361,12.177835052,-7,0.3221649485,4.8324742268,12.5
5,89,2001,123,188,127,153,-1,-65,126,47,16203,7.6022126765,11.61964214,7.849439105,-14,-0.061806607,-4.017429463,7.7876324979
5,89,2002,113,169,-32,153,-1,-56,-33,-106,16097,6.9969040248,10.464396285,-1.981424149,-17,-0.061919505,-3.46749226,-2.043343653
5,89,2003,138,185,19,153,-3,-47,16,-48,16049,8.5858271636,11.50998569,1.1821066385,-17,-0.186648417,-2.924158527,0.9954582219
5,89,2004,127,163,187,153,1,-36,188,134,16183,7.8803673368,10.114172251,11.603375527,-18,0.0620501365,-2.233804914,11.665425664
5,89,2005,146,188,197,153,-1,-42,196,142,16325,8.9824043312,11.566383659,12.120093515,-12,-0.061523317,-2.583979328,12.058570198
5,89,2006,144,174,244,153,1,-30,245,206,16531,8.765522279,10.591672754,14.852690528,-9,0.0608716825,-1.826150475,14.913562211
5,89,2007,141,210,122,153,-1,-69,121,48,16579,8.517064331,12.684989429,7.3693748112,-4,-0.060404712,-4.167925098,7.3089700997
5,89,2008,141,189,258,153,-1,-48,257,195,16774,8.4550115432,11.333313345,15.470872185,-14,-0.059964621,-2.878301802,15.410907565
5,91,2001,573,366,10,1079,26,207,36,202,40638,14.135234477,9.0287885142,0.2466882108,-41,0.641389348,5.1064459629,0.8880775588
5,91,2002,594,367,138,1088,25,227,163,350,40988,14.554186166,8.992232867,3.381275574,-40,0.6125499228,5.5619532992,3.9938254968
5,91,2003,578,362,275,1086,16,216,291,463,41451,14.022489356,8.782251119,6.671599607,-44,0.3881657953,5.2402382368,7.0597654023
5,91,2004,483,396,335,1089,22,87,357,411,41862,11.594829138,9.506319542,8.0419622388,-33,0.5281288634,2.0885095963,8.5700911022
5,91,2005,588,400,267,1092,20,188,287,435,42297,13.973550066,9.5058163714,6.3451324279,-40,0.4752908186,4.4677336946,6.8204232465
5,91,2006,598,387,204,1101,21,211,225,416,42713,14.068933067,9.1048111987,4.7994353605,-20,0.4940595224,4.964121868,5.293494883
5,91,2007,676,288,-331,1101,19,388,-312,72,42785,15.813235397,6.7369996959,-7.742871178,-4,0.444454841,9.0762357014,-7.298416337
5,91,2008,609,303,120,1101,19,306,139,441,43226,14.16097941,7.0456104452,2.7903407704,-4,0.4418039553,7.1153689644,3.2321447257
5,93,2001,923,580,-1211,843,31,343,-1180,-863,50966,17.958071891,11.284595554,-23.56145727,-26,0.6031421762,6.6734763364,-22.95831509
5,93,2002,842,576,-1389,856,29,266,-1360,-1103,49863,16.701544199,11.425284392,-27.55159726,-9,0.5752313323,5.2762598062,-26.97636593
5,93,2003,757,596,-1703,860,20,161,-1683,-1476,48387,15.409669211,12.132315522,-34.66666667,46,0.4071246819,3.2773536896,-34.25954198
5,93,2004,763,582,-964,853,18,181,-946,-820,47567,15.903453738,12.130812681,-20.09296121,-55,0.3751797736,3.7726410572,-19.71778144
5,93,2005,781,530,-676,862,19,251,-657,-441,47126,16.495411488,11.194069255,-14.27771852,-35,0.4012968224,5.3013422323,-13.8764217
5,93,2006,771,535,-593,851,19,236,-574,-358,46768,16.422774618,11.395829339,-12.63126504,-20,0.4047116962,5.0269452787,-12.22655335
5,93,2007,798,514,-413,851,16,284,-397,-121,46647,17.085050581,11.00465664,-8.84226302,-8,0.3425574051,6.080393941,-8.499705615
5,93,2008,776,536,-69,851,15,240,-54,161,46808,16.606923118,11.470761329,-1.476646514,-25,0.3210101118,5.1361617891,-1.155636403
5,95,2001,128,149,-229,135,7,-21,-222,-247,9932,12.729352096,14.817761424,-22.77360648,-4,0.6961364427,-2.088409328,-22.07747004
5,95,2002,121,134,-249,135,7,-13,-242,-260,9672,12.344419506,13.670679453,-25.40297898,-5,0.7141399714,-1.326259947,-24.68883901
5,95,2003,107,121,-127,135,4,-14,-123,-145,9527,11.146413876,12.604823168,-13.22985572,-8,0.4166883692,-1.458409292,-12.81316735
5,95,2004,125,108,-310,135,3,17,-307,-302,9225,13.331911263,11.518771331,-33.06313993,-12,0.3199658703,1.8131399317,-32.74317406
5,95,2005,125,141,-110,135,4,-16,-106,-130,9095,13.64628821,15.3930131,-12.00873362,-8,0.4366812227,-1.746724891,-11.5720524
5,95,2006,107,128,-180,135,3,-21,-177,-203,8892,11.897481514,14.232501251,-20.01445488,-5,0.3335742481,-2.335019736,-19.68088064
5,95,2007,107,118,-207,135,3,-11,-204,-204,8688,12.172923777,13.424345848,-23.54948805,11,0.3412969283,-1.251422071,-23.20819113
5,95,2008,108,131,-156,135,2,-23,-154,-170,8518,12.553760316,15.227246309,-18.13320935,7,0.2324770429,-2.673485993,-17.9007323
5,97,2001,85,129,-60,109,12,-44,-48,-99,9172,9.2175893293,13.989047335,-6.506533644,-7,1.3013067288,-4.771458006,-5.205226915
5,97,2002,74,101,-106,109,11,-27,-95,-133,9039,8.1269562352,11.092197024,-11.64131569,-11,1.208061062,-2.965240789,-10.43325463
5,97,2003,92,111,42,109,11,-19,53,23,9062,10.165184244,12.264515773,4.6406275896,-11,1.215402464,-2.099331529,5.8560300536
5,97,2004,97,109,46,109,10,-12,56,35,9097,10.683407677,12.005066358,5.0663582796,-9,1.1013822347,-1.321658682,6.1677405143
5,97,2005,91,111,-23,109,11,-20,-12,-38,9059,10.024234413,12.227362855,-2.533597709,-6,1.2117206433,-2.203128442,-1.321877065
5,97,2006,108,105,-16,109,10,3,-6,-7,9052,11.926453537,11.595163161,-1.766882005,-4,1.1043012534,0.331290376,-0.662580752
5,97,2007,112,120,-18,109,9,-8,-9,-25,9027,12.390065822,13.275070524,-1.991260579,-8,0.9956302893,-0.885004702,-0.995630289
5,97,2008,102,97,26,109,8,5,34,20,9047,11.286931504,10.733650548,2.8770609716,-19,0.8852495297,0.5532809561,3.7623105013
5,99,2001,135,150,-101,294,13,-15,-88,-111,9810,13.684050479,15.204500532,-10.23769702,-8,1.3177233795,-1.520450053,-8.919973646
5,99,2002,130,122,-126,294,13,8,-113,-111,9699,13.327182326,12.507048029,-12.91711518,-6,1.3327182326,0.820134297,-11.58439694
5,99,2003,125,125,-64,294,10,0,-54,-64,9635,12.9305886,12.9305886,-6.620461363,-10,1.034447088,0,-5.586014275
5,99,2004,146,122,-77,294,9,24,-68,-52,9583,15.194088875,12.69643043,-8.013320845,-8,0.936621917,2.4976584452,-7.076698928
5,99,2005,125,103,-84,294,10,22,-74,-59,9524,13.084209975,10.78138902,-8.792589103,-7,1.046736798,2.3028209557,-7.745852305
5,99,2006,135,111,-131,294,10,24,-121,-101,9423,14.250277089,11.716894495,-13.82804666,-4,1.0555760806,2.5333825936,-12.77247058
5,99,2007,124,99,-125,294,10,25,-115,-92,9331,13.22384558,10.55774768,-13.3304895,-2,1.0664391596,2.6660978991,-12.26405034
5,99,2008,132,102,-214,294,9,30,-205,-174,9157,14.27953267,11.034184336,-23.15015145,1,0.9736045002,3.2453483341,-22.17654695
5,101,2001,103,88,-133,66,1,15,-132,-123,8524,11.996971638,10.249839846,-15.49123522,-6,0.1164754528,1.747131792,-15.37475977
5,101,2002,69,77,0,66,0,-8,0,-17,8507,8.1028712348,9.0423345664,0,-9,0,-0.939463332,0
5,101,2003,88,94,67,66,-1,-6,66,53,8560,10.312298588,11.015409855,7.8514091522,-7,-0.117185211,-0.703111267,7.7342239409
5,101,2004,94,88,-122,66,0,6,-122,-125,8435,11.062077081,10.355987055,-14.35716387,-9,0,0.7060900265,-14.35716387
5,101,2005,82,87,-45,66,0,-5,-45,-56,8379,9.7537766147,10.348519091,-5.352682289,-6,0,-0.594742477,-5.352682289
5,101,2006,77,93,6,66,0,-16,6,-14,8365,9.1973244147,11.108456761,0.7166746297,-4,0,-1.911132346,0.7166746297
5,101,2007,85,88,-27,66,0,-3,-27,-30,8335,10.179640719,10.538922156,-3.233532934,0,0,-0.359281437,-3.233532934
5,101,2008,88,91,-31,66,-1,-3,-32,-37,8298,10.581374376,10.942103048,-3.72752961,-2,-0.120242891,-0.360728672,-3.8477725
5,103,2001,350,397,-588,393,10,-47,-578,-638,28048,12.338280396,13.995135192,-20.72831107,-13,0.352522297,-1.656854796,-20.37578877
5,103,2002,367,366,-441,393,10,1,-431,-441,27607,13.188392777,13.152457102,-15.84763274,-11,0.3593567514,0.0359356751,-15.48827599
5,103,2003,335,406,-194,393,8,-71,-186,-288,27319,12.198230346,14.783526927,-7.064049812,-31,0.2913010232,-2.585296581,-6.772748789
5,103,2004,321,373,-371,393,8,-52,-363,-442,26877,11.845892686,13.764853495,-13.69104731,-27,0.2952247398,-1.918960809,-13.39582257
5,103,2005,384,370,-245,393,9,14,-236,-247,26630,14.35326219,13.829966173,-9.157680304,-25,0.3364045826,0.5232960173,-8.821275721
5,103,2006,388,371,-321,393,9,17,-312,-306,26324,14.654228198,14.012161499,-12.12373003,-11,0.3399176644,0.6420666994,-11.78381237
5,103,2007,361,363,-299,393,7,-2,-292,-278,26046,13.786518999,13.862898606,-11.41875119,16,0.2673286233,-0.076379607,-11.15142257
5,103,2008,355,360,-295,393,6,-5,-289,-276,25770,13.702331326,13.895321908,-11.38644434,18,0.2315886985,-0.192990582,-11.15485564
5,105,2001,134,110,50,157,0,24,50,65,10301,13.049617763,10.712372791,4.8692603594,-9,0,2.3372449725,4.8692603594
5,105,2002,133,120,35,157,-1,13,34,38,10339,12.887596899,11.627906977,3.3914728682,-9,-0.096899225,1.2596899225,3.2945736434
5,105,2003,111,115,-21,157,-1,-4,-22,-42,10297,10.757898818,11.145570847,-2.035278155,-16,-0.096918007,-0.387672029,-2.132196162
5,105,2004,111,111,-7,157,0,0,-7,-13,10284,10.786647879,10.786647879,-0.680239055,-6,0,0,-0.680239055
5,105,2005,111,98,-22,157,0,13,-22,-16,10268,10.801868431,9.5367847411,-2.14091086,-7,0,1.2650836902,-2.14091086
5,105,2006,127,133,-20,157,0,-6,-20,-30,10238,12.386618551,12.971813128,-1.950648591,-4,0,-0.585194577,-1.950648591
5,105,2007,133,127,143,157,0,6,143,150,10388,12.89634442,12.314554446,13.865994376,1,0,0.5817899738,13.865994376
5,105,2008,124,115,-75,157,-1,9,-76,-71,10317,11.977783144,11.108427916,-7.244626902,-4,-0.096595025,0.8693552282,-7.341221927
5,107,2001,474,337,-734,314,6,137,-728,-606,25662,18.255343732,12.979010206,-28.26882342,-15,0.2310803004,5.2763335259,-28.03774312
5,107,2002,445,342,-997,314,6,103,-991,-887,24775,17.645775918,13.561472728,-39.53446874,1,0.2379205742,4.0843031901,-39.29654817
5,107,2003,383,291,-792,314,5,92,-787,-683,24092,15.675200033,11.909877832,-32.41451286,12,0.2046370761,3.7653222011,-32.20987579
5,107,2004,421,325,-540,314,6,96,-534,-468,23624,17.646072596,13.622265068,-22.63391734,-30,0.2514879705,4.0238075279,-22.38242937
5,107,2005,422,309,-459,314,6,113,-453,-354,23270,17.998038129,13.178658251,-19.57606517,-14,0.2558962767,4.819379878,-19.32016889
5,107,2006,397,336,-781,314,6,61,-775,-720,22550,17.328677433,14.666084679,-34.08991707,-6,0.2618943693,2.6625927543,-33.8280227
5,107,2007,405,287,-664,314,6,118,-658,-550,22000,18.181818182,12.884399551,-29.80920314,-10,0.2693602694,5.2974186308,-29.53984287
5,107,2008,378,281,-468,314,5,97,-463,-397,21603,17.338256542,12.889021398,-21.46641286,-31,0.2293420178,4.4492351444,-21.23707084
5,109,2001,136,153,-81,182,20,-17,-61,-90,11230,12.062084257,13.569844789,-7.184035477,-12,1.7738359202,-1.507760532,-5.410199557
5,109,2002,126,133,-58,182,20,-7,-38,-54,11176,11.246987414,11.871820048,-5.177184683,-9,1.7852360975,-0.624832634,-3.391948585
5,109,2003,106,154,-113,182,11,-48,-102,-159,11017,9.5525616185,13.878249899,-10.18339116,-9,0.9913035642,-4.32568828,-9.192087595
5,109,2004,138,152,-59,182,10,-14,-49,-71,10946,12.566589264,13.841460638,-5.372672221,-8,0.9106224104,-1.274871375,-4.462049811
5,109,2005,87,156,-42,182,11,-69,-31,-110,10836,7.9882471766,14.323753558,-3.856395189,-10,1.0100082637,-6.335506381,-2.846386925
5,109,2006,109,120,-67,182,10,-11,-57,-74,10762,10.093527178,11.112140013,-6.204278174,-6,0.9260116677,-1.018612835,-5.278266506
5,109,2007,113,114,-2,182,10,-1,8,-3,10759,10.501370754,10.594303239,-0.185864969,-10,0.9293248455,-0.092932485,0.7434598764
5,109,2008,121,121,-141,182,9,0,-132,-143,10616,11.321637427,11.321637427,-13.19298246,-11,0.8421052632,0,-12.35087719
5,111,2001,360,296,-165,395,16,64,-149,-107,25512,14.08147699,11.578103303,-6.454010287,-22,0.6258434218,2.5033736872,-5.828166866
5,111,2002,354,322,-305,398,15,32,-290,-275,25237,13.951013813,12.68990522,-12.01994128,-17,0.5911446531,1.2611085933,-11.42879663
5,111,2003,336,301,-51,402,12,35,-39,-38,25199,13.323816322,11.935918788,-2.022364977,-34,0.4758505829,1.3878975335,-1.546514394
5,111,2004,350,335,-144,400,15,15,-129,-132,25067,13.925914137,13.329089245,-5.729518959,-18,0.5968248916,0.5968248916,-5.132694068
5,111,2005,360,312,-13,402,13,48,0,25,25092,14.354353157,12.440439403,-0.518351642,-23,0.5183516418,1.9139137543,0
5,111,2006,352,335,-224,400,14,17,-210,-204,24888,14.085634254,13.405362145,-8.963585434,-11,0.5602240896,0.6802721088,-8.403361345
5,111,2007,384,319,-141,401,10,65,-131,-67,24821,15.449918526,12.834697942,-5.673016959,-1,0.4023416283,2.6152205838,-5.27067533
5,111,2008,366,311,-167,401,10,55,-157,-100,24721,14.775342134,12.555003835,-6.741754471,2,0.4036978725,2.2203382988,-6.338056598
5,113,2001,258,224,-142,193,18,34,-124,-109,20153,12.767536806,11.084993196,-7.027093901,-19,0.8907583818,1.68254361,-6.136335519
5,113,2002,277,276,23,193,17,1,40,22,20175,13.7373537,13.687760365,1.1406466971,-19,0.8430866891,0.0495933347,1.9837333862
5,113,2003,258,241,-99,193,11,17,-88,-93,20082,12.81764662,11.973073006,-4.918399285,-22,0.5464888094,0.8445736145,-4.371910475
5,113,2004,255,248,-178,193,14,7,-164,-176,19906,12.753826148,12.403721116,-8.902670801,-19,0.700210063,0.3501050315,-8.202460738
5,113,2005,264,237,81,193,12,27,93,101,20007,13.22877258,11.87582993,4.0588279508,-19,0.6013078446,1.3529426503,4.6601357954
5,113,2006,266,266,186,193,13,0,199,188,20195,13.233172479,13.233172479,9.2532709815,-11,0.6467339933,0,9.9000049749
5,113,2007,274,256,-54,193,7,18,-47,-29,20166,13.577463393,12.685513243,-2.67585045,0,0.3468695027,0.8919501499,-2.328980947
5,113,2008,270,241,49,193,6,29,55,91,20257,13.358731415,11.923904708,2.424362368,7,0.2968606981,1.4348267076,2.7212230661
5,115,2001,739,522,151,1975,33,217,184,432,54936,13.505116959,9.5394736842,2.759502924,31,0.6030701754,3.9656432749,3.3625730994
5,115,2002,691,525,152,2143,30,166,182,366,55302,12.536511911,9.5248462418,2.757669769,18,0.5442769281,3.0116656688,3.3019466971
5,115,2003,729,508,-104,2340,22,221,-82,130,55432,13.166687738,9.1751404266,-1.878375205,-9,0.3973486012,3.9915473116,-1.481026604
5,115,2004,784,514,602,2451,27,270,629,927,56359,14.026173842,9.1957313201,10.770097772,28,0.4830442522,4.8304425222,11.253142024
5,115,2005,767,492,540,2594,26,275,566,873,57232,13.504591033,8.6626581331,9.507795512,32,0.4577827469,4.8419328996,9.9655782588
5,115,2006,766,532,854,2764,27,234,881,1147,58379,13.251334216,9.2032765048,14.773680705,32,0.467083582,4.0480577108,15.240764287
5,115,2007,846,479,426,3022,21,367,447,825,59204,14.389835265,8.1474362791,7.2459454173,11,0.3571944924,6.2423989862,7.6031399097
5,115,2008,861,522,360,3022,21,339,381,748,59952,14.451643224,8.761623418,6.042498909,28,0.352479103,5.690019806,6.394978012
5,117,2001,119,135,21,140,1,-16,22,-4,9500,12.523679225,14.207535256,2.2100610398,-10,0.1052410019,-1.68385603,2.3153020417
5,117,2002,110,105,-117,140,0,5,-117,-119,9381,11.651925216,11.122292251,-12.39341137,-7,0,0.5296329644,-12.39341137
5,117,2003,99,110,-108,140,-1,-11,-109,-128,9253,10.625737898,11.806375443,-11.59171407,-8,-0.107330686,-1.180637544,-11.69904476
5,117,2004,96,126,-173,140,2,-30,-171,-212,9041,10.495244342,13.775008199,-18.91330491,-11,0.2186509238,-3.279763857,-18.69465398
5,117,2005,85,115,-49,140,0,-30,-49,-85,8956,9.4460187809,12.779907762,-5.445352003,-6,0,-3.333888981,-5.445352003
5,117,2006,91,103,-97,140,1,-12,-96,-111,8845,10.224144711,11.572383574,-10.89826414,-3,0.1123532386,-1.348238863,-10.7859109
5,117,2007,93,101,-101,140,1,-8,-100,-118,8727,10.585021625,11.49556112,-11.49556112,-10,0.1138174368,-0.910539495,-11.38174368
5,117,2008,98,94,-137,140,0,4,-137,-147,8580,11.32489744,10.862656728,-15.83174438,-14,0,0.4622407119,-15.83174438
5,119,2001,5733,3335,-1787,8214,469,2398,-1318,1142,363023,15.817266838,9.2012183682,-4.930308013,62,1.2939644422,6.6160484699,-3.636343571
5,119,2002,5607,3233,-863,8321,235,2374,-628,1744,364767,15.408290853,8.8844309485,-2.371563226,-2,0.6457906814,6.5238599046,-1.725772544
5,119,2003,5753,3254,-797,8250,-182,2499,-979,1386,366153,15.741804849,8.9038472063,-2.180813222,-134,-0.498002517,6.8379576424,-2.678815739
5,119,2004,5805,3502,-1755,8229,641,2303,-1114,1324,367477,15.825416082,9.5470468765,-4.784428118,135,1.7474748852,6.2783692052,-3.036953233
5,119,2005,5837,3304,-1156,8054,336,2533,-820,1744,369221,15.846384814,8.9697542276,-3.138328053,31,0.912178396,6.8766305868,-2.226149657
5,119,2006,5759,3330,-102,8278,531,2429,429,2936,372157,15.535934436,8.9832716914,-0.275163277,78,1.4324676481,6.5526627442,1.157304371
5,119,2007,6146,3225,-1451,8590,331,2921,-1120,1854,374011,16.473501946,8.6441659251,-3.889204576,53,0.8871996655,7.8293360208,-3.00200491
5,119,2008,6015,3183,-473,8590,380,2832,-93,2786,376797,16.02273817,8.4788654356,-1.259975919,47,1.0122428104,7.5438727344,-0.247733109
5,121,2001,199,225,49,311,17,-26,66,23,18186,10.949407136,12.379982943,2.6960851743,-17,0.935376489,-1.430575807,3.6314616633
5,121,2002,231,212,-77,311,15,19,-62,-60,18126,12.723066755,11.676580745,-4.241022252,-17,0.8261731659,1.0464860101,-3.414849086
5,121,2003,215,218,-111,311,12,-3,-99,-122,18004,11.901466925,12.067533905,-6.144478273,-20,0.6642679214,-0.16606698,-5.480210352
5,121,2004,213,206,201,311,13,7,214,203,18207,11.764380989,11.37775814,11.101598962,-18,0.7180138632,0.3866228494,11.819612825
5,121,2005,220,212,-131,311,13,8,-118,-127,18080,12.125554606,11.684625348,-7.220216606,-17,0.7165100449,0.4409292584,-6.503706562
5,121,2006,201,207,96,311,13,-6,109,94,18174,11.088431621,11.41942958,5.2959673415,-9,0.7171622442,-0.330997959,6.0131295857
5,121,2007,226,216,-138,311,13,10,-125,-108,18066,12.472406181,11.920529801,-7.61589404,7,0.7174392936,0.5518763797,-6.898454746
5,121,2008,217,190,28,311,12,27,40,68,18134,11.988950276,10.497237569,1.546961326,1,0.6629834254,1.4917127072,2.2099447514
5,123,2001,447,362,-518,2689,1,85,-517,-450,28834,15.382497677,12.457414226,-17.82580268,-18,0.0344127465,2.9250834509,-17.79138993
5,123,2002,478,333,-414,2688,1,145,-413,-286,28548,16.660276742,11.606427103,-14.42961207,-18,0.0348541354,5.0538496393,-14.39475794
5,123,2003,441,332,-167,2689,-1,109,-168,-89,28459,15.471784167,11.647692389,-5.858929605,-30,-0.035083411,3.8240917782,-5.894013016
5,123,2004,419,286,-618,2689,0,133,-618,-521,27938,14.858946398,10.14238346,-21.91605936,-36,0,4.7165629377,-21.91605936
5,123,2005,422,305,-578,2688,0,117,-578,-481,27457,15.236032133,11.011824172,-20.86830941,-20,0,4.224207961,-20.86830941
5,123,2006,426,286,-452,2689,0,140,-452,-322,27135,15.606682298,10.477725674,-16.55920281,-10,0,5.1289566237,-16.55920281
5,123,2007,398,309,-349,2689,0,89,-349,-258,26877,14.737465748,11.4419018,-12.92305414,2,0,3.2955639488,-12.92305414
5,123,2008,382,287,-651,2689,-1,95,-652,-541,26336,14.35739387,10.786837803,-24.46770526,16,-0.037584801,3.5705560671,-24.50529006
5,125,2001,927,758,701,1750,37,169,738,827,84767,10.989466946,8.985993468,8.310265727,-80,0.438630288,2.0034734777,8.748896015
5,125,2002,1013,714,730,1759,31,299,761,991,85758,11.880955872,8.3741386893,8.5617944583,-69,0.3635830523,3.5068171822,8.9253775106
5,125,2003,964,713,757,1751,15,251,772,958,86716,11.178496469,8.2679128448,8.7781346754,-65,0.1739392604,2.9105836242,8.9520739358
5,125,2004,1000,762,1550,1757,31,238,1581,1710,88426,11.419305478,8.7015107741,17.699923491,-109,0.3539984698,2.7177947037,18.05392196
5,125,2005,1018,758,1614,1759,25,260,1639,1821,90247,11.395118457,8.4847738606,18.066523761,-78,0.2798408265,2.910344596,18.346364588
5,125,2006,1078,822,2459,1767,31,256,2490,2695,92942,11.769265622,8.9743379788,26.846590134,-51,0.3384482693,2.794927643,27.185038403
5,125,2007,1214,796,2616,1764,24,418,2640,3104,96046,12.847376553,8.4238152687,27.684297416,46,0.25398438,4.4235612843,27.938281796
5,125,2008,1220,803,1672,1764,24,417,1696,2163,98209,12.560809246,8.2674834625,17.214486114,50,0.2470978868,4.2933257831,17.461584
5,127,2001,153,130,-67,114,34,23,-33,-21,10966,13.938869403,11.843483806,-6.103949346,-11,3.097526534,2.0953855965,-3.006422812
5,127,2002,125,118,-56,115,32,7,-24,-27,10939,11.412919425,10.773795937,-5.112987902,-10,2.9217073727,0.6391234878,-2.19128053
5,127,2003,152,122,-46,123,25,30,-21,-4,10935,13.897778184,11.154795648,-4.205906556,-13,2.2858187803,2.7429825363,-1.920087775
5,127,2004,135,130,-95,125,27,5,-68,-73,10862,12.387025737,11.928247006,-8.716795889,-10,2.4774051475,0.458778731,-6.239390742
5,127,2005,144,135,62,121,25,9,87,85,10947,13.205557339,12.380210005,5.6857260764,-11,2.2926314824,0.8253473337,7.9783575588
5,127,2006,141,112,180,118,26,29,206,230,11177,12.746338818,10.124751401,16.271921895,-5,2.3503887181,2.6215874164,18.622310613
5,127,2007,155,126,34,121,20,29,54,86,11263,13.814616756,11.229946524,3.0303030303,3,1.7825311943,2.5846702317,4.8128342246
5,127,2008,149,122,-69,121,20,27,-49,-15,11248,13.237972547,10.839145307,-6.13033628,7,1.7769090667,2.39882724,-4.353427213
5,129,2001,89,103,-36,52,1,-14,-35,-57,8216,10.795075505,12.49317727,-4.366547395,-8,0.1212929832,-1.698101765,-4.245254412
5,129,2002,86,110,-76,52,1,-24,-75,-106,8110,10.535342399,13.475437952,-9.310302585,-7,0.1225039814,-2.940095553,-9.187798603
5,129,2003,74,100,-167,52,1,-26,-166,-194,7916,9.2349931362,12.479720454,-20.84113316,-2,0.1247972045,-3.244727318,-20.71633595
5,129,2004,83,97,42,52,0,-14,42,20,7936,10.471864749,12.238203381,5.299015897,-8,0,-1.766338632,5.299015897
5,129,2005,83,103,51,52,1,-20,52,26,7962,10.441564977,12.95760473,6.4159013712,-6,0.1258019877,-2.516039753,6.5417033589
5,129,2006,91,96,91,52,0,-5,91,81,8043,11.371446423,11.996251172,11.371446423,-5,0,-0.624804749,11.371446423
5,129,2007,96,99,33,52,1,-3,34,28,8071,11.915104878,12.287451905,4.0958173017,-3,0.1241156758,-0.372347027,4.2199329775
5,129,2008,93,100,-14,52,0,-7,-14,-23,8048,11.539177368,12.4077176,-1.737080464,-2,0,-0.868540232,-1.737080464
5,131,2001,1804,1136,-259,2324,435,668,176,734,116247,15.567828788,9.8032447359,-2.235070763,-110,3.7538833276,5.7645840525,1.5188125647
5,131,2002,1846,1137,-470,2324,397,709,-73,528,116775,15.843997562,9.7587352267,-4.033953876,-108,3.4074035928,6.0852623357,-0.626550283
5,131,2003,1832,1092,-631,2324,325,740,-306,301,117076,15.668096352,9.3392801399,-5.396598689,-133,2.7795476607,6.328816212,-2.617051028
5,131,2004,1810,1170,-650,2324,349,640,-301,245,117321,15.443883667,9.9830629232,-5.546146068,-94,2.9778538121,5.4608207443,-2.568292256
5,131,2005,1866,1129,67,2324,348,737,415,1037,118358,15.835097739,9.5808281603,0.5685699617,-115,2.9531693532,6.2542695785,3.5217393149
5,131,2006,1880,1105,589,2324,358,775,947,1661,120019,15.773333837,9.2710286647,4.9417519308,-61,3.0036454859,6.5023051721,7.9453974167
5,131,2007,1961,1028,119,2324,314,933,433,1367,121386,16.246556616,8.516807854,0.9858950726,1,2.6014374184,7.7297487625,3.587332491
5,131,2008,1981,1042,-403,2324,317,939,-86,888,122274,16.260362801,8.5529015842,-3.307888041,35,2.6019863745,7.7074612164,-0.705901666
5,133,2001,263,173,-384,169,124,90,-260,-180,15566,16.798671436,11.050076648,-24.52733776,-10,7.9202861523,5.7485947879,-16.60705161
5,133,2002,292,136,-172,169,120,156,-52,94,15660,18.702363415,8.7106898098,-11.01646064,-10,7.6859027733,9.9916736053,-3.330557868
5,133,2003,296,150,-153,169,107,146,-46,87,15747,18.849301111,9.5520106983,-9.743050912,-13,6.8137676314,9.297290413,-2.929283281
5,133,2004,284,157,-24,169,99,127,75,192,15939,17.925897873,9.909739317,-1.514864609,-10,6.248816512,8.0161585558,4.733951903
5,133,2005,280,176,32,169,101,104,133,221,16160,17.446026356,10.966073709,1.9938315835,-16,6.2930309355,6.4799526465,8.2868625191
5,133,2006,306,165,-241,169,102,141,-139,-6,16154,18.939159497,10.212291886,-14.91613542,-8,6.3130531658,8.7268676116,-8.603082255
5,133,2007,313,152,-155,169,90,161,-65,100,16254,19.316218218,9.3803999013,-9.565539373,4,5.5541841521,9.9358183165,-4.011355221
5,133,2008,308,133,1,169,90,175,91,265,16519,18.795960089,8.1164373112,0.0610258444,-1,5.4923260001,10.679522778,5.5533518445
5,135,2001,181,264,235,226,2,-83,237,140,17291,10.51042332,15.330120202,13.646129725,-14,0.1161372743,-4.819696882,13.762267
5,135,2002,174,258,156,226,2,-84,158,64,17355,10.044449576,14.893494198,9.0053685851,-10,0.1154534434,-4.849044623,9.1208220285
5,135,2003,171,235,198,226,0,-64,198,127,17482,9.8171484341,13.491402819,11.367224503,-7,0,-3.674254385,11.367224503
5,135,2004,175,249,91,226,1,-74,92,1,17483,10.01001001,14.242814243,5.2052052052,-17,0.0572000572,-4.232804233,5.2624052624
5,135,2005,186,251,143,226,1,-65,144,63,17546,10.619772189,14.3309829,8.1646635645,-16,0.0570955494,-3.711210711,8.2217591139
5,135,2006,190,252,376,226,1,-62,377,306,17852,10.735069778,14.238092548,21.244138087,-9,0.0565003673,-3.50302277,21.300638454
5,135,2007,204,238,-18,226,1,-34,-17,-42,17810,11.440749257,13.3475408,-1.009477876,9,0.0560821042,-1.906791543,-0.953395771
5,135,2008,194,241,85,226,0,-47,85,56,17866,10.875658706,13.510483238,4.765108196,18,0,-2.634824532,4.765108196
5,137,2001,129,145,-46,141,2,-16,-44,-71,11451,11.230575023,12.623514561,-4.004701171,-11,0.1741174422,-1.392939538,-3.830583729
5,137,2002,106,130,111,141,1,-24,112,80,11531,9.2246105648,11.313201636,9.6597337046,-8,0.087024628,-2.088591071,9.7467583326
5,137,2003,124,142,82,141,0,-18,82,53,11584,10.728963876,12.286394116,7.0949599827,-11,0,-1.55743024,7.0949599827
5,137,2004,120,149,44,141,1,-29,45,6,11590,10.356433935,12.859238802,3.7973591093,-10,0.0863036161,-2.502804868,3.8836627255
5,137,2005,109,146,141,141,1,-37,142,94,11684,9.3666752599,12.54618888,12.116524878,-11,0.0859328005,-3.17951362,12.202457678
5,137,2006,138,141,259,141,1,-3,260,251,11935,11.68550743,11.939540201,21.93149583,-6,0.0846775901,-0.25403277,22.01617342
5,137,2007,116,143,23,141,1,-27,24,4,11939,9.7176845103,11.979559353,1.9267822736,7,0.0837731423,-2.261874843,2.0105554159
5,137,2008,135,144,154,141,0,-9,154,151,12090,11.236422656,11.9855175,12.817845104,6,0,-0.749094844,12.817845104
5,139,2001,581,617,-485,983,34,-36,-451,-525,45050,12.822068966,13.616551724,-10.70344828,-38,0.7503448276,-0.794482759,-9.953103448
5,139,2002,594,571,-34,983,32,23,-2,-24,45026,13.188862738,12.678182868,-0.754918069,-45,0.7105111239,0.5106798703,-0.044406945
5,139,2003,607,562,-449,983,23,45,-426,-421,44605,13.544421015,12.540304136,-10.01885508,-40,0.5132152938,1.0041168792,-9.50563979
5,139,2004,571,550,-454,983,28,21,-426,-446,44159,12.865576134,12.392411338,-10.22937227,-41,0.6308863954,0.4731647965,-9.598485873
5,139,2005,563,576,-519,983,25,-13,-494,-545,43614,12.828546364,13.124765019,-11.82596015,-38,0.5696512595,-0.296218655,-11.25630889
5,139,2006,582,548,-154,983,28,34,-126,-112,43502,13.361495018,12.580926581,-3.535515864,-20,0.6428210662,0.7805684375,-2.892694798
5,139,2007,635,571,-448,983,26,64,-422,-337,43165,14.653789793,13.176872397,-10.33842178,21,0.5999976923,1.4769173965,-9.738424083
5,139,2008,576,535,-34,983,26,41,-8,48,43213,13.33672926,12.387413462,-0.787237491,15,0.6020051402,0.949315798,-0.185232351
5,141,2001,151,240,113,276,3,-89,116,14,16225,9.310642496,14.798372179,6.967566901,-13,0.1849796522,-5.487729683,7.1525465532
5,141,2002,192,232,-58,276,3,-40,-55,-113,16112,11.874942017,14.34888827,-3.587222068,-18,0.185545969,-2.473946254,-3.401676099
5,141,2003,179,207,106,276,2,-28,108,68,16180,11.086337173,12.820512821,6.5650935216,-12,0.1238696891,-1.734175647,6.6889632107
5,141,2004,171,222,116,276,3,-51,119,51,16231,10.551973096,13.699052791,7.1580636204,-17,0.185122335,-3.147079695,7.3431859554
5,141,2005,177,205,126,276,3,-28,129,88,16319,10.875576037,12.596006144,7.7419354839,-13,0.1843317972,-1.720430108,7.9262672811
5,141,2006,169,251,152,276,3,-82,155,64,16383,10.335759281,15.350743074,9.2960675188,-9,0.1834750168,-5.014983793,9.4795425356
5,141,2007,178,211,117,276,2,-33,119,86,16469,10.836478753,12.845488859,7.1228540119,0,0.1217581882,-2.009010106,7.2446122002
5,141,2008,190,219,135,276,1,-29,136,106,16575,11.499818424,13.255053868,8.170923617,-1,0.0605253601,-1.755235444,8.2314489771
5,143,2001,2596,1175,1932,6044,920,1421,2852,4366,163154,16.127128489,7.299451454,12.00216188,93,5.715315181,8.827677035,17.717477061
5,143,2002,2727,1208,1234,6182,862,1519,2096,3673,166827,16.528224352,7.3216336698,7.4792185005,58,5.2245432313,9.2065906825,12.703761732
5,143,2003,2857,1171,1914,6234,769,1686,2683,4465,171292,16.899375664,6.9265554435,11.32145783,96,4.5486943946,9.9728202201,15.870152225
5,143,2004,2974,1288,3008,6622,693,1686,3701,5441,176733,17.090726241,7.4017671144,17.286114503,54,3.9824725235,9.6889591265,21.268587027
5,143,2005,3141,1263,4201,6685,724,1878,4925,6911,183644,17.431745089,7.0093263444,23.314473454,108,4.0180144682,10.422418745,27.332487922
5,143,2006,3395,1211,3175,6689,722,2184,3897,6176,189820,18.181136602,6.4852301694,17.002977529,95,3.8665038665,11.695906433,20.869481396
5,143,2007,3535,1201,1020,6933,662,2334,1682,3992,193812,18.429119573,6.2612086583,5.3175960295,-24,3.4512240898,12.167910915,8.7688201193
5,143,2008,3498,1186,-1012,6933,662,2312,-350,1991,195803,17.956187518,6.0880612913,-5.194871861,29,3.3982264543,11.868126227,-1.796645406
5,145,2001,904,737,750,3755,54,167,804,921,68325,13.320661023,10.859875192,11.051433371,-50,0.7957032027,2.4607858306,11.847136574
5,145,2002,882,711,366,3720,47,171,413,518,68843,12.860142307,10.366849411,5.3365216377,-66,0.68529103,2.4932928963,6.0218126677
5,145,2003,920,707,387,3713,27,213,414,546,69389,13.310955495,10.229179929,5.5992823659,-81,0.3906476069,3.0817755657,5.9899299728
5,145,2004,898,749,864,3627,48,149,912,991,70380,12.849773555,10.717684179,12.363256516,-70,0.6868475842,2.132089376,13.0501041
5,145,2005,937,709,742,3716,40,228,782,951,71331,13.22409693,10.006280388,10.472016992,-59,0.5645292179,3.2178165421,11.03654621
5,145,2006,1033,685,865,3695,46,348,911,1219,72550,14.359088413,9.5217575635,12.023825244,-40,0.6394172962,4.8373308498,12.663242541
5,145,2007,1049,702,582,3832,38,347,620,957,73507,14.364255051,9.6126854584,7.969491363,-10,0.5203447969,4.7515695927,8.4898361599
5,145,2008,1043,702,948,3832,39,341,987,1338,74845,14.061151855,9.4639775669,12.78041415,10,0.5257765315,4.5971742882,13.306190682
5,147,2001,98,159,59,142,1,-61,60,-9,8681,11.283173105,18.30637269,6.7929307466,-8,0.1151344194,-7.023199586,6.9080651661
5,147,2002,126,145,-211,142,1,-19,-210,-232,8449,14.711033275,16.929363689,-24.63514302,-3,0.1167542323,-2.218330414,-24.51838879
5,147,2003,79,122,-125,142,-1,-43,-126,-171,8278,9.4458061816,14.587194356,-14.94589586,-2,-0.119567167,-5.141388175,-15.06546302
5,147,2004,104,125,-154,142,0,-21,-154,-185,8093,12.705393684,15.27090587,-18.81375603,-10,0,-2.565512186,-18.81375603
5,147,2005,108,113,-78,142,0,-5,-78,-88,8005,13.417815878,14.039011057,-9.690644801,-5,0,-0.62119518,-9.690644801
5,147,2006,89,110,-145,142,0,-21,-145,-169,7836,11.236664352,13.88801212,-18.30692507,-3,0,-2.651347768,-18.30692507
5,147,2007,111,92,-227,142,0,19,-227,-205,7631,14.353138941,11.896295338,-29.35281567,3,0,2.4568436025,-29.35281567
5,147,2008,87,98,-183,142,-1,-11,-184,-192,7439,11.546118115,13.00597213,-24.28666224,3,-0.132714001,-1.459854015,-24.41937624
5,149,2001,358,253,-209,433,140,105,-69,20,21173,16.916316212,11.95482682,-9.875726504,-16,6.6153191892,4.9614893919,-3.260407315
5,149,2002,355,247,-209,433,132,108,-77,17,21190,16.759908411,11.661119373,-9.867101008,-14,6.2318532682,5.0987890376,-3.63524774
5,149,2003,299,239,-111,433,112,60,1,34,21224,14.099118216,11.269863724,-5.234120809,-27,5.2812750507,2.8292544914,0.0471542415
5,149,2004,329,249,-287,433,100,80,-187,-130,21094,15.548938986,11.768041968,-13.56396805,-23,4.7261212723,3.7808970178,-8.837846779
5,149,2005,316,270,-83,433,106,46,23,52,21146,14.962121212,12.784090909,-3.929924242,-17,5.0189393939,2.178030303,1.0890151515
5,149,2006,361,250,228,433,107,111,335,435,21581,16.8979802,11.702202354,10.672408547,-11,5.0085426077,5.1957778454,15.680951155
5,149,2007,370,210,-140,433,88,160,-52,116,21697,17.098756874,9.7046998475,-6.469799898,8,4.0667313647,7.3940570267,-2.403068534
5,149,2008,356,227,51,433,87,129,138,279,21976,16.302978957,10.395438829,2.3355391203,12,3.9841549699,5.9075401278,6.3196940902
6,0,2001,530883,233502,-38896,828585,270179,297381,231283,508263,34507030,15.498921938,6.8169997351,-1.135553536,-20401,7.887770432,8.6819222029,6.7522168963
6,0,2002,527308,234546,-114576,833096,248044,292762,133468,409465,34916495,15.191046551,6.7569602667,-3.300783128,-16765,7.1458198068,8.4340862842,3.8450366788
6,0,2003,538297,234607,-96329,845531,201624,303690,105295,390903,35307398,15.330878908,6.6816859612,-2.743482193,-18082,5.7423190708,8.6491929463,2.9988368774
6,0,2004,540567,239869,-161077,837749,213821,300698,52744,322268,35629666,15.24074918,6.762867998,-4.541405886,-31174,6.0284705327,8.4778811821,1.4870646465
6,0,2005,548149,231799,-250028,845235,214620,316350,-35408,255749,35885415,15.329605793,6.4825207987,-6.992315369,-25193,6.0020906639,8.8470849946,-0.990224705
6,0,2006,554497,239859,-285494,857836,217830,314638,-67664,235881,36121296,15.401258919,6.6621290341,-7.929649779,-11093,6.0502693978,8.7391298847,-1.879380382
6,0,2007,563029,239619,-268809,861747,192498,323410,-76311,256238,36377534,15.532085138,6.6102859867,-7.415540361,9139,5.3103753536,8.9217991518,-2.105165007
6,0,2008,567139,242053,-144061,866188,196330,325086,52269,379132,36756666,15.509542731,6.6194201892,-3.939634261,1777,5.369033913,8.8901225418,1.4293996516
6,1,2001,22328,10100,-6524,27468,14978,12228,8454,19260,1469656,15.292878346,6.9176850275,-4.468413576,-1422,10.25872142,8.3751933185,5.7903078438
6,1,2002,21874,9567,-33713,27647,14100,12307,-19613,-7776,1461880,14.923234782,6.526953788,-23.00022923,-470,9.6195305123,8.396280994,-13.38069872
6,1,2003,21818,9697,-33518,27450,12301,12121,-21217,-8957,1452923,14.970479995,6.6536229035,-22.99846679,139,8.4403645804,8.3168570912,-14.55810221
6,1,2004,21287,9427,-29929,27414,11310,11860,-18619,-8561,1444362,14.694446698,6.5074716502,-20.66003172,-1802,7.8073092568,8.1869750473,-12.85272246
6,1,2005,20767,9435,-26628,27344,11866,11332,-14762,-4619,1439743,14.401001351,6.5427576319,-18.46534714,-1189,8.228549238,7.8582437186,-10.2367979
6,1,2006,21022,9338,-19133,28284,11833,11684,-7300,3749,1443492,14.582231417,6.4774463407,-13.27189771,-635,8.2081412025,8.1047850765,-5.06375651
6,1,2007,20835,9404,-12103,28774,10755,11431,-1348,10154,1453646,14.383160208,6.4919240989,-8.355142213,71,7.4245686605,7.8912361096,-0.930573552
6,1,2008,20656,9602,-1122,28746,10791,11054,9669,20722,1474368,14.109222155,6.5587118094,-0.766389778,-1,7.3708663961,7.5505103459,6.6044766179
6,3,2001,9,3,-37,1,2,6,-35,-29,1176,7.559848803,2.519949601,-31.07937841,0,1.6799664007,5.039899202,-29.39941201
6,3,2002,13,8,17,1,2,5,19,21,1197,10.956595027,6.7425200169,14.327855036,-3,1.6856300042,4.2140750105,16.01348504
6,3,2003,10,12,-22,1,1,-2,-21,-23,1174,8.4352593842,10.122311261,-18.55757065,0,0.8435259384,-1.687051877,-17.71404471
6,3,2004,13,9,9,1,0,4,9,11,1185,11.02161933,7.630351844,7.630351844,-2,0,3.3912674862,7.630351844
6,3,2005,10,8,-63,1,1,2,-62,-60,1125,8.658008658,6.9264069264,-54.54545455,0,0.8658008658,1.7316017316,-53.67965368
6,3,2006,12,5,29,1,0,7,29,35,1160,10.503282276,4.3763676149,25.382932166,-1,0,6.1269146608,25.382932166
6,3,2007,15,1,-31,1,1,14,-30,-20,1140,13.043478261,0.8695652174,-26.95652174,-4,0.8695652174,12.173913043,-26.08695652
6,3,2008,18,2,-91,1,0,16,-91,-79,1061,16.356201726,1.8173557474,-82.68968651,-4,0,14.538845979,-82.68968651
6,5,2001,235,403,688,4580,17,-168,705,521,35696,6.6317675777,11.372775889,19.415557845,-16,0.4797448886,-4.741008311,19.895302733
6,5,2002,270,374,896,4612,17,-104,913,803,36499,7.4797423644,10.360828312,24.82166355,-6,0.4709467415,-2.881085948,25.292610292
6,5,2003,302,379,437,4499,15,-77,452,357,36856,8.2339308841,10.333310613,11.914661577,-18,0.408970077,-2.099379729,12.323631654
6,5,2004,262,422,547,4511,14,-160,561,358,37214,7.0743890914,11.394626704,14.76981234,-43,0.3780207911,-4.320237613,15.147833131
6,5,2005,271,350,682,4531,15,-79,697,581,37795,7.2257995707,9.3322134677,18.184484529,-37,0.3999520058,-2.106413897,18.584436534
6,5,2006,283,421,524,4505,14,-138,538,381,38176,7.4502112648,11.083176475,13.794737466,-19,0.368561688,-3.63296521,14.163299154
6,5,2007,301,418,528,4658,13,-117,541,438,38614,7.839562443,10.886834223,13.751790598,14,0.3385857534,-3.04727178,14.090376351
6,5,2008,330,405,-347,4240,12,-75,-335,-376,38238,8.5879352522,10.539738719,-9.030344038,34,0.3122885546,-1.951803466,-8.718055483
6,7,2001,2277,2219,2087,6174,479,58,2566,2459,206366,11.099926147,10.81718758,10.1737136,-165,2.3350305772,0.2827385668,12.508744178
6,7,2002,2277,2286,2618,6191,435,-9,3053,2933,209299,10.955938075,10.999242178,12.596682425,-111,2.0930316481,-0.043304103,14.689714073
6,7,2003,2322,2178,1958,6195,361,144,2319,2285,211584,11.033945301,10.349669623,9.3042484491,-178,1.7154411083,0.6842756776,11.019689557
6,7,2004,2401,2164,1177,6197,367,237,1544,1609,213193,11.304755201,10.188875575,5.5417313084,-172,1.7279654972,1.1158796263,7.2696968056
6,7,2005,2363,2195,1330,6248,374,168,1704,1680,214873,11.04035359,10.255427901,6.2139950381,-192,1.7473940934,0.784925689,7.9613891316
6,7,2006,2571,2297,1711,6336,384,274,2095,2258,217131,11.902667568,10.634160795,7.9212229516,-111,1.777761317,1.2685067731,9.6989842687
6,7,2007,2668,2182,233,6380,349,486,582,1054,218185,12.257762177,10.024901451,1.0704867269,-14,1.6034329085,2.2328607265,2.6739196354
6,7,2008,2752,2134,1126,6411,355,618,1481,2152,220337,12.551251705,9.7326930006,5.1354322018,53,1.6190749837,2.818558704,6.7545071855
6,9,2001,307,376,815,431,15,-69,830,737,41435,7.4756796903,9.1558813145,19.845859764,-24,0.3652612227,-1.680201624,20.211120987
6,9,2002,328,416,1225,432,15,-88,1240,1152,42587,7.8074789936,9.9021684797,29.159029778,0,0.3570493442,-2.094689486,29.516079122
6,9,2003,358,393,1400,429,12,-35,1412,1426,44013,8.2678983834,9.0762124711,32.33256351,49,0.2771362587,-0.808314088,32.609699769
6,9,2004,303,432,1037,423,13,-129,1050,854,44867,6.8181818182,9.7209720972,23.334833483,-67,0.2925292529,-2.902790279,23.627362736
6,9,2005,342,385,903,427,14,-43,917,843,45710,7.5515859435,8.5010543515,19.93883657,-31,0.3091292491,-0.949468408,20.247965819
6,9,2006,398,430,856,430,14,-32,870,814,46524,8.6302231281,9.3241104148,18.561484919,-24,0.3035756879,-0.693887287,18.865060607
6,9,2007,391,421,275,431,10,-30,285,224,46748,8.3840809675,9.0273608371,5.8967321383,-31,0.2144266232,-0.64327987,6.1111587615
6,9,2008,409,393,133,427,12,16,145,95,46843,8.740156639,8.3982434208,2.8421536259,-66,0.2564349136,0.3419132182,3.0985885395
6,11,2001,360,161,-162,443,205,199,43,226,19042,19.018437318,8.5054678007,-8.558296793,-16,10.829943473,10.512969518,2.2716466797
6,11,2002,320,133,-125,447,196,187,71,240,19282,16.699718192,6.9408203737,-6.523327419,-18,10.228577393,9.7588978186,3.7052499739
6,11,2003,332,135,-20,420,167,197,147,318,19600,17.077310838,6.9440872383,-1.028753665,-26,8.5900931022,10.1332236,7.5613394373
6,11,2004,334,143,330,420,150,191,480,654,20254,16.761178301,7.1761931048,16.560445627,-17,7.5274752848,9.584985196,24.087920911
6,11,2005,356,141,-22,420,163,215,141,341,20595,17.430047247,6.9034737692,-1.077137751,-15,7.9806115205,10.526573478,6.9034737692
6,11,2006,384,139,-10,420,160,245,150,382,20977,18.473972866,6.6871933032,-0.481093043,-13,7.6974886943,11.786779563,7.2163956509
6,11,2007,401,132,-224,420,142,269,-82,171,21148,19.038575668,6.2670623145,-10.63501484,-16,6.7418397626,12.771513353,-3.893175074
6,11,2008,400,127,-334,420,141,273,-193,56,21204,18.889308651,5.9973554968,-15.77257272,-24,6.6584812996,12.891953155,-9.114091424
6,13,2001,13231,6784,7319,11324,5714,6447,13033,18712,972016,13.744208755,7.0471402157,7.6028919868,-768,5.9356366734,6.6970685393,13.53852866
6,13,2002,13304,7162,-1169,11307,5364,6142,4195,9404,981420,13.621127081,7.3327203963,-1.196865421,-933,5.4918615199,6.2884066844,4.2949960992
6,13,2003,13254,6896,-1889,11281,4666,6358,2777,7751,989171,13.451802023,6.9989155538,-1.91719134,-1384,4.735635147,6.4528864691,2.818443807
6,13,2004,13209,6901,-4183,11301,4307,6308,124,5673,994844,13.315423523,6.9566006305,-4.216701991,-759,4.3417010456,6.358822892,0.1249990549
6,13,2005,13245,6747,-2850,11301,4530,6498,1680,7207,1002051,13.265594836,6.7574910048,-2.854431505,-971,4.5370437604,6.5081038312,1.6826122555
6,13,2006,13360,6955,-6811,11301,4507,6405,-2304,3648,1005699,13.308429834,6.9281534056,-6.784709252,-453,4.4896027892,6.3802764288,-2.295106462
6,13,2007,13411,6959,-1638,11309,4082,6452,2444,8988,1014687,13.275680984,6.8887826386,-1.621472333,92,4.0408120033,6.3868983452,2.4193396707
6,13,2008,13403,7062,4290,11309,4099,6341,8389,15016,1029703,13.111979613,6.9086622415,4.1968508944,286,4.0099980923,6.203317371,8.2068489867
6,15,2001,280,299,-150,3811,66,-19,-84,-127,27344,10.216181702,10.909422603,-5.472954483,-24,2.4080999726,-0.693240901,-3.064854511
6,15,2002,309,246,53,3744,61,63,114,148,27492,11.269968634,8.9722080385,1.9330366912,-29,2.2248158144,2.2977605952,4.1578525057
6,15,2003,291,253,187,3821,46,38,233,244,27736,10.538132831,9.1620192656,6.7719272833,-27,1.6658216847,1.3761135656,8.4377489679
6,15,2004,299,291,340,3745,51,8,391,371,28107,10.708593736,10.422076178,12.176996222,-28,1.8265494332,0.2865175582,14.003545655
6,15,2005,302,251,318,3916,51,51,369,397,28504,10.669304552,8.8675345781,11.23456572,-23,1.801769974,1.801769974,13.036335694
6,15,2006,341,294,-12,3946,53,47,41,73,28577,11.947933638,10.301150996,-0.420455143,-15,1.8570102136,1.6467826422,1.4365550709
6,15,2007,353,272,240,4013,46,81,286,356,28933,12.276125891,9.4592244827,8.3463745436,-11,1.5997217875,2.8169014085,9.9460963311
6,15,2008,349,276,55,3921,48,73,103,167,29100,12.027639447,9.5118294763,1.8954732652,-9,1.6542312133,2.5158099702,3.5497044785
6,17,2001,1688,1148,2907,1053,321,540,3228,3686,160814,10.61828887,7.2214429047,18.286354115,-82,2.0192362129,3.3968459656,20.305590328
6,17,2002,1735,1186,3019,1053,300,549,3319,3805,164619,10.662717057,7.2887506799,18.553742245,-63,1.8436974738,3.3739663771,20.397439719
6,17,2003,1788,1182,1953,1053,267,606,2220,2752,167371,10.771408777,7.1206964065,11.765414621,-74,1.6084821832,3.6507123709,13.373896804
6,17,2004,1841,1259,2400,1054,248,582,2648,3038,170409,10.90058618,7.45455622,14.210432826,-192,1.468411392,3.4460299603,15.678844218
6,17,2005,1874,1256,2233,1051,259,618,2492,3001,173410,10.901084582,7.3061698161,12.989392675,-109,1.5066066739,3.5949147662,14.495999348
6,17,2006,2025,1266,538,1050,259,759,797,1461,174871,11.628541322,7.2699917595,3.0894593733,-95,1.4873047912,4.358549562,4.5767641646
6,17,2007,2032,1203,-546,1054,232,829,-314,328,175199,11.60910675,6.8729111321,-3.119376125,-187,1.3254491959,4.736195618,-1.793926929
6,17,2008,2100,1161,-39,1051,235,939,196,876,176075,11.956478419,6.6102244971,-0.222048885,-259,1.3379868706,5.3462539214,1.1159379857
6,19,2001,14226,5478,-1734,17959,5117,8748,3383,11353,813476,17.610805652,6.7813857275,-2.146572262,-778,6.3344926557,10.829419924,4.1879203936
6,19,2002,14453,5765,3470,18002,4824,8688,8294,16253,829729,17.59123177,7.0167751437,4.2234535557,-729,5.8714524359,10.574456626,10.094905992
6,19,2003,15176,5664,3757,17981,4228,9512,7985,16481,846210,18.110444354,6.7591958896,4.4834567368,-1016,5.0455297001,11.351248464,9.5289864369
6,19,2004,15596,6013,657,18546,3844,9583,4501,13519,859729,18.28435835,7.0494900462,0.7702502844,-565,4.5066089702,11.234868304,5.2768592546
6,19,2005,15993,5837,-2473,18636,4041,10156,1568,10891,870620,18.485288228,6.7466158561,-2.858382904,-833,4.6707340542,11.738672372,1.81235115
6,19,2006,16413,6026,-2426,18579,4028,10387,1602,11551,882171,18.727846047,6.8758910789,-2.768156614,-438,4.596098451,11.851954968,1.8279418368
6,19,2007,16977,6101,-2048,19175,3668,10876,1620,12577,894748,19.10835553,6.8669421622,-2.305113514,81,4.1284943208,12.241413368,1.8233808069
6,19,2008,17406,6052,-883,19638,3676,11354,2793,14405,909153,19.298176563,6.7099025944,-0.978989423,258,4.0756116882,12.588273968,3.0966222647
6,21,2001,401,230,-234,369,131,171,-103,46,26495,15.148080991,8.6884255062,-8.839528558,-22,4.9486249622,6.459655485,-3.890903596
6,21,2002,405,244,-31,382,122,161,91,226,26721,15.22098617,9.1701743836,-1.165063139,-26,4.5850871918,6.0508117859,3.4200240529
6,21,2003,419,213,98,389,107,206,205,377,27098,15.570709229,7.9154202048,3.6418365261,-34,3.976290901,7.6552890243,7.6181274271
6,21,2004,412,251,-111,396,100,161,-11,130,27228,15.167691345,9.2405109892,-4.086441115,-20,3.6814784818,5.9271803556,-0.404962633
6,21,2005,430,237,0,386,107,193,107,275,27503,15.713215545,8.6605397307,0,-25,3.9100327054,7.0526758144,3.9100327054
6,21,2006,442,243,-31,381,106,199,75,260,27763,15.995367857,8.79383346,-1.121847067,-14,3.8359931965,7.2015343973,2.7141461296
6,21,2007,458,237,-114,394,92,221,-22,196,27959,16.438749506,8.5065144826,-4.091741144,-3,3.3021068878,7.9322350239,-0.789634256
6,21,2008,483,199,-92,380,94,284,2,278,28237,17.189835575,7.082354616,-3.274254395,-8,3.3454338387,10.107480959,0.0711794434
6,23,2001,1447,1265,395,4230,148,182,543,603,127003,11.420543561,9.9840964787,3.1175637226,-122,1.1680998252,1.4364470823,4.2856635478
6,23,2002,1464,1238,540,4248,135,226,675,781,127784,11.491952101,9.717921244,4.2388347914,-120,1.0597086979,1.7740308571,5.2985434893
6,23,2003,1442,1243,321,4354,100,199,421,440,128224,11.26527296,9.7106340427,2.5077341333,-180,0.7812255867,1.5546389175,3.28895972
6,23,2004,1476,1267,240,4403,116,209,356,479,128703,11.489644919,9.862723653,1.8682349461,-86,0.902980224,1.6269212656,2.7712151701
6,23,2005,1570,1230,-80,4367,116,340,36,260,128963,12.186318723,9.5472433305,-0.620958916,-116,0.9003904279,2.6390753922,0.2794315121
6,23,2006,1603,1172,-378,4343,120,431,-258,114,129077,12.424430321,9.083862967,-2.929778329,-59,0.9300883584,3.3405673539,-1.999689971
6,23,2007,1654,1212,-1035,4389,98,442,-937,-463,128614,12.837080069,9.4066148992,-8.032876585,32,0.7606008747,3.4304651695,-7.27227571
6,23,2008,1665,1153,-301,4394,102,512,-199,386,129000,12.926316116,8.9513768662,-2.33682952,73,0.7918824287,3.9749392502,-1.544947091
6,25,2001,2583,875,-2018,11066,1171,1708,-847,766,143177,18.088995336,6.1277084471,-14.13224645,-95,8.2006246761,11.961286889,-5.931621777
6,25,2002,2584,893,-1229,10868,1094,1691,-135,1452,144629,17.956540169,6.2055690291,-8.540475181,-104,7.6023432451,11.75097114,-0.938131936
6,25,2003,2814,926,117,11123,940,1888,1057,2730,147359,19.274764716,6.3427264134,0.8014027974,-215,6.4386207652,12.932038303,7.2400235626
6,25,2004,2923,923,-98,11414,916,2000,818,2719,150078,19.654582315,6.206356304,-0.658963075,-99,6.159287513,13.448226011,5.5003244385
6,25,2005,3021,894,292,11769,935,2127,1227,3207,153285,19.916733418,5.8939290553,1.9250864476,-147,6.1642322894,14.022804363,8.089318737
6,25,2006,2986,956,832,11847,936,2030,1768,3714,156999,19.2468835,6.1620966598,5.3628288922,-84,6.0331825038,13.08478684,11.396011396
6,25,2007,3291,954,657,12031,843,2337,1500,3831,160830,20.709249313,6.003228151,4.1342986323,-6,5.304739341,14.706021162,9.4390379732
6,25,2008,3488,1002,-210,11737,852,2486,642,3142,163972,21.47770026,6.1699127468,-1.293095486,14,5.2462731141,15.307787514,3.9531776282
6,27,2001,171,216,45,157,43,-45,88,26,17942,9.5376206146,12.047520776,2.5099001617,-17,2.3983490434,-2.509900162,4.9082492052
6,27,2002,187,200,123,157,42,-13,165,139,18081,10.382255781,11.104016878,6.82897038,-13,2.3318435444,-0.721761097,9.1608139244
6,27,2003,187,242,87,159,26,-55,113,39,18120,10.33120632,13.369796414,4.8064970581,-19,1.4364244082,-3.038590094,6.2429214663
6,27,2004,209,241,-136,157,24,-32,-112,-159,17961,11.58504476,13.358831518,-7.53859372,-15,1.3303400682,-1.773786758,-6.208253652
6,27,2005,211,201,-276,158,25,10,-251,-244,17717,11.828017266,11.267447727,-15.47171927,-3,1.4014238466,0.5605695387,-14.07029542
6,27,2006,218,215,-200,157,24,3,-176,-183,17534,12.368443448,12.198235511,-11.34719582,-10,1.3616634989,0.1702079374,-9.985532325
6,27,2007,248,194,-175,158,23,54,-152,-140,17394,14.200641319,11.108566193,-10.02061383,-42,1.3169949611,3.092075126,-8.703618873
6,27,2008,232,177,-275,157,22,55,-253,-258,17136,13.437590501,10.251954822,-15.9281784,-60,1.2742542716,3.1856356791,-14.65392412
6,29,2001,11719,4916,1411,30957,3165,6803,4576,10725,674235,17.52052895,7.3496817405,2.1095201253,-654,4.7318435128,10.170847209,6.8413636381
6,29,2002,11950,4979,6117,32005,2807,6971,8924,15382,689617,17.523895555,7.301378742,8.9701815153,-513,4.1162824119,10.222516813,13.086463927
6,29,2003,12537,5253,9063,32617,2085,7284,11148,18056,707673,17.944735882,7.5188400404,12.972253433,-376,2.9843482742,10.425895841,15.956601708
6,29,2004,13169,5452,9818,32337,2634,7717,12452,19395,727068,18.357320241,7.5999779751,13.686093866,-774,3.6717428442,10.757342266,17.357836711
6,29,2005,13709,5195,11370,32775,2517,8514,13887,21698,748766,18.577970151,7.0400871643,15.40823697,-703,3.4109527223,11.537882987,18.819189692
6,29,2006,14645,5509,10129,36333,2611,9136,12740,21455,770221,19.282587672,7.2535182987,13.336519667,-421,3.4378174402,12.029069373,16.774337108
6,29,2007,15296,5403,4727,37954,2236,9893,6963,16958,787179,19.642994735,6.9384872223,6.0703736998,102,2.8714524207,12.704507513,8.9418261205
6,29,2008,15820,5473,390,38264,2325,10347,2715,13279,800458,19.928988805,6.8945231183,0.4912961842,217,2.9288810981,13.034465687,3.4201772823
6,31,2001,2223,715,766,20842,566,1508,1332,2726,132502,16.951478965,5.4522300765,5.8411304036,-114,4.3160310815,11.499248889,10.157161485
6,31,2002,2203,714,540,20570,367,1489,907,2279,134781,16.48440043,5.342651796,4.0406610222,-117,2.746152954,11.141748633,6.7868139762
6,31,2003,2334,784,2614,21887,-63,1550,2551,4098,138879,17.057662793,5.7297376306,19.103997661,-3,-0.460425345,11.327925163,18.643572316
6,31,2004,2408,846,1390,22925,692,1562,2082,3511,142390,17.122398842,6.0155936132,9.8837767404,-133,4.920556478,11.106805229,14.804333218
6,31,2005,2617,751,-1084,22706,465,1866,-619,1117,143507,18.307292486,5.253640297,-7.583150575,-130,3.2529197578,13.053652189,-4.330230817
6,31,2006,2600,827,-54,23216,571,1773,517,2216,145723,17.97877122,5.7186322304,-0.373405248,-74,3.9484147564,12.26013899,3.575009508
6,31,2007,2701,786,228,23918,378,1915,606,2509,148232,18.37696246,5.3477573098,1.5512578456,-12,2.5718222177,13.02920515,4.1230800633
6,31,2008,2747,810,-1139,23736,464,1937,-675,1286,149518,18.451721243,5.4408060453,-7.650713686,24,3.1167086482,13.010915197,-4.534005038
6,33,2001,599,792,1859,1166,109,-193,1968,1761,60308,10.079508645,13.32716335,31.281813975,-14,1.8341676833,-3.247654705,33.115981658
6,33,2002,616,819,1458,1180,104,-203,1562,1349,61657,10.101258558,13.430082401,23.90849834,-10,1.705407289,-3.328823843,25.613905629
6,33,2003,681,754,1005,1184,86,-73,1091,1022,62679,10.95418865,12.1284262,16.165873118,4,1.3833483464,-1.17423755,17.549221464
6,33,2004,667,855,874,1187,86,-188,960,697,63376,10.582682163,13.56550712,13.866962834,-75,1.3644837571,-2.982824957,15.231446591
6,33,2005,709,774,785,1185,87,-65,872,756,64132,11.120870847,12.140414719,12.312952913,-51,1.3646202591,-1.019543872,13.677573172
6,33,2006,707,778,544,1181,89,-71,633,530,64662,10.978772303,12.081308135,8.4475984906,-32,1.3820519589,-1.102535832,9.8296504496
6,33,2007,751,746,-232,1178,80,5,-152,-164,64498,11.628987303,11.551563952,-3.592443481,-17,1.2387736141,0.0774233509,-2.353669867
6,33,2008,792,720,241,1185,82,72,323,368,64866,12.244519341,11.131381219,3.725920658,-27,1.2677406388,1.1131381219,4.9936612968
6,35,2001,249,204,-263,8896,6,45,-257,-243,33505,7.404874132,6.0666438672,-7.821212437,-31,0.178430702,1.3382302648,-7.642781735
6,35,2002,267,215,-219,8666,5,52,-214,-197,33308,7.9924565579,6.4358732582,-6.555610435,-35,0.1496714711,1.5565832997,-6.405938964
6,35,2003,327,203,302,8914,0,124,302,401,33709,9.7587179372,6.0581643464,9.0126385842,-25,0,3.7005535909,9.0126385842
6,35,2004,279,210,370,9247,5,69,375,410,34119,8.226691042,6.1921330424,10.909948694,-34,0.1474317391,2.0345579996,11.057380433
6,35,2005,286,229,-91,9274,3,57,-88,-58,34061,8.3895570549,6.717512467,-2.669404517,-27,0.0880023467,1.6720445879,-2.581402171
6,35,2006,280,219,-29,9432,6,61,-23,22,34083,8.2178915238,6.4275651561,-0.851138765,-16,0.1760976755,1.7903263677,-0.675041089
6,35,2007,298,204,808,10410,1,94,809,897,34980,8.6298017752,5.9076495374,23.398925619,-6,0.0289590664,2.7221522378,23.427884685
6,35,2008,327,188,-521,9802,3,139,-518,-406,34574,9.402766196,5.4058716968,-14.98116571,-27,0.0862639101,3.9968944992,-14.8949018
6,37,2001,155576,59873,-86495,175968,97509,95703,11014,98955,9643067,16.216662178,6.2409382849,-9.015916305,-7762,10.1639746,9.9757238935,1.1480582946
6,37,2002,151917,60271,-85997,176105,92093,91646,6096,90612,9733679,15.680341787,6.2209619716,-8.876309779,-7130,9.5055175931,9.4593798154,0.6292078144
6,37,2003,152601,59644,-97390,175866,80682,92957,-16708,67699,9801378,15.623297132,6.106355359,-9.970792509,-8550,8.2602267298,9.5169417729,-1.710565779
6,37,2004,151461,61300,-114141,176731,73352,90161,-40789,39839,9841217,15.421689446,6.2415378416,-11.62178419,-9533,7.4686669455,9.1801516042,-4.153117243
6,37,2005,151645,58780,-157420,176459,77268,92865,-80152,4793,9846010,15.405419971,5.9713843905,-15.99209477,-7920,7.8495564662,9.4340355805,-8.142538307
6,37,2006,150496,60833,-181906,178063,76833,89663,-105073,-19517,9826493,15.300137456,6.1845714295,-18.49342709,-4107,7.8112073487,9.1155660263,-10.68221975
6,37,2007,150587,60568,-180632,179110,70022,90019,-110610,-18623,9807870,15.33912763,6.1695915472,-18.39957833,1968,7.1325970697,9.1695360832,-11.26698126
6,37,2008,149317,61406,-103004,179331,70136,87911,-32868,54179,9862049,15.182268925,6.2436454365,-10.47325106,-864,7.1312952534,8.938623489,-3.341955806
6,39,2001,2144,891,-127,7902,901,1253,774,1902,125474,17.217702754,7.1553046425,-1.019891908,-125,7.2356110919,10.062398111,6.2157191844
6,39,2002,2134,940,542,7110,849,1194,1391,2475,127949,16.841407449,7.4184268989,4.2774333821,-110,6.7002600395,9.4229805503,10.977693422
6,39,2003,2229,924,2235,7409,736,1305,2971,4251,132200,17.136333409,7.1036213862,17.182460821,-25,5.6582958228,10.032712023,22.840756643
6,39,2004,2318,931,2700,8359,671,1387,3371,4583,136783,17.235289963,6.9223705587,20.075618162,-175,4.9891628839,10.312919404,25.064781046
6,39,2005,2375,930,1231,8629,711,1445,1942,3266,140049,17.158420992,6.7188764305,8.8934805225,-121,5.1366894001,10.439544561,14.030169923
6,39,2006,2460,928,1123,8837,706,1532,1829,3282,143331,17.361846284,6.5495094926,7.9257534053,-79,4.9827087303,10.812336792,12.908462136
6,39,2007,2649,979,61,8842,642,1670,703,2323,145654,18.333131477,6.7754381715,0.4221672405,-50,4.4431371871,11.557693306,4.8653044276
6,39,2008,2688,924,336,9228,645,1764,981,2679,148333,18.286522873,6.2859922378,2.2858153592,-66,4.387949127,12.000530636,6.6737644862
6,41,2001,2871,1842,-1846,11141,1478,1029,-368,435,248032,11.585278505,7.4329791033,-7.449120209,-226,5.9641384988,4.1522994014,-1.48498171
6,41,2002,2850,1910,-3728,11124,1369,940,-2359,-1549,246483,11.526445103,7.7247404022,-15.07739907,-130,5.536738016,3.8017047006,-9.540661052
6,41,2003,2790,1809,-3250,11296,1199,981,-2051,-1202,245281,11.34690624,7.357187594,-13.21772232,-132,4.876322789,3.9897186455,-8.341399533
6,41,2004,2826,1802,-3147,10966,1131,1024,-2016,-1245,244036,11.55079427,7.3653684626,-12.86282717,-253,4.6227701061,4.1854258078,-8.240057059
6,41,2005,2787,1769,-1476,11318,1172,1018,-304,484,244520,11.409132218,7.2417491547,-6.042296073,-230,4.7978123286,4.1673830636,-1.244483744
6,41,2006,2747,1824,-1269,10974,1167,923,-102,708,245228,11.218014162,7.448728734,-5.182256997,-113,4.7657162459,3.7692854284,-0.416540752
6,41,2007,2652,1829,-250,10715,1072,823,822,1704,246932,10.776983095,7.4325422627,-1.015929779,59,4.3563068921,3.3444408322,3.3403771131
6,41,2008,2561,1860,-48,10701,1079,701,1031,1862,248794,10.332320677,7.5041454352,-0.193655366,130,4.3532112498,2.828175242,4.1595558837
6,43,2001,136,154,-7,1423,7,-18,0,-38,17106,7.9416058394,8.9927007299,-0.408759124,-20,0.4087591241,-1.051094891,0
6,43,2002,136,172,136,1426,7,-36,143,94,17200,7.92864222,10.027400455,7.92864222,-13,0.408091879,-2.098758235,8.336734099
6,43,2003,143,168,392,1403,6,-25,398,382,17582,8.2226438963,9.660169053,22.540394457,9,0.3450060376,-1.437525157,22.885400495
6,43,2004,125,177,139,1370,4,-52,143,74,17656,7.0946137692,10.045973097,7.8892105114,-17,0.2270276406,-2.951359328,8.116238152
6,43,2005,149,158,74,1412,6,-9,80,57,17713,8.4254573214,8.9343775623,4.184455314,-14,0.3392801606,-0.508920241,4.5237354746
6,43,2006,151,183,249,1445,5,-32,254,212,17925,8.4741006791,10.269936585,13.97384814,-10,0.2805993602,-1.795835905,14.2544475
6,43,2007,143,175,103,1438,5,-32,108,69,17994,7.9623597539,9.744146552,5.7351262563,-7,0.2784041872,-1.781786798,6.0135304435
6,43,2008,159,169,6,1445,4,-10,10,-18,17976,8.8407005838,9.3967194885,0.3336113428,-18,0.2224075619,-0.556018905,0.5560189046
6,45,2001,1070,813,-286,2141,345,257,59,235,86620,12.369584694,9.3985722956,-3.306262825,-81,3.9883240369,2.9710123985,0.6820612121
6,45,2002,1035,844,-112,2143,323,191,211,320,86940,11.926711224,9.7257432588,-1.290619959,-82,3.7220557732,2.200967965,2.4314358147
6,45,2003,1150,840,72,2147,280,310,352,541,87481,13.186485572,9.6318677223,0.8255886619,-121,3.2106225741,3.5546178499,4.036211236
6,45,2004,1069,865,-668,2156,270,204,-398,-267,87214,12.238472767,9.9029737543,-7.647614414,-73,3.0911016343,2.3354990126,-4.556512779
6,45,2005,1131,803,-756,2150,279,328,-477,-228,86986,12.985074627,9.2192881745,-8.67967853,-79,3.2032146958,3.7657864524,-5.476463835
6,45,2006,1113,822,-1150,2141,277,291,-873,-616,86370,12.840628533,9.4833752509,-13.26749579,-34,3.1957359422,3.3572532823,-10.07175985
6,45,2007,1144,788,-1054,2144,251,356,-803,-410,85960,13.27685255,9.1452445889,-12.23234492,37,2.9130157256,4.1316079615,-9.319329194
6,45,2008,1161,790,-397,2142,254,371,-143,261,86221,13.485808539,9.1763899617,-4.611426348,33,2.9503836079,4.309418577,-1.66104274
6,47,2001,3938,1377,2134,2855,1378,2561,3512,5905,217457,18.358589214,6.4194457459,9.9485092387,-168,6.4241076528,11.939143468,16.372616891
6,47,2002,3993,1447,2138,2908,1307,2546,3445,5839,223296,18.118991816,6.5660358523,9.7015788889,-152,5.9307594049,11.552955964,15.632338294
6,47,2003,4243,1503,1786,4367,1142,2740,2928,5467,228763,18.771885971,6.6495745024,7.9016234607,-201,5.0524378455,12.122311468,12.954061306
6,47,2004,4224,1447,1086,4366,1035,2777,2121,4708,233471,18.276457379,6.2608981598,4.6989187295,-190,4.4782512753,12.015559219,9.1771700048
6,47,2005,4412,1458,734,4428,1091,2954,1825,4563,238034,18.714541733,6.1844519146,3.1134346401,-216,4.6277345945,12.530089819,7.7411692347
6,47,2006,4565,1472,-835,4731,1085,3093,250,3220,241254,19.049089483,6.1424446262,-3.484335097,-123,4.527549198,12.906644857,1.0432141009
6,47,2007,4757,1482,-1290,4756,979,3275,-311,2964,244218,19.597422714,6.1053984576,-5.314415661,0,4.0331883198,13.492024257,-1.281227342
6,47,2008,4766,1575,-2348,4820,981,3191,-1367,1899,246117,19.439770769,6.4241793876,-9.577125843,75,4.0013460185,13.015591381,-5.575779824
6,49,2001,74,87,-112,405,17,-13,-95,-118,9298,7.9085176873,9.2978518756,-11.96964839,-10,1.8168216309,-1.389334188,-10.15282676
6,49,2002,62,108,-7,403,17,-46,10,-46,9252,6.6846361186,11.644204852,-0.754716981,-10,1.832884097,-4.959568733,1.0781671159
6,49,2003,83,110,106,409,8,-27,114,82,9334,8.9314537824,11.836866459,11.406434951,-5,0.8608630152,-2.905412676,12.267297966
6,49,2004,81,115,79,407,6,-34,85,41,9375,8.6589342028,12.29354856,8.4451333583,-10,0.6414025335,-3.634614357,9.0865358918
6,49,2005,88,113,-70,410,8,-25,-62,-96,9279,9.4349737322,12.115363997,-7.505092742,-9,0.8577248847,-2.680390265,-6.647367857
6,49,2006,85,101,46,409,7,-16,53,33,9312,9.1442095638,10.86547254,4.948631058,-4,0.7530525523,-1.721262977,5.7016836103
6,49,2007,82,110,-127,408,6,-28,-121,-143,9169,8.8739786808,11.904117743,-13.74384503,6,0.6493155132,-3.030139062,-13.09452952
6,49,2008,102,107,14,410,5,-5,19,15,9184,11.115348989,11.660219038,1.5256361358,1,0.5448700485,-0.544870048,2.0705061843
6,51,2001,131,52,-12,298,56,79,44,106,13002,10.116611321,4.0157541123,-0.926712487,-17,4.3246582748,6.1008572091,3.3979457873
6,51,2002,168,52,-78,298,44,116,-34,67,13069,12.887883088,3.9891066702,-5.983660005,-15,3.3753979517,8.8987764182,-2.608262054
6,51,2003,141,51,-247,298,19,90,-228,-145,12924,10.849074751,3.9241334205,-19.00511676,-7,1.4619320586,6.9249413304,-17.5431847
6,51,2004,154,46,-272,298,57,108,-215,-120,12804,11.971393035,3.5758706468,-21.14427861,-13,4.4309701493,8.3955223881,-16.71330846
6,51,2005,171,45,-191,254,47,126,-144,-23,12781,13.367207348,3.5176861442,-14.93062341,-5,3.6740277506,9.8495212038,-11.25659566
6,51,2006,182,47,14,417,52,135,66,193,12974,14.133178024,3.6497767424,1.0871675403,-8,4.0380508639,10.483401281,5.1252184042
6,51,2007,149,41,-364,254,38,108,-326,-216,12758,11.580910928,3.1866936111,-28.29162133,2,2.9535209078,8.394217317,-25.33810042
6,51,2008,157,61,-121,254,43,96,-78,16,12774,12.298292339,4.7783174056,-9.478301739,-2,3.3683221056,7.5199749334,-6.109979633
6,53,2001,7003,2475,-4114,20517,4167,4528,53,4255,407350,17.281863667,6.1077556157,-10.15244711,-326,10.283239455,11.174108052,0.1307923425
6,53,2002,7257,2349,-5872,20193,3682,4908,-2190,2460,409810,17.761515493,5.7491800871,-14.37172647,-258,9.0116990553,12.012335406,-5.360027412
6,53,2003,7304,2415,-5704,22089,2663,4889,-3041,1575,411385,17.788710355,5.8816724408,-13.89195015,-273,6.4856702732,11.907037914,-7.406279873
6,53,2004,7394,2452,-9122,22005,3552,4942,-5570,-1162,410223,17.998851034,5.9687831667,-22.20523656,-534,8.6464591387,12.030067867,-13.55877742
6,53,2005,7499,2300,-11604,22704,3342,5199,-8262,-3336,406887,18.354933852,5.6295969943,-28.40254066,-273,8.1800491978,12.725336858,-20.22249146
6,53,2006,7429,2384,-11324,22216,3475,5045,-7849,-2965,403922,18.324907592,5.8805464666,-27.93259572,-161,8.5716858101,12.444361126,-19.36090991
6,53,2007,7426,2360,-7305,22423,2965,5066,-4340,724,404646,18.368275767,5.837480583,-18.06898121,-2,7.3339533595,12.530795184,-10.73502785
6,53,2008,7451,2320,-4485,21337,3098,5131,-1387,3592,408238,18.332258969,5.7080715084,-11.03478479,-152,7.6222437642,12.624187461,-3.412541027
6,55,2001,1584,1327,1209,5316,856,257,2065,2215,126753,12.606897979,10.561460617,9.6223103892,-107,6.8128186047,2.0454373615,16.435128994
6,55,2002,1581,1281,871,5362,810,300,1681,1886,128639,12.380967297,10.031637639,6.8208871069,-95,6.3431900764,2.3493296579,13.164077183
6,55,2003,1650,1286,369,5307,703,364,1072,1265,129904,12.763834256,9.9480550624,2.854457479,-171,5.4381669587,2.8157791934,8.2926244377
6,55,2004,1642,1276,-654,5384,643,366,-11,245,130149,12.628195022,9.8133841948,-5.029743937,-110,4.9451457972,2.814810827,-0.08459814
6,55,2005,1597,1272,-982,5319,684,325,-298,-93,130056,12.274937069,9.7769066697,-7.547894929,-120,5.2573932092,2.4980303991,-2.29050172
6,55,2006,1733,1188,-353,5323,681,545,328,810,130866,13.283663317,9.1061696599,-2.70578947,-63,5.2199507899,4.1774936571,2.5141613202
6,55,2007,1717,1192,-218,5328,615,525,397,915,131781,13.074582995,9.0768217417,-1.660022768,-7,4.6830917543,3.9977612537,3.0230689861
6,55,2008,1718,1164,426,5756,618,554,1044,1652,133433,12.955575498,8.777817159,3.2125000943,54,4.6603874607,4.1777583385,7.872887555
6,57,2001,800,922,1175,864,98,-122,1273,1090,93595,8.5975282106,9.9086512628,12.627619559,-61,1.0531972058,-1.311123052,13.680816765
6,57,2002,790,917,915,866,91,-127,1006,821,94416,8.4037636096,9.7547483924,9.7334730415,-58,0.9680284664,-1.350984783,10.701501508
6,57,2003,890,991,900,849,71,-101,971,787,95203,9.3872449491,10.452539039,9.4927196114,-83,0.7488701027,-1.06529409,10.241589714
6,57,2004,773,993,1025,829,73,-220,1098,784,95987,8.0861969768,10.387572572,10.722318113,-94,0.7636382656,-2.301375595,11.485956378
6,57,2005,830,935,712,822,74,-105,786,586,96573,8.6206896552,9.7112588284,7.3950976319,-95,0.7685916078,-1.090569173,8.1636892397
6,57,2006,834,878,154,877,75,-44,229,141,96714,8.6296543482,9.0849358726,1.5934853353,-44,0.7760480529,-0.455281524,2.3695333882
6,57,2007,834,922,128,889,65,-88,193,139,96853,8.6171713154,9.5264172095,1.3225394825,34,0.6716020809,-0.909245894,1.9941415634
6,57,2008,910,968,183,884,67,-58,250,265,97118,9.3828458893,9.9808734295,1.8868799975,73,0.6908249171,-0.59802754,2.5777049147
6,59,2001,46267,16816,-17539,42409,27180,29451,9641,36613,2893531,16.09161302,5.8485867799,-6.100045405,-2479,9.4531748738,10.24302624,3.3531294687
6,59,2002,45032,16718,-23508,42929,25627,28314,2119,28296,2921827,15.487266648,5.7496030339,-8.084798907,-2137,8.8135588557,9.7376636142,0.7287599491
6,59,2003,45256,16947,-22486,43514,22363,28309,-123,25328,2947155,15.422095348,5.7751071651,-7.662657681,-2858,7.6207424047,9.646988183,-0.041915276
6,59,2004,45009,17552,-26808,43466,20475,27457,-6333,18406,2965561,15.22447552,5.9370346893,-9.067913967,-2718,6.9257512115,9.2874408309,-2.142162756
6,59,2005,44773,16595,-43308,43671,21532,28178,-21776,3774,2969335,15.088048721,5.5923473638,-14.59435852,-2628,7.2560664922,9.4957013569,-7.338292027
6,59,2006,44192,17136,-46087,43599,21421,27056,-24666,1150,2970485,14.879912186,5.7698718143,-15.51797866,-1240,7.2126764784,9.1100403716,-8.305302181
6,59,2007,43721,17513,-40512,43770,19486,26208,-21026,6257,2976742,14.702986787,5.8894674779,-13.62382838,1075,6.5529699808,8.8135193091,-7.070858402
6,59,2008,43516,17647,-12033,43787,19538,25869,7505,34017,3010759,14.535613439,5.8946127942,-4.019373024,643,6.526261958,8.6410006445,2.5068889341
6,61,2001,3069,1953,11430,2882,537,1116,11967,12957,264212,11.907648792,7.577594686,44.348134798,-126,2.0835475404,4.3300541063,46.431682339
6,61,2002,3293,2101,11959,2868,496,1192,12455,13621,277833,12.150282726,7.7521239012,44.125487736,-26,1.8301063565,4.3981588245,45.955594093
6,61,2003,3540,2164,11963,2883,414,1376,12377,14088,291921,12.426415611,7.5962608424,41.993562134,335,1.4532587748,4.8301547685,43.446820909
6,61,2004,3715,2274,11214,2892,423,1441,11637,12557,304478,12.458102713,7.6257673135,37.605696857,-521,1.4185134449,4.8323353996,39.024210302
6,61,2005,3878,2368,8535,2893,431,1510,8966,10297,314775,12.524767744,7.6479241925,27.56547001,-179,1.3919997158,4.8768435518,28.957469726
6,61,2006,3876,2424,7297,2910,439,1452,7736,8983,323758,12.140327908,7.5924032117,22.855514124,-205,1.3750268193,4.5479246961,24.230540943
6,61,2007,4106,2578,6757,2910,387,1528,7144,8363,332121,12.520602123,7.8612061066,20.604410265,-309,1.1800957189,4.6593960166,21.784505984
6,61,2008,4484,2662,8032,2910,394,1822,8426,9824,341945,13.304335184,7.8983363647,23.831494245,-424,1.1690249916,5.4059988191,25.000519237
6,63,2001,157,198,109,188,13,-41,122,62,20827,7.5495287555,9.5210617426,5.2413925755,-19,0.6251202154,-1.971532987,5.8665127909
6,63,2002,149,203,95,188,13,-54,108,37,20864,7.1478256698,9.7383128253,4.5573385143,-17,0.6236357967,-2.590487156,5.180974311
6,63,2003,197,236,118,188,12,-39,130,72,20936,9.4258373206,11.291866029,5.6459330144,-19,0.5741626794,-1.866028708,6.2200956938
6,63,2004,164,227,108,188,11,-63,119,38,20974,7.8262944405,10.832736817,5.1539012169,-18,0.5249343832,-3.006442377,5.6788356001
6,63,2005,168,226,61,188,12,-58,73,-2,20972,8.0102989558,10.77575931,2.9085014066,-17,0.5721642111,-2.765460354,3.4806656177
6,63,2006,180,215,-191,188,11,-35,-180,-225,20747,8.6291617728,10.30705434,-9.156499437,-10,0.5273376639,-1.677892567,-8.629161773
6,63,2007,188,208,-134,188,7,-20,-127,-161,20586,9.0968475552,10.064597295,-6.483923257,-14,0.338712409,-0.96774974,-6.145210848
6,63,2008,199,220,-278,188,6,-21,-272,-311,20275,9.7403391987,10.76821419,-13.60710702,-18,0.2936785688,-1.027874991,-13.31342845
6,65,2001,25102,12545,36986,34827,7582,12557,44568,56257,1615534,15.813224787,7.9028326411,23.299654688,-868,4.7763473164,7.9103921462,28.076002005
6,65,2002,25702,12979,49366,34627,7048,12723,56414,68844,1684378,15.577385094,7.8662703733,29.919585734,-293,4.2716290616,7.7111147206,34.191214796
6,65,2003,27734,13033,59497,35100,5923,14701,65420,82015,1766393,16.07408895,7.5536742369,34.483308223,1894,3.4328560197,8.5204147131,37.916164243
6,65,2004,28575,13666,65526,35643,5832,14909,71358,82985,1849378,15.80575761,7.5591070342,36.244551992,-3282,3.2258680099,8.246650576,39.470420002
6,65,2005,30506,13583,51738,35138,5997,16923,57735,73008,1922386,16.17598556,7.2024654777,27.434378185,-1650,3.1799444504,8.9735200824,30.614322635
6,65,2006,32516,14232,55289,35240,6044,18284,61333,78430,2000816,16.576255824,7.2552980958,28.185650395,-1187,3.0811566674,9.3209577279,31.266807062
6,65,2007,34912,14274,37353,36015,5408,20638,42761,63549,2064365,17.176110978,7.0225655389,18.377041514,150,2.6606441386,10.153545439,21.037685653
6,65,2008,36675,14668,8733,34559,5471,22007,14204,36151,2100516,17.611547605,7.0436586303,4.1936372252,-60,2.6272059154,10.567888974,6.8208431405
6,67,2001,18645,9355,19942,25491,7298,9290,27240,35701,1265948,14.938736757,7.495408011,15.977918392,-829,5.84729959,7.4433287464,21.825217982
6,67,2002,19249,9662,18481,25469,6781,9587,25262,34164,1300112,15.002766888,7.5306111315,14.404183846,-685,5.2851453201,7.4721557563,19.689329166
6,67,2003,19767,9547,11673,25374,5746,10220,17419,26526,1326638,15.050537737,7.2690587228,8.887789093,-1113,4.3749881032,7.781479014,13.262777196
6,67,2004,20484,9779,4723,25187,5617,10705,10340,20039,1346677,15.324793375,7.3160102719,3.5334406907,-1006,4.2022732076,8.0087831026,7.7357138983
6,67,2005,21083,9673,-4666,25540,5781,11410,1115,11239,1357916,15.590515837,7.1530171083,-3.450426737,-1286,4.2749500572,8.437498729,0.8245233201
6,67,2006,21578,10087,-6837,25483,5812,11491,-1025,9821,1367737,15.833270046,7.4015291015,-5.016779465,-645,4.2646661185,8.4317409443,-0.752113347
6,67,2007,21945,10123,-4787,25613,5195,11822,408,12495,1380232,15.971795897,7.3676231428,-3.484027658,265,3.7809742395,8.6041727545,0.2969465813
6,67,2008,22023,10126,-3731,25445,5251,11897,1520,13922,1394154,15.875945164,7.2996331441,-2.689604114,505,3.7853420541,8.57631202,1.0957379399
6,69,2001,897,267,14,507,331,630,345,918,54741,16.524814856,4.9187575992,0.2579123835,-57,6.097785638,11.606057257,6.3556980214
6,69,2002,964,257,-523,507,319,707,-204,464,55205,17.535881251,4.6750222837,-9.513761301,-39,5.8028486712,12.860858967,-3.71091263
6,69,2003,892,257,-721,507,282,635,-439,164,55369,16.133991716,4.6484707074,-13.04104039,-32,5.1006565739,11.485521009,-7.940383815
6,69,2004,871,277,-1062,507,245,594,-817,-287,55082,15.771699668,5.015798861,-19.2302469,-64,4.4363563933,10.755900807,-14.7938905
6,69,2005,900,255,-1024,507,267,645,-757,-155,54927,16.36229763,4.6359843286,-18.61665864,-43,4.854148297,11.726313302,-13.76251034
6,69,2006,912,261,-1375,507,266,651,-1109,-479,54448,16.676571429,4.7725714286,-25.14285714,-21,4.864,11.904,-20.27885714
6,69,2007,847,252,-900,507,240,595,-660,-51,54397,15.563415867,4.6304377785,-16.53727778,14,4.4099407414,10.932978088,-12.12733704
6,69,2008,855,270,-528,507,241,585,-287,302,54699,15.674268534,4.9497690108,-9.679548288,4,4.4181271541,10.724499523,-5.261421134
6,71,2001,28930,11416,20226,50033,7400,17514,27626,43864,1762539,16.620638662,6.5586315578,11.620084258,-1276,4.2513904632,10.062007104,15.871474721
6,71,2002,29372,11602,17118,46623,6262,17770,23380,39914,1802453,16.478017342,6.5088505107,9.6033876093,-1236,3.5130513617,9.9691668312,13.116438971
6,71,2003,30556,11783,26413,46915,3839,18773,30252,48284,1850737,16.728393541,6.4508005332,14.46023886,-741,2.1017247939,10.277593008,16.561963654
6,71,2004,31126,12318,29695,48001,6655,18808,36350,52966,1903703,16.580901546,6.5618307923,15.818604106,-2192,3.5451358924,10.019070754,19.363739999
6,71,2005,32482,11800,20764,49833,5911,20682,26675,45502,1949205,16.861030681,6.1252435823,10.778352351,-1855,3.068331764,10.735787099,13.846684115
6,71,2006,33829,12546,5888,52035,6336,21283,12224,32491,1981696,17.211830061,6.3832693828,2.9957508469,-1016,3.2236884114,10.828560679,6.2194392583
6,71,2007,35205,12383,-7638,52316,5153,22822,-2485,20512,2002208,17.673618641,6.2165152574,-3.834429745,175,2.5869097247,11.457103384,-1.247520021
6,71,2008,35837,12314,-16341,51564,5521,23523,-10820,13147,2015355,17.840168281,6.1300843322,-8.134782205,444,2.7484323208,11.710083949,-5.386349884
6,73,2001,44094,19886,6446,98840,16254,24208,22700,44235,2869630,15.485094446,6.983639229,2.2637301856,-2673,5.7081399994,8.5014552175,7.9718701849
6,73,2002,43809,19634,3674,105627,10909,24175,14583,35979,2905609,15.171320183,6.7993722857,1.2723282967,-2779,3.7778523105,8.3719478969,5.0501806072
6,73,2003,44948,19442,1133,110189,-591,25506,542,21702,2927311,15.411834896,6.6663009265,0.3884846698,-4346,-0.20264293,8.7455339693,0.1858417396
6,73,2004,45221,20463,-38101,98740,19083,24758,-19018,2742,2930053,15.440734091,6.987102048,-13.00960637,-2998,6.5159003265,8.4536320434,-6.493706043
6,73,2005,46090,19120,-36060,101586,13251,26970,-22809,1636,2931689,15.725700653,6.5236579843,-12.30350978,-2525,4.5211815873,9.2020426692,-7.782328188
6,73,2006,46298,19903,-35785,103331,16007,26395,-19778,5334,2937023,15.777908338,6.7827489234,-12.19518013,-1283,5.4550299964,8.9951594149,-6.740150139
6,73,2007,47001,19553,-15553,100609,10750,27448,-4803,22711,2959734,15.941304687,6.6317808246,-5.275102908,66,3.6460719002,9.309523862,-1.629031008
6,73,2008,47565,19962,420,105931,12987,27603,13407,41338,3001072,15.959251148,6.6977519483,0.1409205399,328,4.35746441,9.2614991999,4.49838495
6,75,2001,8610,6614,-10045,19406,8571,1996,-1474,6853,784385,11.024913616,8.4690799831,-12.86239922,6331,10.974974983,2.5558336326,-1.887424236
6,75,2002,8202,6429,-20808,19648,8088,1773,-12720,-5612,778773,10.494140707,8.2256560117,-26.62302851,5335,10.348282131,2.2684846957,-16.27474638
6,75,2003,8661,6198,-19667,19753,7135,2463,-12532,-4414,774359,11.152947721,7.9812919958,-25.32560014,5655,9.1878861552,3.1716557253,-16.13771399
6,75,2004,8536,6146,-15356,19705,6435,2390,-8921,-1942,772417,11.037150822,7.9468520329,-19.85549297,4589,8.3205325141,3.0902987892,-11.53496046
6,75,2005,8535,5835,-10305,20349,6804,2700,-3501,4197,776614,11.019792373,7.533742062,-13.30509202,4998,8.7848467849,3.4860503115,-4.520245237
6,75,2006,8411,5945,-4687,20338,6764,2466,2077,9753,786367,10.76276679,7.6072581816,-5.997513725,5210,8.6552555661,3.1555086082,2.6577418408
6,75,2007,8687,6182,-1089,20358,6163,2505,5074,12818,799185,10.957698013,7.797915174,-1.373654096,5239,7.7739487573,3.159782839,6.4002946608
6,75,2008,8654,6334,1414,21116,6170,2320,7584,9791,808976,10.762603993,7.8773207409,1.7585303959,-113,7.6733610627,2.8852832521,9.4318914586
6,77,2001,9841,4431,14817,18809,3261,5410,18078,23240,591263,16.977691441,7.644360408,25.562285752,-248,5.6258766172,9.3333310331,31.188162369
6,77,2002,10141,4532,9237,18670,3070,5609,12307,17595,608858,16.899962587,7.5525717823,15.393447827,-321,5.1161507881,9.3473908048,20.509598615
6,77,2003,10204,4687,9171,18375,2689,5517,11860,17156,626014,16.526409215,7.5910701676,14.85336132,-221,4.35510725,8.9353390473,19.20846857
6,77,2004,10648,4436,8038,16955,2453,6212,10491,16035,642049,16.794118273,6.9964978081,12.677603558,-668,3.8688929493,9.7976204652,16.546496507
6,77,2005,11230,4645,5251,17118,2582,6585,7833,13817,655866,17.304677117,7.1576335893,8.0914389617,-601,3.9786888972,10.147043528,12.070127859
6,77,2006,11753,4861,-2598,17075,2565,6892,-33,6529,662395,17.831066837,7.3748673442,-3.941556338,-330,3.8914903801,10.456199493,-0.050065958
6,77,2007,11737,4619,-4062,17001,2349,7118,-1713,5491,667886,17.645895867,6.9443974619,-6.106980405,86,3.5315846802,10.701498405,-2.575395725
6,77,2008,11805,4731,-5175,16518,2356,7074,-2819,4502,672388,17.615800948,7.0597504689,-7.722301559,247,3.5156990287,10.556050479,-4.206602531
6,79,2001,2450,2082,2846,15869,604,368,3450,3649,251525,9.8117544819,8.3379889107,11.39765439,-169,2.4188978396,1.4737655712,13.81655223
6,79,2002,2331,2010,796,15545,563,321,1359,1460,252985,9.2406493429,7.96812749,3.1555370558,-220,2.2318685457,1.2725218529,5.3874056015
6,79,2003,2572,2054,695,15361,473,518,1168,1368,254353,10.139197143,8.0971659919,2.7397908298,-318,1.8646346223,2.0420311508,4.6044254521
6,79,2004,2677,2102,1050,16064,475,575,1525,1897,256250,10.485641487,8.2334024673,4.1127842962,-203,1.8605452769,2.2522390194,5.9733295731
6,79,2005,2648,1914,552,15840,492,734,1044,1529,257779,10.302920652,7.4470506528,2.1477387463,-249,1.9142888825,2.8558699996,4.0620276288
6,79,2006,2686,2175,993,15872,492,511,1485,1871,259650,10.382100733,8.4069505188,3.8382077541,-125,1.9017101863,1.9751502138,5.7399179404
6,79,2007,2868,2125,867,15732,431,743,1298,2116,261766,11.00081317,8.1508814459,3.3255596299,75,1.6531905427,2.8499317244,4.9787501726
6,79,2008,3039,2098,2002,16064,439,941,2441,3531,265297,11.531828263,7.9610976297,7.596814802,149,1.665835014,3.5707306337,9.2626498161
6,81,2001,10403,4834,-13821,10455,7482,5569,-6339,-1252,707190,14.697322468,6.8294585033,-19.52626106,-482,10.570543757,7.8678639646,-8.955717305
6,81,2002,10252,4668,-19698,10434,7060,5584,-12638,-7185,700005,14.570830624,6.6344749662,-27.99611994,-131,10.034145943,7.9363556579,-17.961974
6,81,2003,10201,4765,-15850,10359,6241,5436,-9609,-4137,695868,14.615942854,6.8272686699,-22.7098024,36,8.9420742431,7.7886741845,-13.76772815
6,81,2004,10011,4679,-12044,10369,5609,5332,-6435,-1907,693961,14.406088807,6.7332024299,-17.33162857,-804,8.0714965654,7.6728863767,-9.260132002
6,81,2005,9971,4615,-9977,10339,5916,5356,-4061,714,694675,14.360854824,6.6468102512,-14.3694964,-581,8.5205914293,7.7140445732,-5.848904969
6,81,2006,9965,4765,-8604,10458,5867,5200,-2737,2150,696825,14.322673374,6.8487243981,-12.36651096,-313,8.4326266619,7.4739489759,-3.933884298
6,81,2007,9666,4708,-5456,10575,5362,4958,-94,4850,701675,13.823382195,6.7329281373,-7.802645692,-14,7.6682159457,7.0904540579,-0.134429746
6,81,2008,9544,4802,972,10457,5365,4742,6337,11015,712690,13.495809073,6.7903264009,1.374468401,-64,7.5864433863,6.7054826724,8.9609117873
6,83,2001,5713,2888,-3431,16512,2776,2825,-655,1864,401690,14.255485854,7.2063439782,-8.561276381,-306,6.9268735746,7.0491418761,-1.634402807
6,83,2002,5638,2975,-4028,16399,2489,2663,-1539,839,402529,14.021056454,7.3984822542,-10.01717194,-285,6.1898562456,6.6225741993,-3.827315694
6,83,2003,5724,2865,-3823,17098,1902,2859,-1921,554,403083,14.210314643,7.1126050754,-9.490921188,-384,4.7218760396,7.0977095674,-4.769045148
6,83,2004,5962,2916,-5851,16885,2276,3046,-3575,-955,402128,14.808540867,7.2428220678,-14.53283673,-426,5.6531766208,7.5657187992,-8.879660114
6,83,2005,6315,2957,-5793,17371,2211,3358,-3582,-552,401576,15.71474075,7.3584304669,-14.41575505,-328,5.5020256214,8.3563102834,-8.913729433
6,83,2006,6195,2889,-6589,17036,2274,3306,-4315,-1183,400393,15.44947498,7.2047672666,-16.4320566,-174,5.6710421475,8.2447077131,-10.76101445
6,83,2007,6142,2818,-3549,17473,1970,3324,-1579,1699,402092,15.30745123,7.023184234,-8.845025141,-46,4.9097490919,8.2842669956,-3.935276049
6,83,2008,6312,2892,-2115,18084,2037,3420,-78,3304,405396,15.633668859,7.1629547436,-5.23846794,-38,5.0452762146,8.4707141159,-0.193191725
6,85,2001,27740,8949,-36898,29763,24571,18791,-12327,5458,1691612,16.425057272,5.298768476,-21.84757618,-1006,14.54866915,11.126288796,-7.298907029
6,85,2002,26883,8605,-57953,29841,23200,18278,-34753,-16408,1675204,15.969390665,5.1116544533,-34.42599774,67,13.781566917,10.857736211,-20.64443082
6,85,2003,27211,8771,-43458,29520,20366,18440,-23092,-4192,1671012,16.263743883,5.2423394067,-25.97441408,460,12.172555507,11.021404476,-13.80185858
6,85,2004,26823,8522,-32417,28811,18443,18301,-13974,2286,1673298,16.040977063,5.0964174972,-19.38636071,-2041,11.029479923,10.944559565,-8.356880792
6,85,2005,26391,8611,-21130,28940,19461,17780,-1669,14658,1687956,15.703067962,5.1236830064,-12.57268865,-1453,11.579606897,10.579384956,-0.993081749
6,85,2006,26706,8935,-16422,29669,19344,17771,2922,19854,1707810,15.728998995,5.2624356331,-9.67204454,-839,11.393011179,10.466563362,1.720966639
6,85,2007,26824,9121,-11003,30027,17642,17703,6639,24148,1731958,15.596400687,5.3032646388,-6.397524484,-194,10.25766854,10.293136049,3.8601440562
6,85,2008,26622,9198,-2097,30601,17664,17424,15567,32541,1764499,15.227986502,5.2613259651,-1.199499951,-450,10.103942362,9.9666605367,8.9044424113
6,87,2001,3509,1696,-3200,8841,1498,1813,-1702,-96,255754,13.717640988,6.6301279896,-12.50967545,-207,5.856091821,7.0875129983,-6.653583631
6,87,2002,3459,1677,-4910,9090,1410,1782,-3500,-1837,253917,13.573462096,6.5807157951,-19.26733128,-119,5.53298108,6.992746301,-13.7343502
6,87,2003,3291,1691,-4812,9677,1250,1600,-3562,-2018,251899,13.012637006,6.6862258212,-19.02668164,-56,4.9425087384,6.3264111851,-14.0841729
6,87,2004,3489,1678,-3655,9753,1124,1811,-2531,-994,250905,13.878171216,6.674569017,-14.53846827,-274,4.4709270412,7.2036021989,-10.06754123
6,87,2005,3418,1571,-4122,9299,1182,1847,-2940,-1302,249603,13.658123347,6.2776219361,-16.47126519,-209,4.7232012276,7.3805014106,-11.74806397
6,87,2006,3460,1567,-2922,9584,1176,1893,-1746,40,249643,13.860902241,6.2774664194,-11.70565212,-107,4.7111043454,7.5834358212,-6.994547778
6,87,2007,3517,1602,-2029,9896,1082,1915,-947,1012,250655,14.059620466,6.4041831069,-8.111165745,44,4.3254220485,7.6554373593,-3.785743697
6,87,2008,3461,1636,-481,9948,1084,1825,603,2482,253137,13.739797377,6.4947438625,-1.909518214,54,4.3033632928,7.2450535141,2.3938450789
6,89,2001,1850,1751,3063,3348,129,99,3192,3180,166962,11.186899838,10.588249522,18.521877948,-111,0.7800595022,0.5986503157,19.30193745
6,89,2002,1995,1841,3969,3337,122,154,4091,4167,171129,11.801556386,10.890559051,23.478885862,-78,0.7216991875,0.910997335,24.20058505
6,89,2003,1959,1839,3099,3338,96,120,3195,3277,174406,11.338938168,10.644363089,17.937401421,-38,0.5556600634,0.6945750792,18.493061484
6,89,2004,2091,1844,1874,3342,102,247,1976,2060,176466,11.918876399,10.510955562,10.681958093,-163,0.5814086048,1.4079208372,11.263366698
6,89,2005,2092,1924,981,3334,101,168,1082,1075,177541,11.818975331,10.869841557,5.5422632886,-175,0.5706101857,0.9491337742,6.1128734743
6,89,2006,2135,1947,502,3338,103,188,605,711,178252,12.001360342,10.944566082,2.8218655229,-82,0.5789883443,1.0567942596,3.4008538673
6,89,2007,2264,1920,351,3361,91,344,442,816,179068,12.672114631,10.746669652,1.9646255457,30,0.5093473637,1.9254449793,2.4739729094
6,89,2008,2328,1820,497,3366,94,508,591,1146,180214,12.959179697,10.131317461,2.7666289989,47,0.5232658469,2.8278622363,3.2898948458
6,91,2001,11,32,-41,36,6,-21,-35,-60,3509,3.1082226618,9.0421022888,-11.58519356,-4,1.6953941791,-5.933879627,-9.889799378
6,91,2002,22,40,-25,36,6,-18,-19,-41,3468,6.3064354307,11.466246238,-7.166403899,-4,1.7199369356,-5.159810807,-5.446466963
6,91,2003,28,46,35,36,3,-18,38,19,3487,8.0517613228,13.227893602,10.064701653,-1,0.8626887132,-5.176132279,10.927390367
6,91,2004,27,37,-74,36,2,-10,-72,-87,3400,7.8408595905,10.744881661,-21.48976332,-5,0.5808044141,-2.904022071,-20.90895891
6,91,2005,22,35,-50,36,3,-13,-47,-62,3338,6.5301276343,10.388839418,-14.84119917,-2,0.8904719501,-3.858711784,-13.95072722
6,91,2006,29,32,45,36,2,-3,47,43,3381,8.63223694,9.5252269683,13.394850424,-1,0.5953266855,-0.892990028,13.99017711
6,91,2007,20,30,-60,36,3,-10,-57,-69,3312,5.9763932467,8.96458987,-17.92917974,-2,0.896458987,-2.988196623,-17.03272075
6,91,2008,30,31,-48,36,2,-1,-46,-49,3263,9.1254752852,9.4296577947,-14.60076046,-2,0.608365019,-0.30418251,-13.99239544
6,93,2001,421,485,-295,696,61,-64,-234,-332,43901,9.5536342388,11.005968185,-6.694351783,-34,1.3842557923,-1.452333946,-5.31009599
6,93,2002,407,508,100,750,60,-101,160,19,43920,9.268853691,11.568986917,2.2773596292,-40,1.3664157775,-2.300133226,3.6437754068
6,93,2003,446,537,339,744,41,-91,380,252,44172,10.125777596,12.191799482,7.6964991146,-37,0.9308450257,-2.066021886,8.6273441402
6,93,2004,479,539,119,732,42,-60,161,69,44241,10.835510615,12.19277708,2.6919118229,-32,0.9500865257,-1.357266465,3.6419983487
6,93,2005,492,504,193,714,42,-12,235,180,44421,11.098328483,11.369019422,4.3536125962,-43,0.9474182852,-0.270690939,5.3010308813
6,93,2006,452,544,-106,680,42,-92,-64,-175,44246,10.195450393,12.270630562,-2.390968455,-19,0.9473648595,-2.075180168,-1.443603595
6,93,2007,540,522,-109,678,29,18,-80,-51,44195,12.211530851,11.804479823,-2.464920116,11,0.6558044346,0.4070510284,-1.809115682
6,93,2008,556,503,247,743,31,53,278,347,44542,12.531413052,11.33687188,5.5670126328,16,0.6986938932,1.1945411722,6.265706526
6,95,2001,5879,2571,2412,15925,1628,3308,4040,6984,403955,14.680507313,6.4200687704,6.0230283447,-364,4.0652944217,8.2604385424,10.088322766
6,95,2002,5843,2569,29,16139,1200,3274,1229,4084,408039,14.391731959,6.3276329628,0.0714290992,-419,2.9556868647,8.0640989958,3.0271159639
6,95,2003,5856,2706,-2315,16114,309,3150,-2006,695,408734,14.339357447,6.6260760334,-5.668649674,-449,0.7566361768,7.7132814136,-4.912013497
6,95,2004,5749,2686,-4324,16238,1762,3063,-2562,116,408850,14.063386759,6.5705786806,-10.57750641,-385,4.3102604748,7.4928080784,-6.267245934
6,95,2005,5629,2705,-5476,15807,1326,2924,-4150,-1581,407269,13.794556921,6.6289352411,-13.4196116,-355,3.2495261108,7.1656216802,-10.17008549
6,95,2006,5810,2741,-4612,15907,1533,3069,-3079,-184,407085,14.268978847,6.7317161824,-11.32676944,-174,3.7649474307,7.5372626646,-7.561822009
6,95,2007,5838,2833,-4281,15892,1128,3005,-3153,-43,407042,14.34174275,6.959602126,-10.51678669,105,2.7710664307,7.3821406243,-7.745720262
6,95,2008,5834,2822,-3932,15924,1298,3012,-2634,473,407515,14.324350537,6.9289196459,-9.654327444,95,3.1870083984,7.3954308907,-6.467319046
6,97,2001,5648,3932,490,11743,2447,1716,2937,4183,464608,12.21145624,8.5013183313,1.0594216639,-470,5.2906220643,3.7101379086,6.3500437282
6,97,2002,5708,3926,-4435,11647,2276,1782,-2159,-706,463902,12.294967206,8.4565594339,-9.552939656,-329,4.9024781639,3.8384077716,-4.650461492
6,97,2003,5806,3809,-3128,11672,1921,1997,-1207,320,464222,12.511259271,8.2079549715,-6.740478643,-470,4.1395330796,4.3033042999,-2.600945563
6,97,2004,5910,3874,-3805,12059,1875,2036,-1930,-307,463915,12.735188878,8.3479055355,-8.199220589,-413,4.0403518015,4.3872833429,-4.158868788
6,97,2005,5746,3645,-5249,12182,1938,2101,-3311,-1616,462299,12.407499779,7.8707512519,-11.33431367,-406,4.1847780319,4.5367485268,-7.149535636
6,97,2006,5774,3773,-5097,11890,1942,2001,-3155,-1352,460947,12.508042277,8.1733362506,-11.04147757,-198,4.2068961035,4.3347060263,-6.834581466
6,97,2007,5879,3730,-2669,12109,1743,2149,-926,1343,462290,12.735624764,8.080265414,-5.781830668,120,3.7758452055,4.6553593498,-2.005985462
6,97,2008,5948,3766,291,12378,1763,2182,2054,4451,466741,12.804739562,8.1073720898,0.6264591817,215,3.7953523618,4.6973674721,4.4218115434
6,99,2001,7396,3575,8443,7501,2273,3821,10716,14232,463940,16.190042555,7.8257709753,18.481953663,-305,4.9756580215,8.3642715794,23.457611684
6,99,2002,7790,3672,7574,7504,2138,4118,9712,13598,477538,16.548448291,7.8005009145,16.089595296,-232,4.5417949225,8.7479473764,20.631390218
6,99,2003,8089,3741,3800,7499,1879,4348,5679,9566,487104,16.770988615,7.7562453221,7.8785704956,-461,3.8957457793,9.0147432934,11.774316275
6,99,2004,7880,3622,-316,7495,1718,4258,1402,5338,492442,16.089086168,7.3952627033,-0.645196857,-322,3.5077474667,8.6938234652,2.8625506102
6,99,2005,8348,3521,1221,7701,1804,4827,3025,7380,499822,16.82616723,7.096901631,2.4610385946,-472,3.6361290947,9.7292655987,6.0971676892
6,99,2006,8431,3696,-897,7770,1796,4735,899,5383,505205,16.77765871,7.3550262829,-1.785026671,-251,3.5740333344,9.4226324268,1.7890066635
6,99,2007,8864,3789,-2911,7811,1643,5075,-1268,3863,509068,17.478528956,7.4713612607,-5.740071953,56,3.2397589209,10.007167695,-2.500313032
6,99,2008,8841,3767,-5329,7777,1647,5074,-3682,1626,510694,17.339339964,7.3879983761,-10.45145828,234,3.23016547,9.9513415875,-7.221292811
6,101,2001,1163,706,-135,1425,560,457,425,804,79931,14.623596424,8.8772648971,-1.697493996,-78,7.0414565756,5.7463315269,5.3439625797
6,101,2002,1251,691,815,1405,517,560,1332,1832,81763,15.473672492,8.547008547,10.080769849,-60,6.3947951068,6.9266639455,16.475564956
6,101,2003,1334,709,1295,1404,412,625,1707,2299,84062,16.089250716,8.5511834766,15.61887532,-33,4.9690939243,7.5380672396,20.587969245
6,101,2004,1333,734,609,1428,449,599,1058,1583,85645,15.709428603,8.6502029969,7.1770757836,-74,5.2914729504,7.0592256065,12.468548734
6,101,2005,1456,707,902,1432,448,749,1350,2014,87659,16.802843558,8.1590730739,10.409453908,-85,5.1701057102,8.6437704842,15.579559618
6,101,2006,1430,663,968,1427,454,767,1422,2141,89800,16.116398717,7.4721484963,10.909562209,-48,5.1166748376,8.6442502212,16.026237046
6,101,2007,1646,715,411,1426,399,931,810,1752,91552,18.152543121,7.8852176982,4.5326216419,11,4.4002823239,10.267325422,8.9329039658
6,101,2008,1612,734,-676,1506,409,878,-267,655,92207,17.544718898,7.9887243618,-7.357462764,44,4.4514826485,9.5559945363,-2.905980115
6,103,2001,675,649,271,997,95,26,366,341,56476,11.988171671,11.526405058,4.8130289226,-51,1.687224161,0.4617666125,6.5002530836
6,103,2002,700,607,391,1007,89,93,480,531,57007,12.336649542,10.697637532,6.8908999586,-42,1.5685168704,1.6390120106,8.459416829
6,103,2003,691,594,791,1014,79,97,870,945,57952,12.021677294,10.334119121,13.761427987,-22,1.374403048,1.6875581729,15.135831035
6,103,2004,776,647,726,1024,74,129,800,866,58818,13.291085039,11.081613428,12.434700694,-63,1.267448831,2.2094716109,13.702149525
6,103,2005,773,584,600,1011,78,189,678,817,59635,13.051590082,9.8604509806,10.130600322,-50,1.3169780419,3.1911391016,11.447578364
6,103,2006,843,605,487,1022,80,238,567,773,60408,14.04496722,10.079721433,8.1137592363,-32,1.3328557267,3.9652457869,9.446614963
6,103,2007,855,591,227,1018,67,264,294,548,60956,14.089845424,9.7392966613,3.7408127616,-10,1.104116542,4.3505487624,4.8449293036
6,103,2008,906,586,216,1017,69,320,285,594,61550,14.791112272,9.566878357,3.5263578927,-11,1.1264754379,5.2242339151,4.6528333306
6,105,2001,97,137,-43,237,6,-40,-37,-88,12919,7.4828357633,10.568541233,-3.31713338,-11,0.4628558204,-3.085705469,-2.854277559
6,105,2002,102,148,286,237,6,-46,292,243,13162,7.8217859745,11.349258081,21.931674399,-3,0.4601050573,-3.527472106,22.391779456
6,105,2003,108,137,205,241,5,-29,210,180,13342,8.1497132508,10.338062179,15.469363115,-1,0.3773015394,-2.188348928,15.846664654
6,105,2004,105,154,52,248,3,-49,55,-5,13337,7.8713594962,11.544660594,3.8981970838,-11,0.2248959856,-3.673301098,4.1230930695
6,105,2005,117,145,322,230,5,-28,327,306,13643,8.6730911787,10.748702743,23.869532987,7,0.3706449222,-2.075611564,24.24017791
6,105,2006,120,156,328,219,4,-36,332,284,13927,8.7051142546,11.316648531,23.793978963,-12,0.2901704752,-2.611534276,24.084149438
6,105,2007,123,164,321,237,4,-41,325,214,14141,8.7644292433,11.685905658,22.873022659,-70,0.2850220892,-2.921476414,23.158044748
6,105,2008,129,172,308,243,3,-43,311,176,14317,9.0659919882,12.087989318,21.645934359,-92,0.210837023,-3.021997329,21.856771382
6,107,2001,7282,2693,-2647,6036,2537,4589,-110,4174,372869,19.639572579,7.2630278708,-7.138965753,-305,6.8422954728,12.376544708,-0.296670281
6,107,2002,7282,2677,-686,6056,2400,4605,1714,5955,378824,19.374930989,7.12258861,-1.825213219,-364,6.3855856048,12.252342379,4.5603723861
6,107,2003,7585,2718,1879,6044,2089,4867,3968,8390,387214,19.803195142,7.0962537107,4.9057618552,-445,5.4540375282,12.706941431,10.359799383
6,107,2004,7765,2691,2264,6009,1895,5074,4159,8906,396120,19.825515042,6.8706324505,5.7804206124,-327,4.8382937546,12.954882592,10.618714367
6,107,2005,8200,2692,1904,5965,1997,5508,3901,9022,405142,20.467712184,6.7194001463,4.7525029266,-387,4.9846367355,13.748312038,9.7371396622
6,107,2006,8099,2780,-185,5943,1986,5319,1801,6906,412048,19.82158372,6.8038032771,-0.452771081,-214,4.860558744,13.017780443,4.4077876626
6,107,2007,8574,2801,-454,5901,1805,5773,1351,7124,419172,20.629917471,6.7394913501,-1.092370251,0,4.3430138832,13.890426121,3.2506436323
6,107,2008,8956,2760,-1054,5867,1809,6196,755,7104,426276,21.186400583,6.5290828058,-2.493352637,153,4.2793879695,14.657317777,1.7860353327
6,109,2001,418,577,682,4813,22,-159,704,507,55158,7.6132193172,10.509156809,12.42156836,-38,0.4006957535,-2.895937491,12.822264113
6,109,2002,427,613,707,4853,19,-186,726,513,55671,7.7055644281,11.062086638,12.758393561,-27,0.3428705483,-3.35652221,13.10126411
6,109,2003,466,602,672,4898,12,-136,684,527,56198,8.3311730685,10.762588385,12.01405215,-21,0.2145366455,-2.431415316,12.228588796
6,109,2004,464,625,162,4869,18,-161,180,-26,56172,8.2584319658,11.123965471,2.8833318501,-45,0.3203702056,-2.865533505,3.2037020557
6,109,2005,492,590,212,4825,15,-98,227,83,56255,8.7523459667,10.495699432,3.771336067,-46,0.2668398161,-1.743353465,4.038175883
6,109,2006,458,579,-20,4857,17,-121,-3,-151,56104,8.152439947,10.306250501,-0.356001744,-27,0.3026014827,-2.153810554,-0.053400262
6,109,2007,493,603,-264,4794,13,-110,-251,-377,55727,8.8168754639,10.784129624,-4.721409985,-16,0.2324936735,-1.96725416,-4.488916311
6,109,2008,507,603,21,4895,15,-96,36,-83,55644,9.1047040971,10.828671737,0.3771179212,-23,0.2693699437,-1.72396764,0.6464878649
6,111,2001,11609,4765,-971,11848,4189,6844,3218,9296,765710,15.253684982,6.2609879353,-1.275848748,-766,5.5041507788,8.992697047,4.2283020306
6,111,2002,11452,4794,2092,13039,3718,6658,5810,11711,777421,14.842550632,6.2133415763,2.7113705836,-757,4.8187742972,8.6292090561,7.5301448808
6,111,2003,11891,4848,-882,12863,2768,7043,1886,7799,785220,15.219106628,6.2048800716,-1.128858132,-1130,3.5427203049,9.0142265562,2.4138621731
6,111,2004,11929,5179,-5126,12716,3484,6750,-1642,4450,789670,15.148994533,6.5769672803,-6.509660992,-658,4.4244359924,8.5720272527,-2.085225
6,111,2005,12027,4598,-11190,13316,3328,7429,-7862,-1105,788565,15.241076266,5.8267621742,-14.18039772,-672,4.2173694032,9.4143140914,-9.96302832
6,111,2006,12405,4972,-7851,14586,3449,7433,-4402,2682,791247,15.70440027,6.2944198424,-9.939157317,-349,4.3663423243,9.4099804281,-5.572814993
6,111,2007,12236,4915,-9275,12503,2949,7321,-6326,1209,792456,15.452392273,6.206971888,-11.71305478,214,3.7241831328,9.245420385,-7.988871651
6,111,2008,12244,4951,-5233,12712,3067,7293,-2166,5284,797740,15.399359576,6.2269053626,-6.581578623,157,3.8573861335,9.1724542132,-2.724192489
6,113,2001,2263,1146,2995,8037,1580,1117,4575,5564,175434,13.107290967,6.6376294512,17.347033339,-128,9.1513564859,6.4696615156,26.498389825
6,113,2002,2362,1144,2385,7819,1485,1218,3870,4962,180396,13.276002586,6.4300368153,13.405277801,-126,8.3466824045,6.8459657702,21.751960206
6,113,2003,2450,1186,285,8294,1309,1264,1594,2576,182972,13.484951894,6.5278175293,1.5686576694,-282,7.2048171551,6.9571343652,8.7734748244
6,113,2004,2417,1132,-44,8503,1213,1285,1169,2333,185305,13.125989405,6.1475465478,-0.238950573,-121,6.5874328291,6.9784428569,6.3484822566
6,113,2005,2384,1168,-1345,8323,1264,1216,-81,980,186285,12.831346376,6.2864985602,-7.239161441,-155,6.803197072,6.5448478161,-0.435964369
6,113,2006,2558,1159,781,8453,1259,1399,2040,3338,189623,13.609713015,6.1664024176,4.1552720346,-101,6.6984474925,7.4433105973,10.853719527
6,113,2007,2701,1177,2333,8861,1153,1524,3486,5011,194634,14.058299523,6.1261083077,12.142914768,1,6.0011919106,7.9321912158,18.144106679
6,113,2008,2785,1197,262,8676,1158,1588,1420,3024,197658,14.19860716,6.1025970451,1.3357397041,16,5.9037655624,8.0960101149,7.2395052665
6,115,2001,1084,556,309,1354,223,528,532,1005,61335,17.819422184,9.1398512308,5.0795216373,-55,3.6658036411,8.679570953,8.7453252784
6,115,2002,1009,528,526,1352,91,481,617,1053,62388,16.31062939,8.5351955578,8.5028652716,-45,1.4710280223,7.775433832,9.9738932939
6,115,2003,1218,547,631,1360,-197,671,434,1063,63451,19.358068643,8.6936482331,10.02868745,-42,-3.13098483,10.66442041,6.89770262
6,115,2004,1176,560,-11,1335,357,616,346,918,64369,18.400876232,8.7623220153,-0.17211704,-44,5.5859802848,9.6385542169,5.4138632452
6,115,2005,1223,534,1833,1347,190,689,2023,2650,67019,18.616616434,8.1285962188,27.902091515,-62,2.8921971565,10.488020215,30.794288672
6,115,2006,1311,521,1965,1208,267,790,2232,2982,70001,19.13589257,7.6047292366,28.681944242,-40,3.8972412786,11.531163334,32.57918552
6,115,2007,1409,495,704,1176,137,914,841,1749,71750,19.8799303,6.9840777137,9.9329105262,-6,1.9329669632,12.895852587,11.865877489
6,115,2008,1505,501,132,1242,198,1004,330,1317,73067,20.784852607,6.9190771802,1.8229903948,-17,2.7344855922,13.865775427,4.5574759869
8,0,2001,66627,28057,44912,104247,21456,38570,66368,104130,4431918,15.212154381,6.4059227559,10.254225427,-808,4.8987945486,8.8062316247,15.153019976
8,0,2002,67401,28888,14441,105596,18959,38513,33400,71238,4503156,15.086836438,6.4662027421,3.2324298601,-675,4.2437253458,8.6206336959,7.4761552059
8,0,2003,68595,28975,-7517,106790,14071,39620,6554,45183,4548339,15.15661225,6.4022573067,-1.660941093,-991,3.109099657,8.7543549436,1.4481585639
8,0,2004,68544,29138,-3332,107808,17727,39406,14395,51711,4600050,14.984933413,6.370083301,-0.728434263,-2090,3.8754364293,8.6148501119,3.1470021662
8,0,2005,69155,29200,8600,108222,16699,39955,25299,62684,4662734,14.931795883,6.3047999392,1.8568931328,-2570,3.6056114447,8.6269959442,5.4625045775
8,0,2006,69732,29451,31864,108749,17624,40281,49488,88740,4751474,14.814204233,6.2567132572,6.7693426786,-1029,3.7441280244,8.5574909753,10.513470703
8,0,2007,71868,28413,33021,109789,15096,43455,48117,91296,4842770,14.981482647,5.9229262879,6.8835022332,-276,3.1468868209,9.0585563594,10.030389054
8,0,2008,73983,29725,36878,109306,15520,44258,52398,96686,4939456,15.126005063,6.077348857,7.5397971791,30,3.1731019095,9.0486562057,10.712899089
8,1,2001,5919,2052,3158,3396,2720,3867,5878,9462,360407,16.641550175,5.7692956511,8.8788672837,-283,7.6474094401,10.872254524,16.526276724
8,1,2002,6467,2149,4916,3614,2555,4318,7471,11579,371986,17.659917558,5.8684340238,13.42448658,-210,6.9771283996,11.791483534,20.40161498
8,1,2003,7096,2291,722,3649,2239,4805,2961,7234,379220,18.892287868,6.0995252967,1.9222423676,-532,5.961081248,12.792762571,7.8833236156
8,1,2004,7377,2214,1235,3643,2062,5163,3297,8173,387393,19.245695025,5.7760564979,3.221964668,-287,5.3795070003,13.469638527,8.6014716682
8,1,2005,7616,2347,4139,3626,2162,5269,6301,11190,398583,19.379726607,5.9721925351,10.532128207,-380,5.5014402475,13.407534072,16.033568455
8,1,2006,7722,2249,4464,3657,2160,5473,6624,11871,410454,19.089361797,5.5596962809,11.035342018,-226,5.3396816215,13.529665516,16.375023639
8,1,2007,7968,2199,2701,3671,1963,5769,4664,10379,420833,19.170274526,5.2905915767,6.4983573663,-54,4.7227973011,13.879682949,11.221154667
8,1,2008,7586,2337,2846,3670,1969,5249,4815,10003,430836,17.814432602,5.4880475866,6.6833476386,-61,4.6238620873,12.326385016,11.307209726
8,3,2001,252,112,-136,995,34,140,-102,25,14992,16.822991422,7.4768850763,-9.079074735,-13,2.2697686839,9.3461063453,-6.809306052
8,3,2002,229,119,47,995,34,110,81,177,15169,15.185172905,7.8909850469,3.1166075395,-14,2.2545671563,7.2941878585,5.3711746958
8,3,2003,220,131,-148,995,28,89,-120,-44,15125,14.52432825,8.648577276,-9.770911732,-13,1.8485508682,5.8757509738,-7.922360864
8,3,2004,270,101,-15,995,25,169,10,168,15293,17.752646459,6.6408047866,-0.986258137,-11,1.643763561,11.111841673,0.6575054244
8,3,2005,261,116,-137,995,28,145,-109,22,15315,17.054364872,7.5797177209,-8.951907998,-14,1.8295870361,9.4746471511,-7.122320962
8,3,2006,228,95,-210,995,29,133,-181,-54,15261,14.913657771,6.2140240712,-13.73626374,-6,1.8969126112,8.6996336996,-11.83935113
8,3,2007,264,80,-211,995,26,184,-185,-2,15259,17.300131062,5.2424639581,-13.82699869,-1,1.7038007864,12.057667104,-12.1231979
8,3,2008,266,111,-29,995,25,155,-4,158,15417,17.34254792,7.2369278915,-1.890728909,7,1.6299387143,10.105620029,-0.260790194
8,5,2001,7380,2869,4264,5088,2863,4511,7127,11191,502853,14.841405107,5.7696465111,8.5750340618,-447,5.7575803281,9.0717585959,14.33261439
8,5,2002,7501,2901,225,5308,2615,4600,2840,6916,509769,14.815005007,5.7296799793,0.4443908981,-524,5.1648097711,9.0853250275,5.6092006692
8,5,2003,8028,2894,-1587,5461,2159,5134,572,5039,514808,15.670857339,5.6491605804,-3.097863801,-667,4.2144221469,10.021696759,1.1165583455
8,5,2004,8042,2884,-1399,5742,2249,5158,850,5619,520427,15.536568992,5.5716817921,-2.702767971,-389,4.344907195,9.9648871995,1.6421392244
8,5,2005,8116,3057,-1056,5757,2257,5059,1201,5822,526249,15.508141966,5.8413491854,-2.017816402,-438,4.3127003963,9.6667927802,2.2948839947
8,5,2006,8025,2943,-961,5307,2308,5082,1347,6154,532403,15.160789381,5.5599007039,-1.815516336,-275,4.360261918,9.6008886773,2.5447455821
8,5,2007,8393,3079,3628,5762,2043,5314,5671,10904,543307,15.604577442,5.7245912002,6.7453123983,-81,3.7984215077,9.8799862416,10.543733906
8,5,2008,8383,3179,3589,5728,2073,5204,5662,10975,554282,15.27529886,5.7926965376,6.539788573,109,3.7773702178,9.482602322,10.317158791
8,7,2001,114,59,395,84,4,55,399,454,10492,11.105698977,5.7476863127,38.480272772,0,0.3896736483,5.3580126644,38.86994642
8,7,2002,125,59,390,84,4,66,394,459,10951,11.658816397,5.5029613394,36.375507159,-1,0.3730821247,6.1558550576,36.748589283
8,7,2003,118,59,161,84,2,59,163,215,11166,10.670524936,5.3352624678,14.558936565,-7,0.1808563548,5.3352624678,14.739792919
8,7,2004,129,63,149,84,1,66,150,205,11371,11.447841328,5.5908062298,13.222700448,-11,0.088742956,5.8570350978,13.311443404
8,7,2005,108,62,205,84,2,46,207,244,11615,9.3970242756,5.3945880101,17.836944227,-9,0.1740189681,4.0024362656,18.010963195
8,7,2006,105,64,454,84,1,41,455,488,12103,8.8540349102,5.3967450881,38.283160469,-8,0.084324142,3.4572898221,38.367484611
8,7,2007,151,71,358,84,2,80,360,435,12538,12.255996104,5.762753135,29.057262286,-5,0.1623310742,6.493242969,29.219593361
8,7,2008,141,63,34,84,1,78,35,110,12648,11.196696577,5.0027793218,2.6999126499,-3,0.0794091956,6.1939172556,2.7793218455
8,9,2001,40,68,-1,85,2,-28,1,-32,4469,8.9186176143,15.161649944,-0.22296544,-5,0.4459308807,-6.24303233,0.2229654404
8,9,2002,40,64,-113,85,2,-24,-111,-135,4334,9.0878109735,14.540497558,-25.673066,0,0.4543905487,-5.452686584,-25.21867545
8,9,2003,33,63,-206,85,1,-30,-205,-226,4108,7.8180525942,14.925373134,-48.80360104,9,0.2369106847,-7.10732054,-48.56669036
8,9,2004,27,55,-23,85,0,-28,-23,-54,4054,6.616025484,13.477088949,-5.63587356,-3,0,-6.861063465,-5.63587356
8,9,2005,36,56,-49,85,1,-20,-48,-71,3983,8.9585666293,13.93554809,-12.19360458,-3,0.248849073,-4.976981461,-11.94475551
8,9,2006,39,63,-46,85,0,-24,-46,-72,3911,9.8809222194,15.961489739,-11.65442108,-2,0,-6.08056752,-11.65442108
8,9,2007,47,56,-41,85,1,-9,-40,-47,3864,12.090032154,14.405144695,-10.54662379,2,0.2572347267,-2.31511254,-10.28938907
8,9,2008,40,58,-12,85,0,-18,-12,-30,3834,10.392309691,15.068849052,-3.117692907,0,0,-4.676539361,-3.117692907
8,11,2001,68,64,-202,878,7,4,-195,-200,5768,11.588275392,10.906612134,-34.42399455,-9,1.1929107021,0.6816632584,-33.23108384
8,11,2002,66,78,152,1067,7,-12,159,146,5914,11.299435028,13.353877761,26.022941277,-1,1.1984249272,-2.054442732,27.221366204
8,11,2003,61,67,235,1408,4,-6,239,245,6159,10.105193407,11.099146857,38.929843452,12,0.6626356332,-0.99395345,39.592479086
8,11,2004,63,66,60,1505,3,-3,63,54,6213,10.1842871,10.669253152,9.6993210475,-6,0.4849660524,-0.484966052,10.1842871
8,11,2005,62,49,-33,1565,4,13,-29,-22,6191,9.9967752338,7.9006772009,-5.320864237,-6,0.6449532409,2.0960980329,-4.675910996
8,11,2006,63,73,-55,1548,3,-10,-52,-63,6128,10.22810293,11.851611332,-8.929296209,-1,0.4870525205,-1.623508402,-8.442243689
8,11,2007,66,42,-292,1520,3,24,-289,-259,5869,11.002750688,7.0017504376,-48.67883638,6,0.5001250313,4.0010002501,-48.17871134
8,11,2008,58,43,14,1517,2,15,16,33,5902,9.8547277207,7.3060912412,2.3787273809,2,0.3398181973,2.5486364795,2.7185455781
8,13,2001,3559,1357,2475,8506,1641,2202,4116,6105,277756,12.955786876,4.9398715342,9.0097141099,-213,5.9737134765,8.0159153414,14.983427586
8,13,2002,3598,1323,-1489,8506,1530,2275,41,2076,279832,12.905586203,4.7454392849,-5.340860994,-240,5.4879229826,8.1601469185,0.1470619884
8,13,2003,3525,1450,-3793,8506,1355,2075,-2438,-514,279318,12.6084235,5.1864437092,-13.56702137,-151,4.8466422248,7.4219797908,-8.720379147
8,13,2004,3572,1443,-1414,8506,1234,2129,-180,1731,281049,12.748787848,5.1501962107,-5.046692614,-218,4.4042564962,7.5985916373,-0.642436118
8,13,2005,3511,1386,-2095,8506,1289,2125,-806,1066,282115,12.468836786,4.9221896286,-7.440106257,-253,4.5777073819,7.5466471578,-2.862398875
8,13,2006,3529,1478,-260,8506,1282,2051,1022,2935,285050,12.444350409,5.2118871933,-0.916840778,-138,4.5207302989,7.2324632162,3.6038895207
8,13,2007,3427,1412,582,8506,1181,2015,1763,3755,288805,11.943783708,4.9211037631,2.0283869619,-23,4.1160223401,7.0226799453,6.144409302
8,13,2008,3652,1440,971,8506,1183,2212,2154,4356,293161,12.550561373,4.9487427101,3.3369647024,-10,4.0655296014,7.6018186629,7.4024943038
8,14,2001,576,210,474,7,128,366,602,1892,41450,14.220817697,5.1846731187,11.702547897,924,3.1601817104,9.0361445783,14.862729607
8,14,2002,605,198,-192,7,123,407,-69,1095,42545,14.405619382,4.7145663432,-4.571700696,757,2.9287457587,9.6910530389,-1.642954938
8,14,2003,639,186,1107,169,102,453,1209,2582,45127,14.577059951,4.243087873,25.253216534,920,2.32685464,10.333972078,27.580071174
8,14,2004,615,219,130,169,94,396,224,1499,46626,13.405556222,4.773685874,2.8336948111,879,2.0489793249,8.6318703476,4.882674136
8,14,2005,650,201,423,169,100,449,523,1913,48539,13.660484422,4.2242421058,8.8898229391,941,2.101612988,9.436242316,10.991435927
8,14,2006,674,228,1270,180,102,446,1372,2915,51454,13.480943666,4.5603192223,25.401778124,1097,2.04014281,8.9206244437,27.441920934
8,14,2007,729,229,1546,180,87,500,1633,2166,53620,13.875935055,4.3588328226,29.426880104,33,1.6559757885,9.5171022327,31.082855892
8,14,2008,867,271,540,180,88,596,628,1238,54858,15.984807979,4.996404801,9.9559357658,14,1.6224487915,10.988403179,11.578384557
8,15,2001,157,146,66,1337,11,11,77,74,16390,9.6006848896,8.9280254388,4.0359567052,-14,0.6726594509,0.6726594509,4.7086161561
8,15,2002,139,163,302,1333,11,-24,313,283,16673,8.4081904243,9.8599643106,18.268154735,-6,0.6653963645,-1.451773886,18.933551099
8,15,2003,136,139,28,1360,7,-3,35,10,16683,8.1544549706,8.3343326538,1.6788583763,-22,0.4197145941,-0.179877683,2.0985729704
8,15,2004,147,147,55,1332,5,0,60,46,16729,8.7992338082,8.7992338082,3.2922303364,-14,0.2992936669,0,3.5915240034
8,15,2005,151,138,-23,1338,7,13,-16,-13,16716,9.0297503364,8.252354612,-1.375392435,-10,0.4185976977,0.7773957243,-0.956794738
8,15,2006,140,166,-56,1336,6,-26,-50,-85,16631,8.3965574115,9.9559180736,-3.358622965,-9,0.3598524605,-1.559360662,-2.998770504
8,15,2007,133,145,123,1322,5,-12,128,102,16733,7.9726651481,8.6920033569,7.3732166407,-14,0.2997242537,-0.719338209,7.6729408944
8,15,2008,144,154,287,1389,4,-10,291,262,16995,8.5388994307,9.1318785579,17.018500949,-19,0.2371916509,-0.592979127,17.2556926
8,17,2001,17,15,-51,30,8,2,-43,-42,2176,7.7378243059,6.8274920346,-23.21347292,-1,3.6413290851,0.9103322713,-19.57214383
8,17,2002,29,20,-86,30,8,9,-78,-68,2108,13.538748833,9.3370681606,-40.14939309,1,3.7348272642,4.2016806723,-36.41456583
8,17,2003,20,32,-109,30,1,-12,-108,-116,1992,9.756097561,15.609756098,-53.17073171,4,0.487804878,-5.853658537,-52.68292683
8,17,2004,18,28,-43,30,0,-10,-43,-55,1937,9.1626368033,14.252990583,-21.88852125,-2,0,-5.09035378,-21.88852125
8,17,2005,23,27,-53,30,1,-4,-52,-57,1880,12.051349227,14.147236049,-27.77050039,-1,0.5239717055,-2.095886822,-27.24652869
8,17,2006,23,23,-46,30,0,0,-46,-46,1834,12.385568121,12.385568121,-24.77113624,0,0,0,-24.77113624
8,17,2007,24,10,-90,30,1,14,-89,-78,1756,13.370473538,5.5710306407,-50.13927577,-3,0.5571030641,7.7994428969,-49.5821727
8,17,2008,16,14,-5,30,0,2,-5,-7,1749,9.1298145506,7.9885877318,-2.853067047,-4,0,1.1412268188,-2.853067047
8,19,2001,109,37,30,42,2,72,32,91,9401,11.65090054,3.9548928438,3.2066698733,-13,0.2137779916,7.696007696,3.4204478649
8,19,2002,106,47,41,42,2,59,43,94,9495,11.219305673,4.9745977985,4.3395427604,-8,0.2116850127,6.2447078747,4.5512277731
8,19,2003,91,47,-194,42,1,44,-193,-156,9339,9.6633747478,4.9909737708,-20.60104067,-7,0.1061909313,4.672400977,-20.49484974
8,19,2004,103,46,-330,42,0,57,-330,-286,9053,11.200521966,5.0021748586,-35.88516746,-13,0,6.1983471074,-35.88516746
8,19,2005,96,60,-67,42,1,36,-66,-36,9017,10.625345877,6.6408411732,-7.415605977,-6,0.1106806862,3.9845047039,-7.304925291
8,19,2006,122,41,-199,42,0,81,-199,-122,8895,13.622152747,4.5779365788,-22.21974096,-4,0,9.0442161679,-22.21974096
8,19,2007,79,34,9,42,1,45,10,38,8933,8.8624635405,3.8142248149,1.0096477451,-17,0.1121830828,5.0482387256,1.1218308279
8,19,2008,94,47,-47,42,0,47,-47,-25,8908,10.537525923,5.2687629617,-5.268762962,-25,0,5.2687629617,-5.268762962
8,21,2001,131,73,-138,53,9,58,-129,-76,8322,15.669856459,8.7320574163,-16.50717703,-5,1.0765550239,6.9377990431,-15.43062201
8,21,2002,106,74,-51,53,9,32,-42,-17,8305,12.750345823,8.9011848199,-6.134600349,-7,1.0825765321,3.8491610032,-5.052023817
8,21,2003,109,73,-113,53,4,36,-109,-76,8229,13.18495222,8.8302891012,-13.66880368,-3,0.4838514576,4.3546631184,-13.18495222
8,21,2004,123,76,-26,53,3,47,-23,18,8247,14.930808449,9.2255401797,-3.156105851,-6,0.3641660597,5.705268269,-2.791939791
8,21,2005,122,72,-90,53,4,50,-86,-43,8204,14.831925111,8.7532672786,-10.9415841,-7,0.4862926266,6.0786578324,-10.45529147
8,21,2006,116,49,-155,53,3,67,-152,-88,8116,14.215686275,6.0049019608,-18.99509804,-3,0.3676470588,8.2107843137,-18.62745098
8,21,2007,123,72,-118,53,1,51,-117,-64,8052,15.21523998,8.9064819396,-14.59673429,2,0.1237011381,6.3087580406,-14.47303315
8,21,2008,139,57,-60,53,0,82,-60,15,8067,17.246727464,7.0723990322,-7.44463056,-7,0,10.174328432,-7.44463056
8,23,2001,47,38,-104,0,4,9,-100,-93,3575,12.97804777,10.492889687,-28.7173823,-2,1.1045147039,2.4851580837,-27.6128676
8,23,2002,43,32,-27,0,4,11,-23,-18,3557,12.05832866,8.9736399327,-7.571508693,-6,1.1217049916,3.0846887269,-6.449803702
8,23,2003,48,46,-34,0,-1,2,-35,-38,3519,13.566986998,13.001695873,-9.609949124,-5,-0.282645562,0.5652911249,-9.892594686
8,23,2004,28,51,-2,0,0,-23,-2,-29,3490,7.9897274932,14.552717934,-0.570694821,-4,0,-6.562990441,-0.570694821
8,23,2005,40,32,-137,0,0,8,-137,-129,3361,11.677127427,9.3417019413,-39.99416144,0,0,2.3354254853,-39.99416144
8,23,2006,37,40,-16,0,0,-3,-16,-20,3341,11.041480155,11.936735303,-4.774694121,-1,0,-0.895255148,-4.774694121
8,23,2007,32,26,-42,0,0,6,-42,-49,3292,9.6487260666,7.8395899291,-12.66395296,-13,0,1.8091361375,-12.66395296
8,23,2008,32,15,-57,0,0,17,-57,-60,3232,9.8099325567,4.598405886,-17.47394237,-20,0,5.2115266708,-17.47394237
8,25,2001,42,40,147,2248,1,2,148,149,5682,7.4899687918,7.1333036112,26.214890771,-1,0.1783325903,0.3566651806,26.393223362
8,25,2002,41,49,120,2381,1,-8,121,111,5793,7.1459694989,8.5403050109,20.91503268,-2,0.174291939,-1.394335512,21.089324619
8,25,2003,43,49,-162,2256,1,-6,-161,-164,5629,7.5293293644,8.5799334617,-28.36631063,3,0.1751006829,-1.050604097,-28.19120995
8,25,2004,54,53,307,2531,0,1,307,293,5922,9.3498398407,9.1766946585,53.155570946,-15,0,0.1731451822,53.155570946
8,25,2005,38,48,35,2646,1,-10,36,22,5944,6.4048542053,8.0903421541,5.8992078207,-4,0.1685487949,-1.685487949,6.0677566155
8,25,2006,33,48,299,2986,0,-15,299,279,6223,5.4245089176,7.8901947892,49.149338374,-5,0,-2.465685872,49.149338374
8,25,2007,31,28,390,3435,1,3,391,397,6620,4.827532508,4.3603519427,60.733473488,3,0.1557268551,0.4671805653,60.889200343
8,25,2008,41,29,-294,3190,0,12,-294,-288,6332,6.3310685608,4.4780728845,-45.39839407,-6,0,1.8529956763,-45.39839407
8,27,2001,28,15,110,16,1,13,111,122,3636,7.8321678322,4.1958041958,30.769230769,-2,0.2797202797,3.6363636364,31.048951049
8,27,2002,32,27,28,16,1,5,29,31,3667,8.7635218403,7.3942215528,7.6680816103,-3,0.2738600575,1.3693002876,7.9419416678
8,27,2003,25,28,125,16,1,-3,126,129,3796,6.6997186118,7.5036848452,33.498593059,6,0.2679887445,-0.803966233,33.766581804
8,27,2004,35,20,15,16,0,15,15,26,3822,9.188763455,5.2507219743,3.9380414807,-4,0,3.9380414807,3.9380414807
8,27,2005,24,31,67,16,1,-7,68,59,3881,6.2313384396,8.0488121511,17.39581981,-2,0.2596391016,-1.817473712,17.655458912
8,27,2006,17,33,17,16,0,-16,17,-2,3879,4.381443299,8.5051546392,4.381443299,-3,0,-4.12371134,4.381443299
8,27,2007,19,19,127,16,1,0,128,122,4001,4.8223350254,4.8223350254,32.233502538,-6,0.2538071066,0,32.487309645
8,27,2008,23,24,12,16,0,-1,12,-2,3999,5.75,6,3,-13,0,-0.25,3
8,29,2001,323,313,175,929,75,10,250,234,28148,11.522956726,11.16620884,6.2430880097,-26,2.675609147,0.3567478863,8.9186971567
8,29,2002,320,339,579,923,74,-19,653,624,28772,11.243851019,11.911454673,20.344342937,-10,2.6001405481,-0.667603654,22.944483486
8,29,2003,345,332,178,890,55,13,233,221,28993,11.944949364,11.494849823,6.1629014109,-25,1.9042672899,0.4500995412,8.0671687008
8,29,2004,328,302,369,923,48,26,417,409,29402,11.233838514,10.343351314,12.638068328,-34,1.6439763678,0.8904871992,14.282044696
8,29,2005,337,339,69,934,55,-2,124,92,29494,11.443901114,11.511817441,2.3431132844,-30,1.8676989948,-0.067916327,4.2108122793
8,29,2006,344,305,239,935,54,39,293,318,29812,11.60084983,10.285637204,8.0598927596,-14,1.8210636361,1.315212626,9.8809563956
8,29,2007,364,323,310,909,45,41,355,411,30223,12.126259682,10.760389773,10.32730907,15,1.4991255101,1.3658699092,11.82643458
8,29,2008,385,320,574,918,45,65,619,700,30923,12.59281065,10.466751709,18.774735878,16,1.4718869591,2.1260589409,20.246622837
8,31,2001,11400,4517,-4771,12919,6854,6883,2083,8461,564528,20.346333867,8.0617886034,-8.5151192,-505,12.232787046,12.284545264,3.7176678461
8,31,2002,10835,4594,-15665,12988,6467,6241,-9198,-3051,561477,19.245029995,8.1598216704,-27.82403275,-94,11.486627502,11.085208325,-16.33740525
8,31,2003,10445,4276,-14292,13128,5702,6169,-8590,-2285,559192,18.640651254,7.6311560327,-25.50619318,136,10.176064476,11.009495221,-15.3301287
8,31,2004,10316,4346,-9791,13354,5160,5970,-4631,679,559871,18.436852974,7.7672123911,-17.498568,-660,9.2220009061,10.669640583,-8.276567092
8,31,2005,10396,4277,-7584,13378,5444,6119,-2140,3482,563353,18.511000477,7.6155780147,-13.50398496,-497,9.6935250671,10.895422462,-3.81045989
8,31,2006,10222,4214,-2357,13379,5409,6008,3052,8768,572121,18.00481561,7.4224508884,-4.151570181,-292,9.5272987316,10.582364722,5.3757285504
8,31,2007,10239,3919,-353,13257,4934,6320,4581,10739,582860,17.730161795,6.7862588216,-0.611265467,-162,8.5438634921,10.943902973,7.9325980254
8,31,2008,11186,4217,3932,13261,4940,6969,8872,15847,598707,18.934178087,7.1379786335,6.6555684104,6,8.3617771993,11.796199454,15.01734561
8,33,2001,23,20,-12,0,1,3,-11,-11,1835,12.496604184,10.866612334,-6.5199674,-3,0.5433306167,1.62999185,-5.976636783
8,33,2002,23,21,6,0,1,2,7,7,1842,12.510198531,11.422355181,3.2635300517,-2,0.5439216753,1.0878433506,3.807451727
8,33,2003,18,23,-35,0,1,-5,-34,-40,1802,9.8792535675,12.62349067,-19.20965971,-1,0.5488474204,-2.744237102,-18.66081229
8,33,2004,25,18,-10,0,0,7,-10,-4,1798,13.888888889,10,-5.555555556,-1,0,3.8888888889,-5.555555556
8,33,2005,22,11,-5,0,1,11,-4,5,1803,12.218828103,6.1094140517,-2.777006387,-2,0.5554012774,6.1094140517,-2.22160511
8,33,2006,21,19,86,0,0,2,86,87,1890,11.372867587,10.289737341,46.574600596,-1,0,1.0831302464,46.574600596
8,33,2007,27,12,4,0,1,15,5,18,1908,14.218009479,6.3191153239,2.1063717746,-2,0.5265929437,7.8988941548,2.6329647183
8,33,2008,25,8,64,0,0,17,64,78,1986,12.840267078,4.1088854648,32.871083719,-3,0,8.7313816127,32.871083719
8,35,2001,3656,485,13289,466,430,3171,13719,17000,197290,19.365432491,2.5689920017,70.390380846,110,2.2776630118,16.796440489,72.668043858
8,35,2002,3760,504,8956,466,389,3256,9345,12687,209977,18.464545372,2.4750348052,43.980975625,86,1.9102947207,15.989510567,45.891270346
8,35,2003,3993,531,7915,466,313,3462,8228,11944,221921,18.490476918,2.4589139102,36.652172504,254,1.4494162974,16.031563008,38.101588801
8,35,2004,3982,590,9577,466,343,3392,9920,12860,234781,17.438066836,2.5837416959,41.939820715,-452,1.5020735622,14.85432514,43.441894277
8,35,2005,4183,592,7551,466,343,3591,7894,11295,246076,17.398103802,2.4622704879,31.406426443,-190,1.4266195563,14.935833314,32.833045999
8,35,2006,4114,661,9481,466,356,3453,9837,13130,259206,16.283976077,2.6163607649,37.527558868,-160,1.4091141185,13.667615312,38.936672987
8,35,2007,4238,730,7959,466,314,3508,8273,11826,271032,15.985274537,2.7534805125,30.020481369,45,1.1843738095,13.231794025,31.204855178
8,35,2008,4479,710,5474,466,321,3769,5795,9589,280621,16.238468748,2.5740818957,19.845808869,25,1.1637750542,13.664386852,21.009583923
8,37,2001,787,66,89,353,633,721,722,1400,43383,18.438254106,1.5462830635,2.0851392826,-43,14.830260291,16.891971042,16.915399574
8,37,2002,770,81,-117,353,593,689,476,1118,44501,17.52309863,1.8433389468,-2.662600701,-47,13.495061672,15.679759683,10.832460971
8,37,2003,832,88,-354,353,522,744,168,865,45366,18.516251794,1.958449709,-7.878309057,-47,11.617167592,16.557802085,3.7388585354
8,37,2004,793,86,-92,353,466,707,374,1051,46417,17.279888432,1.8739853786,-2.004728545,-30,10.154385888,15.405903054,8.149657344
8,37,2005,766,85,338,353,499,681,837,1476,47893,16.24430071,1.8025660057,7.1678507051,-42,10.582122787,14.441734705,17.749973492
8,37,2006,853,97,282,353,497,756,779,1507,49400,17.534663337,1.9939769562,5.7969226974,-28,10.216562343,15.54068638,16.01348504
8,37,2007,882,65,255,353,451,817,706,1491,50891,17.588816544,1.2962279766,5.085202062,-32,8.9938279606,16.292588567,14.079030023
8,37,2008,878,111,271,353,450,767,721,1440,52331,17.011877313,2.1507043072,5.2508186239,-48,8.7190715158,14.861173006,13.96989014
8,39,2001,248,83,900,35,9,165,909,1071,21169,12.01928902,4.0225846318,43.618387574,-3,0.4361838757,7.9967043885,44.054571449
8,39,2002,235,90,471,35,7,145,478,617,21786,10.941683157,4.1904318473,21.929926667,-6,0.325922477,6.7512513095,22.255849144
8,39,2003,217,89,75,37,3,128,78,175,21961,9.9206802752,4.0688504355,3.4288065467,-31,0.1371522619,5.8518298398,3.5659588086
8,39,2004,213,104,89,47,6,109,95,189,22150,9.6574550566,4.7153771168,4.035274648,-15,0.2720409875,4.9420779397,4.3073156356
8,39,2005,200,89,144,53,4,111,148,238,22388,8.9810947955,3.996587184,6.4663882527,-21,0.1796218959,4.9845076115,6.6460101486
8,39,2006,198,88,157,53,5,110,162,260,22648,8.7929656275,3.9079847233,6.9722000178,-12,0.2220445866,4.8849809042,7.1942446043
8,39,2007,189,104,-82,53,4,85,-78,8,22656,8.3436341162,4.5912060745,-3.619989405,1,0.176584849,3.7524280417,-3.443404556
8,39,2008,198,97,160,53,5,101,165,273,22929,8.6870681145,4.2557858945,7.0198530218,7,0.2193704069,4.43128222,7.2392234288
8,41,2001,8358,3023,8654,15490,1115,5335,9769,16120,535556,15.844669912,5.7308491439,16.405811608,1016,2.1137601043,10.113820768,18.519571712
8,41,2002,8714,3137,3145,15428,-100,5577,3045,9306,544862,16.130793822,5.8070117306,5.8218208138,684,-0.185113539,10.323782092,5.6367072744
8,41,2003,8441,3218,2907,15429,-2327,5223,580,6390,551252,15.401682672,5.8716520362,5.3041928121,587,-4.245908728,9.5300306355,1.0582840836
8,41,2004,8247,3383,-531,15526,2373,4864,1842,7644,558896,14.857478462,6.0946828711,-0.956629206,938,4.2751056616,8.7627955912,3.3184764554
8,41,2005,8560,3251,2544,15547,691,5309,3235,8520,567416,15.20005114,5.7728231609,4.5173983763,-24,1.2270134741,9.4272279795,5.7444118504
8,41,2006,8645,3435,5683,16080,1614,5210,7297,12514,579930,15.069560534,5.9877316869,9.9063403716,7,2.8134494738,9.0818288467,12.719789845
8,41,2007,9182,3264,-402,16022,598,5918,196,6146,586076,15.74949014,5.598598978,-0.68953333,32,1.0257237098,10.150891162,0.3361903798
8,41,2008,9136,3457,3088,16010,983,5679,4071,9977,596053,15.456857923,5.8487694659,5.2244721177,227,1.663101066,9.6080884574,6.8875731836
8,43,2001,447,477,519,9061,23,-30,542,471,46750,9.6099065883,10.254866762,11.157811005,-41,0.4944694665,-0.644960174,11.652280472
8,43,2002,406,472,537,9109,17,-66,554,453,47203,8.6426191819,10.04757698,11.431247539,-35,0.3618830692,-1.404957798,11.793130608
8,43,2003,420,532,88,9164,6,-112,94,-83,47120,8.9055691613,11.280387604,1.8659287767,-65,0.1272224166,-2.374818443,1.9931511932
8,43,2004,402,501,-134,9280,22,-99,-112,-247,46873,8.5538284766,10.660368325,-2.851276159,-36,0.4681199664,-2.106539849,-2.383156192
8,43,2005,403,498,204,9243,16,-95,220,84,46957,8.5900031973,10.614941916,4.3482894597,-41,0.3410423106,-2.024938719,4.6893317702
8,43,2006,439,487,256,9219,20,-48,276,206,47163,9.3285167871,10.348491288,5.4398640034,-22,0.4249893753,-1.019974501,5.8648533787
8,43,2007,433,467,186,9197,14,-34,200,168,47331,9.1646030436,9.8842254535,3.9367578894,2,0.29631511,-0.71962241,4.2330729993
8,43,2008,448,479,-55,9007,16,-31,-39,-48,47283,9.4700572854,10.125351428,-1.16261864,22,0.3382163316,-0.655294143,-0.824402308
8,45,2001,805,273,509,850,310,532,819,1318,45555,17.930327869,6.080719886,11.337312901,-33,6.9048467569,11.849607983,18.242159658
8,45,2002,814,286,445,848,294,528,739,1234,46789,17.629732305,6.1942302694,9.6378757689,-33,6.3674954518,11.435502036,16.005371221
8,45,2003,870,291,-159,849,259,579,100,620,47409,18.471729761,6.1784751269,-3.375867853,-59,5.4990551816,12.293254634,2.1231873288
8,45,2004,808,282,-199,843,231,526,32,520,47929,16.95021922,5.9157943317,-4.174620823,-38,4.8459166335,11.034424888,0.6712958107
8,45,2005,838,274,575,848,239,564,814,1337,49266,17.243685375,5.6381501106,11.831884356,-41,4.9179484541,11.605535264,16.74983281
8,45,2006,897,279,1230,852,241,618,1471,2058,51324,17.834774829,5.5472711005,24.455711303,-31,4.7917288001,12.287503728,29.247440103
8,45,2007,965,282,1114,847,225,683,1339,2029,53353,18.437670166,5.3880030952,21.284522866,7,4.2989386398,13.049667071,25.583461505
8,45,2008,1002,287,1124,847,226,715,1350,2073,55426,18.422673494,5.2767537852,20.6657535,8,4.1552137821,13.145919709,24.820967282
8,47,2001,58,16,-23,24,2,42,-21,16,4831,12.025710139,3.3174372797,-4.76881609,-5,0.41467966,8.7082728592,-4.35413643
8,47,2002,64,26,-9,24,1,38,-8,27,4858,13.210857674,5.3669109299,-1.85777686,-3,0.2064196512,7.8439467437,-1.651357209
8,47,2003,51,29,-8,24,0,22,-8,6,4864,10.491668381,5.965850648,-1.645751903,-8,0,4.525817733,-1.645751903
8,47,2004,56,24,-35,24,1,32,-34,-6,4858,11.52026332,4.9372557087,-7.200164575,-4,0.2057189879,6.5830076116,-6.994445587
8,47,2005,54,20,46,24,1,34,47,77,4935,11.02828551,4.0845501889,9.3944654345,-4,0.2042275094,6.9437353211,9.5986929439
8,47,2006,70,29,74,24,1,41,75,112,5047,14.025245442,5.8104588259,14.826688038,-4,0.2003606492,8.2147866159,15.027048688
8,47,2007,59,11,-10,24,1,48,-9,38,5085,11.646269246,2.171338334,-1.97394394,-1,0.197394394,9.474930912,-1.776549546
8,47,2008,53,24,36,24,1,29,37,68,5153,10.353584685,4.6884157062,7.0326235593,2,0.1953506544,5.6651689783,7.2279742137
8,49,2001,151,62,53,393,23,89,76,154,12644,12.015596403,4.9335561391,4.2173947641,-11,1.8301901806,7.0820402642,6.0475849447
8,49,2002,162,67,206,393,23,95,229,317,12961,12.653778559,5.2333528608,16.090607303,-7,1.7965241164,7.4204256981,17.88713142
8,49,2003,163,55,-48,393,14,108,-34,55,13016,12.549563075,4.234515148,-3.695576856,-19,1.0778765831,8.315047927,-2.617700273
8,49,2004,144,41,65,393,13,103,78,170,13186,10.991527364,3.1295320968,4.9614533242,-11,0.9922906648,7.8619952675,5.953743989
8,49,2005,141,74,-144,393,14,67,-130,-72,13114,10.72243346,5.6273764259,-10.95057034,-9,1.0646387833,5.0950570342,-9.885931559
8,49,2006,141,60,172,393,13,81,185,257,13371,10.647536341,4.5308665282,12.988484048,-9,0.9816877478,6.1166698131,13.970171795
8,49,2007,166,37,71,393,8,129,79,194,13565,12.325512326,2.7472527473,5.2717552718,-14,0.594000594,9.5782595783,5.8657558658
8,49,2008,161,54,117,393,7,107,124,216,13781,11.775031083,3.9493893074,8.557010166,-15,0.5119578732,7.8256417758,9.0689680392
8,51,2001,188,66,59,1042,21,122,80,188,14193,13.334279027,4.6811830626,4.1846939499,-14,1.4894673381,8.6530959643,5.674161288
8,51,2002,171,71,14,1110,21,100,35,120,14313,11.997474216,4.981407423,0.982249351,-15,1.4733740265,7.016066793,2.4556233775
8,51,2003,179,71,-173,1066,17,108,-156,-59,14254,12.531942451,4.9707704694,-12.11187734,-11,1.1901844786,7.5611719817,-10.92169286
8,51,2004,165,68,-41,902,18,97,-23,64,14318,11.549769005,4.7599048019,-2.869942601,-10,1.2599748005,6.7898642027,-1.609967801
8,51,2005,167,72,-10,843,18,95,8,92,14410,11.626287942,5.0125313283,-0.696184907,-11,1.2531328321,6.6137566138,0.5569479254
8,51,2006,158,52,145,843,18,106,163,262,14672,10.86582766,3.5760951791,9.9718038649,-7,1.2378791005,7.2897324806,11.209682965
8,51,2007,169,44,139,843,16,125,155,266,14938,11.415062479,2.9719689294,9.388720027,-14,1.0807159743,8.4430935495,10.469436001
8,51,2008,186,61,82,843,16,125,98,209,15147,12.36496593,4.0551769985,5.451221539,-14,1.0636529832,8.3097889314,6.5148745222
8,53,2001,6,5,24,0,1,1,25,25,815,7.476635514,6.230529595,29.906542056,-1,1.246105919,1.246105919,31.152647975
8,53,2002,10,5,-24,0,1,5,-23,-18,797,12.406947891,6.2034739454,-29.77667494,0,1.2406947891,6.2034739454,-28.53598015
8,53,2003,6,1,-27,0,1,5,-26,-20,777,7.623888183,1.2706480305,-34.30749682,1,1.2706480305,6.3532401525,-33.03684879
8,53,2004,9,1,25,0,0,8,25,32,809,11.349306431,1.2610340479,31.525851198,-1,0,10.088272383,31.525851198
8,53,2005,7,3,-21,0,1,4,-20,-17,792,8.7445346658,3.7476577139,-26.233604,-1,1.249219238,4.9968769519,-24.98438476
8,53,2006,7,7,33,0,0,0,33,34,826,8.652657602,8.652657602,40.791100124,1,0,0,40.791100124
8,53,2007,8,0,7,0,1,8,8,16,842,9.5923261391,0,8.3932853717,0,1.1990407674,9.5923261391,9.5923261391
8,53,2008,11,2,-10,0,0,9,-10,-2,840,13.079667063,2.3781212842,-11.89060642,-1,0,10.701545779,-11.89060642
8,55,2001,74,89,61,1061,8,-15,69,48,7871,9.4303555499,11.341914107,7.7736714668,-6,1.0194978973,-1.911558557,8.7931693641
8,55,2002,83,98,67,1035,8,-15,75,55,7926,10.508324365,12.40741913,8.4826232829,-5,1.0128505412,-1.899094765,9.4954738241
8,55,2003,78,114,55,1165,5,-36,60,13,7939,9.8329656477,14.371257485,6.9335014182,-11,0.6303183107,-4.538291837,7.563819729
8,55,2004,74,92,-191,1086,4,-18,-187,-216,7723,9.449623292,11.748180309,-24.3902439,-11,0.5107904482,-2.298557017,-23.87945345
8,55,2005,61,96,87,1167,5,-35,92,52,7775,7.8719834817,12.388695316,11.22725513,-5,0.6452445477,-4.516711834,11.872499677
8,55,2006,60,93,80,1173,4,-33,84,47,7822,7.6937872668,11.925370264,10.258383022,-4,0.5129191511,-4.231582997,10.771302173
8,55,2007,59,85,22,1167,5,-26,27,-8,7814,7.5466871323,10.872345869,2.8140189307,-9,0.639549757,-3.325658736,3.4535686876
8,55,2008,65,93,161,1172,4,-28,165,124,7938,8.2529202641,11.808024378,20.441848654,-13,0.5078720163,-3.555104114,20.94972067
8,57,2001,17,18,-54,10,2,-1,-52,-53,1523,10.971281058,11.616650532,-34.8499516,0,1.290738948,-0.645369474,-33.55921265
8,57,2002,17,9,-9,10,2,8,-7,0,1523,11.162179908,5.9093893631,-5.909389363,-1,1.3131976362,5.252790545,-4.596191727
8,57,2003,11,12,-26,10,1,-1,-25,-26,1497,7.2847682119,7.9470198675,-17.21854305,0,0.6622516556,-0.662251656,-16.55629139
8,57,2004,11,8,-33,10,0,3,-33,-32,1465,7.4274139095,5.4017555706,-22.28224173,-2,0,2.025658339,-22.28224173
8,57,2005,10,11,-40,10,1,-1,-39,-41,1424,6.9228106611,7.6150917272,-27.69124264,-1,0.6922810661,-0.692281066,-26.99896158
8,57,2006,15,12,-30,10,0,3,-30,-27,1397,10.634526764,8.5076214108,-21.26905353,0,0,2.1269053527,-21.26905353
8,57,2007,10,7,-23,10,1,3,-22,-21,1376,7.2124053372,5.048683736,-16.58853228,-2,0.7212405337,2.1637216012,-15.86729174
8,57,2008,12,2,-37,10,0,10,-37,-30,1346,8.8170462895,1.4695077149,-27.18589273,-3,0,7.3475385746,-27.18589273
8,59,2001,6594,3118,-970,7783,1263,3476,293,3262,529702,12.486957246,5.9045090528,-1.836874208,-507,2.3917238402,6.5824481935,0.554849632
8,59,2002,6545,3364,-4419,7725,1173,3181,-3246,-441,529261,12.36114954,6.3533853402,-8.345900659,-376,2.2153748526,6.0077641995,-6.130525807
8,59,2003,6601,3436,-6493,7755,1024,3165,-5469,-2628,526633,12.50314899,6.5082290457,-12.298583,-324,1.9395886329,5.9949199446,-10.35899437
8,59,2004,6333,3389,-6715,7822,933,2944,-5782,-3372,523261,12.06407504,6.4558898327,-12.79176755,-534,1.7773222821,5.6081852073,-11.01444527
8,59,2005,6206,3337,-4067,7792,979,2869,-3088,-695,522566,11.868119679,6.3815525895,-7.77757698,-476,1.8722025727,5.48656709,-5.905374407
8,59,2006,6170,3484,-1754,7767,978,2686,-776,1674,524240,11.788239655,6.6564387289,-3.351146249,-236,1.8685410668,5.1318009259,-1.482605182
8,59,2007,6274,3432,148,7840,889,2842,1037,3874,528114,11.923744291,6.5225199885,0.281274172,-5,1.6895455332,5.4012243028,1.9708197052
8,59,2008,6369,3431,1362,7796,893,2938,2255,5225,533339,12.000531347,6.4647233556,2.5662935617,32,1.6825992295,5.5358079915,4.2488927913
8,61,2001,14,24,-70,24,1,-10,-69,-79,1535,8.8917116545,15.242934265,-44.45855827,0,0.635122261,-6.35122261,-43.82343601
8,61,2002,13,16,-47,24,1,-3,-46,-50,1485,8.6092715232,10.59602649,-31.12582781,-1,0.6622516556,-1.986754967,-30.46357616
8,61,2003,24,18,-41,24,1,6,-40,-32,1453,16.337644656,12.253233492,-27.91014295,2,0.680735194,4.0844111641,-27.22940776
8,61,2004,11,21,-46,24,0,-10,-46,-59,1394,7.727432385,14.752370917,-32.31471725,-3,0,-7.024938532,-32.31471725
8,61,2005,15,20,-4,24,1,-5,-3,-9,1385,10.79525009,14.393666787,-2.878733357,-1,0.7196833393,-3.598416697,-2.159050018
8,61,2006,8,18,-6,24,0,-10,-6,-16,1369,5.8097312999,13.071895425,-4.357298475,0,0,-7.262164125,-4.357298475
8,61,2007,21,18,-43,24,1,3,-42,-37,1332,15.549796372,13.32839689,-31.84005924,2,0.7404664939,2.2213994817,-31.09959274
8,61,2008,14,9,-15,24,0,5,-15,-11,1321,10.55408971,6.7847719563,-11.30795326,-1,0,3.7693177535,-11.30795326
8,63,2001,108,69,-69,598,35,39,-34,-3,7975,13.539773083,8.6504105811,-8.650410581,-8,4.3878894252,4.8893625024,-4.262521156
8,63,2002,79,85,210,765,35,-6,245,237,8212,9.7609192562,10.502254896,25.94674739,-2,4.3244578983,-0.74133564,30.271205288
8,63,2003,79,68,-163,788,22,11,-141,-133,8079,9.6986065926,8.3481677,-20.01104905,-3,2.7008777853,1.3504388926,-17.31017126
8,63,2004,90,72,-6,964,20,18,14,28,8107,11.120721611,8.896577289,-0.741381441,-4,2.4712714692,2.2241443223,1.7298900284
8,63,2005,108,68,-141,1000,22,40,-119,-86,8021,13.392857143,8.4325396825,-17.48511905,-7,2.7281746032,4.9603174603,-14.75694444
8,63,2006,98,93,-89,1035,21,5,-68,-66,7955,12.268402604,11.642463696,-11.14171257,-3,2.6289434151,0.6259389084,-8.512769154
8,63,2007,103,68,-103,1024,19,35,-84,-48,7907,12.987012987,8.5739503215,-12.98701299,1,2.3956625898,4.4130626655,-10.5913504
8,63,2008,105,61,-126,1018,18,44,-108,-64,7843,13.333333333,7.746031746,-16,0,2.2857142857,5.5873015873,-13.71428571
8,65,2001,135,44,-199,99,103,91,-96,-10,7812,17.27005245,5.6287578355,-25.45733657,-5,13.176410388,11.641294614,-12.28092619
8,65,2002,129,38,-219,99,98,91,-121,-31,7781,16.545885974,4.873981915,-28.08952735,-1,12.569742833,11.67190406,-15.51978452
8,65,2003,118,36,-316,99,90,82,-226,-136,7645,15.298846104,4.6674445741,-40.96979126,8,11.668611435,10.63140153,-29.30117983
8,65,2004,116,37,-145,99,80,79,-65,5,7650,15.168355672,4.8381824126,-18.96044459,-9,10.460934946,10.330173259,-8.499509644
8,65,2005,113,27,-212,99,86,86,-126,-44,7606,14.813843734,3.5395909806,-27.792344,-4,11.274252753,11.274252753,-16.51809124
8,65,2006,113,28,-138,99,85,85,-53,28,7634,14.829396325,3.6745406824,-18.11023622,-4,11.154855643,11.154855643,-6.955380577
8,65,2007,123,35,51,99,75,88,126,207,7841,15.896607431,4.5234248788,6.591276252,-7,9.6930533118,11.373182553,16.284329564
8,65,2008,123,18,-7,99,74,105,67,153,7994,15.53520682,2.2734449005,-0.884117461,-19,9.3463845911,13.26176192,8.4622671298
8,67,2001,471,218,625,1828,33,253,658,881,45093,10.548121606,4.8821454566,13.996976653,-30,0.7390403673,5.6659761492,14.73601702
8,67,2002,457,242,653,1841,31,215,684,874,45967,10.037338019,5.3151768065,14.342191961,-25,0.6808697562,4.7221612124,15.023061718
8,67,2003,484,266,99,1814,30,218,129,286,46253,10.496638473,5.7688137064,2.1470396877,-61,0.6506180872,4.7278247669,2.7976577749
8,67,2004,517,270,420,1831,30,247,450,656,46909,11.098945922,5.7963547369,9.016551813,-41,0.6440394152,5.3025911852,9.6605912282
8,67,2005,505,246,642,1839,30,259,672,893,47802,10.664020019,5.1947503458,13.55703139,-38,0.6335061397,5.469269673,14.19053753
8,67,2006,566,302,711,1832,30,264,741,979,48781,11.720489113,6.2536885373,14.723087914,-26,0.6212273381,5.4668005757,15.344315252
8,67,2007,594,271,399,1838,28,323,427,739,49520,12.085329752,5.5136773787,8.1179235206,-11,0.5696788436,6.5716523738,8.6876023642
8,67,2008,626,264,595,1836,28,362,623,962,50482,12.519749605,5.2798944021,11.899762005,-23,0.5599888002,7.2398552029,12.459750805
8,69,2001,3320,1526,5277,7120,661,1794,5938,7586,260717,12.922109262,5.9394996186,20.539147764,-146,2.5727452476,6.9826096433,23.111893011
8,69,2002,3293,1524,2717,7120,618,1769,3335,4915,265632,12.512610454,5.7908345983,10.323948559,-189,2.3482518253,6.7217758559,12.672200384
8,69,2003,3363,1534,1032,7120,535,1829,1567,3035,268667,12.588457025,5.7421032044,3.8630055456,-361,2.0026239989,6.8463538206,5.8656295445
8,69,2004,3509,1559,918,7120,521,1950,1439,3204,271871,12.983361022,5.7683271111,3.3966159641,-185,1.9277090602,7.2150339107,5.3243250243
8,69,2005,3329,1538,1593,7120,533,1791,2126,3699,275570,12.162041206,5.618870344,5.8198052393,-218,1.9472418032,6.5431708622,7.7670470425
8,69,2006,3511,1538,3021,7120,535,1973,3556,5374,280944,12.617831717,5.5272643635,10.856869728,-155,1.9226829873,7.0905673532,12.779552716
8,69,2007,3596,1474,3223,7120,487,2122,3710,5783,286727,12.669310217,5.1931488485,11.355168751,-49,1.7157825572,7.4761613681,13.070951308
8,69,2008,3751,1640,3562,7120,491,2111,4053,6098,292825,12.944481254,5.6595439236,12.292253327,-66,1.6944122357,7.2849373309,13.986665562
8,71,2001,162,209,-110,391,21,-47,-89,-151,15125,10.65754416,13.749547712,-7.236604059,-15,1.3815335022,-3.092003553,-5.855070557
8,71,2002,171,183,329,578,21,-12,350,334,15459,11.182317552,11.96704159,21.514517395,-4,1.3732670677,-0.784724039,22.887784462
8,71,2003,167,161,263,870,9,6,272,279,15738,10.706157643,10.321505273,16.86059557,1,0.5769785556,0.3846523704,17.437574126
8,71,2004,176,183,-118,868,7,-7,-111,-132,15606,11.2302195,11.676875957,-7.52935171,-14,0.4466564574,-0.446656457,-7.082695253
8,71,2005,176,165,17,870,10,11,27,23,15629,11.269409316,10.565071234,1.0885224908,-15,0.6403073475,0.7043380823,1.7288298383
8,71,2006,191,171,144,873,9,20,153,167,15796,12.15592681,10.883054893,9.1646778043,-6,0.5727923628,1.2728719173,9.7374701671
8,71,2007,193,144,90,862,7,49,97,148,15944,12.161310649,9.0737240076,5.6710775047,2,0.4410838059,3.0875866415,6.1121613106
8,71,2008,195,155,48,868,7,40,55,104,16048,12.190547637,9.6899224806,3.0007501875,9,0.4376094024,2.5006251563,3.4383595899
8,73,2001,51,59,-191,1044,10,-8,-181,-190,5874,8.5441447479,9.8844027475,-31.99865974,-1,1.6753224996,-1.340258,-30.32333724
8,73,2002,59,64,0,1046,10,-5,10,-1,5873,10.045117902,10.896399081,0,-6,1.7025623563,-0.851281178,1.7025623563
8,73,2003,62,60,-71,1046,2,2,-69,-71,5802,10.620985011,10.278372591,-12.1627409,-4,0.3426124197,0.3426124197,-11.82012848
8,73,2004,62,46,-183,1053,1,16,-182,-173,5629,10.847694865,8.0482897384,-32.01819613,-7,0.1749628204,2.7994051264,-31.84323331
8,73,2005,49,50,-138,1048,2,-1,-136,-141,5488,8.8153278762,8.9952325268,-24.82684177,-4,0.3598093011,-0.179904651,-24.46703247
8,73,2006,80,51,-154,1049,1,29,-153,-126,5362,14.746543779,9.400921659,-28.38709677,-2,0.1843317972,5.3456221198,-28.20276498
8,73,2007,53,43,-64,1045,1,10,-63,-50,5312,9.9306726625,8.0569608394,-11.99175567,3,0.1873711823,1.8737118231,-11.80438449
8,73,2008,60,53,-34,1040,0,7,-34,-26,5286,11.322891112,10.001887149,-6.416304963,1,0,1.321003963,-6.416304963
8,75,2001,270,202,515,2322,46,68,561,622,21269,12.882908674,9.6383242676,24.572955435,-7,2.1948659223,3.2445844069,26.767821357
8,75,2002,252,205,-113,2263,43,47,-70,-41,21228,11.859660682,9.6477398405,-5.318022449,-18,2.0236722592,2.2119208415,-3.294350189
8,75,2003,299,194,-54,2369,40,105,-14,61,21289,14.06496225,9.1257614601,-2.540160406,-30,1.8816003011,4.9392007903,-0.658560105
8,75,2004,238,210,-208,2324,39,28,-169,-161,21128,11.221915741,9.90169036,-9.807388547,-20,1.8388853526,1.3202253813,-7.968503194
8,75,2005,223,201,-312,2336,41,22,-271,-265,20863,10.621323617,9.5734800314,-14.86032721,-16,1.9527994094,1.0478435855,-12.9075278
8,75,2006,231,202,6,2329,39,29,45,64,20927,11.055276382,9.6673845418,0.2871500359,-10,1.8664752333,1.3878918402,2.1536252692
8,75,2007,250,190,-36,2454,33,60,-3,63,20990,11.928334566,9.0655342701,-1.717680177,6,1.5745401627,2.8628002958,-0.143140015
8,75,2008,247,188,-192,2436,33,59,-159,-85,20905,11.79138322,8.9748179974,-9.165771572,15,1.5753669889,2.8165652226,-7.590404583
8,77,2001,1513,1185,1451,3306,131,328,1582,1798,119284,12.780335347,10.009714069,12.256620349,-112,1.106559108,2.770621278,13.363179457
8,77,2002,1529,1165,2428,3315,128,364,2556,2850,122134,12.666826831,9.6513101757,20.11449022,-70,1.0604014614,3.0155166558,21.174891682
8,77,2003,1555,1234,2011,3320,106,321,2117,2389,124523,12.608602229,10.005797524,16.306044426,-49,0.8594931423,2.6028047045,17.165537568
8,77,2004,1717,1203,2137,3316,100,514,2237,2608,127131,13.645719917,9.5607461038,16.983636262,-143,0.794741987,4.0849738133,17.77837825
8,77,2005,1757,1243,1874,3305,106,514,1980,2394,129525,13.691478087,9.6861168256,14.603204289,-100,0.8260083536,4.0053612618,15.429212643
8,77,2006,1866,1279,3729,3290,106,587,3835,4343,133868,14.168941468,9.7117235462,28.315103287,-79,0.8048809194,4.4572179215,29.119984206
8,77,2007,2033,1204,4073,3287,92,829,4165,5015,138883,14.907369726,8.8285652482,29.866068319,21,0.6746079758,6.0788044773,30.540676294
8,77,2008,2169,1266,3329,3283,93,903,3422,4288,143171,15.380033611,8.9770044034,23.605408893,-37,0.6594481908,6.4030292072,24.264857084
8,79,2001,5,5,-16,1,1,0,-15,-16,821,6.0313630881,6.0313630881,-19.30036188,-1,1.2062726176,0,-18.09408926
8,79,2002,6,8,38,1,1,-2,39,36,857,7.1513706794,9.5351609058,45.292014303,-1,1.1918951132,-2.383790226,46.483909416
8,79,2003,6,4,33,1,1,2,34,37,894,6.8532267276,4.5688178184,37.692747002,1,1.1422044546,2.2844089092,38.834951456
8,79,2004,9,5,44,1,0,4,44,45,939,9.8199672668,5.4555373704,48.00872886,-3,0,4.3644298963,48.00872886
8,79,2005,1,5,-12,1,1,-4,-11,-16,923,1.0741138561,5.3705692803,-12.88936627,-1,1.0741138561,-4.296455424,-11.81525242
8,79,2006,3,7,10,1,0,-4,10,6,929,3.2397408207,7.5593952484,10.799136069,0,0,-4.319654428,10.799136069
8,79,2007,4,4,30,1,1,0,31,31,960,4.2350449974,4.2350449974,31.76283748,0,1.0587612493,0,32.821598729
8,79,2008,4,3,2,1,0,1,2,2,962,4.1623309053,3.121748179,2.0811654527,-1,0,1.0405827263,2.0811654527
8,81,2001,198,100,-156,311,40,98,-116,-29,13137,15.055316884,7.603695396,-11.86176482,-11,3.0414781584,7.451621488,-8.820286659
8,81,2002,210,106,24,311,40,104,64,154,13291,15.892235508,8.0217950658,1.8162554866,-14,3.0270924777,7.870440442,4.8433479643
8,81,2003,176,102,-155,311,36,74,-119,-59,13232,13.271500207,7.6914376202,-11.68796893,-14,2.7146250424,5.5800625872,-8.97334389
8,81,2004,205,86,-55,311,32,119,-23,87,13319,15.441979586,6.4780987533,-4.142970133,-9,2.4104553501,8.9638808331,-1.732514783
8,81,2005,172,91,-319,311,34,81,-285,-214,13105,13.018468059,6.8876778686,-24.14471692,-10,2.5734181048,6.1307901907,-21.57129882
8,81,2006,205,91,70,311,33,114,103,212,13317,15.517371887,6.8881992279,5.2986147907,-5,2.4979184013,8.6291726591,7.796533192
8,81,2007,227,100,133,311,32,127,165,293,13610,16.860400342,7.4274891373,9.8785605526,1,2.3767965239,9.4329112044,12.255357077
8,81,2008,217,106,85,311,31,111,116,230,13840,15.810564663,7.723132969,6.1930783242,3,2.2586520947,8.087431694,8.4517304189
8,83,2001,311,247,-210,438,13,64,-197,-153,23712,13.073543939,10.383168338,-8.827794943,-20,0.5464825441,2.6903756017,-8.281312399
8,83,2002,334,280,192,438,12,54,204,238,23950,14.015358147,11.749402039,8.056732827,-20,0.5035458017,2.2659561076,8.5602786287
8,83,2003,313,235,238,438,10,78,248,302,24252,12.987012987,9.7506327538,9.8751089166,-24,0.4149205427,3.2363802332,10.290029459
8,83,2004,315,240,131,438,8,75,139,195,24447,12.936610608,9.8564652252,5.3799872687,-19,0.3285488408,3.0801453829,5.7085361096
8,83,2005,306,261,9,438,9,45,18,45,24492,12.50536382,10.666339729,0.3678048182,-18,0.3678048182,1.8390240912,0.7356096365
8,83,2006,298,251,393,438,9,47,402,436,24928,12.059894779,10.157830838,15.904492108,-13,0.3642250101,1.9020639417,16.268717119
8,83,2007,336,228,139,438,8,108,147,250,25178,13.411567477,9.1007065022,5.548237736,-5,0.3193230352,4.3108609747,5.8675607712
8,83,2008,339,244,104,438,7,95,111,206,25384,13.409279696,9.6515169495,4.1137613227,0,0.2768877813,3.7577627467,4.3906491041
8,85,2001,463,314,563,550,58,149,621,740,34338,13.630475742,9.2439943476,16.574422986,-30,1.7074894018,4.3864813943,18.281912388
8,85,2002,503,353,583,550,53,150,636,766,35104,14.486909939,10.16675787,16.790991043,-20,1.5264537312,4.3201520694,18.317444774
8,85,2003,448,346,454,550,42,102,496,565,35669,12.660195272,9.7777400986,12.829751459,-33,1.1868933068,2.8824551736,14.016644766
8,85,2004,474,340,382,550,43,134,425,526,36195,13.191584103,9.4623177112,10.631192252,-33,1.196704887,3.7292663921,11.827897139
8,85,2005,516,312,668,550,41,204,709,884,37079,14.084122608,8.515981112,18.232933919,-29,1.1190872615,5.5681414963,19.352021181
8,85,2006,507,366,812,550,42,141,854,972,38051,13.496605883,9.7431119393,21.615865833,-23,1.1180620258,3.7534939438,22.733927858
8,85,2007,530,370,1211,550,37,160,1248,1395,39446,13.677948824,9.5487567261,31.25282269,-13,0.9548756726,4.1291920978,32.207698363
8,85,2008,582,368,867,550,37,214,904,1093,40539,14.552728637,9.2017253235,21.679064825,-25,0.92517347,5.3510033131,22.604238295
8,87,2001,477,277,-341,484,196,200,-145,33,27276,17.498486766,10.16159504,-12.50940039,-22,7.1901538913,7.3368917258,-5.319246501
8,87,2002,482,253,-157,484,188,229,31,237,27513,17.594772673,9.2354304696,-5.731077406,-23,6.8626914162,8.3593422037,1.1316140101
8,87,2003,494,234,-244,484,164,260,-80,157,27670,17.904064658,8.4808727325,-8.843303191,-23,5.943859522,9.423191925,-2.899443669
8,87,2004,417,225,-304,484,143,192,-161,3,27673,15.069656506,8.1311096254,-10.98603256,-28,5.1677718953,6.9385468804,-5.818260665
8,87,2005,441,243,-329,594,155,198,-174,0,27673,15.936111011,8.7811223937,-11.88884472,-24,5.6011274528,7.1549886171,-6.28771727
8,87,2006,415,247,-205,731,154,168,-51,105,27778,14.968170096,8.9087662982,-7.393915349,-12,5.5544534815,6.0594037979,-1.839461867
8,87,2007,411,231,-346,691,139,180,-207,-21,27757,14.801476546,8.3190780589,-12.46061043,6,5.0058521653,6.4823984874,-7.454758261
8,87,2008,429,225,-298,673,139,204,-159,47,27804,15.442486636,8.0992062778,-10.72694876,2,5.0035096561,7.3432803585,-5.723439103
8,89,2001,303,217,-346,568,36,86,-310,-238,20015,15.049170557,10.777788815,-17.18486143,-14,1.7880202642,4.2713817423,-15.39684116
8,89,2002,323,247,-439,568,36,76,-403,-331,19684,16.272450188,12.443638379,-22.11642611,-4,1.8136476989,3.8288118089,-20.30277841
8,89,2003,299,230,-206,568,31,69,-175,-120,19564,15.236445169,11.720342438,-10.49735018,-14,1.5796983286,3.5161027313,-8.917651855
8,89,2004,286,218,-225,568,28,68,-197,-148,19416,14.674191893,11.185223191,-11.54438173,-19,1.4366341714,3.4889687019,-10.10774756
8,89,2005,305,247,-266,568,31,58,-235,-194,19222,15.787566644,12.785340856,-13.76882861,-17,1.6046379212,3.0022257881,-12.16419069
8,89,2006,234,226,-257,568,31,8,-226,-225,18997,12.245218347,11.826578403,-13.44880818,-7,1.622229781,0.4186399435,-11.8265784
8,89,2007,270,218,-301,568,23,52,-278,-213,18784,14.292898547,11.54019216,-15.93393505,13,1.2175432095,2.7527063868,-14.71639184
8,89,2008,283,207,-115,568,23,76,-92,-10,18774,15.070025028,11.022951169,-6.12386176,6,1.2247723521,4.0470738591,-4.899089408
8,91,2001,40,24,18,18,5,16,23,35,3811,10.544352181,6.3266113088,4.7449584816,-4,1.3180440227,4.2177408725,6.0630025043
8,91,2002,30,14,89,18,5,16,94,108,3919,7.7619663648,3.6222509702,23.027166882,-2,1.2936610608,4.1397153946,24.320827943
8,91,2003,31,25,21,18,3,6,24,27,3946,7.8830260648,6.3572790846,5.340114431,-3,0.7628734901,1.5257469803,6.1029879212
8,91,2004,36,27,143,18,2,9,145,148,4094,8.9552238806,6.7164179104,35.572139303,-6,0.4975124378,2.2388059701,36.069651741
8,91,2005,34,23,64,18,3,11,67,74,4168,8.2304526749,5.5676591624,15.4926168,-4,0.7262164125,2.6627935125,16.218833212
8,91,2006,38,25,32,18,2,13,34,44,4212,9.0692124105,5.9665871122,7.6372315036,-3,0.477326969,3.1026252983,8.1145584726
8,91,2007,40,19,147,18,1,21,148,167,4379,9.3120707717,4.4232336166,34.221860086,-2,0.2328017693,4.8888371552,34.454661855
8,91,2008,44,16,163,18,0,28,163,181,4560,9.8445016221,3.5798187717,36.469403736,-10,0,6.2646828504,36.469403736
8,93,2001,167,57,532,70,9,110,541,648,15345,11.117768457,3.7946874376,35.417082751,-3,0.5991611744,7.3230810199,36.016243925
8,93,2002,171,70,464,70,9,101,473,574,15919,10.939099284,4.4779938588,29.682702149,0,0.5757420676,6.4611054248,30.258444217
8,93,2003,172,66,216,70,8,106,224,325,16244,10.695519697,4.1040947673,13.431582875,-5,0.4974660324,6.5914249293,13.929048907
8,93,2004,147,72,112,70,6,75,118,178,16422,9.0001836772,4.4082532297,6.8572828017,-15,0.3673544358,4.5919304476,7.2246372375
8,93,2005,166,60,42,70,8,106,50,143,16565,10.064570892,3.6377967078,2.5464576955,-13,0.485039561,6.4267741838,3.0314972565
8,93,2006,160,65,-14,70,7,95,-7,80,16645,9.6356519121,3.9144835893,-0.843119542,-8,0.4215597712,5.7211683228,-0.421559771
8,93,2007,146,62,226,70,7,84,233,308,16953,8.6909935115,3.6906958748,13.453181737,-9,0.4166914697,5.0002976368,13.869873207
8,93,2008,149,74,-20,70,6,75,-14,40,16993,8.7786484416,4.359865669,-1.178342073,-21,0.3535026218,4.4187827726,-0.824839451
8,95,2001,53,55,-7,89,29,-2,22,15,4472,11.871430171,12.319408668,-1.56792474,-5,6.495688207,-0.447978497,4.9277634674
8,95,2002,59,58,27,89,29,1,56,51,4523,13.118399111,12.896053363,6.0033351862,-6,6.4480266815,0.2223457476,12.451361868
8,95,2003,59,54,-102,89,21,5,-81,-74,4449,13.152028533,12.037449844,-22.73740526,2,4.6812304949,1.1145786893,-18.05617477
8,95,2004,68,64,51,89,19,4,70,69,4518,15.166722427,14.274562284,11.37504182,-5,4.237760678,0.8921601427,15.612802498
8,95,2005,68,38,-49,89,20,30,-29,-3,4515,15.055906122,8.4135945976,-10.84910882,-4,4.4282076829,6.6423115244,-6.42090114
8,95,2006,58,52,-47,89,19,6,-28,-23,4492,12.878871988,11.546574886,-10.4363273,-1,4.2189408238,1.3322971023,-6.217386477
8,95,2007,66,38,-74,89,15,28,-59,-28,4464,14.738722644,8.4859312193,-16.52523448,3,3.3497096918,6.2527914247,-13.17552479
8,95,2008,62,49,-12,89,14,13,2,13,4477,13.868694777,10.960742646,-2.684263505,-2,3.1316407561,2.9079521306,0.4473772509
8,97,2001,157,42,-68,328,89,115,21,118,14908,10.573102566,2.8284732979,-4.579432958,-18,5.9936696074,7.744629268,1.4142366489
8,97,2002,169,36,-207,328,88,133,-119,2,14910,11.335434972,2.4146488698,-13.884231,-12,5.9024750151,8.9207861024,-7.981755986
8,97,2003,162,42,-167,328,65,120,-102,5,14915,10.863369656,2.8164291702,-11.19865884,-13,4.35875943,8.0469404862,-6.839899413
8,97,2004,157,40,-251,328,58,117,-193,-94,14821,10.559591068,2.6903416734,-16.881894,-18,3.9009954264,7.8692493947,-12.98089857
8,97,2005,173,52,-106,328,62,121,-44,68,14889,11.645910468,3.5005048805,-7.135644564,-9,4.173678896,8.1454055873,-2.961965668
8,97,2006,156,35,-171,328,61,121,-110,3,14892,10.476478292,2.3504919244,-11.48383197,-8,4.0965716396,8.1259863671,-7.387260334
8,97,2007,161,26,-12,328,57,135,45,153,15045,10.755920767,1.7369809934,-0.801683535,-27,3.8079967933,9.0189397735,3.0063132578
8,97,2008,158,30,288,328,56,128,344,429,15474,10.354205577,1.9659884007,18.873488646,-43,3.6698450146,8.3882171762,22.543333661
8,99,2001,272,142,-416,300,89,130,-327,-203,14237,18.969906197,9.9034069115,-29.01279771,-6,6.2070648952,9.0664992851,-22.80573282
8,99,2002,246,146,-262,300,87,100,-175,-82,14155,17.328825021,10.284587208,-18.45590307,-7,6.1284868977,7.0442378135,-12.32741617
8,99,2003,243,119,-380,300,67,124,-313,-183,13972,17.278771287,8.461620507,-27.02030078,6,4.7641056636,8.8171507804,-22.25619512
8,99,2004,205,126,-335,300,63,79,-272,-211,13761,14.783831536,9.0866476761,-24.15894422,-18,4.543323838,5.6971838604,-19.61562038
8,99,2005,233,103,-288,300,67,130,-221,-103,13658,16.99551406,7.513038404,-21.00733068,-12,4.8871220686,9.4824756556,-16.12020861
8,99,2006,188,98,-440,300,69,90,-371,-286,13372,13.910469848,7.2512023677,-32.55641879,-5,5.1054384018,6.6592674806,-27.45098039
8,99,2007,189,119,-427,300,60,70,-367,-286,13086,14.286794164,8.9953889183,-32.277572,11,4.5354902109,5.2914052461,-27.74208179
8,99,2008,199,108,-131,300,61,91,-70,30,13116,15.189680177,8.2436455232,-9.999236699,9,4.6561331196,6.9460346538,-5.34310358
8,101,2001,2007,1393,1599,4070,182,614,1781,2286,144119,14.037320949,9.7428939123,11.183695166,-109,1.2729409132,4.2944270367,12.456636079
8,101,2002,1996,1483,2003,4172,169,513,2172,2607,146726,13.725523904,10.197871719,13.773659509,-78,1.162131032,3.5276521859,14.935790541
8,101,2003,2058,1453,638,4019,132,605,770,1204,147930,13.968831451,9.8623479583,4.3304735013,-171,0.8959600348,4.1064834926,5.2264335361
8,101,2004,1948,1534,202,3919,149,414,351,667,148597,13.138769825,10.346444,1.3624391708,-98,1.0049675072,2.7923258253,2.367406678
8,101,2005,1997,1553,659,3949,142,444,801,1106,149703,13.389205498,10.412336574,4.4183707677,-139,0.9520616829,2.9768689239,5.3704324506
8,101,2006,2024,1424,1319,3908,151,600,1470,1995,151698,13.430612374,9.4492055434,8.7524593482,-75,1.0019873856,3.9814068301,9.7544467338
8,101,2007,2174,1435,2044,4193,136,739,2180,2980,154678,14.191712145,9.3675744836,13.343081704,61,0.8877979998,4.8241376609,14.230879703
8,101,2008,2221,1515,1130,4210,140,706,1270,2059,156737,14.263924345,9.7297818024,7.2571969879,83,0.8991217507,4.5341425429,8.1563187387
8,103,2001,66,57,-145,232,10,9,-135,-129,5850,11.159015978,9.6373319807,-24.51601995,-3,1.6907599966,1.521683997,-22.82525995
8,103,2002,66,40,37,232,9,26,46,67,5917,11.217812527,6.7986742585,6.2887736891,-5,1.5297017082,4.419138268,7.8184753973
8,103,2003,74,36,-90,232,3,38,-87,-50,5867,12.55940258,6.1099796334,-15.27494908,-1,0.5091649695,6.4494229464,-14.76578411
8,103,2004,77,48,30,232,4,29,34,60,5927,13.057486858,8.1397320672,5.087332542,-3,0.6783110056,4.9177547906,5.7656435476
8,103,2005,75,59,-103,232,4,16,-99,-89,5838,12.749681258,10.029749256,-17.50956226,-6,0.6799830004,2.7199320017,-16.82957926
8,103,2006,93,52,159,232,4,41,163,202,6040,15.659201886,8.7556827749,26.772183869,-2,0.6735140596,6.903519111,27.445697929
8,103,2007,103,36,105,232,3,67,108,177,6217,16.806722689,5.8741943379,17.133066819,2,0.4895161948,10.932528351,17.622583014
8,103,2008,99,45,63,232,3,54,66,123,6340,15.768097476,7.1673170343,10.034243848,3,0.4778211356,8.6007804412,10.512064984
8,105,2001,172,132,-322,251,19,40,-303,-266,12162,13.989426596,10.736071574,-26.18950793,-3,1.5453436356,3.2533550224,-24.64416429
8,105,2002,174,136,-67,251,19,38,-48,-20,12142,14.318630678,11.191573404,-5.513495721,-10,1.5635286373,3.1270572745,-3.949967084
8,105,2003,171,127,-8,251,16,44,8,34,12176,14.063656551,10.444937906,-0.657948844,-18,1.315897689,3.6187186446,0.6579488445
8,105,2004,175,131,-46,251,14,44,-32,3,12179,14.370765757,10.757544652,-3.777458427,-9,1.1496612605,3.6132211045,-2.627797167
8,105,2005,183,137,-197,251,15,46,-182,-147,12032,15.117095535,11.317169881,-16.27359465,-11,1.2391061914,3.7999256536,-15.03448846
8,105,2006,192,116,-312,251,14,76,-298,-226,11806,16.108733954,9.7323600973,-26.17669268,-4,1.1745951842,6.3763738569,-25.00209749
8,105,2007,155,121,-257,251,15,34,-242,-202,11604,13.242204186,10.337462623,-21.95642888,6,1.2815036309,2.9047415634,-20.67492525
8,105,2008,159,117,-41,251,14,42,-27,13,11617,13.694500667,10.077085397,-3.531286336,-2,1.2058050902,3.6174152707,-2.325481245
8,107,2001,203,82,182,257,54,121,236,340,20171,10.149492525,4.0997950102,9.0995450227,-17,2.6998650067,6.0496975151,11.799410029
8,107,2002,223,69,48,257,52,154,100,235,20406,10.991448357,3.40094142,2.3658722922,-19,2.5630283165,7.5905069374,4.9289006087
8,107,2003,236,66,198,257,46,170,244,396,20802,11.454086585,3.2032615026,9.6097845079,-18,2.2325761988,8.2508250825,11.842360707
8,107,2004,228,61,66,257,38,167,104,257,21059,10.893194143,2.9144072048,3.1532930413,-14,1.8155323571,7.9787869377,4.9688253983
8,107,2005,237,70,30,257,43,167,73,222,21281,11.195087388,3.3065658951,1.4170996693,-18,2.0311761927,7.8885214927,3.4482758621
8,107,2006,250,91,211,257,42,159,253,401,21682,11.637921002,4.2362032447,9.8224053255,-11,1.9551707283,7.4017177571,11.777576054
8,107,2007,258,71,398,257,37,187,435,620,22302,11.731538741,3.2284467079,18.097489996,-2,1.6824299745,8.5030920335,19.779919971
8,107,2008,277,88,461,257,36,189,497,678,22980,12.234441942,3.8867541186,20.361291462,-8,1.5900357758,8.347687823,21.951327238
8,109,2001,79,45,116,36,34,34,150,181,6159,13.018043998,7.4153415177,19.115102579,-3,5.60270248,5.60270248,24.717805059
8,109,2002,98,50,209,36,34,48,243,291,6450,15.544452375,7.9308430486,33.150923943,0,5.3929732731,7.6136093267,38.543897216
8,109,2003,98,41,69,36,21,57,90,144,6594,15.026065624,6.2864152101,10.579576817,-3,3.2198712052,8.739650414,13.799448022
8,109,2004,84,35,148,36,20,49,168,207,6801,12.541993281,5.2258305338,22.097797686,-10,2.9861888764,7.3161627473,25.083986562
8,109,2005,73,35,-35,36,21,38,-14,18,6819,10.719530103,5.1395007342,-5.139500734,-6,3.0837004405,5.5800293686,-2.055800294
8,109,2006,97,42,-47,36,20,55,-27,25,6844,14.198931421,6.1479909244,-6.879894606,-3,2.9276147259,8.0509404962,-3.95227988
8,109,2007,78,23,-43,36,16,55,-27,20,6864,11.380215932,3.355704698,-6.273708783,-8,2.3344032682,8.0245112343,-3.939305515
8,109,2008,84,32,132,36,15,52,147,194,7058,12.06723172,4.5970406551,18.962792702,-5,2.1548628071,7.4701910645,21.117655509
8,111,2001,4,4,7,5,1,0,8,8,567,7.1047957371,7.1047957371,12.43339254,0,1.7761989343,0,14.209591474
8,111,2002,5,1,-2,5,1,4,-1,1,568,8.8105726872,1.7621145374,-3.524229075,-2,1.7621145374,7.0484581498,-1.762114537
8,111,2003,6,0,-4,5,1,6,-3,4,572,10.526315789,0,-7.01754386,1,1.7543859649,10.526315789,-5.263157895
8,111,2004,7,3,5,5,0,4,5,8,580,12.152777778,5.2083333333,8.6805555556,-1,0,6.9444444444,8.6805555556
8,111,2005,4,3,-17,5,1,1,-16,-15,565,6.9868995633,5.2401746725,-29.69432314,0,1.7467248908,1.7467248908,-27.94759825
8,111,2006,9,2,2,5,0,7,2,8,573,15.817223199,3.5149384886,3.5149384886,-1,0,12.30228471,3.5149384886
8,111,2007,6,3,-13,5,1,3,-12,-11,562,10.572687225,5.2863436123,-22.90748899,-2,1.7621145374,5.2863436123,-21.14537445
8,111,2008,4,0,-10,5,0,4,-10,-10,552,7.1813285458,0,-17.95332136,-4,0,7.1813285458,-17.95332136
8,113,2001,64,14,185,17,39,50,224,271,6888,9.4779711218,2.0733061829,27.397260274,-3,5.7756386524,7.4046649389,33.172898926
8,113,2002,82,14,173,17,39,68,212,279,7167,11.668445393,1.9921736037,24.617573817,-1,5.5496264674,9.6762717894,30.167200285
8,113,2003,75,24,-110,17,27,51,-83,-35,7132,10.490244073,3.3568781034,-15.38569131,-3,3.7764878663,7.1333659696,-11.60920344
8,113,2004,78,16,-82,17,25,62,-57,-1,7131,10.937390451,2.243567272,-11.49828227,-6,3.5055738624,8.6938231789,-7.992708406
8,113,2005,75,16,1,17,27,59,28,82,7213,10.457334077,2.2308979364,0.139431121,-5,3.7646402677,8.2264361405,3.9040713887
8,113,2006,103,21,-95,17,26,82,-69,10,7223,14.269880853,2.9093931837,-13.16154059,-3,3.6021058465,11.36048767,-9.559434746
8,113,2007,94,14,184,17,22,80,206,282,7505,12.764801738,1.9011406844,24.986420424,-4,2.9875067898,10.863661054,27.973927213
8,113,2008,94,5,-51,17,21,89,-30,47,7552,12.485886963,0.6641429236,-6.77425782,-12,2.7894002789,11.821744039,-3.984857541
8,115,2001,33,37,-92,57,7,-4,-85,-90,2653,12.231282431,13.71386212,-34.09933284,-1,2.5945144552,-1.482579689,-31.50481838
8,115,2002,30,42,34,57,7,-12,41,27,2680,11.250703169,15.750984437,12.750796925,-2,2.6251640728,-4.500281268,15.375960998
8,115,2003,19,39,-33,57,4,-20,-29,-52,2628,7.1590052751,14.694800301,-12.43406179,-3,1.5071590053,-7.535795026,-10.92690279
8,115,2004,31,44,-90,57,3,-13,-87,-104,2524,12.034161491,17.080745342,-34.9378882,-4,1.1645962733,-5.046583851,-33.77329193
8,115,2005,34,49,-24,57,4,-15,-20,-38,2486,13.572854291,19.560878244,-9.580838323,-3,1.5968063872,-5.988023952,-7.984031936
8,115,2006,21,34,-58,57,3,-13,-55,-68,2418,8.5644371941,13.866231648,-23.65415987,0,1.2234910277,-5.301794454,-22.43066884
8,115,2007,14,28,-75,57,2,-14,-73,-89,2329,5.8984621866,11.796924373,-31.59890457,-2,0.8426374552,-5.898462187,-30.75626712
8,115,2008,25,28,33,57,1,-3,34,25,2354,10.676916507,11.958146487,14.093529789,-6,0.4270766603,-1.281229981,14.520606449
8,117,2001,331,45,466,927,274,286,740,1012,24705,13.678251167,1.8595809744,19.256994091,-14,11.322781933,11.818670193,30.579776024
8,117,2002,365,42,-303,927,264,323,-39,264,24969,14.695816725,1.6910254862,-12.19954101,-20,10.629303056,13.004791239,-1.570237951
8,117,2003,349,33,-157,927,226,316,69,354,25323,13.87894695,1.312335958,-6.24353774,-31,8.9875129245,12.566610992,2.7439751849
8,117,2004,353,47,-598,927,209,306,-389,-116,25207,13.971897882,1.8602810212,-23.66910746,-33,8.2723134771,12.111616861,-15.39679398
8,117,2005,338,46,-356,927,216,292,-140,137,25344,13.372633578,1.8199442148,-14.08478566,-15,8.5458250084,11.552689363,-5.538960654
8,117,2006,369,51,-8,927,213,318,205,508,25852,14.415188687,1.9923431518,-0.312524416,-15,8.3209625752,12.422845535,8.0084381592
8,117,2007,348,30,48,927,196,318,244,529,26381,13.32490954,1.1486990983,1.8379185572,-33,7.5048341087,12.176210442,9.3427526659
8,117,2008,380,37,-21,927,195,343,174,462,26843,14.279272509,1.3903502179,-0.789117691,-55,7.3275214189,12.888922291,6.5384037276
8,119,2001,211,83,294,120,2,128,296,410,21058,10.118448185,3.9802426509,14.098690836,-14,0.0959094615,6.138205534,14.194600297
8,119,2002,249,95,89,120,-1,154,88,223,21281,11.762205059,4.4875882756,4.2041616477,-19,-0.047237771,7.2746167836,4.1569238763
8,119,2003,234,95,-106,120,-5,139,-111,-2,21279,10.996240602,4.4642857143,-4.981203008,-30,-0.234962406,6.5319548872,-5.216165414
8,119,2004,216,93,-246,120,6,123,-240,-135,21144,10.183155364,4.384414115,-11.5974825,-18,0.2828654268,5.7987412489,-11.31461707
8,119,2005,209,103,69,120,2,106,71,158,21302,9.8478066249,4.8532252745,3.251189747,-19,0.094237384,4.9945813504,3.3454271309
8,119,2006,204,125,133,120,4,79,137,205,21507,9.5307061599,5.8398934803,6.2136466631,-11,0.1868765914,3.6908126796,6.4005232545
8,119,2007,217,110,171,120,2,107,173,275,21782,10.025641618,5.0821224792,7.9003903994,-5,0.0924022269,4.9435191388,7.9927926263
8,119,2008,225,115,-214,120,3,110,-211,-121,21661,10.358400663,5.2942936722,-9.851989964,-20,0.1381120088,5.0641069908,-9.713877955
8,121,2001,47,43,-145,39,6,4,-139,-138,4804,9.6449825569,8.8241329776,-29.75579725,-3,1.231274369,0.8208495793,-28.52452288
8,121,2002,41,65,169,161,6,-24,175,141,4945,8.4111190891,13.334700995,34.670222587,-10,1.2308954765,-4.923581906,35.901118063
8,121,2003,56,51,-53,161,3,5,-50,-51,4894,11.383270658,10.366907206,-10.77345259,-6,0.6098180709,1.0163634516,-10.16363452
8,121,2004,39,57,-88,222,2,-18,-86,-110,4784,8.059516429,11.779293242,-18.18557553,-6,0.4133085348,-3.719776813,-17.772267
8,121,2005,44,46,-57,222,3,-2,-54,-58,4726,9.2534174553,9.6740273396,-11.9873817,-2,0.6309148265,-0.420609884,-11.35646688
8,121,2006,42,58,-28,222,2,-16,-26,-45,4681,8.9295205698,12.331242692,-5.953013713,-3,0.4252152652,-3.401722122,-5.527798448
8,121,2007,42,31,-80,222,2,11,-78,-77,4604,9.0468497577,6.6774367259,-17.23209478,-10,0.4308023694,2.3694130318,-16.80129241
8,121,2008,45,58,-93,222,1,-13,-92,-107,4497,9.8890231843,12.745852104,-20.43731458,-2,0.2197560708,-2.85682892,-20.21755851
8,123,2001,3205,1206,7092,5031,966,1999,8058,10041,193077,17.04275045,6.412966316,37.712070575,-16,5.1367541138,10.629784134,42.848824688
8,123,2002,3382,1177,7431,5050,900,2205,8331,10583,203660,17.049077853,5.9334017246,37.46058472,47,4.5370106645,11.115676128,41.997595384
8,123,2003,3640,1223,3982,5048,776,2417,4758,7176,210836,17.563498803,5.9011425924,19.213695669,1,3.7443063383,11.662356211,22.958002007
8,123,2004,3904,1220,4063,5037,729,2684,4792,7204,218040,18.205728462,5.6892901445,18.947201522,-272,3.399584029,12.516438318,22.346785551
8,123,2005,3851,1273,5189,5065,753,2578,5942,8314,226354,17.331467122,5.7291502586,23.353150583,-206,3.3888846384,11.602316863,26.742035221
8,123,2006,4021,1262,4976,5077,752,2759,5728,8356,234710,17.442263981,5.4742942411,21.584855899,-131,3.2620200233,11.96796974,24.846875922
8,123,2007,4128,1275,4316,5060,686,2853,5002,7938,242648,17.295195639,5.3419027229,18.082864433,83,2.8741531513,11.953292916,20.957017584
8,123,2008,4382,1294,3305,5051,690,3088,3995,7127,249775,17.797706443,5.2556440296,13.423418484,44,2.8024686093,12.542062414,16.225887093
8,125,2001,141,114,-96,135,51,27,-45,-26,9787,14.387755102,11.632653061,-9.795918367,-8,5.2040816327,2.7551020408,-4.591836735
8,125,2002,119,114,-136,135,50,5,-86,-84,9703,12.211390457,11.698306824,-13.95587481,-3,5.1308363263,0.5130836326,-8.825038481
8,125,2003,163,106,54,210,38,57,92,133,9836,16.684579559,10.850094682,5.527406725,-16,3.8896565843,5.8344848764,9.4170633093
8,125,2004,140,104,-210,210,34,36,-176,-152,9684,14.344262295,10.655737705,-21.51639344,-12,3.4836065574,3.6885245902,-18.03278689
8,125,2005,140,106,-108,213,37,34,-71,-46,9638,14.491253493,10.971949074,-11.17896698,-9,3.8298312804,3.5193044198,-7.3491357
8,125,2006,154,113,-72,213,36,41,-36,1,9639,15.977589874,11.723815946,-7.470042019,-4,3.7350210095,4.2537739275,-3.735021009
8,125,2007,155,90,-108,213,32,65,-76,-9,9630,16.088017022,9.3414292387,-11.20971509,2,3.3213970626,6.7465877835,-7.888318024
8,125,2008,156,112,-41,213,31,44,-10,39,9669,16.166640759,11.606819006,-4.248924815,5,3.2126016892,4.5598217524,-1.036323126
9,0,2001,42858,30431,-7175,109700,14444,12427,7269,16494,3428208,12.531721853,8.8980546854,-2.097977141,-3202,4.2234399749,3.6336671675,2.1254628342
9,0,2002,42147,29585,-2754,111559,13295,12562,10541,20053,3448261,12.258326185,8.6047068634,-0.800992486,-3050,3.8668101318,3.6536193212,3.0658176457
9,0,2003,42705,29892,47,113389,10978,12813,11025,19671,3467932,12.349279437,8.6440618415,0.0135912922,-4167,3.1745788471,3.7052175959,3.1881701393
9,0,2004,42638,29810,-14320,113702,11649,12828,-2671,7419,3475351,12.281798106,8.5867161111,-4.124849873,-2738,3.3554731962,3.6950819951,-0.769376677
9,0,2005,41911,29698,-17357,113170,11643,12213,-5714,3363,3478714,12.053669329,8.5411913751,-4.991900421,-3136,3.3485450596,3.5124779535,-1.643355361
9,0,2006,41589,29124,-15125,116850,13466,12465,-1659,9182,3487896,11.939522953,8.3610249461,-4.342140582,-1624,3.8658687654,3.5784980069,-0.476271817
9,0,2007,42172,27468,-24218,113018,11690,14704,-12528,1972,3489868,12.087539791,7.873009176,-6.941478674,-204,3.3506435586,4.2145306147,-3.590835116
9,0,2008,42284,27733,-14985,113018,11872,14551,-3113,11384,3501252,12.096488116,7.9337788509,-4.286866768,-54,3.3963084599,4.1627092655,-0.890558308
9,1,2001,12273,7031,-7586,18300,6854,5242,-732,3745,888226,13.846619887,7.9325009717,-8.558661979,-765,7.7328063803,5.9141189153,-0.825855598
9,1,2002,11926,7039,-7931,18482,6471,4887,-1460,2687,890913,13.406484822,7.9128162555,-8.915548476,-740,7.2743051555,5.4936685666,-1.641243321
9,1,2003,12171,7097,-8081,18373,5723,5074,-2358,1863,892776,13.646997879,7.9576652656,-9.06099662,-853,6.4170379478,5.6893326135,-2.643958672
9,1,2004,12047,6787,-9447,18072,5177,5260,-4270,170,892946,13.492581712,7.6014071619,-10.58059429,-820,5.7982149517,5.8911745501,-4.78237934
9,1,2005,11816,6787,-10881,18477,5446,5029,-5435,-1108,891838,13.240817937,7.6054021103,-12.1930721,-702,6.1026992622,5.6354158262,-6.090372841
9,1,2006,11640,6565,-11663,18566,5671,5075,-5992,-1326,890512,13.061407692,7.3666788229,-13.08721632,-409,6.3635088507,5.6947288692,-6.723707465
9,1,2007,11655,6166,-10259,18036,5144,5489,-5115,83,890595,13.087366452,6.9237839164,-11.51980201,-291,5.7761830143,6.163582536,-5.743618997
9,1,2008,11270,6331,-5190,18036,5148,4939,-42,4435,895030,12.623031152,7.0910745537,-5.813090655,-462,5.7660483024,5.5319565978,-0.047042352
9,3,2001,10648,8265,-2098,26976,3328,2383,1230,2770,861209,12.383929734,9.6124323117,-2.44003424,-843,3.8705595564,2.7714974227,1.4305253168
9,3,2002,10491,7730,-1727,26835,3130,2761,1403,3334,864543,12.158178,8.9584134916,-2.001446326,-830,3.6274041693,3.1997645085,1.6259578433
9,3,2003,10407,8075,173,27438,2750,2332,2923,3947,868490,12.010157914,9.3189223748,0.1996499778,-1308,3.173626815,2.6912355391,3.3732767928
9,3,2004,10669,7911,-4758,26834,2608,2758,-2150,-72,868418,12.285049064,9.1092907627,-5.478701232,-680,3.0030375817,3.1757583015,-2.475663651
9,3,2005,10474,8023,-2258,27361,2710,2451,452,2078,870496,12.046599199,9.2275983746,-2.5970232,-825,3.1168878967,2.8190008247,0.5198646972
9,3,2006,10377,7936,-2931,27549,3347,2441,416,2449,872945,11.904044932,9.103835461,-3.362316247,-408,3.8395334284,2.8002094708,0.4772171814
9,3,2007,10621,7395,-3975,27475,2916,3226,-1059,2130,875075,12.152034874,8.4610015904,-4.548002883,-37,3.3363462661,3.6910332834,-1.211656617
9,3,2008,10760,7431,-4065,27475,2927,3329,-1138,2237,877312,12.280392402,8.48100334,-4.639386163,46,3.3405862974,3.7993890619,-1.298799866
9,5,2001,1973,1596,904,2495,198,377,1102,1311,183925,10.765566556,8.7084866822,4.9326265418,-168,1.0803761673,2.0570798742,6.0130027091
9,5,2002,1926,1701,1356,2521,190,225,1546,1627,185552,10.425547463,9.2076096753,7.3401050674,-144,1.0284807985,1.2179377877,8.368585866
9,5,2003,1865,1644,938,2521,159,221,1097,1106,186658,10.021224578,8.8337228984,5.040165498,-212,0.8543564117,1.1875016792,5.8945219097
9,5,2004,1963,1733,704,2538,160,230,864,957,187615,10.489669306,9.2606199218,3.7619598528,-137,0.8549908756,1.2290493837,4.6169507285
9,5,2005,1876,1701,-125,2532,163,175,38,33,187648,9.9983211774,9.0656419631,-0.666199439,-180,0.8687240682,0.9326792143,0.2025246294
9,5,2006,1864,1695,180,2531,170,169,350,433,188081,9.9220448781,9.0224603371,0.9581373809,-86,0.9049075264,0.899584541,1.8630449074
9,5,2007,1834,1591,-658,2512,149,243,-509,-266,187815,9.7580181752,8.4651073701,-3.500968353,0,0.792772469,1.2929108051,-2.708195884
9,5,2008,1883,1567,-562,2512,152,316,-410,-70,187745,10.02769198,8.3448716583,-2.99286399,24,0.8094578762,1.6828203217,-2.183406114
9,7,2001,1825,1400,862,6251,260,425,1122,1405,157020,11.674956419,8.9561309514,5.5144177715,-142,1.6632814624,2.7188254674,7.1776992339
9,7,2002,1835,1337,1514,6190,239,498,1753,2121,159141,11.608009843,8.4577161636,9.5773988569,-130,1.5118879305,3.1502936795,11.089286787
9,7,2003,1823,1364,1074,6274,205,459,1279,1566,160707,11.399164603,8.5290512994,6.7156899527,-172,1.281858883,2.8701133038,7.9975488357
9,7,2004,1778,1358,62,6469,216,420,278,592,161299,11.043272486,8.4346254418,0.3850859922,-106,1.3415899083,2.6086470438,1.7266759004
9,7,2005,1730,1300,138,6248,214,430,352,631,161930,10.704485055,8.0438327007,0.853883779,-151,1.3241386138,2.6606523548,2.1780223928
9,7,2006,1708,1297,640,6408,225,411,865,1198,163128,10.508893797,7.9801143181,3.9377588,-78,1.3843683281,2.5287794794,5.3221271281
9,7,2007,1707,1300,85,6398,205,407,290,699,163827,10.441803918,7.952164671,0.5199492285,2,1.2539951981,2.489639247,1.7739444266
9,7,2008,1730,1299,255,6398,209,431,464,967,164794,10.5288463,7.9057637826,1.5519397726,72,1.2719820097,2.6230825176,2.8239217822
9,9,2001,10259,7877,-1131,27680,3019,2382,1888,3456,828441,12.409385119,9.5280949979,-1.368068483,-814,3.6518114509,2.8812901212,2.2837429676
9,9,2002,10107,7789,-409,28231,2856,2318,2447,3930,832371,12.171154833,9.3797491829,-0.49253016,-835,3.4392815081,2.7914056498,2.9467513481
9,9,2003,10429,7479,818,28308,2527,2950,3345,5081,837452,12.491144271,8.9578356508,0.9797445598,-1214,3.026668096,3.5333086201,4.0064126557
9,9,2004,10185,7877,-2689,28324,2347,2308,-342,1362,838814,12.152009287,9.3982697257,-3.208321352,-604,2.8002715559,2.7537395616,-0.408049796
9,9,2005,10179,7836,-2689,28455,2458,2343,-231,1303,840117,12.12557276,9.3345110669,-3.203228721,-809,2.9280536246,2.7910616934,-0.275175097
9,9,2006,10196,7642,-3378,28463,2972,2554,-406,1764,841881,12.123676723,9.0868122316,-4.016651625,-384,3.5338924303,3.0368644909,-0.482759195
9,9,2007,10573,7246,-3497,28745,2617,3327,-880,2477,844358,12.540333844,8.5942740027,-4.147691994,30,3.1039490843,3.9460598409,-1.04374291
9,9,2008,10644,7223,-4497,28745,2625,3421,-1872,1743,846101,12.593029467,8.5456080272,-5.32044847,194,3.1056653844,4.04742144,-2.214783086
9,11,2001,3062,2298,508,12978,338,764,846,1365,260901,11.767034242,8.8310400683,1.9522055503,-245,1.2989084173,2.9359941741,3.2511139677
9,11,2002,3157,2119,1236,12542,-6,1038,1230,2044,262945,12.053160662,8.0901639031,4.7189441172,-224,-0.022907496,3.9629967586,4.6960366214
9,11,2003,3197,2264,2243,12793,-736,933,1507,2204,265149,12.107692949,8.5742311028,8.4946998072,-236,-2.787382549,3.5334618458,5.7073172579
9,11,2004,3241,2259,-51,13252,763,982,712,1523,266672,12.188311481,8.4953395973,-0.191793855,-171,2.8693865041,3.6929718834,2.6775926487
9,11,2005,3112,2237,-2386,11480,276,875,-2110,-1468,265204,11.701975648,8.4117350661,-8.972016034,-233,1.0378358866,3.2902405824,-7.934180147
9,11,2006,3088,2177,1283,14466,610,911,1893,2673,267877,11.585481381,8.1676143025,4.8135274002,-131,2.2885827857,3.4178670784,7.1021101859
9,11,2007,3082,2074,-5467,11261,250,1008,-5217,-4107,263770,11.594159282,7.8021694846,-20.566278,102,0.9404736602,3.7919897977,-19.62580434
9,11,2008,3200,2121,-765,11261,393,1079,-372,749,264519,12.114581224,8.0296958672,-2.896142074,42,1.4878220065,4.0848853563,-1.408320067
9,13,2001,1520,914,1117,11212,249,606,1366,1848,138700,11.032400418,6.6339565672,8.1073626756,-124,1.8072813843,4.3984438509,9.9146440599
9,13,2002,1455,846,2423,12930,231,609,2654,3200,141900,10.370634355,6.0299358517,17.270135424,-63,1.646471846,4.3406985032,18.91660727
9,13,2003,1483,935,1811,13784,201,548,2012,2474,144374,10.360703382,6.5322034135,12.652214312,-86,1.4042490761,3.8284999686,14.056463388
9,13,2004,1415,903,740,14077,203,512,943,1340,145714,9.7556603513,6.2256970299,5.1019001131,-115,1.3995753013,3.5299633215,6.5014754144
9,13,2005,1397,904,102,14254,205,493,307,670,146384,9.5652828845,6.1897034557,0.6983957439,-130,1.4036385049,3.3755794288,2.1020342488
9,13,2006,1390,869,159,14466,218,521,377,828,147212,9.4687938528,5.9196991785,1.0831210234,-70,1.485033856,3.5490946743,2.5681548795
9,13,2007,1384,860,-317,14243,194,524,-123,371,147583,9.3895758069,5.8345630014,-2.15064706,-30,1.3161688631,3.5550128055,-0.834478197
9,13,2008,1403,873,124,14243,198,530,322,823,148406,9.4800820301,5.8988678633,0.8378689749,-29,1.3378875566,3.5812141667,2.1757565315
9,15,2001,1298,1050,249,3808,198,248,447,594,109786,11.855072199,9.5900044753,2.2742010613,-101,1.8084008439,2.2650677237,4.0826019052
9,15,2002,1250,1024,784,3828,184,226,968,1110,110896,11.328517958,9.2803219112,7.1052464632,-84,1.6675578434,2.0481960468,8.7728043066
9,15,2003,1330,1034,1071,3898,149,296,1220,1430,112326,11.91638817,9.2643198251,9.5958283682,-86,1.3349938626,2.6520683445,10.930822231
9,15,2004,1340,982,1119,4136,175,358,1294,1547,113873,11.847974571,8.6826201707,9.893942944,-105,1.5473101119,3.1653544003,11.441253056
9,15,2005,1327,910,742,4363,171,417,913,1224,115097,11.591038127,7.9486395598,6.4811984103,-106,1.4936454557,3.6423985675,7.974843866
9,15,2006,1326,943,585,4401,253,383,838,1163,116260,11.462804238,8.1519037678,5.0571195166,-58,2.1870961328,3.3109004698,7.2442156494
9,15,2007,1316,836,-130,4348,215,480,85,585,116845,11.291049098,7.1727333176,-1.115377191,20,1.8446622767,4.1183157804,0.7292850861
9,15,2008,1394,888,-285,4348,220,506,-65,500,117345,11.904863572,7.5835859772,-2.433921175,59,1.8788163457,4.3212775951,-0.555104829
10,0,2001,10906,7043,2835,24575,2146,3863,4981,8094,794498,13.797186669,8.9101032196,3.5865600777,-750,2.7149057943,4.8870834498,6.301465872
10,0,2002,10829,6891,4193,24501,1821,3938,6014,9276,803774,13.550884956,8.6230629079,5.24691667,-676,2.2787110079,4.9278220478,7.5256276779
10,0,2003,11332,6998,5814,24289,1152,4334,6966,10488,814262,14.00710491,8.6499929544,7.1864902882,-812,1.4239485401,5.3571119555,8.6104388283
10,0,2004,11292,7109,6090,24134,1862,4183,7952,11420,825682,13.771201943,8.6698082374,7.427082876,-715,2.2708092471,5.1013937061,9.6978921231
10,0,2005,11464,7340,7813,24287,1640,4124,9453,12837,838519,13.777181963,8.8210498612,9.3894908127,-740,1.9709157728,4.9561321018,11.360406586
10,0,2006,11836,7246,5792,24225,1898,4590,7690,11847,850366,14.016348064,8.5808092321,6.8589631621,-433,2.2476367544,5.4355388318,9.1065999165
10,0,2007,12130,6786,4615,24109,1544,5344,6159,11587,861953,14.167920814,7.9260932104,5.3903507466,84,1.8034022866,6.2418276034,7.1937530332
10,0,2008,12267,7061,4126,24107,1606,5206,5732,11139,873092,14.140267255,8.139270163,4.7560726091,201,1.8512488149,6.0009970923,6.6073214239
10,1,2001,1939,1063,816,3562,134,876,950,1702,128812,15.153054446,8.3072186057,6.3769429748,-124,1.0471940669,6.8458358406,7.4241370418
10,1,2002,1859,1087,1815,3599,-42,772,1773,2462,131274,14.295271564,8.3587736364,13.956921941,-83,-0.322970095,5.9364979276,13.633951847
10,1,2003,1989,1152,2471,3588,-386,837,2085,2899,134173,14.986042411,8.6796987723,18.617652488,-23,-2.908301846,6.3063436392,15.709350643
10,1,2004,2023,1127,3099,3350,326,896,3425,4146,138319,14.848142331,8.2718024749,22.74562189,-175,2.3927307958,6.5763398558,25.138352686
10,1,2005,2085,1184,4016,3376,69,901,4085,4887,143206,14.812183643,8.4113311429,28.530325904,-99,0.4901873723,6.4008524998,29.020513276
10,1,2006,2234,1241,3190,3411,219,993,3409,4314,147520,15.368422501,8.5372481305,21.945061673,-88,1.5065731995,6.8311743704,23.451634873
10,1,2007,2261,1185,3084,3396,74,1076,3158,4185,151705,15.112373632,7.9204611914,20.613250898,-49,0.4946110786,7.1919124405,21.107861977
10,1,2008,2358,1213,2509,3365,125,1145,2634,3710,155415,15.355561344,7.899192498,16.338890336,-69,0.8140140662,7.4563688461,17.152904402
10,3,2001,6902,4177,-301,17576,1644,2725,1343,3556,505415,13.704314814,8.2936718311,-0.597652674,-512,3.2642558033,5.4106429829,2.6666031288
10,3,2002,6943,4088,-516,17467,1522,2855,1006,3358,508773,13.691741571,8.0616217112,-1.017562819,-503,3.0014159111,5.6301198594,1.9838530923
10,3,2003,7206,4038,-67,17268,1275,3168,1208,3597,512370,14.113596235,7.9087845679,-0.131225499,-779,2.4972016652,6.2048116669,2.3659761659
10,3,2004,7148,4138,-210,17348,1266,3010,1056,3733,516103,13.900219063,8.0468811529,-0.408372412,-333,2.461902257,5.8533379097,2.0535298447
10,3,2005,7131,4268,56,17473,1293,2863,1349,3721,519824,13.767379362,8.2399628545,0.1081157263,-491,2.4963148948,5.5274165071,2.6044306211
10,3,2006,7278,4084,-963,17376,1385,3194,422,3370,523194,13.955655607,7.8311208436,-1.846564489,-246,2.6557547425,6.1245347635,0.8091902537
10,3,2007,7378,3866,-1552,17275,1230,3512,-322,3214,526408,14.058662236,7.3666018167,-2.957311438,24,2.343745534,6.6920604191,-0.613565904
10,3,2008,7373,3983,-1527,17307,1239,3390,-288,3233,529641,13.96336723,7.5432105897,-2.891911265,131,2.3464820288,6.4201566405,-0.545429237
10,5,2001,2065,1803,2320,3437,368,262,2688,2836,160271,12.999439734,11.350116145,14.604697425,-114,2.3166071777,1.6493235885,16.921304602
10,5,2002,2027,1716,2894,3435,341,311,3235,3456,163727,12.512422916,10.592657979,17.864307804,-90,2.1049512651,1.9197649368,19.96925907
10,5,2003,2137,1808,3410,3433,263,329,3673,3992,167719,12.895011555,10.909771124,20.576504167,-10,1.586985512,1.9852404313,22.163489679
10,5,2004,2121,1844,3201,3436,270,277,3471,3541,171260,12.514049543,10.879730013,18.886125689,-207,1.5930190366,1.6343195301,20.479144726
10,5,2005,2248,1888,3741,3438,278,360,4019,4229,175489,12.966151308,10.889721383,21.577567635,-150,1.6034653308,2.0764299248,23.181032966
10,5,2006,2324,1921,3565,3438,294,403,3859,4163,179652,13.08775951,10.81823839,20.076532983,-99,1.6556804199,2.2695211198,21.732213403
10,5,2007,2491,1735,3083,3438,240,756,3323,4188,183840,13.705941259,9.5462898771,16.963234404,109,1.3205242481,4.1596513816,18.283758652
10,5,2008,2536,1865,3144,3435,242,671,3386,4196,188036,13.63895492,10.030225129,16.908862094,139,1.3015091052,3.6087297917,18.210371199
11,0,2001,7618,5919,-4277,35273,3854,1699,-423,5955,577678,13.255600091,10.299277624,-7.442137252,4679,6.7061016999,2.9563224671,-0.736035552
11,0,2002,7625,5913,-7556,35594,3469,1712,-4087,1434,579112,13.183032357,10.22311742,-13.06373672,3809,5.9976313765,2.959914937,-7.066105343
11,0,2003,7480,5678,-10261,35449,2752,1802,-7509,-1741,577371,12.935771646,9.8194266582,-17.74518086,3966,4.7592571616,3.1163449873,-12.9859237
11,0,2004,7789,5522,-7014,35403,3129,2267,-3885,2150,579521,13.465388299,9.5462670673,-12.12559167,3768,5.4093208355,3.9191212317,-6.716270836
11,0,2005,7913,5468,-6766,35225,3031,2445,-3735,2528,582049,13.624663171,9.4148437029,-11.64974991,3818,5.2187986949,4.2098194685,-6.430951213
11,0,2006,8198,5365,-2638,35308,3177,2833,539,3370,585419,14.044068017,9.1908300699,-4.519181682,-2,5.4425474617,4.8532379474,0.9233657796
11,0,2007,8450,5311,-3323,35206,2783,3139,-540,2449,587868,14.403977884,9.0531984076,-5.664428226,-150,4.7439373316,5.3507794768,-0.920490894
11,0,2008,8313,5372,-1622,35206,2832,2941,1210,3965,591833,14.093401633,9.1073924664,-2.749849326,-186,4.8012165795,4.9860091667,2.0513672532
11,1,2001,7618,5919,-4277,35273,3854,1699,-423,5955,577678,13.255600091,10.299277624,-7.442137252,4679,6.7061016999,2.9563224671,-0.736035552
11,1,2002,7625,5913,-7556,35594,3469,1712,-4087,1434,579112,13.183032357,10.22311742,-13.06373672,3809,5.9976313765,2.959914937,-7.066105343
11,1,2003,7480,5678,-10261,35449,2752,1802,-7509,-1741,577371,12.935771646,9.8194266582,-17.74518086,3966,4.7592571616,3.1163449873,-12.9859237
11,1,2004,7789,5522,-7014,35403,3129,2267,-3885,2150,579521,13.465388299,9.5462670673,-12.12559167,3768,5.4093208355,3.9191212317,-6.716270836
11,1,2005,7913,5468,-6766,35225,3031,2445,-3735,2528,582049,13.624663171,9.4148437029,-11.64974991,3818,5.2187986949,4.2098194685,-6.430951213
11,1,2006,8198,5365,-2638,35308,3177,2833,539,3370,585419,14.044068017,9.1908300699,-4.519181682,-2,5.4425474617,4.8532379474,0.9233657796
11,1,2007,8450,5311,-3323,35206,2783,3139,-540,2449,587868,14.403977884,9.0531984076,-5.664428226,-150,4.7439373316,5.3507794768,-0.920490894
11,1,2008,8313,5372,-1622,35206,2832,2941,1210,3965,591833,14.093401633,9.1073924664,-2.749849326,-186,4.8012165795,4.9860091667,2.0513672532
12,0,2001,205390,166242,157832,396425,100559,39148,258391,293488,16340734,12.683100335,10.265660285,9.7463318182,-4051,6.2096493823,2.4174400503,15.9559812
12,0,2002,205559,167714,185226,400598,91676,37845,276902,311945,16652679,12.460608425,10.166514146,11.228059371,-2802,5.557230469,2.2940942788,16.78528984
12,0,2003,208890,168122,170864,404944,73877,40768,244741,284658,16937337,12.437624323,10.010236375,10.173499173,-851,4.3987475326,2.4273879477,14.572246706
12,0,2004,215366,170131,266157,406804,80965,45235,347122,376474,17313811,12.575695273,9.9343239532,15.541493675,-15883,4.7277247466,2.6413713199,20.269218422
12,0,2005,221683,170037,266850,411589,79896,51646,346746,388665,17702476,12.661707965,9.7118806457,15.241478915,-9727,4.5633621863,2.9498273189,19.804841102
12,0,2006,231469,170972,174416,419194,87440,60497,261856,316617,18019093,12.959621119,9.572479865,9.7653045419,-5736,4.895641622,3.3871412535,14.660946164
12,0,2007,235829,173436,37650,422031,76200,62393,113850,180433,18199526,13.022528551,9.5771735526,2.0790411694,4190,4.2077805341,3.4453549982,6.2868217035
12,0,2008,235241,176811,-9286,425791,77427,58430,68141,128814,18328340,12.880084481,9.6808830825,-0.508433753,2243,4.2393388105,3.1992013987,3.7309050575
12,1,2001,2501,1519,1055,12706,864,982,1919,2705,221282,11.371825972,6.9067587568,4.7969917633,-196,3.9285316431,4.4650672147,8.7255234064
12,1,2002,2466,1576,1071,13460,810,890,1881,2564,223846,11.079959023,7.081109254,4.8120989918,-207,3.6394025988,3.9988497691,8.4515015906
12,1,2003,2436,1567,509,13512,702,869,1211,1755,225601,10.839987807,6.9730135033,2.2650056625,-325,3.1238388509,3.866974304,5.3888445134
12,1,2004,2552,1616,944,13368,664,936,1608,2381,227982,11.252626311,7.1254875072,4.1624134943,-163,2.9277993223,4.1271388037,7.0902128166
12,1,2005,2685,1565,1748,13480,694,1120,2442,3374,231356,11.69073754,6.8141542829,7.6109531543,-188,3.0217399823,4.8765832568,10.632693137
12,1,2006,2677,1598,3285,13440,748,1079,4033,4984,236340,11.447606993,6.8334986829,14.047586466,-128,3.198658958,4.6141083097,17.246245424
12,1,2007,2935,1621,1184,13453,675,1314,1859,3094,239434,12.337790632,6.814159664,4.977153018,-79,2.8374816615,5.5236309676,7.8146346795
12,1,2008,2966,1610,-82,13495,677,1356,595,1930,241364,12.337821705,6.6971992396,-0.341099589,-21,2.8161514815,5.6406224652,2.4750518929
12,3,2001,346,178,34,2141,4,168,38,184,22558,15.401050476,7.923083771,1.5133980237,-22,0.1780468263,7.4779667052,1.69144485
12,3,2002,352,203,472,2181,1,149,473,610,23168,15.396054761,8.8789747627,20.644709793,-12,0.0437387919,6.5170799983,20.688448585
12,3,2003,345,182,21,2232,-6,163,15,143,23311,14.845414058,7.8314937929,0.9036338992,-35,-0.258181114,7.0139202651,0.6454527851
12,3,2004,370,219,378,2309,8,151,386,511,23822,15.700252477,9.2928521418,16.039717395,-26,0.3394649184,6.4074003352,16.379182314
12,3,2005,377,161,398,2310,3,216,401,596,24418,15.630182421,6.6749585406,16.500829187,-21,0.1243781095,8.9552238806,16.625207297
12,3,2006,374,203,446,2312,6,171,452,610,25028,15.127613963,8.2109776322,18.039881891,-13,0.2426889941,6.9166363305,18.282570885
12,3,2007,393,226,501,2399,2,167,503,663,25691,15.497150969,8.9118476311,19.755910014,-7,0.0788659082,6.585303338,19.834775922
12,3,2008,407,215,281,2424,2,192,283,473,26164,15.697618359,8.2923536785,10.837913412,-2,0.0771381738,7.4052646804,10.915051586
12,5,2001,2023,1390,946,3454,87,633,1033,1531,149783,13.57558676,9.3277635177,6.348247689,-135,0.5838240475,4.2478232422,6.9320717365
12,5,2002,1883,1485,2211,3423,-136,398,2075,2375,152158,12.472635382,9.8363587588,14.645245263,-98,-0.900838243,2.6362766236,13.74440702
12,5,2003,2059,1472,2495,3434,-566,587,1929,2484,154642,13.422425033,9.5958279009,16.264667536,-32,-3.68970013,3.8265971317,12.574967405
12,5,2004,2126,1475,2243,3422,376,651,2619,3096,157738,13.611626865,9.4436263525,14.360714514,-174,2.4073244126,4.1680005122,16.768038927
12,5,2005,2376,1472,2912,3526,48,904,2960,3720,161458,14.887404604,9.2231732227,18.24584268,-144,0.3007556486,5.6642313813,18.546598328
12,5,2006,2328,1488,1473,3600,228,840,1701,2458,163916,14.309686699,9.1463976839,9.0541960943,-83,1.4014641612,5.1632890151,10.455660256
12,5,2007,2443,1520,-1323,3462,32,923,-1291,-362,163554,14.920450728,9.2832931261,-8.080129478,6,0.19543775,5.6371576022,-7.884691727
12,5,2008,2328,1495,-516,3692,108,833,-408,392,163946,14.216793893,9.1297709924,-3.151145038,-33,0.6595419847,5.0870229008,-2.491603053
12,7,2001,320,262,-208,3764,11,58,-197,-162,25916,12.30911259,10.078085933,-8.000923183,-23,0.4231257453,2.2310266569,-7.577797438
12,7,2002,300,255,212,3982,8,45,220,246,26162,11.521179769,9.7930028035,8.1416337033,-19,0.3072314605,1.7281769653,8.4488651638
12,7,2003,287,256,703,4381,-1,31,702,754,26916,10.814273334,9.646181092,26.489317608,21,-0.037680395,1.1680922416,26.451637213
12,7,2004,317,272,678,4806,10,45,688,693,27609,11.627693718,9.9770747364,24.869325997,-40,0.3668042182,1.6506189821,25.236130215
12,7,2005,327,259,351,4850,6,68,357,398,28007,11.759205984,9.3138665132,12.622266974,-27,0.2157652474,2.4453394707,12.838032221
12,7,2006,332,258,309,4905,8,74,317,377,28384,11.774928623,9.1503963398,10.959195616,-14,0.2837332198,2.6245322835,11.242928836
12,7,2007,369,265,294,4988,6,104,300,409,28793,12.907287895,9.2694614968,10.283855396,5,0.2098745999,3.6378263987,10.493729996
12,7,2008,348,256,116,4875,6,92,122,219,29012,12.040480927,8.8573652798,4.0134936424,5,0.2075944987,3.1831156474,4.2210881412
12,9,2001,4895,5179,8081,9881,668,-284,8749,8145,485843,10.160439462,10.749931762,16.773546741,-320,1.3865523107,-0.5894923,18.160099051
12,9,2002,4836,5472,8771,9889,510,-636,9281,8415,494258,9.8683707087,11.166196137,17.898155394,-230,1.0407090698,-1.297825428,18.938864464
12,9,2003,4854,5421,9191,10039,171,-567,9362,8737,502995,9.7347413344,10.871865013,18.432634447,-58,0.3429420618,-1.137123679,18.775576509
12,9,2004,5093,5597,13502,10039,675,-504,14177,12909,515904,9.9970654599,10.986368619,26.503117581,-764,1.3249595887,-0.98930316,27.82807717
12,9,2005,5330,5683,10500,10040,514,-353,11014,10176,526080,10.230483386,10.908036976,20.153860328,-485,0.9865794484,-0.67755359,21.140439776
12,9,2006,5445,5716,4761,9788,661,-271,5422,4890,530970,10.302256279,10.815004021,9.0080885483,-261,1.250650395,-0.512747741,10.258738943
12,9,2007,5728,5806,3538,9965,491,-78,4029,4035,535005,10.746968738,10.893313633,6.6380543634,84,0.9212223551,-0.146344896,7.5592767185
12,9,2008,5779,5932,1017,10010,536,-153,1553,1516,536521,10.786485816,11.072059847,1.8982273879,116,1.0004423598,-0.285574032,2.8986697476
12,11,2001,22446,16279,13877,20100,15899,6167,29776,36182,1668165,13.603026289,9.865618148,8.4099258579,239,9.635325446,3.7374081405,18.045251304
12,11,2002,22207,16120,9305,20142,14965,6087,24270,30372,1698537,13.192138776,9.5761371217,5.5276647592,15,8.8900057089,3.6160016538,14.417670468
12,11,2003,22368,16120,1205,20058,13081,6248,14286,19734,1718271,13.092921815,9.4357072449,0.7053366768,-800,7.6568539994,3.6572145699,8.3621906762
12,11,2004,22633,15675,1808,20115,12040,6958,13848,21399,1739670,13.090448912,9.0660887505,1.0457089927,593,6.9636815666,4.0243601611,8.0093905593
12,11,2005,23182,15454,3747,20123,12626,7728,16373,24036,1763706,13.234091916,8.8223473587,2.1390795621,-65,7.207904604,4.4117445572,9.3469841661
12,11,2006,23165,15499,-19872,20150,12992,7666,-6880,827,1764533,13.131196611,8.7856860037,-11.26454302,41,7.3645804607,4.3455106074,-3.899962559
12,11,2007,22723,15185,-35988,20285,11743,7538,-24245,-15762,1748771,12.935402117,8.6442846961,-20.48669856,945,6.6848755473,4.2911174211,-13.80182301
12,11,2008,21765,15309,-16648,20097,11770,6456,-4878,2463,1751234,12.43712509,8.7479875029,-9.513129267,885,6.7257046776,3.6891375869,-2.787424589
12,13,2001,136,146,-341,1556,3,-10,-338,-353,12688,10.5717284,11.34906137,-26.5070543,-5,0.2331998912,-0.777332971,-26.27385441
12,13,2002,151,142,10,1599,2,9,12,10,12698,11.896320807,11.187268573,0.787835815,-11,0.157567163,0.7090522335,0.945402978
12,13,2003,150,143,233,1664,1,7,234,240,12938,11.70229365,11.156186613,18.177562802,-1,0.078015291,0.546107037,18.255578093
12,13,2004,144,144,82,1744,2,0,84,71,13009,11.099549081,11.099549081,6.3205765599,-13,0.1541604039,0,6.4747369638
12,13,2005,146,141,298,1730,2,5,300,293,13302,11.09801984,10.717950667,22.652122686,-12,0.152027669,0.3800691726,22.804150355
12,13,2006,172,137,43,1723,2,35,45,74,13376,12.894519829,10.27063498,3.2236299573,-6,0.1499362771,2.6238848489,3.3735662344
12,13,2007,164,157,172,1757,2,7,174,182,13558,12.177916388,11.658127274,12.77196109,1,0.1485111755,0.5197891141,12.920472266
12,13,2008,155,140,37,1757,1,15,38,59,13617,11.407543698,10.303587856,2.7230910764,6,0.0735970561,1.1039558418,2.7966881325
12,15,2001,1047,2146,4653,2756,187,-1099,4840,3680,145919,7.2668466605,14.894606431,32.294782723,-61,1.2978990693,-7.627759771,33.592681793
12,15,2002,999,2176,4416,2790,182,-1177,4598,3427,149346,6.7668027027,14.739301983,29.912112848,6,1.2327908828,-7.97249928,31.144903731
12,15,2003,1058,2208,3509,2433,150,-1150,3659,2623,151969,7.0225511508,14.655758923,23.291240064,114,0.9956357964,-7.633207773,24.286875861
12,15,2004,1025,2308,5532,2715,139,-1283,5671,4088,156057,6.6552823463,14.985747956,35.919045795,-300,0.9025212157,-8.33046561,36.821567011
12,15,2005,1105,2295,-1925,2820,147,-1190,-1778,-2915,153142,7.147500477,14.844808683,-12.45152798,53,0.9508439549,-7.697308206,-11.50068403
12,15,2006,1128,2037,543,2774,152,-909,695,-338,152804,7.3738502873,13.316075386,3.549646016,-124,0.9936394004,-5.942225099,4.5432854164
12,15,2007,1195,2156,1142,2775,138,-961,1280,-325,152479,7.8288014727,14.124599142,7.4815826626,-644,0.9040791659,-6.29579767,8.3856618285
12,15,2008,1200,2096,-655,2795,138,-896,-517,-2419,150060,7.9328615484,13.856064838,-4.330020262,-1006,0.9122790781,-5.923203289,-3.417741184
12,17,2001,849,2054,3597,2161,68,-1205,3665,2430,121070,7.0835593008,17.137374327,30.01126361,-30,0.5673522173,-10.05381503,30.578615827
12,17,2002,849,2032,3271,2161,64,-1183,3335,2145,123215,6.9508975172,16.636305954,26.780195264,-7,0.5239781403,-9.685408437,27.304173404
12,17,2003,880,2148,3626,2161,53,-1268,3679,2502,125717,7.0702039111,17.257725001,29.132453843,91,0.4258190992,-10.18752109,29.558272942
12,17,2004,915,2150,4870,2161,56,-1235,4926,3445,129162,7.1798775105,16.870750435,38.214211449,-246,0.4394241974,-9.690872924,38.653635647
12,17,2005,932,2126,4996,2161,56,-1194,5052,3727,132889,7.113119202,16.225849167,38.129982332,-131,0.4273977203,-9.112729965,38.557380052
12,17,2006,1108,2275,5146,2161,62,-1167,5208,3966,136855,8.2151966309,16.867845068,38.154694822,-75,0.4596951183,-8.652648437,38.61438994
12,17,2007,1143,2280,4054,2161,56,-1137,4110,3089,139944,8.2587003566,16.474047955,29.292013338,116,0.4046257393,-8.215347599,29.696639077
12,17,2008,1188,2285,2387,2161,56,-1097,2443,1472,141416,8.4446971851,16.242536252,16.967586011,126,0.398066534,-7.797839067,17.365652545
12,19,2001,1837,1115,3067,1567,146,722,3213,3835,145456,12.797960129,7.7679507589,21.367089666,-100,1.0171487092,5.0300093703,22.384238375
12,19,2002,1903,1200,4449,1567,5,703,4454,5122,150578,12.856631333,8.1071768783,30.057358276,-35,0.0337799037,4.7494544546,30.09113818
12,19,2003,1996,1148,4058,1567,-288,848,3770,4676,155254,13.052917942,7.507389678,26.537445395,58,-1.883386958,5.5455282639,24.654058437
12,19,2004,2119,1203,6159,1567,317,916,6476,7094,162348,13.343744687,7.5755190458,38.784390527,-298,1.9962090919,5.7682256409,40.780599618
12,19,2005,2137,1287,4956,1567,106,850,5062,5773,168121,12.933134424,7.7889302779,29.993736175,-139,0.6415125171,5.1442041462,30.635248692
12,19,2006,2335,1315,6830,1567,236,1020,7066,7980,176101,13.56682606,7.6404181023,39.683692501,-106,1.3712081157,5.9264079577,41.054900616
12,19,2007,2435,1266,4224,1567,102,1169,4326,5578,181679,13.611716697,7.0769746772,23.6122757,83,0.5701827939,6.5347420202,24.182458494
12,19,2008,2615,1316,1520,1567,151,1299,1671,3048,184727,14.273783726,7.1832884833,8.2968073667,78,0.8242223108,7.090495243,9.1210296775
12,21,2001,3282,2361,6764,4791,2490,921,9254,10061,264096,12.668610834,9.113525344,26.109227203,-114,9.6114689142,3.55508549,35.720696117
12,21,2002,3586,2410,7454,4788,2344,1176,9798,10938,275034,13.302913954,8.9403297906,27.651957784,-36,8.6954908835,4.3625841634,36.347448667
12,21,2003,3647,2406,5922,4728,2077,1241,7999,9320,284354,13.039250038,8.6022581822,21.173139216,80,7.4259726701,4.4369918554,28.599111887
12,21,2004,3795,2466,7537,4728,1861,1329,9398,10278,294632,13.109125264,8.5183406853,26.035171835,-449,6.428480136,4.5907845786,32.463651971
12,21,2005,4015,2505,7627,4728,1975,1510,9602,10849,305481,13.38081328,8.3484277128,25.418546174,-263,6.5820937057,5.0323855674,32.000639879
12,21,2006,4221,2632,2736,4728,1977,1589,4713,6121,311602,13.680493548,8.530457005,8.8675267347,-181,6.407565919,5.1500365429,15.275092654
12,21,2007,4129,2811,-1054,4728,1805,1318,751,2053,313655,13.20736913,8.9915026941,-3.371413675,-16,5.773625885,4.2158664357,2.4022122103
12,21,2008,4073,2978,-1342,4728,1805,1095,463,1603,315258,12.952506945,9.4703082938,-4.267680903,45,5.740062616,3.4821986507,1.4723817126
12,23,2001,742,616,479,2985,38,126,517,587,57316,13.012407383,10.802753299,8.4001929063,-56,0.6664036126,2.2096540839,9.0665965189
12,23,2002,791,644,868,3042,35,147,903,1007,58323,13.680505712,11.138110845,15.012236356,-43,0.6053321111,2.5423948668,15.617568467
12,23,2003,807,657,1375,3136,22,150,1397,1560,59883,13.654129232,11.116186996,23.264470501,13,0.372231528,2.5379422364,23.636702029
12,23,2004,778,708,1537,3196,30,70,1567,1551,61434,12.825902388,11.671900888,25.338575797,-86,0.4945720715,1.1540015002,25.833147869
12,23,2005,850,614,2232,3410,28,236,2260,2454,63888,13.565056415,9.7987583984,35.620242256,-42,0.4468489172,3.7662980163,36.067091173
12,23,2006,864,644,2645,4222,36,220,2681,2858,66746,13.227796745,9.8596077591,40.494817582,-43,0.5511581977,3.368188986,41.04597578
12,23,2007,863,685,961,4289,30,178,991,1122,67868,12.821846168,10.177247537,14.277861144,-47,0.4457188703,2.6445986302,14.723580014
12,23,2008,915,721,1059,4554,30,194,1089,1224,69092,13.361565421,10.528621495,15.464369159,-59,0.4380841121,2.8329439252,15.902453271
12,27,2001,435,309,-197,3193,419,126,222,304,32566,13.420127106,9.532917875,-6.077620781,-44,12.926513235,3.8872092306,6.8488924539
12,27,2002,451,281,-492,2896,394,170,-98,32,32598,13.84199865,8.6243938371,-15.10036216,-40,12.092566448,5.2176048125,-3.007795715
12,27,2003,440,300,363,3046,349,140,712,836,33434,13.32687182,9.0865035134,10.994669251,-16,10.570632421,4.2403683063,21.565301672
12,27,2004,458,304,238,3052,312,154,550,672,34106,13.562333432,9.0020728457,7.0476754516,-32,9.2389694996,4.5602605863,16.286644951
12,27,2005,477,302,-523,3165,333,175,-190,-24,34082,13.990731507,8.8578635537,-15.33994251,-9,9.7671144483,5.1328679533,-5.572828064
12,27,2006,483,297,-346,3192,332,186,-14,150,34232,14.140586117,8.6951430161,-10.12969523,-22,9.7198231695,5.445443101,-0.409872061
12,27,2007,481,263,-382,3185,299,218,-83,47,34279,14.041540774,7.6775992176,-11.15149392,-88,8.7285253463,6.3639415568,-2.422968574
12,27,2008,485,264,-696,3167,299,221,-397,-288,33991,14.208290611,7.7339973634,-20.38962941,-112,8.759337923,6.4742932474,-11.63029149
12,29,2001,164,137,60,1028,0,27,60,71,13888,11.839018228,9.8899115683,4.3313481321,-16,0,1.9491066594,4.3313481321
12,29,2002,159,157,31,874,-1,2,30,20,13908,11.440495035,11.296589437,2.2305367679,-12,-0.071952799,0.1439055979,2.1585839689
12,29,2003,147,192,18,918,-1,-45,17,-45,13863,10.586583126,13.827373879,1.2963163012,-17,-0.072017572,-3.240790753,1.2242987289
12,29,2004,154,188,361,1183,0,-34,361,306,14169,10.987442922,13.413242009,25.756278539,-21,0,-2.425799087,25.756278539
12,29,2005,179,176,413,1405,0,3,413,402,14571,12.456506611,12.247738344,28.740431454,-14,0,0.2087682672,28.740431454
12,29,2006,174,176,291,1403,0,-2,291,281,14852,11.827481902,11.96342997,19.78044387,-8,0,-0.135948068,19.78044387
12,29,2007,175,188,69,1359,0,-13,69,61,14913,11.758777087,12.632286242,4.6363178229,5,0,-0.873509155,4.6363178229
12,29,2008,178,180,41,1407,-1,-2,40,44,14957,11.918312688,12.052226314,2.7452293271,6,-0.066956813,-0.133913626,2.6782725142
12,31,2001,12172,6958,5063,16717,1630,5214,6693,11239,791001,15.498200556,8.8593887175,6.4465485882,-668,2.0754244912,6.6388118386,8.5219730793
12,31,2002,12036,6809,6184,17934,675,5227,6859,11486,802487,15.106483387,8.5460323517,7.76158967,-600,0.8471980963,6.5604510357,8.6087877662
12,31,2003,12202,7439,6638,16751,-1170,4763,5468,9488,811975,15.115871417,9.2154538168,8.2231727969,-743,-1.449399243,5.9004176004,6.7737735543
12,31,2004,12642,7552,2378,17285,2434,5090,4812,9336,821311,15.480448617,9.2476149309,2.911921121,-566,2.9804945368,6.2328336862,5.8924156578
12,31,2005,12815,6948,2764,18018,1196,5867,3960,9088,830399,15.517251818,8.4130991518,3.3468344927,-739,1.4481961119,7.104152666,4.7950306046
12,31,2006,13473,7063,2428,16905,1980,6410,4408,10386,840785,16.123897787,8.4526898295,2.9057243248,-432,2.3695774972,7.671207958,5.2753018219
12,31,2007,13242,6848,-1315,14036,1079,6394,-236,6179,846964,15.691906794,8.1149507421,-1.558288584,21,1.2786261464,7.5769560521,-0.279662438
12,31,2008,13153,6946,-3955,14034,1384,6207,-2571,3998,850962,15.49301913,8.1817464365,-4.658624699,362,1.6302241676,7.3112726939,-3.028400531
12,33,2001,3901,2865,3024,25268,202,1036,3226,4031,298810,13.143774565,9.653143842,10.188868055,-231,0.6806056042,3.4906307226,10.869473659
12,33,2002,3884,2915,603,24754,-406,969,197,858,299668,12.979591564,9.7413772937,2.0151116666,-308,-1.356775019,3.2382142702,0.6583366473
12,33,2003,3946,2901,2103,24753,-1585,1045,518,1252,300920,13.140455687,9.660532678,7.0031369258,-311,-5.278160736,3.4799230088,1.72497619
12,33,2004,4079,2845,-1302,21827,1007,1234,-295,690,301610,13.539574793,9.4435131861,-4.321776509,-249,3.3425721541,4.0960616069,-0.979204355
12,33,2005,4003,2904,-235,22112,104,1099,-131,682,302292,13.257117877,9.6174544876,-0.778271971,-286,0.3444267447,3.6396633891,-0.433845227
12,33,2006,4356,2963,2114,24379,600,1393,2714,3951,306243,14.316349922,9.7381416024,6.9478337318,-156,1.9719490251,4.57820832,8.9197827569
12,33,2007,4498,2887,-4443,21888,61,1611,-4382,-2586,303657,14.74995901,9.4671257583,-14.56960157,185,0.2000327923,5.2828332514,-14.36956878
12,33,2008,4388,2956,-2615,21973,272,1432,-2343,-718,302939,14.467619305,9.7461902156,-8.621883428,193,0.89680776,4.7214290895,-7.725075668
12,35,2001,408,639,3290,462,78,-231,3368,3142,53695,7.8274882971,12.259227995,63.118716906,5,1.4964315862,-4.431739698,64.615148492
12,35,2002,467,666,3791,462,75,-199,3866,3706,57401,8.4071433715,11.98963059,68.24728163,39,1.350183625,-3.582487218,69.597465255
12,35,2003,544,713,4584,462,56,-169,4640,4702,62103,9.1042977641,11.932654974,76.717097336,231,0.9372071228,-2.82835721,77.654304458
12,35,2004,541,751,6468,462,58,-210,6526,6069,68172,8.3055075801,11.529456918,99.297639609,-247,0.8904241029,-3.223949338,100.18806371
12,35,2005,669,757,7228,462,59,-88,7287,7166,75338,9.3233920981,10.549787471,100.73165633,-33,0.8222423524,-1.226395373,101.55389868
12,35,2006,777,822,6981,462,66,-45,7047,6936,82274,9.8596553562,10.430677867,88.584625536,-66,0.8374996828,-0.571022511,89.422125219
12,35,2007,958,907,5799,462,58,51,5857,5904,88178,11.240701194,10.642292258,68.042616103,-4,0.6805434961,0.5984089362,68.723159599
12,35,2008,952,916,3068,462,58,36,3126,3069,91247,10.611676188,10.210394315,34.198132925,-93,0.6465096837,0.4012818726,34.844642608
12,37,2001,97,128,88,458,3,-31,91,52,9893,9.8307489612,12.972534712,8.9186176143,-8,0.3040437823,-3.14178575,9.2226613966
12,37,2002,102,127,84,512,2,-25,86,52,9945,10.283294687,12.803710051,8.4685956246,-9,0.2016332292,-2.520415364,8.6702288537
12,37,2003,98,117,42,548,2,-19,44,16,9961,9.8462775043,11.755249673,4.2198332161,-9,0.2009444389,-1.908972169,4.420777655
12,37,2004,125,118,30,547,3,7,33,31,9992,12.529444194,11.827795319,3.0070666065,-9,0.3007066607,0.7016488749,3.3077732672
12,37,2005,117,102,65,535,3,15,68,76,10068,11.665004985,10.169491525,6.480558325,-7,0.2991026919,1.4955134596,6.7796610169
12,37,2006,129,96,1056,1554,3,33,1059,1084,11152,12.158341188,9.0480678605,99.528746466,-8,0.2827521206,3.110273327,99.811498586
12,37,2007,119,116,136,1834,3,3,139,139,11291,10.604642873,10.337298935,12.119591855,-3,0.267343938,0.267343938,12.386935793
12,37,2008,116,105,-85,1862,2,11,-83,-89,11202,10.314320011,9.3362379407,-7.557906904,-17,0.1778331036,0.97808207,-7.380073801
12,39,2001,706,426,88,2884,77,280,165,402,45463,15.598073439,9.4118686757,1.9442357828,-43,1.7012063099,6.1862047634,3.6454420927
12,39,2002,700,492,-544,2968,74,208,-470,-295,45168,15.447253147,10.857212212,-12.00472245,-33,1.6329953327,4.5900409352,-10.37172711
12,39,2003,715,459,-238,3048,56,256,-182,19,45187,15.826462288,10.159924741,-5.268109125,-55,1.2395550883,5.6665375463,-4.028554037
12,39,2004,676,445,6,3172,54,231,60,261,45448,14.916974679,9.8196061124,0.1323991835,-30,1.1915926518,5.0973685662,1.3239918354
12,39,2005,682,443,77,3328,58,239,135,337,45785,14.950730547,9.7113982879,1.6879857069,-37,1.2714697533,5.2393322592,2.9594554602
12,39,2006,778,460,-47,3370,59,318,12,307,46092,16.935685754,10.013387464,-1.02310698,-23,1.2843257834,6.9222982901,0.2612188034
12,39,2007,750,505,380,3292,52,245,432,664,46756,16.155436843,10.877994141,8.1854213338,-13,1.1201102878,5.2774427021,9.3055316216
12,39,2008,756,476,465,3690,52,280,517,804,47560,16.031214216,10.093727469,9.8604690615,7,1.1026761101,5.9374867467,10.963145172
12,41,2001,176,161,11,1243,9,15,20,19,14557,12.098298677,11.067193676,0.7561436673,-16,0.6186630005,1.0311050009,1.3748066678
12,41,2002,181,128,270,1243,9,53,279,322,14879,12.297866558,8.6968338089,18.344883816,-10,0.6114961272,3.601032749,18.956379943
12,41,2003,184,151,521,1300,4,33,525,574,15453,12.132401424,9.9564816036,34.353158381,16,0.263747857,2.1759198207,34.616906238
12,41,2004,179,169,273,1300,3,10,276,266,15719,11.484665726,10.843064288,17.515719235,-20,0.1924804312,0.6416014372,17.708199666
12,41,2005,197,138,455,1310,4,59,459,503,16222,12.335243104,8.6409317179,28.49002849,-15,0.2504617889,3.6943113866,28.740490279
12,41,2006,174,181,365,1279,3,-7,368,353,16575,10.610726591,11.037594902,22.258133366,-8,0.1829435619,-0.426868311,22.441076928
12,41,2007,214,170,360,1284,3,44,363,408,16983,12.754037785,10.131712259,21.455390667,1,0.1787949222,2.622325526,21.634185589
12,41,2008,214,167,152,1290,2,47,154,208,17191,12.52414116,9.7735120267,8.895651665,7,0.1170480482,2.7506291333,9.0126997132
12,43,2001,99,114,196,913,20,-15,216,196,10783,9.2653252223,10.669162377,18.343472157,-5,1.8717828732,-1.403837155,20.21525503
12,43,2002,82,93,147,934,20,-11,167,148,10931,7.552730957,8.5659021829,13.539651838,-8,1.8421295017,-1.013171226,15.381781339
12,43,2003,63,100,55,976,18,-37,73,30,10961,5.7555271332,9.1357573543,5.0246665449,-6,1.6444363238,-3.380230221,6.6691028686
12,43,2004,76,111,209,974,15,-35,224,173,11134,6.8793844761,10.047522064,18.918307309,-16,1.3577732519,-3.168137588,20.276080561
12,43,2005,81,109,162,974,17,-28,179,142,11276,7.2289156627,9.7278000892,14.457831325,-9,1.5171798304,-2.498884427,15.975011156
12,43,2006,87,107,-57,968,18,-20,-39,-64,11212,7.7374599787,9.5161864105,-5.069370331,-5,1.6008537887,-1.778726432,-3.468516542
12,43,2007,87,107,-126,970,14,-20,-112,-138,11074,7.8075922104,9.6024409943,-11.30754734,-6,1.2563941488,-1.794848784,-10.05115319
12,43,2008,72,87,125,1208,13,-15,138,101,11175,6.4722009978,7.8205762057,11.236460066,-22,1.1685918468,-1.348375208,12.405051912
12,45,2001,118,149,340,3007,2,-31,342,305,14892,8.0056989721,10.108891075,23.067268225,-6,0.1356898131,-2.103192103,23.202958038
12,45,2002,106,150,47,2932,2,-44,49,-8,14884,7.1198280494,10.075228372,3.1569048898,-13,0.1343363783,-2.955400322,3.2912412681
12,45,2003,121,148,354,3158,-3,-27,351,332,15216,8.0398671096,9.8338870432,23.521594684,8,-0.199335548,-1.794019934,23.322259136
12,45,2004,116,165,220,3277,1,-49,221,154,15370,7.5851696855,10.789249984,14.385666645,-18,0.0653893938,-3.204080298,14.451056039
12,45,2005,136,144,318,3442,-1,-8,317,298,15668,8.7634512533,9.2789483858,20.491011019,-11,-0.064437142,-0.515497133,20.426573877
12,45,2006,119,134,42,3365,1,-15,43,19,15687,7.5904959337,8.5472811354,2.6789985648,-9,0.0637856801,-0.956785202,2.7427842449
12,45,2007,143,163,71,3451,-1,-20,70,45,15732,9.1027722079,10.375887202,4.5195582291,-5,-0.06365575,-1.273114994,4.4559024794
12,45,2008,137,135,-43,3438,-1,2,-44,-65,15667,8.7263925603,8.5989999682,-2.738940731,-23,-0.063696296,0.1273925921,-2.802637027
12,47,2001,168,135,352,2820,29,33,381,410,13735,12.416851441,9.977827051,26.016260163,-4,2.1433850702,2.4390243902,28.159645233
12,47,2002,169,134,-47,2887,29,35,-18,4,13739,12.302540584,9.7546771493,-3.421416612,-13,2.1110868457,2.5478634345,-1.310329766
12,47,2003,161,129,117,2969,13,32,130,147,13886,11.656108597,9.3393665158,8.4705882353,-15,0.9411764706,2.3167420814,9.4117647059
12,47,2004,186,139,-9,3058,11,47,2,40,13926,13.375521358,9.9956853157,-0.647202646,-9,0.7910254566,3.379836042,0.1438228103
12,47,2005,191,135,-193,2989,13,56,-180,-135,13791,13.782155356,9.741313995,-13.92647112,-11,0.9380524588,4.0408413609,-12.98841866
12,47,2006,185,127,248,3055,12,58,260,312,14103,13.264501326,9.1059009106,17.781601778,-6,0.860400086,4.1586004159,18.642001864
12,47,2007,186,119,55,3065,6,67,61,129,14232,13.128639492,8.3995059114,3.8821245809,1,0.4235044997,4.7291335804,4.3056290806
12,47,2008,191,114,28,3052,5,77,33,116,14348,13.365990203,7.977606718,1.9594121763,6,0.3498950315,5.388383485,2.3093072078
12,49,2001,472,197,-749,1857,257,275,-492,-233,26671,17.620158656,7.3541763882,-27.96080261,-16,9.5940270649,10.265982268,-18.36677555
12,49,2002,438,216,152,2236,245,222,397,595,27266,16.241170254,8.0093442349,5.6362052024,-24,9.0846728591,8.2318260192,14.720878061
12,49,2003,506,184,-398,2269,203,322,-195,110,27376,18.520551956,6.734746166,-14.56754877,-17,7.4301819114,11.78580579,-7.137366861
12,49,2004,499,223,-228,2279,196,276,-32,220,27596,18.154696937,8.1132212763,-8.295132067,-24,7.1309030052,10.04147566,-1.164229062
12,49,2005,463,208,-282,2383,203,255,-79,156,27752,16.730505167,7.5160800752,-10.1900701,-20,7.3354050734,9.2144250921,-2.854665029
12,49,2006,494,215,-122,2275,204,279,82,345,28097,17.69055847,7.6993321277,-4.368923347,-16,7.3054128095,9.9912263425,2.9364894627
12,49,2007,520,175,24,2476,185,345,209,530,28627,18.334391087,6.1702277696,0.8462026655,-24,6.5228122135,12.164163317,7.3690148791
12,49,2008,518,180,-233,2474,185,338,-48,261,28888,18.012692341,6.2592367209,-8.1022342,-29,6.4331044075,11.75345562,-1.669129792
12,51,2001,654,290,-954,2403,435,364,-519,-166,36165,18.042374752,8.0004414037,-26.31869345,-11,12.000662105,10.041933348,-14.31803134
12,51,2002,681,266,-767,2164,409,415,-358,44,36209,18.818912869,7.3507060547,-21.19545693,-13,11.302401415,11.468206815,-9.893055517
12,51,2003,674,280,-595,1856,351,394,-244,140,36349,18.578240856,7.7179635602,-16.40067257,-10,9.6750186058,10.860277295,-6.72565396
12,51,2004,681,313,70,1966,330,368,400,741,37090,18.546004167,8.5240812103,1.9063440406,-27,8.9870504773,10.021922956,10.893394518
12,51,2005,713,296,514,2500,344,417,858,1241,38331,18.907200912,7.849272749,13.630156057,-34,9.1221277893,11.057928163,22.752283847
12,51,2006,719,277,-123,2532,348,442,225,647,38978,18.600680387,7.1660479375,-3.182035727,-20,9.0028327879,11.434632449,5.8207970611
12,51,2007,746,268,-530,2491,308,478,-222,268,39246,19.073430149,6.8521169973,-13.55082839,12,7.8748210268,12.221313152,-5.676007363
12,51,2008,742,310,-545,2738,309,432,-236,207,39453,18.856656374,7.8781178922,-13.85023952,11,7.8527046087,10.978538482,-5.997534911
12,53,2001,1201,2068,3450,2103,91,-867,3541,2644,134077,9.0467402358,15.5775677,25.987721743,-30,0.6854732402,-6.530827464,26.673194983
12,53,2002,1231,2207,4435,2041,84,-976,4519,3562,137639,9.0609312665,16.244902766,32.64437869,19,0.6182926291,-7.1839715,33.262671319
12,53,2003,1256,2281,5392,2057,64,-1025,5456,4655,142294,8.9735758199,16.296756724,38.523503838,224,0.4572522711,-7.323180904,38.980756109
12,53,2004,1330,2292,7951,2080,76,-962,8027,6713,149007,9.1314482271,15.736300253,54.589582597,-352,0.5217970415,-6.604852026,55.111379638
12,53,2005,1457,2201,8123,2084,76,-744,8199,7327,156334,9.5434284947,14.416668577,53.20608762,-128,0.4978040944,-4.873240082,53.703891715
12,53,2006,1531,2245,7602,2097,95,-714,7697,6882,163216,9.5822250039,14.051009232,47.579408543,-101,0.5945861368,-4.468784228,48.17399468
12,53,2007,1684,2417,6214,2060,76,-733,6290,5593,168809,10.143814472,14.559144643,37.430916347,36,0.4577968526,-4.415330171,37.888713199
12,53,2008,1798,2483,3558,2083,77,-685,3635,2880,171689,10.561001827,14.58452032,20.898801168,-70,0.4522787212,-4.023518494,21.351079889
12,55,2001,853,1261,1128,1319,373,-408,1501,1041,88447,9.7012845957,14.341523886,12.828896863,-52,4.2421795477,-4.640239291,17.07107641
12,55,2002,896,1289,1403,1319,358,-393,1761,1338,89785,10.054311235,14.46429373,15.743525293,-30,4.0172359621,-4.409982495,19.760761255
12,55,2003,888,1329,998,1319,322,-441,1320,845,90630,9.843970845,14.732699609,11.063381648,-34,3.5695479866,-4.888728764,14.632929634
12,55,2004,948,1424,2338,1319,288,-476,2626,2010,92640,10.345392045,15.539913788,25.514268566,-140,3.1429039123,-5.194521744,28.657172478
12,55,2005,945,1392,2579,1319,308,-447,2887,2368,95008,10.072049795,14.836289222,27.487636426,-72,3.2827421555,-4.764239427,30.770378581
12,55,2006,992,1432,2419,1319,359,-440,2778,2279,97287,10.317480954,14.89378299,25.159260511,-59,3.7338464339,-4.576302036,28.893106945
12,55,2007,1131,1389,1696,1319,328,-258,2024,1733,99020,11.522767909,14.151303825,17.279057802,-33,3.341704575,-2.628535916,20.620762377
12,55,2008,1112,1547,1212,1319,327,-435,1539,991,100011,11.174138702,15.545317061,12.17900729,-113,3.2859202838,-4.371178359,15.464927574
12,57,2001,14845,8851,12758,18731,5049,5994,17807,23122,1026388,14.628109027,8.7216835973,12.571600874,-679,4.9752322317,5.9064254301,17.546833106
12,57,2002,14956,8858,14402,18506,4514,6098,18916,24434,1050822,14.400084729,8.5287476952,13.866676937,-580,4.3462143933,5.8713370338,18.21289133
12,57,2003,15162,8702,11086,19717,3527,6460,14613,20300,1071122,14.290669311,8.2019129628,10.448909114,-773,3.3243101609,6.088756348,13.773219274
12,57,2004,15805,8908,18209,20106,4195,6897,22404,28027,1099149,14.565001329,8.2091130555,16.780392863,-1274,3.8658766578,6.3558882739,20.646269521
12,57,2005,16336,8869,21402,19783,4024,7467,25426,31921,1131070,14.649682385,7.9534790081,19.192733987,-972,3.6086142213,6.6962033773,22.801348208
12,57,2006,16977,9173,15298,19905,4747,7804,20045,27207,1158277,14.831303424,8.0136388236,13.364509618,-642,4.1470340669,6.8176646004,17.511543685
12,57,2007,17480,9152,51,19994,4046,8328,4097,12241,1170518,15.012055591,7.859858854,0.0437994757,-184,3.4747584051,7.1521967369,3.5185578808
12,57,2008,17223,9236,-2100,19984,4134,7987,2034,10266,1180784,14.649755752,7.8560729332,-1.786244387,245,3.516349665,6.7936828191,1.7301052778
12,59,2001,228,228,114,1735,3,0,117,100,18635,12.267958031,12.267958031,6.1339790153,-17,0.1614205004,0,6.2953995157
12,59,2002,215,212,-5,1694,3,3,-2,-17,18618,11.542694548,11.381633694,-0.268434757,-18,0.1610608542,0.1610608542,-0.107373903
12,59,2003,222,227,269,1854,3,-5,272,263,18881,11.840315742,12.10698952,14.347049255,-4,0.1600042668,-0.266673778,14.507053521
12,59,2004,211,185,-67,1819,2,26,-65,-53,18828,11.19096237,9.8119812246,-3.553528335,-14,0.1060754727,1.3789811451,-3.447452863
12,59,2005,241,214,51,1778,3,27,54,66,18894,12.777689412,11.346164042,2.7039923652,-15,0.1590583744,1.4315253698,2.8630507396
12,59,2006,227,233,234,1775,2,-6,236,220,19114,11.944853715,12.260576721,12.313197222,-10,0.1052410019,-0.315723006,12.418438224
12,59,2007,232,233,88,1770,3,-1,91,85,19199,12.110771801,12.162973403,4.5937410278,-5,0.1566048078,-0.052201603,4.7503458356
12,59,2008,248,216,108,1838,2,32,110,129,19328,12.874088302,11.212915618,5.6064578088,-13,0.1038232928,1.6611726841,5.7102811016
12,61,2001,1097,1570,2124,2225,311,-473,2435,1911,115287,9.5949060408,13.731998618,18.577557366,-51,2.7201602358,-4.137092577,21.297717602
12,61,2002,1117,1614,2691,2210,290,-497,2981,2459,117746,9.5866250703,13.852115366,23.095441418,-25,2.4889178786,-4.265490295,25.584359297
12,61,2003,1152,1597,2199,2271,232,-445,2431,1994,119740,9.7016245168,13.449213848,18.518986382,8,1.9537993819,-3.747589332,20.472785764
12,61,2004,1212,1843,4846,2270,231,-631,5077,4219,123959,9.9466965396,15.125215943,39.770372468,-227,1.8957812712,-5.178519403,41.666153739
12,61,2005,1281,1859,3084,2336,234,-578,3318,2619,126578,10.226034478,14.840123415,24.619118134,-121,1.8679875627,-4.614088937,26.487105697
12,61,2006,1409,1633,2781,2384,236,-224,3017,2722,129300,11.013060912,12.763895294,21.736921502,-71,1.844629081,-1.750834382,23.581550583
12,61,2007,1435,1690,2155,2377,217,-255,2372,2146,131446,11.006880259,12.962806716,16.529496138,29,1.6644550635,-1.955926457,18.193951202
12,61,2008,1531,1685,779,2348,218,-154,997,869,132315,11.608994506,12.776718317,5.9068626522,26,1.653011628,-1.167723811,7.5598742801
12,63,2001,533,521,-541,5833,17,12,-524,-546,46208,11.467051053,11.208881048,-11.63916439,-34,0.3657408403,0.2581700049,-11.27342355
12,63,2002,535,518,22,5767,15,17,37,9,46217,11.576954287,11.20908845,0.4760616716,-45,0.3245875034,0.3678658372,0.800649175
12,63,2003,535,490,247,6217,12,45,259,251,46468,11.54447861,10.573447699,5.329880779,-53,0.2589415763,0.9710309112,5.5888223553
12,63,2004,544,511,747,6490,17,33,764,745,47213,11.61388115,10.909362624,15.947737535,-52,0.3629337859,0.7045185256,16.310671321
12,63,2005,604,522,1356,6980,15,82,1371,1412,48625,12.604603602,10.893382583,28.297752457,-41,0.3130282351,1.7112210188,28.610780692
12,63,2006,550,523,345,7004,20,27,365,368,48993,11.268413612,10.715236944,7.0683685386,-24,0.409760495,0.5531766682,7.4781290336
12,63,2007,587,512,43,6809,16,75,59,139,49132,11.96433121,10.43566879,0.876433121,5,0.3261146497,1.5286624204,1.2025477707
12,63,2008,608,535,420,7234,16,73,436,524,49656,12.309187351,10.831275054,8.5030570515,15,0.3239259829,1.477912297,8.8269830344
12,65,2001,141,177,516,1602,0,-36,516,480,13386,10.725696029,13.464171611,39.251483341,0,0,-2.738475582,39.251483341
12,65,2002,162,143,353,1598,-1,19,352,365,13751,11.939418506,10.539116336,26.016140325,-6,-0.073700114,1.4003021705,25.942440211
12,65,2003,151,158,224,1700,-2,-7,222,205,13956,10.899772621,11.405060093,16.169199119,-10,-0.144367849,-0.505287472,16.02483127
12,65,2004,149,154,343,2001,1,-5,344,320,14276,10.55539813,10.909606121,24.298668178,-19,0.0708415982,-0.354207991,24.369509776
12,65,2005,174,140,85,1982,0,34,85,108,14384,12.142358688,9.769713887,5.9316120028,-11,0,2.3726448011,5.9316120028
12,65,2006,161,151,144,1977,0,10,144,146,14530,11.136473681,10.444767241,9.9605727329,-8,0,0.6917064398,9.9605727329
12,65,2007,168,152,-109,1977,0,16,-109,-101,14429,11.602610587,10.497600055,-7.52788425,-8,0,1.1050105321,-7.52788425
12,65,2008,157,158,135,1956,-1,-1,134,118,14547,10.83655439,10.905577029,9.3180563225,-15,-0.069022639,-0.069022639,9.249033683
12,67,2001,110,67,15,1281,29,43,44,79,7118,15.54001554,9.4652821926,2.1190930282,-8,4.0969131878,6.0747333475,6.216006216
12,67,2002,93,74,37,1296,28,19,65,77,7195,12.995179208,10.340250122,5.1701250611,-7,3.9125270733,2.6549290854,9.0826521344
12,67,2003,70,70,7,1386,19,0,26,17,7212,9.7174984383,9.7174984383,0.9717498438,-9,2.637606719,0,3.6093565628
12,67,2004,100,66,161,1542,17,34,178,203,7415,13.673343816,9.0244069187,22.014083544,-9,2.3244684488,4.6489368975,24.338551993
12,67,2005,107,78,379,1835,19,29,398,419,7834,14.033707128,10.230179028,49.708177585,-8,2.4919666863,3.8035281002,52.200144272
12,67,2006,99,58,63,1810,18,41,81,118,7952,12.542759407,7.348283289,7.9817559863,-4,2.2805017104,5.1944761181,10.262257697
12,67,2007,95,57,-51,1854,16,38,-35,5,7957,11.942925388,7.1657552329,-6.411465208,2,2.0114400654,4.7771701553,-4.400025143
12,67,2008,101,68,5,1858,15,33,20,56,8013,12.648716343,8.5159674389,0.6261740764,3,1.8785222292,4.1327489042,2.5046963056
12,69,2001,2449,2956,11320,3763,376,-507,11696,11075,223873,11.216682583,13.538796943,51.846813734,-114,1.7221203148,-2.322114361,53.568934049
12,69,2002,2535,3039,10696,3755,359,-504,11055,10526,234399,11.063298652,13.262865722,46.679701138,-25,1.5667551149,-2.199567069,48.246456253
12,69,2003,2738,3028,10986,3751,299,-290,11285,11286,245685,11.406337224,12.614459136,45.766990777,291,1.2456153506,-1.208121912,47.012606127
12,69,2004,2964,3041,15126,3767,294,-77,15420,14761,260446,11.712382763,12.016651815,59.771086932,-582,1.1617545655,-0.304269053,60.932841498
12,69,2005,3035,3203,14542,3758,306,-168,14848,14652,275098,11.334269453,11.961668882,54.307395844,-28,1.1427632463,-0.627399429,55.450159091
12,69,2006,3344,3311,13389,3742,349,33,13738,13534,288632,11.863835524,11.7467582,47.501463467,-237,1.2381813989,0.1170773243,48.739644865
12,69,2007,3613,3671,12120,3754,301,-58,12421,11671,300303,12.269605304,12.466571014,41.15904132,-692,1.022184112,-0.196965709,42.181225432
12,69,2008,3768,4008,8031,3776,303,-240,8334,6940,307243,12.403999039,13.194062672,26.437504321,-1154,0.9974553367,-0.790063633,27.434959657
12,71,2001,5246,5236,12814,5643,1922,10,14736,14659,458541,11.626476719,11.604314163,28.39909887,-87,4.259643205,0.0221625557,32.658742076
12,71,2002,5409,5450,13686,5657,1816,-41,15502,15499,474040,11.600064766,11.687992786,29.3508017,38,3.8945678713,-0.087928019,33.245369571
12,71,2003,5483,5343,13763,5659,1610,140,15373,15983,490023,11.3747753,11.084337849,28.552075954,470,3.3400306826,0.2904374507,31.892106636
12,71,2004,5737,5437,21206,5661,1468,300,22674,21936,511959,11.451303516,10.852490364,42.328105695,-1038,2.9301923587,0.5988131523,45.258298053
12,71,2005,6299,5702,27533,5661,1534,597,29067,29200,541159,11.962572095,10.828796013,52.288537467,-464,2.9132537854,1.1337760821,55.201791252
12,71,2006,7047,5863,24655,5660,1642,1184,26297,27128,568287,12.703637671,10.569239062,44.445606185,-353,2.9600359098,2.1343986098,47.405642095
12,71,2007,7684,6192,16637,5661,1489,1492,18126,19842,588129,13.289335326,10.708949029,28.773382589,224,2.5751978527,2.580386297,31.348580442
12,71,2008,7891,6254,1749,5661,1492,1637,3241,5007,593136,13.360253626,10.58864861,2.9612322383,129,2.5261054886,2.7716050167,5.4873377269
12,73,2001,3006,1500,-607,12018,544,1506,-63,1212,241590,12.473857186,6.2244796335,-2.518839425,-231,2.2574112804,6.249377552,-0.261428145
12,73,2002,2864,1582,495,11561,496,1282,991,2044,243634,11.804857138,6.5206997181,2.0402947917,-229,2.0444165993,5.2841574201,4.084711391
12,73,2003,3054,1574,2601,12572,415,1480,3016,4311,247945,12.425266336,6.4038537041,10.582225848,-185,1.6884366501,6.0214126315,12.270662498
12,73,2004,3139,1470,784,11606,425,1669,1209,2701,250646,12.591482799,5.8966166658,3.1448622217,-177,1.7048041381,6.6948661328,4.8496663598
12,73,2005,3093,1531,1261,11183,429,1562,1690,3027,253673,12.266045896,6.0715539173,5.0008030631,-225,1.7013041349,6.1944919783,6.702107198
12,73,2006,3180,1532,1981,11479,445,1648,2426,3944,257617,12.439124567,5.9926851689,7.749026971,-130,1.7406951045,6.4464393984,9.4897220755
12,73,2007,3371,1542,2254,12793,403,1829,2657,4524,262141,12.971421315,5.9335306046,8.6732671743,38,1.550721682,7.0378907107,10.223988856
12,73,2008,3451,1614,-411,12883,406,1837,-5,1922,264063,13.116585963,6.1345029684,-1.562131797,90,1.5431277603,6.9820829944,-0.019004036
12,75,2001,432,450,344,637,31,-18,375,330,34946,12.420574452,12.938098387,9.8904574337,-27,0.8912912222,-0.517523935,10.781748656
12,75,2002,370,447,720,631,29,-77,749,661,35607,10.488568877,12.671325103,20.410188086,-11,0.8220770201,-2.182756226,21.232265106
12,75,2003,414,432,375,575,14,-18,389,353,35960,11.569578158,12.072603295,10.47969036,-18,0.3912417734,-0.503025137,10.870932134
12,75,2004,426,467,849,630,22,-41,871,779,36739,11.719555977,12.847494463,23.35657987,-51,0.6052352852,-1.127938486,23.961815156
12,75,2005,432,460,664,626,19,-28,683,623,37362,11.659761677,12.41548697,17.92148554,-32,0.5128135923,-0.755725294,18.434299132
12,75,2006,468,463,977,633,27,5,1004,989,38351,12.36247408,12.230396365,25.807985419,-20,0.7132196584,0.1320777145,26.521205077
12,75,2007,490,463,546,635,22,27,568,602,38953,12.677222395,11.978681569,14.126047811,7,0.5691814136,0.6985408258,14.695229225
12,75,2008,467,455,450,596,22,12,472,507,39460,11.91129022,11.605218522,11.477688649,23,0.561131445,0.3060716973,12.038820094
12,77,2001,80,68,26,1424,13,12,39,43,7039,11.40007125,9.6900605629,3.7050231564,-8,1.8525115782,1.7100106876,5.5575347346
12,77,2002,89,58,99,1459,13,31,112,139,7178,12.520222269,8.1592459731,13.926988816,-4,1.8287965112,4.360976296,15.755785327
12,77,2003,87,47,26,1513,11,40,37,70,7248,12.061555525,6.5160127547,3.6046028005,-7,1.5250242617,5.54554277,5.1296270622
12,77,2004,90,59,50,1552,9,31,59,84,7332,12.345679012,8.0932784636,6.8587105624,-6,1.2345679012,4.2524005487,8.0932784636
12,77,2005,93,69,257,1713,11,24,268,286,7618,12.441471572,9.2307692308,34.381270903,-6,1.4715719064,3.2107023411,35.852842809
12,77,2006,115,60,80,1682,10,55,90,140,7758,14.958376691,7.8043704475,10.405827263,-5,1.3007284079,7.1540062435,11.706555671
12,77,2007,104,44,-1,1640,5,60,4,55,7813,13.358165821,5.6515316935,-0.128443902,-9,0.6422195106,7.7066341275,0.5137756085
12,77,2008,105,40,91,1667,4,65,95,144,7957,13.316423589,5.072923272,11.540900444,-16,0.5072923272,8.2435003171,12.048192771
12,79,2001,240,193,41,1748,16,47,57,82,18830,12.773431263,10.271967641,2.1821278408,-22,0.8515620842,2.5014636223,3.033689925
12,79,2002,206,215,-197,1752,15,-9,-182,-205,18625,10.999866506,11.480443199,-10.51928981,-14,0.8009611534,-0.480576692,-9.718328661
12,79,2003,239,205,-21,1797,11,34,-10,-5,18620,12.833937441,11.008189019,-1.127668143,-29,0.5906833132,1.8257484226,-0.53698483
12,79,2004,222,204,231,1895,8,18,239,237,18857,11.847266323,10.886677162,12.327560904,-20,0.4269285162,0.9605891614,12.75448942
12,79,2005,242,215,-82,1869,10,27,-72,-60,18797,12.853880066,11.41976948,-4.355446964,-15,0.5311520688,1.4341105859,-3.824294896
12,79,2006,244,221,92,1877,9,23,101,114,18911,12.941550865,11.721650578,4.8796011456,-10,0.477352286,1.2199002864,5.3569534316
12,79,2007,262,219,-45,1884,9,43,-36,1,18912,13.854004177,11.5802554,-2.379504534,-6,0.4759009069,2.2737487772,-1.903603627
12,79,2008,256,225,-51,1899,8,31,-43,-17,18895,13.542465681,11.902557727,-2.697913085,-5,0.4232020525,1.6399079536,-2.274711032
12,81,2001,3204,3347,5586,5991,937,-143,6523,6277,271903,11.921217274,12.45328159,20.78399491,-103,3.4863235286,-0.532064317,24.270318439
12,81,2002,3216,3265,6539,5989,826,-49,7365,7286,279189,11.671372475,11.849201222,23.731064868,-30,2.9976845971,-0.177828747,26.728749465
12,81,2003,3321,3347,5952,5991,614,-26,6566,6610,285799,11.756001897,11.84803925,21.069474042,70,2.1734974902,-0.092037353,23.242971532
12,81,2004,3493,3325,8052,5951,804,168,8856,8568,294367,12.04138126,11.46223667,27.757572833,-456,2.7716205362,0.5791445897,30.529193369
12,81,2005,3586,3364,9310,5951,747,222,10057,9986,304353,11.978888295,11.237306253,31.099679316,-293,2.4953233565,0.7415820417,33.595002672
12,81,2006,4020,3367,5843,6069,821,653,6664,7151,311504,13.054978672,10.934356515,18.975184174,-166,2.6662033556,2.1206221574,21.64138753
12,81,2007,4028,3461,1281,6061,702,567,1983,2627,314131,12.876517458,11.063959018,4.0950394399,77,2.2441199741,1.8125584406,6.339159414
12,81,2008,3945,3577,398,6071,724,368,1122,1635,315766,12.525857402,11.357412402,1.2636986682,145,2.2987885321,1.1684449997,3.5624872003
12,83,2001,2886,3499,4525,6934,362,-613,4887,4098,264372,11.001704006,13.338517782,17.249726482,-176,1.3799781186,-2.336813775,18.629704601
12,83,2002,3010,3568,7067,7101,343,-558,7410,6816,271188,11.240570618,13.324370752,26.391067294,-36,1.2809022332,-2.083800134,27.671969527
12,83,2003,2874,3759,8201,7569,289,-885,8490,7835,279023,10.44690128,13.66384896,29.810381835,230,1.0505060786,-3.21694768,30.860887914
12,83,2004,3066,3803,11583,7808,287,-737,11870,10589,289612,10.783718906,13.375891389,40.739666042,-544,1.0094348747,-2.592172483,41.749100917
12,83,2005,3338,3813,12177,7887,290,-475,12467,11824,301436,11.295190915,12.90250538,41.204775247,-168,0.9813077787,-1.607314465,42.186083025
12,83,2006,3555,4019,12677,8057,325,-464,13002,12325,313761,11.557273524,13.065733415,41.212814757,-213,1.0565721224,-1.508459892,42.269386879
12,83,2007,3741,4208,10738,8606,292,-467,11030,10332,324093,11.729957012,13.194241943,33.669146858,-231,0.9155700207,-1.46428493,34.584716879
12,83,2008,3961,4392,6134,8568,294,-431,6428,5535,329628,12.118319589,13.436924927,18.766415642,-462,0.8994662861,-1.318605338,19.665881928
12,85,2001,1237,1521,1947,3354,355,-284,2302,1954,129104,9.6544834422,11.871034208,15.195860357,-64,2.7706884575,-2.216550766,17.966548815
12,85,2002,1217,1659,2550,3215,337,-442,2887,2415,131519,9.3391603964,12.731032948,19.56849549,-30,2.5861109726,-3.391872552,22.154606462
12,85,2003,1193,1646,3001,3390,279,-453,3280,2897,134416,8.9721172467,12.378964785,22.569424859,70,2.0982570929,-3.406847538,24.667681952
12,85,2004,1216,1717,2843,3533,264,-501,3107,2411,136827,8.9661300015,12.66023455,20.962752956,-195,1.9465940135,-3.694104548,22.909346969
12,85,2005,1296,1730,1681,3520,273,-434,1954,1403,138230,9.4235013106,12.579210854,12.222921067,-117,1.9850431002,-3.155709544,14.207964167
12,85,2006,1380,1669,-119,3543,283,-289,164,-195,138035,9.9904077607,12.08260185,-0.861491684,-70,2.0487575335,-2.092194089,1.1872658498
12,85,2007,1383,1673,815,3582,261,-290,1076,755,138790,9.9918721214,12.087058611,5.888196514,-31,1.8856678407,-2.09518649,7.7738643547
12,85,2008,1367,1714,-23,3639,261,-347,238,-130,138660,9.8540277527,12.355379348,-0.165795639,-21,1.8814200757,-2.501351595,1.7156244368
12,86,2001,32374,18836,-31226,46046,40220,13538,8994,24823,2283934,14.252115046,8.2922357142,-13.74672714,2291,17.706186049,5.959879332,3.9594589092
12,86,2002,32366,18630,-30468,46382,38016,13736,7548,23137,2307071,14.099745045,8.1158700546,-13.27291083,1853,16.561079764,5.9838749903,3.2881689303
12,86,2003,32470,18246,-36456,46336,33422,14224,-3034,13578,2320649,14.032828261,7.8855246212,-15.75549082,2388,14.444261969,6.1473036398,-1.311228856
12,86,2004,32240,18618,-28668,46616,30341,13622,1673,16732,2337381,13.842761854,7.9939373512,-12.30906628,1437,13.027395702,5.8488245031,0.7183294225
12,86,2005,32024,18270,-28003,47137,31970,13754,3967,19316,2356697,13.644426019,7.7842762732,-11.93120353,1595,13.621418306,5.8601497461,1.690214777
12,86,2006,33213,18525,-29146,47260,32502,14688,3356,19724,2376421,14.034300434,7.8278208995,-12.31577155,1680,13.733864231,6.2064795342,1.4180926822
12,86,2007,32736,18791,-39732,48038,29539,13945,-10193,6540,2382961,13.75640787,7.8964033566,-16.69628536,2788,12.412956136,5.8600045132,-4.283329222
12,86,2008,31846,19318,-28399,48186,29568,12528,1169,15284,2398245,13.321325205,8.0808063907,-11.87942958,1587,12.368427547,5.2405188147,0.4889979641
12,87,2001,759,691,-832,1342,417,68,-415,-439,78999,9.581095325,8.722709973,-10.50259725,-92,5.2639219374,0.8583853519,-5.238675309
12,87,2002,706,726,-415,1350,325,-20,-90,-209,78790,8.9486592855,9.2021623814,-5.26018924,-99,4.1194253085,-0.253503096,-1.140763932
12,87,2003,711,734,-151,1305,136,-23,-15,-151,78639,9.0326432868,9.3248384986,-1.918325086,-113,1.7277629916,-0.292195212,-0.190562095
12,87,2004,744,710,-1415,1255,415,34,-1000,-1048,77591,9.5244191256,9.0891634129,-18.11431863,-82,5.312680023,0.4352557127,-12.80163861
12,87,2005,748,724,-2156,1255,321,24,-1835,-1841,75750,9.7560339374,9.4430061106,-28.12033311,-30,4.1867471844,0.3130278269,-23.93358593
12,87,2006,721,727,-2015,1255,383,-6,-1632,-1669,74081,9.6241765723,9.7042668073,-26.89697059,-31,5.1124266674,-0.080090235,-21.78454392
12,87,2007,691,645,-1410,1306,293,46,-1117,-1171,72910,9.401936173,8.7760475131,-19.18484805,-100,3.9866386377,0.6258886598,-15.19820941
12,87,2008,610,651,-774,1306,318,-41,-456,-667,72243,8.404924459,8.9698456112,-10.66460907,-170,4.3815835704,-0.564921152,-6.283025497
12,89,2001,736,501,948,687,38,235,986,1168,59123,12.572814705,8.5583969661,16.194331984,-53,0.6491398896,4.0144177386,16.843471873
12,89,2002,708,541,1165,687,23,167,1188,1331,60454,11.841742141,9.0485628507,19.485352534,-24,0.3846893633,2.7931792903,19.870041898
12,89,2003,684,549,951,687,-8,135,943,1052,61506,11.216792391,9.0029517875,15.59527714,-26,-0.131190554,2.2138406035,15.464086586
12,89,2004,731,615,1310,687,45,116,1355,1391,62897,11.752128164,9.8872213693,21.060585356,-80,0.7234552221,1.8649067949,21.784040578
12,89,2005,749,592,1480,687,28,157,1508,1611,64508,11.757780307,9.293198854,23.232997135,-54,0.439543189,2.4645814528,23.672540324
12,89,2006,796,632,1725,687,41,164,1766,1893,66401,12.161119556,9.6555622608,26.354184968,-37,0.6263893239,2.5055572955,26.980574292
12,89,2007,851,601,1602,687,24,250,1626,1920,68321,12.6334229,8.9220765725,23.78230727,44,0.3562892475,3.711346328,24.138596517
12,89,2008,876,641,1213,687,28,235,1241,1514,69835,12.681316772,9.2793653551,17.559859869,38,0.4053388923,3.4019514172,17.965198761
12,91,2001,2366,1460,162,5482,72,906,234,971,171929,13.800464876,8.5159250715,0.9449177134,-169,0.4199634282,5.2845398047,1.3648811416
12,91,2002,2405,1366,3496,5720,-573,1039,2923,3903,175832,13.831338189,7.8559700484,20.105762291,-59,-3.295366645,5.9753681408,16.810395645
12,91,2003,2503,1353,3338,5724,-1824,1150,1514,2686,178518,14.127275293,7.6365175674,18.840129815,22,-10.29490617,6.4907577254,8.5452236489
12,91,2004,2583,1469,1663,5554,960,1114,2623,3558,182076,14.326361504,8.1476674598,9.2236698337,-179,5.3245478294,6.1786940437,14.548217663
12,91,2005,2783,1439,-14,4705,-14,1344,-28,1183,183259,15.235331956,7.8777012879,-0.076641986,-133,-0.076641986,7.3576306677,-0.153283972
12,91,2006,2790,1406,-2237,4821,514,1384,-1723,-425,182834,15.242028665,7.6811083522,-12.2209384,-86,2.8080296537,7.5609203126,-9.412908742
12,91,2007,2690,1418,-2860,4362,-55,1272,-2915,-1747,181087,14.783428272,7.7929001074,-15.71769697,-104,-0.302263403,6.9905281641,-16.01996038
12,91,2008,2677,1416,-2602,4390,171,1261,-2431,-1394,179693,14.84006874,7.849659072,-14.4243029,-224,0.9479461167,6.9904096679,-13.47635678
12,93,2001,562,361,8,1974,209,201,217,381,36294,15.566357832,9.9990305649,0.2215851649,-37,5.7889124323,5.5673272674,6.0104975972
12,93,2002,549,356,126,2021,197,193,323,483,36777,15.026481094,9.7439476673,3.4487005789,-33,5.3920159845,5.2825334264,8.8407165633
12,93,2003,535,411,204,2100,177,124,381,456,37233,14.457505742,11.106607215,5.5127685448,-49,4.7831374139,3.3508985272,10.295905959
12,93,2004,580,379,1037,2373,157,201,1194,1338,38571,15.302622553,9.9994723234,27.360033771,-57,4.1422616221,5.3031502295,31.502295393
12,93,2005,608,468,393,2376,170,140,563,668,39239,15.627811335,12.029302146,10.101529366,-35,4.369618301,3.5985091891,14.471147667
12,93,2006,598,404,266,2395,165,194,431,604,39843,15.123542652,10.217242862,6.7271945575,-21,4.1728838421,4.9062997901,10.9000784
12,93,2007,603,433,-74,2412,151,170,77,250,40093,15.087069656,10.833666934,-1.851481185,3,3.7780224179,4.2534027222,1.926541233
12,93,2008,610,390,-133,2424,150,220,17,266,40359,15.164321583,9.6952219957,-3.306319296,29,3.7289315368,5.4690995873,0.4226122408
12,95,2001,14170,6347,10942,19576,6504,7823,17446,24627,927391,15.485027224,6.9360245444,11.957457155,-642,7.1075947119,8.5490026801,19.065051867
12,95,2002,14337,6445,5536,20349,6166,7892,11702,18839,946230,15.304055623,6.8797264762,5.9094128428,-755,6.5819074402,8.4243291466,12.491320283
12,95,2003,14373,6588,6203,20311,5534,7785,11737,18559,964789,15.042236629,6.8947509156,6.4918245188,-963,5.7916744941,8.1474857131,12.283499013
12,95,2004,15143,6471,14519,20576,5129,8672,19648,27223,992012,15.477301984,6.6138559823,14.839526349,-1097,5.2422295369,8.8634460019,20.081755886
12,95,2005,15940,6567,21459,20626,5357,9373,26816,35247,1027259,15.787875922,6.5043275519,21.254205107,-942,5.3058752391,9.2835483697,26.560080346
12,95,2006,16779,6559,8924,21765,6676,10220,15600,25256,1052515,16.13540702,6.3074160942,8.5817016657,-564,6.4199283191,9.8279909259,15.001629985
12,95,2007,16807,6737,-4630,23508,5870,10070,1240,11464,1063979,15.881925486,6.3661886119,-4.375160052,154,5.5469091809,9.5157368743,1.1717491285
12,95,2008,16668,6799,-7342,23539,5878,9869,-1464,8822,1072801,15.601044562,6.3637810163,-6.872022389,417,5.5017362574,9.2372635461,-1.370286131
12,97,2001,2748,1306,4548,2454,1585,1442,6133,9105,183255,15.377512906,7.308235755,25.450119612,1530,8.8694897945,8.0692771506,34.319609407
12,97,2002,2786,1422,6152,2450,1529,1364,7681,10465,193720,14.780821009,7.5442668612,32.638769149,1420,8.1119437628,7.2365541482,40.750712912
12,97,2003,2962,1428,8298,2451,1403,1534,9701,11714,205434,14.841389539,7.1551331065,41.577937337,479,7.0298681712,7.6862564324,48.607805509
12,97,2004,3287,1493,11038,2451,1322,1794,12360,13911,219345,15.476282961,7.0295377126,51.9705541,-243,6.2244131654,8.4467452487,58.194967265
12,97,2005,3428,1474,8029,2444,1384,1954,9413,11432,230777,15.231426147,6.5493355135,35.674772617,65,6.1494439285,8.6820906332,41.824216546
12,97,2006,3747,1574,9277,2452,2135,2173,11412,13588,244365,15.772127069,6.6253877788,39.049378923,3,8.9867871079,9.1467392906,48.03616603
12,97,2007,4058,1657,7229,2454,1838,2401,9067,11461,255826,16.225801744,6.6254690708,28.904958306,-7,7.3491926084,9.6003326729,36.254150914
12,97,2008,4156,1731,3695,2453,1839,2425,5534,7850,263676,15.999938403,6.6640744405,14.22516179,-109,7.0798572479,9.335863962,21.305019037
12,99,2001,13576,13261,13684,19502,7919,315,21603,21061,1156485,11.846892699,11.572012676,11.941137279,-857,6.9103965297,0.2748800236,18.851533809
12,99,2002,13837,13369,19397,20035,7464,468,26861,26638,1183123,11.828477249,11.428410229,16.581410219,-691,6.380556059,0.4000670198,22.961966278
12,99,2003,14242,13685,15117,20009,6585,557,21702,21704,1204827,11.928222953,11.461714022,12.661069118,-555,5.5151908541,0.4665089303,18.176259972
12,99,2004,14821,13498,23661,20500,5976,1323,29637,29377,1234204,12.153187065,11.068330005,19.401967421,-1583,4.9003067202,1.08485706,24.302274141
12,99,2005,15092,13717,14333,20699,6291,1375,20624,20803,1255007,12.125930666,11.021162931,11.516098876,-1196,5.0546136908,1.1047677356,16.570712567
12,99,2006,15581,13483,-1577,21186,6477,2098,4900,6373,1261380,12.383627797,10.716157729,-1.253384316,-625,5.1478568281,1.6674700672,3.8944725116
12,99,2007,15296,13920,-8548,21735,5862,1376,-2686,-994,1260386,12.131181085,11.039882368,-6.77937604,316,4.6491228766,1.0912987169,-2.130253164
12,99,2008,15117,14348,-1950,21764,5868,769,3918,4907,1265293,11.97064235,11.361697191,-1.54413922,220,4.6466712516,0.6089451589,3.102532032
12,101,2001,3777,5217,12071,5385,683,-1440,12754,11267,358541,10.702521199,14.782910536,34.204430339,-47,1.9353513314,-4.080389337,36.139781671
12,101,2002,3896,5331,13481,5558,644,-1435,14125,12763,371304,10.676239476,14.608581274,36.942090444,73,1.7647582706,-3.932341799,38.706848714
12,101,2003,3944,5362,14284,5699,556,-1418,14840,14089,385393,10.424251715,14.172119091,37.753552611,667,1.469544613,-3.747867376,39.223097224
12,101,2004,4332,5664,20912,5783,538,-1332,21450,19163,404556,10.967796655,14.340166264,52.945190133,-955,1.3621132503,-3.372369609,54.307303383
12,101,2005,4674,5317,21358,6006,548,-643,21906,20940,425496,11.261945035,12.811245561,51.461836126,-323,1.3203992039,-1.549300526,52.78223533
12,101,2006,5020,5426,19672,6173,583,-406,20255,19569,445065,11.532793222,12.465525104,45.193846267,-280,1.3393662248,-0.932731882,46.533212492
12,101,2007,5381,5594,16079,6138,525,-213,16604,16437,461502,11.871157896,12.341062492,35.472281696,46,1.1582155538,-0.469904596,36.63049725
12,101,2008,5734,5762,9299,6094,528,-28,9827,9526,471028,12.297727687,12.357779374,19.943594308,-273,1.1324032471,-0.060051687,21.075997555
12,103,2001,9581,13050,2233,22803,3104,-3469,5337,945,923253,10.382750828,14.142041363,2.419860411,-923,3.3637468499,-3.759290536,5.7836072609
12,103,2002,9092,12772,1967,22852,2840,-3680,4807,290,923543,9.8462418156,13.831522269,2.1301757205,-837,3.0755968716,-3.985280453,5.2057725921
12,103,2003,9134,12093,1500,22888,2408,-2959,3908,-159,923384,9.8910243881,13.095265812,1.6243197484,-1108,2.6075746361,-3.204241424,4.2318943846
12,103,2004,9078,12113,2355,22989,2377,-3035,4732,954,924338,9.8261535014,13.111279727,2.5490847649,-743,2.572897871,-3.285126226,5.1219826359
12,103,2005,9136,12009,1125,23048,2445,-2873,3570,-202,924136,9.8849104721,12.993420519,1.2172202584,-899,2.6454253617,-3.108510047,3.8626456201
12,103,2006,9254,11801,-3241,23082,2599,-2547,-642,-3603,920533,10.033236315,12.794707343,-3.513909541,-414,2.8178497064,-2.761471028,-0.696059835
12,103,2007,9290,11662,-6227,23051,2288,-2372,-3939,-6089,914444,10.125467513,12.710786021,-6.78700605,222,2.493764227,-2.585318508,-4.293241823
12,103,2008,9000,11717,-4247,23049,2311,-2717,-1936,-4184,910260,9.8646136579,12.842630914,-4.655001578,469,2.5330135737,-2.978017256,-2.121988005
12,105,2001,6874,5178,3323,12558,1293,1696,4616,5908,491250,14.077526746,10.604223668,6.8052984255,-404,2.6479840097,3.4733030785,9.4532824352
12,105,2002,6841,5263,4436,12693,1215,1578,5651,6900,498150,13.82858298,10.638770972,8.9670507378,-329,2.45603396,3.1898120073,11.423084698
12,105,2003,6919,5279,7034,12834,1042,1640,8076,9542,507692,13.757627938,10.496678405,13.986292082,-174,2.0718959837,3.2609495328,16.058188065
12,105,2004,7192,5495,10743,12768,999,1697,11742,12758,520450,13.990285389,10.689184957,20.897891536,-681,1.9433113325,3.3011004317,22.841202869
12,105,2005,7400,5631,15104,13402,1039,1769,16143,17413,537863,13.984520647,10.641464293,28.543540522,-499,1.9635022909,3.3430563548,30.507042812
12,105,2006,8062,5648,15648,13541,1172,2414,16820,18923,556786,14.729835774,10.319289562,28.589986379,-311,2.1413256669,4.4105462116,30.731312046
12,105,2007,8542,5647,11915,13407,1039,2895,12954,16181,572967,15.121889475,9.9968754232,21.093106192,332,1.8393401035,5.1250140517,22.932446296
12,105,2008,8866,5822,3188,13385,1043,3044,4231,7627,580594,15.371532151,10.093961221,5.5272326301,352,1.8083135612,5.2775709304,7.3355461913
12,107,2001,886,878,-75,1378,88,8,13,-59,70353,12.588356481,12.474691862,-1.065605797,-80,1.2503108017,0.1136646183,0.1847050048
12,107,2002,923,902,532,1370,82,21,614,586,70939,13.065141692,12.767884947,7.5305042041,-49,1.1607168134,0.2972567449,8.6912210175
12,107,2003,907,916,247,1399,58,-9,305,221,71160,12.765747824,12.892420073,3.4764495176,-75,0.8163322754,-0.12667225,4.292781793
12,107,2004,957,921,722,1409,64,36,786,751,71911,13.377973174,12.874726534,10.092890942,-71,0.8946606929,0.5032466398,10.987551635
12,107,2005,980,918,653,1420,61,62,714,705,72616,13.561479862,12.703508687,9.0363738263,-71,0.8441329302,0.8579711749,9.8805067565
12,107,2006,1024,897,534,1423,74,127,608,698,73314,14.034125951,12.293565408,7.3185774001,-37,1.0141848832,1.7405605427,8.3327622833
12,107,2007,1091,922,96,1409,63,169,159,344,73658,14.846365294,12.546607517,1.3063712816,16,0.8573061536,2.299757777,2.1636774352
12,107,2008,1052,919,-427,1416,63,133,-364,-199,73459,14.30154231,12.493457588,-5.80490358,32,0.856461184,1.8080847217,-4.948442396
12,109,2001,1287,1145,5052,2162,137,142,5189,5314,129784,10.123734533,9.0067412902,39.739787771,-17,1.077662495,1.116993243,40.817450266
12,109,2002,1328,1162,5722,2225,110,166,5832,6022,135806,10.00037652,8.7503294552,43.088971723,24,0.8283444407,1.250047065,43.917316164
12,109,2003,1461,1202,5875,2186,35,259,5910,6401,142207,10.510299878,8.6470776546,42.264210666,232,0.2517867869,1.8632222234,42.515997453
12,109,2004,1535,1218,9508,2290,141,317,9649,9569,151776,10.442780705,8.2861934193,64.684012341,-397,0.9592391397,2.1565872857,65.643251481
12,109,2005,1636,1248,8183,2298,107,388,8290,8572,160348,10.483013161,7.996821776,52.434288936,-106,0.6856249439,2.4861913855,53.11991388
12,109,2006,1769,1288,7324,2250,135,481,7459,7832,168180,10.769249501,7.8410363805,44.586762772,-108,0.8218477573,2.9282131203,45.408610529
12,109,2007,1897,1390,6393,2289,103,507,6496,6978,175158,11.050335238,8.0969773226,37.240270521,-25,0.5999918448,2.9533579155,37.840262365
12,109,2008,2052,1391,5709,2289,111,661,5820,6382,181540,11.50553129,7.7993148265,32.010271995,-99,0.6223752306,3.7062164632,32.632647225
12,111,2001,2173,2392,4001,2718,623,-219,4624,4303,197716,11.111423597,12.231258741,20.458723337,-102,3.1856497473,-1.119835144,23.644373084
12,111,2002,2282,2283,6043,2731,578,-1,6621,6598,204314,11.352386638,11.357361391,30.062433152,-22,2.8754073079,-0.004974753,32.93784046
12,111,2003,2356,2416,7522,2728,491,-60,8013,8177,212491,11.305046724,11.59295114,36.093616919,224,2.3560178021,-0.287904416,38.449634721
12,111,2004,2633,2392,12472,2731,483,241,12955,12661,225152,12.032638475,10.931284175,56.996227519,-535,2.2072785352,1.1013543002,59.203506054
12,111,2005,2936,2468,11554,2730,492,468,12046,12279,237431,12.693938169,10.670517507,49.954278475,-235,2.1271858239,2.0234206618,52.081464299
12,111,2006,3223,2437,11028,2732,516,786,11544,12187,249618,13.234807997,10.007206667,45.284971327,-143,2.1188833156,3.2276013296,47.403854643
12,111,2007,3641,2602,8696,2733,470,1039,9166,10472,260090,14.286611158,10.209767161,34.121497014,267,1.8441931459,4.076843997,35.96569016
12,111,2008,3751,2695,3266,2727,472,1056,3738,5018,265108,14.284136649,10.262796126,12.437214155,224,1.797417355,4.021340523,14.23463151
12,113,2001,1484,896,2563,2665,52,588,2615,3122,121505,12.372440472,7.4701527379,21.368305209,-81,0.43353565,4.9022877343,21.801840859
12,113,2002,1545,910,5968,2701,-117,635,5851,6529,128034,12.382833946,7.2934491202,47.832202582,43,-0.937729173,5.0893848256,46.894473409
12,113,2003,1585,935,4141,2375,-448,650,3693,4459,132493,12.167644812,7.1777589271,31.789411462,116,-3.439182887,4.9898858851,28.350228575
12,113,2004,1642,1055,5109,2494,281,587,5390,5729,138222,12.130838705,7.7941746856,37.744491439,-248,2.0759839684,4.3366640194,39.820475408
12,113,2005,1693,1062,3538,2466,28,631,3566,4081,142303,12.07022547,7.57151769,25.224133321,-116,0.1996257018,4.4987077801,25.423759023
12,113,2006,1813,1040,1294,2755,165,773,1459,2157,144460,12.64458804,7.2533764816,9.0248741993,-75,1.1507760764,5.391211558,10.175650276
12,113,2007,1857,1011,2450,3582,15,846,2465,3274,147734,12.71073328,6.9200599602,16.769680418,-37,0.1026715128,5.7906733198,16.872351931
12,113,2008,1877,1015,1516,3712,74,862,1590,2319,150053,12.606325998,6.8169530571,10.181774221,-133,0.4969995332,5.7893729411,10.678773754
12,115,2001,2725,4737,6923,6473,1117,-2012,8040,5907,332914,8.2585642827,14.356263856,20.981299277,-121,3.3852536895,-6.097699573,24.366552966
12,115,2002,2799,4848,7161,6473,1034,-2049,8195,6084,338998,8.3314481658,14.430461132,21.315291288,-62,3.0777839955,-6.099012966,24.393075284
12,115,2003,2938,4647,6950,6473,925,-1709,7875,6250,345248,8.5875547683,13.582834244,20.314331395,84,2.7037059771,-4.995279476,23.018037373
12,115,2004,3014,4705,10372,6473,826,-1691,11198,8939,354187,8.6183848392,13.453716214,29.658224138,-568,2.3619063959,-4.835331375,32.020130534
12,115,2005,2952,4910,10467,6473,869,-1958,11336,9034,363221,8.229626656,13.688166288,29.180048173,-344,2.4226102859,-5.458539632,31.602658459
12,115,2006,3040,4864,5248,6473,880,-1824,6128,4115,367336,8.3224170051,13.315867208,14.367119883,-189,2.409120712,-4.993450203,16.776240595
12,115,2007,3235,5067,4440,6473,808,-1832,5248,3535,370871,8.7644793398,13.727856821,12.029146296,119,2.1890878846,-4.963377481,14.218234181
12,115,2008,3308,5163,2075,6473,808,-1855,2883,1186,372057,8.9053044171,13.899058859,5.5860056425,158,2.175177137,-4.993754442,7.7611827795
12,117,2001,4600,2665,3613,3606,1338,1935,4951,6581,373610,12.421706121,7.1964884377,9.756440047,-305,3.6130962588,5.2252176836,13.369536306
12,117,2002,4441,2677,4714,3606,1273,1764,5987,7513,381123,11.768400216,7.093899432,12.491834861,-238,3.3733784,4.6745007837,15.865213261
12,117,2003,4656,2696,1697,3606,1117,1960,2814,4330,385453,12.147523533,7.0338753105,4.4274801194,-444,2.9142576861,5.1136482227,7.3417378055
12,117,2004,4596,2670,3682,3606,1053,1926,4735,6303,391756,11.826934583,6.8707387588,9.4749288801,-358,2.7096958476,4.9561958238,12.184624728
12,117,2005,4735,2775,7909,3606,1096,1960,9005,10612,402368,11.925089784,6.9888329782,19.918803613,-353,2.7602742141,4.9362568062,22.679077827
12,117,2006,4929,2692,2717,3606,1320,2237,4037,6065,408433,12.158347116,6.6403470149,6.7020144277,-209,3.2560393981,5.5180001011,9.9580538258
12,117,2007,4820,2794,-3149,3606,1167,2026,-1982,128,408561,11.79935226,6.8397075132,-7.708746943,84,2.8568141259,4.9596447465,-4.851932817
12,117,2008,4938,2795,-1231,3606,1170,2143,-61,2293,410854,12.05250087,6.8219400426,-3.004582538,211,2.8556958318,5.2305608269,-0.148886706
12,119,2001,464,600,1273,6915,67,-136,1340,1168,54725,8.5702148095,11.082174323,23.512679854,-36,1.237509466,-2.511959513,24.75018932
12,119,2002,432,754,2994,8044,66,-322,3060,2772,57497,7.6990251466,13.437650372,53.358521502,34,1.176239953,-5.738625225,54.534761455
12,119,2003,493,765,1469,8778,44,-272,1513,1304,58801,8.4782197458,13.155858226,25.262687235,63,0.756676813,-4.67763848,26.019364048
12,119,2004,482,738,1578,8659,45,-256,1623,1261,60062,8.1101772629,12.417657303,26.551576184,-106,0.7571742258,-4.30748004,27.30875041
12,119,2005,513,801,3587,8907,43,-288,3630,3320,63382,8.3114610674,12.977544474,58.115420758,-22,0.6966721752,-4.666083406,58.812092933
12,119,2006,514,878,5013,9473,48,-364,5061,4648,68030,7.8227254741,13.362554409,76.294402338,-49,0.7305268925,-5.539828935,77.02492923
12,119,2007,604,811,4246,10165,41,-207,4287,4059,72089,8.6212433717,11.575874792,60.605628073,-21,0.5852168514,-2.95463142,61.190844925
12,119,2008,735,803,2833,10365,41,-68,2874,2632,74721,10.012941898,10.939309311,38.594101219,-174,0.5585450582,-0.926367414,39.152646278
12,121,2001,465,410,364,665,111,55,475,502,35525,13.182514033,11.623291943,10.319215286,-28,3.1467936724,1.5592220899,13.466008958
12,121,2002,480,493,318,665,104,-13,422,381,35906,13.439543056,13.80353068,8.9036972743,-28,2.9119009954,-0.363987624,11.81559827
12,121,2003,455,440,396,665,94,15,490,475,36381,12.588708896,12.173696515,10.956326864,-30,2.6007442555,0.4150123812,13.557071119
12,121,2004,495,466,561,665,83,29,644,629,37010,13.489392432,12.699104795,15.28797809,-44,2.261857721,0.7902876374,17.549835811
12,121,2005,504,492,854,665,86,12,940,919,37929,13.450940098,13.130679619,22.791870722,-33,2.2952000961,0.3202604785,25.087070818
12,121,2006,447,492,637,665,87,-45,724,659,38588,11.683678137,12.859887345,16.649894795,-20,2.2740044696,-1.176209208,18.923899264
12,121,2007,547,463,565,665,81,84,646,752,39340,14.038599733,11.882763577,14.500564624,22,2.078842008,2.1558361565,16.579406632
12,121,2008,543,478,288,665,81,65,369,462,39802,13.722170276,12.079553208,7.2780571631,28,2.0469535771,1.6426170681,9.3250107402
12,123,2001,261,235,54,1372,3,26,57,64,19279,13.560554892,12.209695017,2.8056320466,-19,0.155868447,1.3508598743,2.9615004936
12,123,2002,239,215,-45,1408,3,24,-42,-40,19239,12.409782439,11.163611818,-2.336569915,-22,0.1557713277,1.2461706215,-2.180798588
12,123,2003,216,235,-50,1407,3,-19,-47,-94,19145,11.254689454,12.244685286,-2.605252188,-28,0.1563151313,-0.989995832,-2.448937057
12,123,2004,228,202,-37,1361,2,26,-35,-22,19123,11.915961116,10.557123445,-1.933730532,-13,0.1045259747,1.3588376712,-1.829204557
12,123,2005,231,200,314,1461,3,31,317,330,19453,11.976358358,10.369141435,16.279552053,-18,0.1555371215,1.6072169224,16.435089175
12,123,2006,259,190,556,1919,3,69,559,617,20070,13.106292539,9.614654758,28.135516029,-11,0.1518103383,3.4916377805,28.287326367
12,123,2007,248,203,909,2706,3,45,912,979,21049,12.062550159,9.8737809772,44.213137479,22,0.1459179455,2.1887691821,44.359055424
12,123,2008,239,191,437,3209,2,48,439,497,21546,11.22197441,8.9681887545,20.518840239,10,0.0939077356,2.2537856556,20.612747975
12,125,2001,139,140,341,4429,2,-1,343,336,13798,10.198092443,10.271460015,25.018341893,-6,0.1467351431,-0.073367572,25.165077036
12,125,2002,136,141,-21,4403,1,-5,-20,-38,13760,9.8700921692,10.232963205,-1.52405835,-13,0.0725742071,-0.362871036,-1.451484143
12,125,2003,148,145,8,4249,-1,3,7,-10,13750,10.759723737,10.541621229,0.5816066885,-20,-0.072700836,0.2181025082,0.5089058524
12,125,2004,155,205,705,4909,0,-50,705,624,14374,11.022614137,14.578296117,50.135115915,-31,0,-3.55568198,50.135115915
12,125,2005,156,151,272,5203,0,5,272,264,14638,10.754170688,10.40948573,18.750861712,-13,0,0.3446849579,18.750861712
12,125,2006,165,212,-56,5051,0,-47,-56,-110,14528,11.314544332,14.537475142,-3.840087773,-7,0,-3.22293081,-3.840087773
12,125,2007,165,168,415,5373,0,-3,415,419,14947,11.195928753,11.399491094,28.159457167,7,0,-0.203562341,28.159457167
12,125,2008,159,176,209,5441,-1,-17,208,194,15141,10.568997607,11.699016219,13.89258176,3,-0.066471683,-1.130018612,13.826110077
12,127,2001,4615,5819,6753,14719,851,-1204,7604,6155,451167,10.299281728,12.986244935,15.070649948,-245,1.8991741605,-2.686963207,16.969824109
12,127,2002,4551,5907,7841,14471,789,-1356,8630,7075,458242,10.008697957,12.9908545,17.244166266,-199,1.735192856,-2.982156543,18.979359122
12,127,2003,4671,6024,8263,14770,672,-1353,8935,7576,465818,10.109733134,13.038114408,17.884120079,-6,1.4544510097,-2.928381274,19.338571088
12,127,2004,4882,6033,11878,14674,655,-1151,12533,10693,476511,10.36156162,12.804445157,25.209878928,-689,1.3901726467,-2.442883536,26.600051574
12,127,2005,4901,6265,10376,14968,676,-1364,11052,9205,485716,10.186785447,13.021875296,21.566636563,-483,1.4050738547,-2.835089849,22.971710418
12,127,2006,5153,6150,9771,15227,776,-997,10547,9305,495021,10.508423767,12.541588622,19.925831288,-245,1.5824833773,-2.033164855,21.508314665
12,127,2007,5351,6163,4553,15568,685,-812,5238,4713,499734,10.758427955,12.390990746,9.1540127971,287,1.3772235375,-1.632562792,10.531236335
12,127,2008,5519,6221,-2127,15545,689,-702,-1438,-1698,498036,11.062669754,12.469807671,-4.263507622,442,1.381079808,-1.407137918,-2.882427814
12,129,2001,295,175,969,1549,7,120,976,1093,24082,12.534256761,7.4355760447,41.171846785,-3,0.2974230418,5.0986807164,41.469269826
12,129,2002,271,177,804,1602,6,94,810,885,24967,11.050174315,7.2172725234,32.783542988,-19,0.2446533059,3.8329017921,33.028196294
12,129,2003,282,204,602,1691,6,78,608,678,25645,11.143602308,8.061329329,23.788824785,-8,0.2370979214,3.0822729787,24.025922706
12,129,2004,298,209,893,1705,6,89,899,946,26591,11.409755724,8.0021441152,34.190979401,-42,0.2297266253,3.4076116089,34.420706026
12,129,2005,317,214,1021,1746,6,103,1027,1115,27706,11.676519881,7.8825717811,37.607970974,-15,0.2210066855,3.7939481003,37.82897766
12,129,2006,272,230,1355,2245,6,42,1361,1383,29089,9.5783079496,8.0993045162,47.715467911,-20,0.2112862048,1.4790034334,47.926754116
12,129,2007,337,229,908,2086,6,108,914,1010,30099,11.387443401,7.7380550112,30.681894979,-12,0.2027437994,3.6493883895,30.884638778
12,129,2008,352,262,921,2065,5,90,926,990,31089,11.505523959,8.563770674,30.103941949,-26,0.1634307381,2.941753285,30.267372687
12,131,2001,474,431,1632,1875,50,43,1682,1725,42548,11.370860371,10.339326624,39.150304063,0,1.1994578451,1.0315337467,40.349761908
12,131,2002,499,435,1423,1835,45,64,1468,1539,44087,11.519593698,10.042130779,32.850464593,7,1.038841115,1.4774629191,33.889305708
12,131,2003,492,446,1533,1892,30,46,1563,1673,45760,10.951951651,9.9279886919,34.12467862,64,0.6678019299,1.0239629593,34.79248055
12,131,2004,530,458,1941,1997,48,72,1989,1961,47721,11.339202619,9.7987826403,41.527155251,-100,1.0269466523,1.5404199784,42.554101903
12,131,2005,564,498,1836,1957,42,66,1878,1899,49620,11.588128332,10.232070762,37.723056061,-45,0.8629457269,1.3560575708,38.586001788
12,131,2006,648,485,1594,1932,49,163,1643,1777,51397,12.829523744,9.6023441599,31.559044517,-29,0.9701337399,3.2271795836,32.529178257
12,131,2007,684,487,1086,1987,40,197,1126,1342,52739,13.136667435,9.3531535684,20.857340401,19,0.7682261658,3.7835138665,21.625566567
12,131,2008,644,478,898,2003,41,166,939,1098,53837,12.085272482,8.9701246059,16.85182405,-7,0.7694039934,3.1151478757,17.621228044
12,133,2001,217,245,332,1634,14,-28,346,302,21319,10.251322751,11.574074074,15.684051398,-16,0.6613756614,-1.322751323,16.34542706
12,133,2002,210,242,-63,1596,14,-32,-49,-104,21215,9.8744533785,11.379131989,-2.962336014,-23,0.6582968919,-1.50467861,-2.304039122
12,133,2003,226,247,172,1644,12,-21,184,149,21364,10.615561662,11.601963409,8.0791000258,-14,0.5636581413,-0.986401747,8.6427581672
12,133,2004,257,272,382,1697,9,-15,391,348,21712,11.932398551,12.628842047,17.736094345,-28,0.4178660971,-0.696443495,18.153960442
12,133,2005,239,241,173,1671,12,-2,185,166,21878,10.965817848,11.057582014,7.9376003671,-17,0.5505849966,-0.091764166,8.4881853636
12,133,2006,256,259,469,1704,12,-3,481,465,22343,11.578209448,11.71389159,21.211641528,-13,0.5427285679,-0.135682142,21.754370096
12,133,2007,280,252,463,1893,9,28,472,500,22843,12.393219139,11.153897225,20.493073076,0,0.3983534723,1.2393219139,20.891426548
12,133,2008,282,233,1033,2668,8,49,1041,1085,23928,12.058754356,9.9634388831,44.1726711,-5,0.3420923222,2.0953154733,44.514763422
13,0,2001,133775,64552,55256,240893,36499,69223,91755,188539,8418592,16.070376899,7.7546250761,6.6378975586,27561,4.3846210908,8.3157518224,11.022518649
13,0,2002,133084,64575,43308,250557,31458,68509,74766,165082,8583674,15.654854476,7.5960463152,5.0943797727,21807,3.7004479285,8.0588081612,8.7948277012
13,0,2003,134077,65529,36629,255566,20612,68548,57241,149250,8732924,15.485374206,7.5683456993,4.230507632,23461,2.3806061676,7.9170285064,6.6111137996
13,0,2004,137656,67097,51800,263476,31970,70559,83770,177817,8910741,15.604014245,7.6057893867,5.8717959109,23488,3.6239636153,7.9982248586,9.4957595262
13,0,2005,139825,65424,62318,265036,28666,74401,90984,183217,9093958,15.532056382,7.2674361288,6.9224150873,17832,3.1842798372,8.2646202527,10.106694924
13,0,2006,143741,66721,120420,267275,31345,77020,151765,224757,9318715,15.613268101,7.247291037,13.080121501,-4028,3.4047202163,8.3659770637,16.484841717
13,0,2007,148974,68420,98666,268614,25852,80554,124518,204582,9523297,15.812960951,7.2624940479,10.472979213,-490,2.7440806215,8.5504669034,13.217059834
13,0,2008,149805,69917,56674,270256,27118,79888,83792,162447,9685744,15.597342939,7.2795929792,5.9007630834,-1233,2.8234621395,8.3177499595,8.7242252229
13,1,2001,283,188,-68,259,39,95,-29,49,17454,16.236839841,10.786310565,-3.901431481,-17,2.2375857024,5.4505292751,-1.663845779
13,1,2002,244,198,-11,282,38,46,27,56,17510,13.957213134,11.325935248,-0.629218625,-17,2.1736643405,2.6312778858,1.5444457156
13,1,2003,265,168,109,307,30,97,139,216,17726,15.041434896,9.5357021228,6.1868543535,-20,1.7028039505,5.5057327733,7.889658304
13,1,2004,270,177,-110,299,31,93,-79,1,17727,15.231433165,9.9850506304,-6.205398697,-13,1.7487941782,5.2463825346,-4.456604519
13,1,2005,302,171,-158,289,31,131,-127,-12,17715,17.041927656,9.6495683088,-8.915975396,-16,1.7493369449,7.3923593477,-7.166638452
13,1,2006,248,213,-114,320,31,35,-83,-56,17659,14.021597784,12.042743258,-6.445411884,-8,1.752699723,1.9788545259,-4.692712161
13,1,2007,277,179,113,301,30,98,143,243,17902,15.578864486,10.067208459,6.3552768482,2,1.6872416411,5.5116560277,8.0425184894
13,1,2008,267,173,10,294,30,94,40,136,18038,14.858096828,9.6271563717,0.5564830273,2,1.6694490818,5.2309404563,2.2259321091
13,3,2001,144,57,-119,41,58,87,-61,19,7628,18.901358535,7.4817877535,-15.61987268,-7,7.6130471878,11.419570782,-8.006825491
13,3,2002,154,78,-44,41,56,76,12,81,7709,20.082154267,10.171480733,-5.737758362,-7,7.3026015518,9.9106735346,1.5648431897
13,3,2003,160,67,75,45,41,93,116,203,7912,20.485244223,8.5781960182,9.6024582293,-6,5.249343832,11.907048204,14.851802061
13,3,2004,149,75,-141,44,37,74,-104,-40,7872,18.879878358,9.5032944754,-17.86619361,-10,4.6882919412,9.3765838824,-13.17790167
13,3,2005,148,73,-40,46,41,75,1,69,7941,18.718775691,9.2329096313,-5.059128565,-7,5.1856067792,9.4858660596,0.1264782141
13,3,2006,170,86,-39,41,39,84,0,81,8022,21.299254526,10.774916996,-4.886299568,-3,4.8862995678,10.524337531,0
13,3,2007,169,46,-14,43,36,123,22,134,8156,20.892570157,5.6867350723,-1.730745457,-11,4.4504883175,15.205835085,2.7197428607
13,3,2008,177,64,-119,49,35,113,-84,25,8181,21.668605007,7.8349758218,-14.56815817,-4,4.2847524025,13.833629185,-10.28340577
13,5,2001,160,130,-58,141,13,30,-45,-23,10101,15.822002472,12.855377009,-5.735475896,-8,1.2855377009,2.9666254635,-4.449938195
13,5,2002,142,117,-119,164,13,25,-106,-90,10011,14.120922832,11.634844869,-11.83373111,-9,1.292760541,2.4860779634,-10.54097056
13,5,2003,155,117,44,164,11,38,55,82,10093,15.419816952,11.639474731,4.3772383605,-11,1.0943095901,3.7803422205,5.4715479507
13,5,2004,150,119,-64,173,9,31,-55,-33,10060,14.886121173,11.809656131,-6.3514117,-9,0.8931672704,3.0764650424,-5.45824443
13,5,2005,164,131,182,331,11,33,193,217,10277,16.12823917,12.882922752,17.898411762,-9,1.0817721395,3.2453164184,18.980183901
13,5,2006,159,106,-45,356,10,53,-35,13,10290,15.461661886,10.30777459,-4.375942043,-5,0.9724315651,5.1538872952,-3.403510478
13,5,2007,157,122,145,367,10,35,155,193,10483,15.115775285,11.746016464,13.960429404,3,0.9627882347,3.3697588215,14.923217638
13,5,2008,157,116,-87,372,9,41,-78,-41,10442,15.005973716,11.087216249,-8.315412186,-4,0.8602150538,3.9187574671,-7.455197133
13,7,2001,41,39,-17,15,3,2,-14,-17,4037,10.134717587,9.6403411198,-4.202199975,-5,0.7415647015,0.4943764677,-3.460635274
13,7,2002,42,44,-83,14,2,-2,-81,-85,3952,10.514457379,11.015145826,-20.77857053,-2,0.5006884466,-0.500688447,-20.27788209
13,7,2003,38,41,189,12,2,-3,191,199,4151,9.379242256,10.11970875,46.649389115,11,0.4936443293,-0.740466494,47.143033444
13,7,2004,32,42,-87,14,2,-10,-85,-100,4051,7.8029748842,10.241404535,-21.21433797,-5,0.4876859303,-2.438429651,-20.72665204
13,7,2005,32,33,-62,12,3,-1,-59,-61,3990,7.9592090536,8.2079343365,-15.42096754,-1,0.7461758488,-0.248725283,-14.67479169
13,7,2006,31,28,-66,8,3,3,-63,-61,3929,7.8292713726,7.0715999495,-16.66877131,-1,0.7576714232,0.7576714232,-15.91109989
13,7,2007,33,14,-166,9,2,19,-164,-155,3774,8.5680903544,3.6349474231,-43.10009087,-10,0.5192782033,4.9331429313,-42.58081267
13,7,2008,24,8,34,9,2,16,36,31,3805,6.3332893522,2.1110964507,8.9721599156,-21,0.5277741127,4.2221929014,9.4999340282
13,9,2001,523,412,-175,7855,22,111,-153,-81,44665,11.698784266,9.2158682936,-3.914507164,-39,0.492109472,2.4829159723,-3.422397692
13,9,2002,543,388,158,8085,21,155,179,295,44960,12.117154812,8.6582984658,3.5258019526,-39,0.4686192469,3.4588563459,3.9944211994
13,9,2003,540,418,9,8271,17,122,26,78,45038,12.000266673,9.2890953132,0.2000044445,-70,0.377786173,2.7111713594,0.5777906176
13,9,2004,571,388,76,8264,22,183,98,249,45287,12.643232771,8.59119845,1.6828120675,-32,0.487129809,4.0520343205,2.1699418766
13,9,2005,573,386,78,8310,20,187,98,245,45532,12.618504938,8.5004239201,1.7177022429,-40,0.4404364725,4.1180810183,2.1581387155
13,9,2006,537,398,-80,8253,22,139,-58,59,45591,11.786266914,8.7354454967,-1.755868442,-22,0.4828638214,3.0508214172,-1.27300462
13,9,2007,588,414,570,8733,18,174,588,768,46359,12.789559543,9.0048939641,12.398042414,6,0.3915171289,3.7846655791,12.789559543
13,9,2008,587,402,141,8871,20,185,161,357,46716,12.61348375,8.638195004,3.0298146656,11,0.4297609455,3.9752887456,3.4595756111
13,11,2001,207,131,246,4,27,76,273,343,14848,14.104180152,8.925833816,16.761489456,-6,1.839675672,5.178346336,18.601165128
13,11,2002,223,130,192,1,27,93,219,300,15148,14.868649153,8.6678223763,12.801706894,-12,1.800240032,6.2008267769,14.601946926
13,11,2003,196,130,124,5,16,66,140,196,15344,12.855831038,8.5268267086,8.1332808606,-10,1.0494555949,4.329004329,9.1827364555
13,11,2004,211,94,145,6,13,117,158,262,15606,13.634894992,6.0743134087,9.3699515347,-13,0.8400646204,7.5605815832,10.210016155
13,11,2005,230,127,216,61,16,103,232,321,15927,14.58789205,8.0550534361,13.699933403,-14,1.0148098817,6.5328386135,14.714743285
13,11,2006,212,146,147,46,15,66,162,220,16147,13.219430068,9.1039471223,9.1663029245,-8,0.9353370331,4.1154829457,10.101639958
13,11,2007,218,132,264,54,13,86,277,371,16518,13.347619777,8.0820450023,16.164090005,8,0.7959589775,5.2655747742,16.960048982
13,11,2008,213,130,142,42,12,83,154,242,16760,12.801250075,7.8129695294,8.5341667167,5,0.7211971873,4.9882805457,9.2553639041
13,13,2001,805,375,1418,464,62,430,1480,1895,48456,16.944336277,7.8933243525,29.847290485,-15,1.3050296263,9.0510119242,31.152320111
13,13,2002,833,361,1972,495,58,472,2030,2514,50970,16.756180476,7.261682055,39.667692555,12,1.1666968399,9.4944984209,40.834389395
13,13,2003,877,407,1522,487,45,470,1567,2077,53047,16.862628224,7.8256438851,29.264447158,40,0.8652431814,9.0369843391,30.129690339
13,13,2004,998,408,2599,514,48,590,2647,3120,56167,18.276045196,7.471569579,47.594630725,-117,0.8790081858,10.804475617,48.473638911
13,13,2005,1065,394,2504,513,47,671,2551,3188,59355,18.438046433,6.8212115441,43.351050016,-34,0.8136978238,11.616834889,44.16474784
13,13,2006,1109,400,2972,539,52,709,3024,3689,63044,18.121063081,6.5360011111,48.562488256,-44,0.8496801444,11.585061969,49.4121684
13,13,2007,1234,470,3092,567,44,764,3136,3884,66928,18.98870526,7.2323269627,47.579478657,-16,0.6770689071,11.756378297,48.256547564
13,13,2008,1282,481,2372,551,46,801,2418,3145,70073,18.71519186,7.0218465559,34.627484471,-74,0.6715279451,11.693345304,35.299012416
13,15,2001,1404,623,1943,840,132,781,2075,2809,79510,17.975686731,7.9763909072,24.876609202,-47,1.6900218294,9.9992958242,26.566631031
13,15,2002,1393,611,1855,875,121,782,1976,2732,82242,17.223898313,7.5547752114,22.936347,-26,1.4961175132,9.669123102,24.432464514
13,15,2003,1468,684,1344,955,103,784,1447,2197,84439,17.614485154,8.2072941727,16.126613111,-34,1.2358937131,9.4071909816,17.362506824
13,15,2004,1509,683,860,948,101,826,961,1709,86148,17.691852251,8.0076441933,10.082831634,-78,1.1841465059,9.6842080581,11.26697814
13,15,2005,1429,672,1218,1061,106,757,1324,2013,88161,16.39617002,7.7104452438,13.975182004,-68,1.2162309462,8.6857247761,15.191412951
13,15,2006,1501,687,1157,947,106,814,1263,2027,90188,16.832166146,7.7039960975,12.974561113,-50,1.1886806206,9.1281700486,14.163241734
13,15,2007,1534,733,1500,962,96,801,1596,2373,92561,16.78805356,8.0219317206,16.4159585,-24,1.050621344,8.7661218392,17.466579844
13,15,2008,1578,764,1472,992,98,814,1570,2352,94913,16.834334361,8.1504635309,15.703510887,-32,1.0454783063,8.6838708301,16.748989193
13,17,2001,310,223,-286,361,35,87,-251,-174,17298,17.831463906,12.827149842,-16.45096347,-10,2.0132297958,5.0043140638,-14.43773368
13,17,2002,289,218,-234,371,33,71,-201,-140,17158,16.775017414,12.653819364,-13.58254005,-10,1.9154864175,4.1211980497,-11.66705363
13,17,2003,261,199,-184,353,25,62,-159,-110,17048,15.260480617,11.635385605,-10.75834649,-13,1.4617318599,3.6250950126,-9.296614629
13,17,2004,274,225,-56,348,26,49,-30,7,17055,16.06896754,13.19532006,-3.284168548,-12,1.5247925402,2.8736474797,-1.759376008
13,17,2005,322,224,25,373,26,98,51,135,17190,18.805665061,13.082201781,1.4600671631,-14,1.5184698496,5.7234632793,2.9785370127
13,17,2006,332,187,109,373,27,145,136,271,17461,19.162506133,10.793339298,6.2913047243,-10,1.5583965831,8.369166835,7.8497013073
13,17,2007,338,198,41,403,24,140,65,198,17659,19.248291572,11.275626424,2.3348519362,-7,1.3667425968,7.9726651481,3.701594533
13,17,2008,318,207,-163,403,24,111,-139,-24,17635,18.020060067,11.7300391,-9.236697456,4,1.3600045333,6.2900209667,-7.876692922
13,19,2001,231,149,-161,148,9,82,-152,-83,16166,14.252660805,9.1932747185,-9.933672682,-13,0.5552984729,5.0593860867,-9.378374209
13,19,2002,249,179,18,136,3,70,21,75,16241,15.367050329,11.046996019,1.1108711081,-16,0.1851451847,4.3200543093,1.2960162928
13,19,2003,224,158,93,156,-12,66,81,131,16372,13.736853402,9.6893876675,5.7032471714,-16,-0.735902861,4.0474657345,4.9673443106
13,19,2004,249,180,80,142,13,69,93,148,16520,15.140459686,10.944910617,4.8644047185,-14,0.7904657668,4.1955490697,5.6548704852
13,19,2005,273,193,28,125,4,80,32,98,16618,16.476552598,11.648258797,1.6899028306,-14,0.2414146901,4.8282938017,1.9313175207
13,19,2006,252,169,-44,185,9,83,-35,40,16658,15.146051208,10.15747085,-2.644548624,-8,0.5409304003,4.9885803582,-2.103618223
13,19,2007,304,182,-79,133,4,122,-75,34,16692,18.230884558,10.914542729,-4.737631184,-13,0.23988006,7.3163418291,-4.497751124
13,19,2008,278,172,264,174,7,106,271,366,17058,16.474074074,10.192592593,15.644444444,-11,0.4148148148,6.2814814815,16.059259259
13,21,2001,2516,1666,-1116,5418,159,850,-957,-234,153618,16.365824308,10.836829609,-7.259244804,-127,1.0342472436,5.5289946987,-6.224997561
13,21,2002,2416,1639,-433,5561,141,777,-292,347,153965,15.709580829,10.657286001,-2.815500206,-138,0.9168257023,5.0522948277,-1.898674504
13,21,2003,2412,1669,-764,5863,95,743,-669,-97,153868,15.670834511,10.843541791,-4.963730334,-171,0.6172177772,4.8272927204,-4.346512557
13,21,2004,2442,1609,-337,5860,131,833,-206,518,154386,15.844076638,10.439442797,-2.186508529,-109,0.8499484192,5.4046338409,-1.33656011
13,21,2005,2448,1665,-876,5871,122,783,-754,-107,154279,15.861856705,10.788395186,-5.676056566,-136,0.7905010286,5.0734615198,-4.885555538
13,21,2006,2441,1655,-441,5897,135,786,-306,407,154686,15.801142524,10.713187578,-2.854692279,-73,0.8738853915,5.0879549464,-1.980806888
13,21,2007,2672,1667,-1023,5981,111,1005,-912,120,154806,17.267005286,10.772491696,-6.610833236,27,0.7173044861,6.49451359,-5.89352875
13,21,2008,2593,1647,-733,6099,117,946,-616,410,155216,16.727845121,10.625052416,-4.728696673,80,0.7547851443,6.102792705,-3.973911529
13,23,2001,164,130,77,752,6,34,83,106,11781,13.983628922,11.084583902,6.5654843111,-11,0.5115961801,2.8990450205,7.0770804911
13,23,2002,142,101,-138,599,4,41,-134,-101,11680,12.105195857,8.6100336729,-11.76420442,-8,0.3409914326,3.4951621841,-11.42321299
13,23,2003,149,137,97,704,0,12,97,98,11778,12.70355529,11.680450166,8.2700997527,-11,0,1.0231051241,8.2700997527
13,23,2004,138,126,159,808,7,12,166,166,11944,11.634769412,10.623050333,13.405277801,-12,0.5901694629,1.0117190793,13.995447264
13,23,2005,129,134,29,925,4,-5,33,22,11966,10.790464241,11.208699289,2.425763279,-6,0.3345880385,-0.418235048,2.7603513174
13,23,2006,144,118,288,1219,6,26,294,314,12280,11.878247958,9.7335642993,23.756495917,-6,0.4949269983,2.1446836592,24.251422915
13,23,2007,154,120,334,1551,4,34,338,362,12642,12.358558703,9.6300457427,26.803627317,-10,0.3210015248,2.7285129604,27.124628842
13,23,2008,158,119,23,1574,6,39,29,41,12683,12.477788746,9.397828233,1.8163869694,-27,0.473840079,3.0799605133,2.2902270484
13,25,2001,142,125,158,81,1,17,159,164,14832,9.6271186441,8.4745762712,10.711864407,-12,0.0677966102,1.1525423729,10.779661017
13,25,2002,169,129,194,81,-1,40,193,224,15056,11.30888651,8.6322269807,12.981798715,-9,-0.066916488,2.6766595289,12.914882227
13,25,2003,157,139,112,83,-7,18,105,107,15163,10.390813726,9.1995102419,7.4125550151,-16,-0.463284688,1.1913034846,6.9492703266
13,25,2004,189,163,44,87,4,26,48,64,15227,12.438302073,10.727212899,2.8956893715,-10,0.2632444883,1.7110891741,3.1589338598
13,25,2005,181,125,6,84,0,56,6,49,15276,11.867685146,8.1959151559,0.3934039275,-13,0,3.6717699898,0.3934039275
13,25,2006,155,172,148,82,4,-17,152,127,15403,10.104631833,11.212881776,9.648293621,-8,0.2607646925,-1.108249943,9.9090583135
13,25,2007,116,166,59,81,2,-50,61,14,15417,7.5275794938,10.772225827,3.8286826736,3,0.1297858533,-3.244646334,3.9584685269
13,25,2008,131,140,99,81,4,-9,103,94,15511,8.4712881531,9.0532850491,6.4019658562,0,0.2586652871,-0.581996896,6.6606311433
13,27,2001,222,204,-164,396,13,18,-151,-150,16309,13.549804688,12.451171875,-10.00976563,-17,0.7934570313,1.0986328125,-9.216308594
13,27,2002,211,193,-79,410,11,18,-68,-65,16244,12.963474949,11.85758609,-4.853623322,-15,0.6758209689,1.1058888582,-4.177802353
13,27,2003,191,210,-145,413,2,-19,-143,-174,16070,11.821501516,12.9974624,-8.974438324,-12,0.1237853562,-1.175960884,-8.850652968
13,27,2004,241,222,49,409,12,19,61,68,16138,14.965226031,13.785394933,3.042722305,-12,0.7451564829,1.1798310979,3.7878787879
13,27,2005,197,202,-23,386,9,-5,-14,-32,16106,12.219327627,12.529462846,-1.426622007,-13,0.5582433941,-0.310135219,-0.868378613
13,27,2006,226,166,103,415,12,60,115,167,16273,13.959665215,10.253559406,6.362148306,-8,0.7412211619,3.7061058093,7.1033694679
13,27,2007,191,179,32,408,8,12,40,51,16324,11.718869835,10.982605761,1.9633708623,-1,0.4908427156,0.7362640734,2.4542135779
13,27,2008,181,194,110,412,10,-13,120,101,16425,11.053772634,11.847690006,6.7177623744,-6,0.6107056704,-0.793917372,7.3284680448
13,29,2001,358,145,396,136,8,213,404,605,24115,15.034120735,6.0892388451,16.62992126,-12,0.3359580052,8.9448818898,16.965879265
13,29,2002,347,173,602,143,-17,174,585,754,24869,14.167891556,7.0635309489,24.579454516,-5,-0.694104197,7.1043606075,23.885350318
13,29,2003,366,158,829,175,-76,208,753,986,25855,14.431038562,6.2297926031,32.686696633,25,-2.9966091,8.2012459585,29.690087533
13,29,2004,422,196,965,170,42,226,1007,1183,27038,15.956742858,7.4111886261,36.488760327,-50,1.5881118484,8.5455542321,38.076872176
13,29,2005,436,202,552,193,2,234,554,764,27802,15.900802334,7.366885485,20.131291028,-24,0.0729394602,8.533916849,20.204230489
13,29,2006,404,207,698,169,23,197,721,903,28705,14.299113384,7.3265259171,24.704903817,-15,0.8140584352,6.972587467,25.518962252
13,29,2007,476,206,1002,169,-1,270,1001,1286,29991,16.219163146,7.0192176639,34.142019899,15,-0.034073872,9.1999454818,34.107946027
13,29,2008,514,203,855,178,10,311,865,1182,31173,16.807272252,6.6378915702,27.957622131,6,0.3269897325,10.169380681,28.284611863
13,31,2001,686,420,467,3586,90,266,557,776,57001,12.117358204,7.4187907371,8.2489887482,-47,1.5897408722,4.6985674668,9.8387296204
13,31,2002,735,385,272,3648,83,350,355,651,57652,12.821295561,6.7159167226,4.7447515547,-54,1.4478469818,6.1053788388,6.1925985365
13,31,2003,732,391,1570,4285,63,341,1633,2006,59658,12.479754497,6.6660983718,26.766686557,32,1.0740772313,5.8136561248,27.840763788
13,31,2004,799,427,1197,4198,73,372,1270,1565,61223,13.219612677,7.0647992654,19.804601219,-77,1.207799406,6.1548134115,21.012400625
13,31,2005,783,418,1875,4970,75,365,1950,2266,63489,12.556931169,6.7034447367,30.06927962,-49,1.2027711848,5.8534864327,31.272050805
13,31,2006,821,458,769,4726,80,363,849,1177,64666,12.81260973,7.1475947095,12.001092427,-35,1.2484881589,5.6650150209,13.249580586
13,31,2007,837,444,1070,4839,64,393,1134,1518,66184,12.793274742,6.7863966374,16.354604509,-9,0.9782193351,6.0068781047,17.332823844
13,31,2008,884,446,1084,4899,67,438,1151,1577,67761,13.199447534,6.6594497742,16.185747882,-12,1.0004106163,6.5399977603,17.186158498
13,33,2001,484,220,117,344,6,264,123,364,22643,21.548461778,9.7947553537,5.2090289836,-23,0.2671296915,11.753706424,5.476158675
13,33,2002,391,239,-99,361,4,152,-95,34,22677,17.255075022,10.547219771,-4.368932039,-23,0.1765225066,6.7078552515,-4.192409532
13,33,2003,393,237,-112,334,-3,156,-115,13,22690,17.32536866,10.448123085,-4.937509644,-28,-0.132254723,6.877245575,-5.069764366
13,33,2004,411,251,-16,379,7,160,-9,135,22825,18.059980226,11.02933099,-0.703064924,-16,0.3075909041,7.0306492365,-0.39547402
13,33,2005,398,271,-84,380,3,127,-81,25,22850,17.427476738,11.866447729,-3.67816092,-21,0.13136289,5.5610290093,-3.54679803
13,33,2006,389,243,-355,375,5,146,-350,-213,22637,17.103787895,10.684371359,-15.60885528,-9,0.2198430321,6.4194165366,-15.38901225
13,33,2007,347,269,-5,344,3,78,-2,77,22714,15.302859915,11.863023969,-0.220502304,1,0.1323013825,3.4398359463,-0.088200922
13,33,2008,364,255,-97,384,5,109,-92,18,22732,16.019011574,11.222109757,-4.268802535,1,0.2200413678,4.7969018175,-4.048761167
13,35,2001,276,198,555,1926,3,78,558,628,20357,13.770393654,9.8787606646,27.690465499,-8,0.1496781919,3.8916329891,27.840143691
13,35,2002,312,194,748,1980,3,118,751,870,21227,15.005771451,9.3305117353,35.975375144,1,0.1442862639,5.6752597153,36.119661408
13,35,2003,321,199,462,2007,1,122,463,585,21812,14.916703455,9.2474267525,21.4689003,0,0.0464694812,5.6692767025,21.515369781
13,35,2004,287,191,129,2041,5,96,134,213,22025,13.093961722,8.7140999612,5.8854392408,-17,0.2281178,4.3798617606,6.1135570409
13,35,2005,299,193,333,1992,3,106,336,430,22455,13.444244604,8.678057554,14.973021583,-12,0.1348920863,4.7661870504,15.107913669
13,35,2006,306,205,533,2231,5,101,538,625,23080,13.440210827,9.0040628088,23.410563303,-14,0.219611288,4.436148018,23.630174591
13,35,2007,343,213,441,2247,3,130,444,578,23658,14.677564295,9.1146390517,18.871154093,4,0.1283751979,5.5629252428,18.999529291
13,35,2008,332,208,655,2334,5,124,660,765,24423,13.81002891,8.6520663048,27.245689566,-19,0.2079823631,5.1579626048,27.453671929
13,37,2001,99,63,-121,1322,2,36,-119,-87,6235,15.768097476,10.034243848,-19.27211914,-4,0.3185474237,5.7338536275,-18.95357171
13,37,2002,92,70,11,1319,2,22,13,29,6264,14.721177694,11.200896072,1.7601408113,-6,0.320025602,3.5202816225,2.0801664133
13,37,2003,101,72,-143,1345,1,29,-142,-114,6150,16.271951023,11.59980667,-23.03850491,-1,0.161108426,4.6721443531,-22.87739649
13,37,2004,88,68,-34,1368,0,20,-34,-17,6133,14.328747049,11.072213629,-5.536106814,-3,0,3.2565334202,-5.536106814
13,37,2005,84,80,-94,1338,1,4,-93,-92,6041,13.799901429,13.142763266,-15.44274684,-3,0.1642845408,0.6571381633,-15.2784623
13,37,2006,97,80,67,1432,0,17,67,81,6122,15.950012332,13.154649346,11.017018828,-3,0,2.7953629861,11.017018828
13,37,2007,97,83,-45,1411,1,14,-44,-40,6082,15.896427401,13.602097673,-7.374631268,-10,0.1638806949,2.294329728,-7.210750574
13,37,2008,82,58,178,1602,0,24,178,189,6271,13.276127257,9.3904314741,28.818910386,-13,0,3.8856957824,28.818910386
13,39,2001,716,186,291,2053,-31,530,260,746,44504,16.224422741,4.2147243434,6.5940042147,-44,-0.702454057,12.009698398,5.8915501575
13,39,2002,805,200,779,2237,-271,605,508,1083,45587,17.870819505,4.4399551565,17.293625334,-30,-6.016139237,13.430864348,11.277486097
13,39,2003,762,215,-897,1186,-793,547,-1690,-1139,44448,16.926750708,4.7759204754,-19.92558449,4,-17.6153718,12.150830233,-37.54095629
13,39,2004,755,251,-79,877,345,504,266,737,45185,16.846473955,5.6006158446,-1.762743632,-33,7.698057635,11.24585811,5.9353140027
13,39,2005,676,231,214,951,-42,445,172,577,45762,14.865800961,5.0798816893,4.7060375823,-40,-0.923614853,9.7859192717,3.7824227297
13,39,2006,729,219,-1038,582,163,510,-875,-383,45379,15.997191165,4.8057405558,-22.77789359,-18,3.5768753909,11.191450609,-19.2010182
13,39,2007,868,259,1175,548,-65,609,1110,1730,47109,18.770002595,5.6007265807,25.408701669,11,-1.405587752,13.169276014,24.003113917
13,39,2008,882,276,-112,543,27,606,-85,532,47641,18.617414248,5.8258575198,-2.364116095,11,0.5699208443,12.791556728,-1.794195251
13,43,2001,172,135,-225,420,50,37,-175,-142,9441,18.082422204,14.192598823,-23.65433137,-4,5.2565180824,3.889823381,-18.39781329
13,43,2002,169,130,242,450,48,39,290,324,9765,17.598667083,13.537436218,25.20045819,-5,4.9984379881,4.0612308654,30.198896178
13,43,2003,179,127,51,438,36,52,87,129,9894,18.210488835,12.920290961,5.1884632993,-10,3.6624446818,5.2901978737,8.8509079811
13,43,2004,186,141,5,457,35,45,40,79,9973,18.724518045,14.194392712,0.5033472593,-6,3.5234308149,4.5301253335,4.0267780742
13,43,2005,186,117,-15,463,37,69,22,84,10057,18.572141787,11.682476286,-1.49775337,-7,3.6944583125,6.8896655017,2.1967049426
13,43,2006,165,109,108,451,35,56,143,193,10250,16.250553996,10.735214458,10.636726252,-6,3.4470872113,5.5153395381,14.083813463
13,43,2007,201,106,115,437,31,95,146,238,10488,19.384704407,10.222779439,11.090751278,-3,2.9896807792,9.1619249687,14.080432057
13,43,2008,180,117,6,432,32,63,38,92,10580,17.087526106,11.106891969,0.5695842035,-9,3.0377824188,5.9806341371,3.6073666224
13,45,2001,1474,763,2678,3169,204,711,2882,3560,91561,16.417727582,8.4984573573,29.828137356,-33,2.2721956761,7.9192702242,32.100333033
13,45,2002,1432,792,2479,3165,193,640,2672,3294,94855,15.363488113,8.4971247103,26.596429491,-18,2.0706377135,6.8663634023,28.667067205
13,45,2003,1551,847,2688,3258,161,704,2849,3621,98476,16.045021233,8.7621747159,27.807232156,68,1.6655373427,7.2828465171,29.472769499
13,45,2004,1541,811,2015,3148,160,730,2175,2782,101258,15.430522595,8.1208006649,20.176835191,-123,1.602130834,7.3097219302,21.778966025
13,45,2005,1538,834,2351,2963,160,704,2511,3136,104394,14.957306518,8.1107891,22.863867115,-79,1.5560266859,6.8465174178,24.419893801
13,45,2006,1633,859,2764,3692,163,774,2927,3636,108030,15.374910556,8.0875983881,26.023424848,-65,1.534666516,7.2873121681,27.558091364
13,45,2007,1828,881,2740,3905,150,947,2890,3815,111845,16.627629335,8.013644116,24.923251848,-22,1.3644115975,8.6139852189,26.287663445
13,45,2008,1844,913,790,3819,152,931,942,1843,113688,16.352374154,8.0963761401,7.005626671,-30,1.347918043,8.2559980136,8.3535447141
13,47,2001,743,475,815,446,29,268,844,1070,54701,13.717091903,8.7693386996,15.046339032,-42,0.5353912048,4.9477532031,15.581730237
13,47,2002,724,480,1120,424,27,244,1147,1368,56069,13.072131444,8.6666064819,20.222081791,-23,0.4874966146,4.4055249616,20.709578406
13,47,2003,736,469,1234,566,21,267,1255,1539,57608,12.948969449,8.2514492817,21.710636276,17,0.3694678783,4.6975201668,22.080104155
13,47,2004,753,510,1045,553,23,243,1068,1239,58847,12.932033833,8.7587480143,17.946846421,-72,0.3950023614,4.1732858186,18.341848783
13,47,2005,709,474,637,596,24,235,661,844,59691,11.962408679,7.9974354216,10.747608362,-52,0.4049334391,3.9649732575,11.152541801
13,47,2006,669,499,950,572,27,170,977,1116,60807,11.103918737,8.2822951418,15.767896563,-31,0.4481402181,2.8216235954,16.216036781
13,47,2007,806,499,974,576,20,307,994,1313,62120,13.11347385,8.1186395178,15.846803387,12,0.3253963735,4.9948343326,16.172199761
13,47,2008,827,524,388,562,22,303,410,705,62825,13.237824643,8.3876905839,6.2107327224,-8,0.3521549482,4.850134059,6.5628876706
13,49,2001,119,84,151,1215,0,35,151,177,10447,11.488149829,8.109282232,14.577400203,-9,0,3.3788675967,14.577400203
13,49,2002,122,94,33,1269,-1,28,32,49,10496,11.650670869,8.9767464069,3.1514109726,-11,-0.095497302,2.6739244616,3.0559136704
13,49,2003,110,82,136,1295,-5,28,131,155,10651,10.403366908,7.7552371495,12.862344541,-4,-0.472880314,2.6481297584,12.389464227
13,49,2004,131,102,-127,1299,2,29,-125,-107,10544,12.361405992,9.6249115357,-11.98395848,-11,0.1887237556,2.7364944562,-11.79523473
13,49,2005,92,77,34,1334,-1,15,33,41,10585,8.7084102418,7.2885607459,3.2183255242,-7,-0.094656633,1.419849496,3.1236688911
13,49,2006,118,67,132,1540,1,51,133,179,10764,11.054381938,6.2766405921,12.365918778,-5,0.0936812029,4.7777413462,12.459599981
13,49,2007,147,80,-213,1343,-1,67,-214,-151,10613,13.753099125,7.484679796,-19.92795996,-4,-0.093558497,6.2684193292,-20.02151845
13,49,2008,139,85,193,1562,1,54,194,235,10848,12.953730022,7.9213456968,17.986114347,-13,0.0931923023,5.0323843251,18.079306649
13,51,2001,3562,2339,-184,8864,425,1223,241,1231,233566,15.290802123,10.040759732,-0.789867375,-233,1.8244219265,5.250042391,1.0345545513
13,51,2002,3527,2217,799,9866,199,1310,998,2103,235669,15.032979211,9.449422997,3.4055430648,-205,0.8481890737,5.5835562138,4.2537321385
13,51,2003,3624,2230,14,10477,-274,1394,-260,778,236447,15.352159215,9.4468308636,0.0593074583,-356,-1.160731685,5.9053283515,-1.101424226
13,51,2004,3653,2298,709,10680,628,1355,1337,2513,238960,15.367884781,9.6675059475,2.9827074486,-179,2.6419467951,5.7003788333,5.6246542436
13,51,2005,3765,2215,-748,10954,329,1550,-419,901,239861,15.7261273,9.2518916255,-3.124340829,-230,1.3742087335,6.4742356747,-1.750132095
13,51,2006,3804,2212,2013,11507,504,1592,2517,3986,243847,15.728497358,9.1460137108,8.3232032549,-123,2.0839018581,6.5824836472,10.407105113
13,51,2007,4071,2224,2487,11739,285,1847,2772,4685,248532,16.536042358,9.0336915262,10.101974292,66,1.1576448224,7.5023508314,11.259619115
13,51,2008,4079,2221,306,11472,362,1858,668,2588,251120,16.327363845,8.8901875705,1.2248524973,62,1.4490085099,7.4371762747,2.6738610073
13,53,2001,246,36,809,5643,-39,210,770,984,15975,15.888393722,2.3251307886,52.250855777,4,-2.518891688,13.563262934,49.73196409
13,53,2002,244,31,3247,8872,-340,213,2907,3212,19187,13.878618964,1.7632671634,184.68801547,92,-19.33905921,12.1153518,165.34895626
13,53,2003,240,42,-990,6970,-1005,198,-1995,-1748,17439,13.10544422,2.2934527385,-54.05995741,49,-54.87904767,10.811991481,-108.9390051
13,53,2004,216,38,-540,6970,432,178,-108,42,17481,12.371134021,2.1764032073,-30.92783505,-28,24.742268041,10.194730813,-6.18556701
13,53,2005,241,28,-1382,6970,-56,213,-1438,-1228,16253,14.288255173,1.6600462441,-81.93513962,-3,-3.320092488,12.628208929,-85.25523211
13,53,2006,190,31,-3164,5068,200,159,-2964,-2795,13458,12.789875804,2.0867692101,-212.9850897,10,13.463027162,10.703106594,-199.5220625
13,53,2007,230,17,314,5068,-86,213,228,443,13901,16.813480025,1.2427354801,22.954055338,2,-6.286779488,15.570744545,16.667275851
13,53,2008,213,20,-371,5068,31,193,-340,-147,13754,15.40408606,1.4463930573,-26.83059121,0,2.2419092388,13.957693003,-24.58868197
13,55,2001,359,277,230,1635,24,82,254,314,25808,13.995555729,10.798799267,8.9665120268,-22,0.9356360376,3.1967564617,9.9021480644
13,55,2002,320,287,59,1632,25,33,84,93,25901,12.376955656,11.100582104,2.282001199,-24,0.9669496606,1.276373552,3.2489508596
13,55,2003,311,250,278,1716,19,61,297,341,26242,11.928734442,9.5890148246,10.662984485,-17,0.7287651267,2.3397196172,11.391749612
13,55,2004,325,306,-388,1238,21,19,-367,-377,25865,12.474331664,11.745063043,-14.89243288,-29,0.8060337383,0.7292686203,-14.08639914
13,55,2005,293,281,31,1295,19,12,50,39,25904,11.31951554,10.855917634,1.197627924,-23,0.734030018,0.4635979061,1.931657942
13,55,2006,311,272,141,1373,23,39,164,190,26094,11.961998538,10.461940844,5.423285511,-13,0.8846494096,1.5000576945,6.3079349206
13,55,2007,335,285,637,1726,19,50,656,710,26804,12.665885289,10.775454649,24.084086355,4,0.7183636432,1.8904306401,24.802449998
13,55,2008,304,282,-49,1767,20,22,-29,-3,26801,11.342225539,10.521406585,-1.828187669,4,0.7461990486,0.8208189535,-1.08198862
13,57,2001,2522,805,5333,1148,532,1717,5865,7541,151284,17.096740298,5.4571276527,36.152623319,-41,3.6064495792,11.639612646,39.759072898
13,57,2002,2711,813,5259,1172,501,1898,5760,7640,158924,17.478595007,5.2416443161,33.906282236,-18,3.2300907778,12.236950691,37.136373014
13,57,2003,2809,836,4472,1319,420,1973,4892,6930,165854,17.29796969,5.1481319548,27.538811126,65,2.5863820825,12.149837735,30.125193209
13,57,2004,2972,940,5557,1437,404,2032,5961,7714,173568,17.512123551,5.5388277719,32.743899924,-279,2.3805174679,11.973295779,35.124417392
13,57,2005,3103,933,6701,1341,419,2170,7120,9157,182725,17.418248464,5.2372625901,37.615108913,-133,2.3519968116,12.180985874,39.967105725
13,57,2006,3360,941,8234,1418,425,2419,8659,10951,193676,17.853300071,4.9999867163,43.751212138,-127,2.2582299197,12.853313355,46.009442058
13,57,2007,3381,1036,7260,1456,385,2345,7645,9994,203670,17.017913858,5.2145988635,36.542459217,4,1.9378576857,11.803314995,38.480316903
13,57,2008,3569,1096,4066,1475,388,2473,4454,6859,210529,17.233262272,5.2921421829,19.633074923,-68,1.8734955903,11.94112009,21.506570513
13,59,2001,1269,662,258,8002,709,607,967,1474,103425,12.357821751,6.4467123715,2.5124649423,-100,6.9044094734,5.9111093799,9.4168744157
13,59,2002,1362,618,-576,7463,653,744,77,733,104158,13.122461859,5.9542448081,-5.549587394,-88,6.2914593199,7.1682170505,0.7418719259
13,59,2003,1390,628,410,8103,544,762,954,1582,105740,13.244528295,5.9838588267,3.9066594251,-134,5.1834700664,7.260669468,9.0901294915
13,59,2004,1418,699,2270,10405,583,719,2853,3430,109170,13.196221674,6.505048625,21.125122144,-142,5.4255269648,6.6911730492,26.550649109
13,59,2005,1450,576,-1599,9282,579,874,-1020,-228,108942,13.295921362,5.2816901408,-14.6621919,-82,5.3091989437,8.0142312207,-9.352992958
13,59,2006,1567,643,820,9295,615,924,1435,2298,111240,14.233679411,5.8406227575,7.4483836099,-61,5.5862877074,8.3930566531,13.034671317
13,59,2007,1682,682,490,8998,544,1000,1034,2001,113241,14.985678075,6.0762380781,4.3656255986,-33,4.8467353584,8.9094399971,9.2123609571
13,59,2008,1678,685,-44,8927,553,993,509,1496,114737,14.720718666,6.0093517796,-0.386002158,-6,4.8513453052,8.7113668863,4.4653431471
13,61,2001,49,43,-8,57,1,6,-7,-5,3361,14.568158169,12.784302066,-2.378474803,-4,0.2973093504,1.7838561023,-2.081165453
13,61,2002,39,49,-51,52,1,-10,-50,-63,3298,11.713470491,14.716924463,-15.31761526,-3,0.3003453972,-3.003453972,-15.01726986
13,61,2003,43,47,-14,59,1,-4,-13,-22,3276,13.081837542,14.298752662,-4.259202921,-5,0.30422878,-1.21691512,-3.954974141
13,61,2004,49,54,-64,67,0,-5,-64,-72,3204,15.12345679,16.666666667,-19.75308642,-3,0,-1.543209877,-19.75308642
13,61,2005,39,51,-30,53,1,-12,-29,-45,3159,12.258368694,16.030174446,-9.42951438,-4,0.314317146,-3.771805752,-9.115197234
13,61,2006,60,39,1,52,0,21,1,21,3180,18.930430667,12.304779934,0.3155071778,-1,0,6.6256507336,0.3155071778
13,61,2007,65,28,-14,49,1,37,-13,23,3203,20.366598778,8.773304089,-4.386652044,-1,0.3133322889,11.593294689,-4.073319756
13,61,2008,57,23,-4,49,0,34,-4,28,3231,17.718371153,7.1495181846,-1.243394467,-2,0,10.568852969,-1.243394467
13,63,2001,4502,1352,4325,3268,1536,3150,5861,8805,247173,18.544262997,5.5690456625,17.815179357,-206,6.3269631195,12.975217335,24.142142476
13,63,2002,4489,1387,1017,3172,1392,3102,2409,5252,252425,17.97044824,5.5524641812,4.0712733037,-259,5.5724802741,12.417984059,9.6437535779
13,63,2003,4468,1329,1483,3406,1106,3139,2589,5395,257820,17.513155445,5.2092622172,5.8128938059,-333,4.3351723192,12.303893228,10.148066125
13,63,2004,4743,1384,-136,3706,1238,3359,1102,4299,262119,18.244447906,5.3237014342,-0.523138291,-162,4.7620970922,12.920746472,4.2389588009
13,63,2005,4593,1346,-1748,3885,1220,3247,-528,2525,264644,17.438582437,5.1104576441,-6.636760744,-194,4.6320641351,12.328124792,-2.004696609
13,63,2006,5034,1369,-1002,3744,1273,3665,271,3789,268433,18.886577361,5.1362185951,-3.759306817,-147,4.7760454869,13.750358766,1.01673867
13,63,2007,4736,1413,-1527,3887,1113,3323,-414,2711,271144,17.554491759,5.2374359915,-5.659989214,-198,4.1254538277,12.317055768,-1.534535386
13,63,2008,4706,1460,-1534,3870,1136,3246,-398,2574,273718,17.274098763,5.3591551622,-5.630783575,-274,4.1698631947,11.9149436,-1.46092038
13,65,2001,135,70,-69,270,8,65,-61,-7,6861,19.666399592,10.197392381,-10.05171535,-11,1.1654162721,9.469007211,-8.886299075
13,65,2002,114,89,20,328,7,25,27,44,6905,16.562545402,12.930408252,2.9057097196,-8,1.0169984019,3.6321371495,3.9227081215
13,65,2003,113,86,77,366,6,27,83,104,7009,16.242633319,12.361650137,11.067989076,-6,0.8624407072,3.8809831824,11.930429783
13,65,2004,106,84,-62,360,6,22,-56,-40,6969,15.166690514,12.018886822,-8.871083131,-6,0.8584919159,3.1478036915,-8.012591215
13,65,2005,110,74,34,360,6,36,40,70,7039,15.705311251,10.565391205,4.854368932,-6,0.8566533409,5.1399200457,5.711022273
13,65,2006,96,65,-165,357,6,31,-159,-131,6908,13.766401377,9.3210009321,-23.66100237,-3,0.860400086,4.4454004445,-22.80060228
13,65,2007,123,67,4,362,5,56,9,66,6974,17.720789512,9.6527877827,0.5762858378,1,0.7203572972,8.0680017289,1.296643135
13,65,2008,110,75,48,374,5,35,53,86,7060,15.676214907,10.688328345,6.8405301411,-2,0.712555223,4.9878865612,7.5530853641
13,67,2001,10545,3350,3095,7951,4590,7195,7685,14228,626870,17.014760648,5.4053530744,4.9939008255,-652,7.4061404811,11.609407573,12.400041307
13,67,2002,10529,3279,-101,9330,4262,7250,4161,10747,637617,16.653393827,5.1862929394,-0.159748578,-664,6.7410736528,11.467100888,6.5813250749
13,67,2003,10397,3264,-4112,9169,3660,7133,-452,6016,643633,16.229463415,5.0950243902,-6.418731707,-665,5.7131707317,11.134439024,-0.705560976
13,67,2004,10547,3326,-1720,10723,3497,7221,1777,8524,652157,16.278872348,5.1335478743,-2.654751156,-474,5.3974795299,11.145324474,2.7427283742
13,67,2005,10651,3310,-1289,10696,3613,7341,2324,9040,661197,16.219541723,5.0405298191,-1.962913274,-625,5.501943878,11.179011904,3.5390306041
13,67,2006,11240,3364,5885,11211,3652,7876,9537,17048,678245,16.78310819,5.0229871842,8.7872412542,-365,5.4530170026,11.760121006,14.240258257
13,67,2007,11122,3471,-130,11012,3277,7651,3147,10651,688896,16.270450524,5.0777498444,-0.190177897,-147,4.7939459061,11.19270068,4.6037680093
13,67,2008,10854,3628,-1249,10857,3300,7226,2051,9262,698158,15.650436104,5.231231084,-1.800939257,-15,4.7582862672,10.41920502,2.9573470103
13,69,2001,626,317,203,1961,137,309,340,615,38176,16.53088979,8.3710735836,5.3606559542,-34,3.6177825898,8.1598162061,8.9784385439
13,69,2002,673,339,-109,1989,133,334,24,322,38498,17.55484258,8.8426324439,-2.843206302,-36,3.4692333777,8.7122101364,0.6260270757
13,69,2003,616,364,-94,2057,118,252,24,224,38722,15.954415954,9.4276094276,-2.434602435,-52,3.0562030562,6.5268065268,0.6216006216
13,69,2004,629,342,-285,2021,106,287,-179,75,38797,16.228279519,8.8236432359,-7.35303603,-33,2.7348134006,7.4046362827,-4.618222629
13,69,2005,619,344,-45,2008,114,275,69,306,39103,15.892169448,8.8318356868,-1.155327343,-38,2.9268292683,7.0603337612,1.7715019255
13,69,2006,681,330,218,2212,113,351,331,663,39766,17.269142502,8.3683069394,5.5281542811,-19,2.8655111641,8.9008355628,8.3936654452
13,69,2007,675,347,-36,2363,105,328,69,396,40162,16.890201181,8.6828145331,-0.90081073,-1,2.6273646282,8.207386648,1.7265538985
13,69,2008,632,370,-16,2420,104,262,88,365,40527,15.66508446,9.1710146364,-0.396584417,15,2.5777987086,6.4940698236,2.1812142919
13,71,2001,700,459,-290,1274,232,241,-58,147,42271,16.588660466,10.877421648,-6.87244505,-36,5.49795604,5.7112388175,-1.37448901
13,71,2002,714,413,-33,1479,192,301,159,415,42686,16.808503125,9.7225655332,-0.77686359,-45,4.5199336135,7.085937592,3.7430700237
13,71,2003,661,446,-178,1464,117,215,-61,100,42786,15.467053538,10.43616623,-4.165106702,-54,2.7377386747,5.0308873081,-1.427368027
13,71,2004,692,436,34,1481,205,256,239,467,43253,16.085728565,10.134938807,0.7903392648,-28,4.765280861,5.9507897581,5.5556201258
13,71,2005,745,434,-383,1330,179,311,-204,70,43323,17.210312327,10.025873221,-8.847717612,-37,4.1350951765,7.1844391055,-4.712622436
13,71,2006,747,482,315,1376,198,265,513,755,44078,17.093625931,11.029622087,7.2081555131,-23,4.5308406082,6.0640038443,11.738996121
13,71,2007,732,437,128,1435,161,295,289,580,44658,16.498377209,9.8494410386,2.8849621349,-4,3.6287414353,6.6489361702,6.5137035701
13,71,2008,725,443,178,1423,171,282,349,621,45279,16.122396789,9.8513403827,3.958326384,-10,3.8026618633,6.2710564062,7.7609882473
13,73,2001,1266,521,985,739,106,745,1091,1743,91521,13.965879569,5.7474117342,10.866027943,-93,1.1693390477,8.2184678349,12.03536699
13,73,2002,1292,583,1885,742,50,709,1935,2596,94117,13.919563882,6.2810415971,20.308342042,-48,0.5386828128,7.6385222853,20.847024855
13,73,2003,1295,535,1592,798,-73,760,1519,2257,96374,13.596442877,5.6170632733,16.714700432,-22,-0.766440409,7.9793796032,15.948260023
13,73,2004,1350,616,2443,857,155,734,2598,3197,99571,13.779376866,6.2874786292,24.935568654,-135,1.5820766031,7.4918982368,26.517645258
13,73,2005,1397,630,1880,882,82,767,1962,2638,102209,13.846763802,6.2444246209,18.634156011,-91,0.8127663792,7.6023391813,19.446922391
13,73,2006,1435,666,2395,818,124,769,2519,3231,105440,13.821400536,6.414670911,23.067773021,-57,1.1943231126,7.4067296255,24.262096133
13,73,2007,1563,625,2313,778,67,938,2380,3320,108760,14.593837535,5.8356676004,21.596638655,2,0.6255835668,8.7581699346,22.222222222
13,73,2008,1604,671,878,785,87,933,965,1867,110627,14.622561957,6.1170443098,8.0041205723,-31,0.7931190089,8.5055176469,8.7972395812
13,75,2001,229,181,-100,230,28,48,-72,-39,15799,14.476720296,11.442298574,-6.32171192,-15,1.7700793375,3.0344217214,-4.551632582
13,75,2002,232,180,8,266,28,52,36,71,15870,14.651551991,11.367583441,0.5052259307,-17,1.7682907575,3.2839685497,2.2735166882
13,75,2003,239,155,-70,274,21,84,-49,14,15884,15.053221641,9.7625496001,-4.408893368,-21,1.3226680103,5.2906720413,-3.086225357
13,75,2004,237,172,142,342,21,65,163,211,16095,14.822227087,10.75705932,8.8808280434,-17,1.3133618937,4.0651677663,10.194189937
13,75,2005,235,179,104,283,22,56,126,167,16262,14.525450443,11.064066508,6.4282844516,-15,1.3598294032,3.4613839355,7.7881138548
13,75,2006,286,187,-138,242,24,99,-114,-22,16240,17.59891699,11.506984186,-8.491785121,-7,1.4768321949,6.0919328041,-7.014952926
13,75,2007,275,165,54,250,17,110,71,182,16422,16.839140285,10.103484171,3.3065948197,1,1.0409650358,6.7356561141,4.3475598555
13,75,2008,250,163,82,286,19,87,101,186,16608,15.137753557,9.8698153194,4.9651831668,-2,1.1504692704,5.267938238,6.1156524372
13,77,2001,1548,663,2486,810,269,885,2755,3597,93746,16.835694282,7.2106365045,27.037167949,-43,2.9255825335,9.6250577775,29.962750483
13,77,2002,1528,598,2494,786,253,930,2747,3640,97386,15.988950045,6.2574555804,26.097147521,-37,2.6473850533,9.7314944646,28.744532574
13,77,2003,1534,682,2179,808,201,852,2380,3228,100614,15.494949495,6.8888888889,22.01010101,-4,2.0303030303,8.6060606061,24.04040404
13,77,2004,1604,705,2820,821,201,899,3021,3773,104387,15.648704153,6.8780152292,27.512060917,-147,1.9609660441,8.7706889235,29.473026961
13,77,2005,1635,678,3216,783,206,957,3422,4307,108694,15.346276768,6.3637771552,30.185704028,-72,1.9335370117,8.9824996128,32.11924104
13,77,2006,1690,786,4129,735,211,904,4340,5169,113863,15.187120603,7.0633590496,37.105101165,-75,1.8961434599,8.1237615532,39.001244625
13,77,2007,1816,797,3457,806,181,1019,3638,4589,118452,15.63394529,6.8613735661,29.761315455,-68,1.5582291286,8.7725717237,31.319544584
13,77,2008,1877,794,3313,864,185,1083,3498,4472,122924,15.552499006,6.5789473684,27.450947899,-109,1.5328781652,8.9735516373,28.983826064
13,79,2001,135,116,12,107,1,19,13,17,12446,10.854271357,9.3266331658,0.9648241206,-15,0.0804020101,1.527638191,1.0452261307
13,79,2002,137,126,2,104,1,11,3,2,12448,11.006668273,10.122921186,0.1606812887,-12,0.0803406443,0.8837470877,0.241021933
13,79,2003,170,93,-71,112,1,77,-70,-8,12440,13.661202186,7.4734811958,-5.705560913,-15,0.0803600129,6.18772099,-5.6252009
13,79,2004,142,127,134,110,0,15,134,136,12576,11.35273425,10.153501759,10.713143588,-13,0,1.1992324912,10.713143588
13,79,2005,170,114,-10,126,1,56,-9,37,12613,13.497955457,9.0515701298,-0.79399738,-10,0.079399738,4.4463853269,-0.714597642
13,79,2006,149,80,-107,120,0,69,-107,-45,12568,11.834319527,6.3539970613,-8.498471069,-7,0,5.4803224654,-8.498471069
13,79,2007,144,93,-122,124,1,51,-121,-68,12500,11.488750598,7.4198180948,-9.733524813,2,0.0797829903,4.0689325036,-9.653741822
13,79,2008,127,106,-7,132,0,21,-7,10,12510,10.155937625,8.4766093563,-0.55977609,-4,0,1.6793282687,-0.55977609
13,81,2001,367,249,-87,467,36,118,-51,46,22019,16.684851791,11.320240044,-3.955264594,-21,1.6366612111,5.3646117476,-2.318603382
13,81,2002,331,238,-150,458,34,93,-116,-40,21979,15.046138461,10.818673576,-6.81849175,-17,1.5455247966,4.2274648848,-5.272966953
13,81,2003,315,243,-342,461,31,72,-311,-244,21735,14.411858901,11.117719724,-15.64716109,-5,1.4183099236,3.2941391774,-14.22885117
13,81,2004,330,249,-74,525,29,81,-45,19,21754,15.176251466,11.451171561,-3.40315942,-17,1.3336705834,3.7250799053,-2.069488836
13,81,2005,349,239,-130,514,32,110,-98,-9,21745,16.046345893,10.988758362,-5.9771489,-21,1.4712981908,5.0575875307,-4.505850709
13,81,2006,353,279,35,505,33,74,68,132,21877,16.184494063,12.791710605,1.6046948787,-10,1.5129980285,3.3927834579,3.1176929072
13,81,2007,365,227,82,607,27,138,109,250,22127,16.589400964,10.317243887,3.7269339151,3,1.2271611672,6.2721570766,4.9540950823
13,81,2008,340,255,-86,508,27,85,-59,35,22162,15.353699564,11.515274673,-3.883582831,9,1.2192643772,3.8384248911,-2.664318454
13,83,2001,183,133,229,859,12,50,241,283,15459,11.947119308,8.6828790599,14.950220336,-8,0.7834176595,3.2642402481,15.733637996
13,83,2002,197,147,84,878,11,50,95,131,15590,12.689619633,9.4689039905,5.4108022803,-14,0.7085574415,3.220715643,6.1193597217
13,83,2003,171,146,113,913,6,25,119,130,15720,10.923027787,9.3260938997,7.218141169,-14,0.3832641329,1.5969338869,7.6014053018
13,83,2004,184,149,40,896,9,35,49,73,15793,11.677720306,9.4564148129,2.5386348491,-11,0.571192841,2.221305493,3.1098276902
13,83,2005,148,155,92,918,8,-7,100,78,15871,9.3481556342,9.7902981304,5.8110156645,-15,0.50530571,-0.442142496,6.3163213744
13,83,2006,154,164,117,958,8,-10,125,107,15978,9.6706333009,10.298596502,7.3471694559,-8,0.5023705611,-0.627963201,7.849540017
13,83,2007,175,155,106,1000,8,20,114,135,16113,10.906484684,9.6600292917,6.6062135801,1,0.498582157,1.2464553925,7.1047957371
13,83,2008,186,167,0,998,8,19,8,29,16142,11.533095644,10.354983723,0,2,0.4960471245,1.1781119206,0.4960471245
13,85,2001,245,117,477,80,12,128,489,610,16909,14.755480607,7.0464948205,28.728017345,-7,0.7227174175,7.7089857866,29.450734763
13,85,2002,239,103,482,90,12,136,494,624,17533,13.878404274,5.9810696243,27.989083096,-6,0.6968236455,7.8973346496,28.685906742
13,85,2003,239,133,715,133,11,106,726,856,18389,13.306608763,7.4049329102,39.808473916,24,0.6124380602,5.9016758532,40.420911976
13,85,2004,277,132,274,134,9,145,283,408,18797,14.898079923,7.0994460281,14.736728876,-20,0.4840531383,7.7986338945,15.220782015
13,85,2005,243,153,770,230,11,90,781,857,19654,12.639463213,7.9581805415,40.050973967,-14,0.572156771,4.6812826715,40.623130738
13,85,2006,282,130,721,240,11,152,732,872,20526,14.036834246,6.4708810353,35.888501742,-12,0.5475360876,7.5659532106,36.43603783
13,85,2007,303,171,794,350,10,132,804,942,21468,14.430632948,8.1440205744,37.814925942,6,0.4762585131,6.2866123732,38.291184455
13,85,2008,336,160,342,366,9,176,351,538,22006,15.457514836,7.3607213507,15.733541887,11,0.414040576,8.0967934858,16.147582463
13,87,2001,446,315,-420,671,47,131,-373,-271,27972,15.867650983,11.206973228,-14.94263097,-29,1.672151561,4.660677755,-13.27047941
13,87,2002,409,290,-47,764,45,119,-2,88,28060,14.598800685,10.35122787,-1.677612793,-29,1.6062250143,4.2475728155,-0.071387778
13,87,2003,408,301,-124,815,40,107,-84,-16,28044,14.54441751,10.730072722,-4.420362185,-39,1.4259232853,3.8143447883,-2.994438899
13,87,2004,392,303,-49,789,41,89,-8,62,28106,13.962600178,10.792520036,-1.745325022,-19,1.4603739982,3.1700801425,-0.284951024
13,87,2005,393,294,-277,795,42,99,-235,-160,27946,14.022693213,10.490259045,-9.883679441,-24,1.498608435,3.5324341683,-8.385071005
13,87,2006,416,297,246,846,42,119,288,392,28338,14.782176107,10.553620922,8.7413829863,-15,1.4924312416,4.2285551844,10.233814228
13,87,2007,429,291,20,913,37,138,57,194,28532,15.087040619,10.233866714,0.703358537,-1,1.3012132935,4.8531739054,2.0045718305
13,87,2008,406,303,140,1083,38,103,178,291,28823,14.157440502,10.565774562,4.8818760352,10,1.3250806381,3.5916659402,6.2069566734
13,89,2001,11250,4185,-9257,14324,7470,7065,-1787,13314,682129,16.655020489,6.195667622,-13.70449108,8036,11.058933605,10.459352867,-2.645557477
13,89,2002,10933,4112,-12772,14852,7028,6821,-5744,7698,689827,15.93782891,5.9943613352,-18.6186729,6621,10.245226523,9.9434675748,-8.373446379
13,89,2003,10994,4087,-13055,15559,6181,6907,-6874,6987,696814,15.857024277,5.8948206493,-18.82967545,6954,8.9150688606,9.9622036273,-9.914606592
13,89,2004,11051,4122,-11764,15086,5593,6929,-6171,7260,704074,15.777135645,5.8848387594,-16.79506142,6502,7.9849352696,9.892296886,-8.810126149
13,89,2005,10973,4024,-7648,15455,5904,6949,-1744,12114,716188,15.45207856,5.6665601136,-10.76984387,6909,8.3139589738,9.7855184466,-2.4558849
13,89,2006,11377,3898,-2434,15653,5896,7479,3462,10951,727139,15.76496525,5.4014093826,-3.372763068,10,8.1700127553,10.363555868,4.7972496877
13,89,2007,11166,4137,-6186,15609,5376,7029,-810,6219,733358,15.290685294,5.6651947933,-8.471088951,0,7.3618774979,9.6254905008,-1.109211453
13,89,2008,10932,4167,-5487,15731,5384,6765,-103,6598,739956,14.840013738,5.6566353133,-7.44851403,-64,7.308693191,9.1833784244,-0.139820839
13,91,2001,250,215,102,1820,19,35,121,140,19296,13.0032248,11.182773328,5.3053157183,-16,0.9882450848,1.820451472,6.2935608031
13,91,2002,229,236,56,1849,18,-7,74,48,19344,11.85300207,12.215320911,2.8985507246,-19,0.9316770186,-0.362318841,3.8302277433
13,91,2003,273,213,115,1934,16,60,131,172,19516,14.050437468,10.962429233,5.9186824498,-19,0.8234688626,3.0880082347,6.7421513124
13,91,2004,247,213,-69,1973,16,34,-53,-32,19484,12.666666667,10.923076923,-3.538461538,-13,0.8205128205,1.7435897436,-2.717948718
13,91,2005,253,206,53,1936,17,47,70,103,19587,12.95078191,10.544905429,2.7130096491,-14,0.8702106422,2.4058764813,3.5832202913
13,91,2006,268,205,179,1906,18,63,197,249,19836,13.59612409,10.400020293,9.0809933288,-11,0.9131725135,3.1961037973,9.9941658423
13,91,2007,273,198,93,1923,16,75,109,174,20010,13.702755609,9.9382623099,4.667971691,-10,0.8030919038,3.7644932992,5.4710635948
13,91,2008,285,221,43,1946,16,64,59,106,20116,14.205253452,11.015301799,2.1432487664,-17,0.7974879131,3.1899516523,2.9407366795
13,93,2001,202,125,140,1438,11,77,151,219,11715,17.405540476,10.770755245,12.063245875,-9,0.9478264616,6.6347852311,13.011072336
13,93,2002,171,117,-202,1324,11,54,-191,-142,11573,14.685675026,10.048093439,-17.34799038,-5,0.9446925455,4.6375815871,-16.40329784
13,93,2003,184,109,-111,1303,8,75,-103,-36,11537,15.923842492,9.4331458243,-9.606231069,-8,0.6923409779,6.4906966681,-8.913890091
13,93,2004,169,116,-54,1432,12,53,-42,1,11538,14.647887324,10.054171181,-4.680390033,-10,1.0400866739,4.593716143,-3.640303359
13,93,2005,174,128,50,1463,10,46,60,98,11636,15.016829205,11.046862864,4.3151808061,-8,0.8630361612,3.9699663416,5.1782169673
13,93,2006,165,110,1,1543,11,55,12,63,11699,14.141847011,9.4278980073,0.0857081637,-4,0.9427898007,4.7139490036,1.0284979644
13,93,2007,160,103,-207,1543,9,57,-198,-136,11563,13.756340813,8.8556443986,-17.79726593,5,0.7737941708,4.9006964148,-17.02347176
13,93,2008,171,123,-70,1534,11,48,-59,-15,11548,14.798148068,10.644281944,-6.057721431,-4,0.9519276535,4.1538661244,-5.105793778
13,95,2001,1632,843,-563,4932,85,789,-478,223,96109,17.00044272,8.7814786843,-5.864736061,-88,0.885439725,8.2189640355,-4.979296336
13,95,2002,1445,825,-933,4924,17,620,-916,-367,95742,15.063773449,8.6004242876,-9.726298013,-71,0.1772208641,6.4633491616,-9.549077148
13,95,2003,1466,873,-574,4960,-138,593,-712,-224,95518,15.32991739,9.1289344348,-6.002300533,-105,-1.443061801,6.2009829551,-7.445362334
13,95,2004,1457,949,-1123,4687,162,508,-961,-540,94978,15.296909121,9.9634637998,-11.79027381,-87,1.7008231144,5.3334453217,-10.0894507
13,95,2005,1488,806,-559,4585,64,682,-495,108,95086,15.65788366,8.4813536493,-5.882229144,-79,0.6734573617,7.1765300109,-5.208771782
13,95,2006,1651,882,-890,4786,118,769,-772,-46,95040,17.36743002,9.2780577091,-9.362212428,-43,1.2412820971,8.089372311,-8.12093033
13,95,2007,1688,890,-211,4730,49,798,-162,615,95655,17.703662917,9.334277249,-2.212957865,-21,0.5139096463,8.3693856682,-1.699048218
13,95,2008,1631,883,-737,4685,75,748,-662,99,95754,17.042040865,9.2263164219,-7.700787319,13,0.7836622102,7.8157244435,-6.917125109
13,97,2001,1446,633,1854,847,177,813,2031,2786,95489,15.367284475,6.7271722496,19.703281755,-58,1.8810576433,8.6401122258,21.584339398
13,97,2002,1463,664,1785,843,163,799,1948,2698,98187,15.107705653,6.8568124084,18.43284661,-49,1.683223528,8.2508932444,20.116070138
13,97,2003,1469,666,2272,929,140,803,2412,3227,101414,14.719365133,6.67331326,22.765417007,12,1.4027985832,8.0460518735,24.16821559
13,97,2004,1585,705,4312,1020,148,880,4460,5127,106541,15.243682527,6.7803130485,41.470510447,-213,1.4233848669,8.463369479,42.893895314
13,97,2005,1753,705,4652,1196,147,1048,4799,5761,112302,16.02061752,6.4429751009,42.514496694,-86,1.3434288508,9.5776424195,43.857925545
13,97,2006,1827,697,5105,994,154,1130,5259,6315,118617,15.823730399,6.0367488167,44.214638033,-74,1.3338010298,9.7869815823,45.548439063
13,97,2007,2034,803,4199,1042,137,1231,4336,5604,124221,16.75190868,6.6134624729,34.582725933,37,1.1283242326,10.138446207,35.711050165
13,97,2008,2066,775,2263,1096,140,1291,2403,3711,127932,16.386876222,6.1470615063,17.949419598,17,1.1104369173,10.239814716,19.059856516
13,99,2001,190,139,-89,264,6,51,-83,-42,12298,15.423329816,11.283383392,-7.224612387,-10,0.4870525205,4.1399464242,-6.737559867
13,99,2002,199,143,-168,252,5,56,-163,-115,12183,16.257505821,11.682529308,-13.72492954,-8,0.4084800457,4.5749765124,-13.31644949
13,99,2003,172,148,-32,254,5,24,-27,-23,12160,14.131372468,12.159553054,-2.629092552,-20,0.4107957113,1.9718194142,-2.218296841
13,99,2004,194,146,-178,257,6,48,-172,-136,12024,16.043665233,12.074098578,-14.72047635,-12,0.496195832,3.9695666556,-14.22428052
13,99,2005,177,144,-48,272,6,33,-42,-21,12003,14.733424897,11.98651517,-3.995505057,-12,0.4994381321,2.7469097266,-3.496066925
13,99,2006,162,146,-65,249,6,16,-59,-48,11955,13.523666416,12.187995659,-5.426162451,-5,0.5008765339,1.3356707572,-4.925285917
13,99,2007,193,135,-199,225,6,58,-193,-127,11828,16.230080309,11.352646849,-16.73464239,8,0.5045620822,4.8774334609,-16.23008031
13,99,2008,186,142,-172,214,6,44,-166,-115,11713,15.802217408,12.064058451,-14.61280319,7,0.5097489486,3.7381589567,-14.10305425
13,101,2001,41,30,-40,0,54,11,14,20,3811,10.786635096,7.8926598264,-10.52354644,-5,14.206787687,2.8939752697,3.6832412523
13,101,2002,61,23,-84,0,49,38,-35,0,3811,16.00629756,6.035161375,-22.04145893,-3,12.857517712,9.9711361847,-9.183941223
13,101,2003,63,16,27,0,44,47,71,115,3926,16.285381931,4.1359700142,6.979449399,-3,11.373917539,12.149411917,18.353366938
13,101,2004,94,31,7,0,39,63,46,106,4032,23.624026137,7.7909022367,1.7592359889,-3,9.8014576527,15.8331239,11.560693642
13,101,2005,83,14,-67,0,42,69,-25,43,4075,20.476131738,3.4538053534,-16.52892562,-1,10.36141606,17.022326385,-6.16750956
13,101,2006,60,20,-129,0,42,40,-87,-49,4026,14.812986051,4.937662017,-31.84792001,-2,10.369090236,9.8753240341,-21.47882977
13,101,2007,28,14,-8,0,39,14,31,35,4061,6.9246939533,3.4623469766,-1.978483987,-10,9.6451094349,3.4623469766,7.6666254483
13,101,2008,26,6,-40,0,39,20,-1,2,4063,6.4007877893,1.4771048744,-9.84736583,-17,9.6011816839,4.9236829148,-0.246184146
13,103,2001,598,269,1171,255,12,329,1183,1497,39312,15.506891231,6.9755079285,30.365501057,-15,0.3111750749,8.5313833029,30.676676132
13,103,2002,585,259,1439,443,8,326,1447,1775,41087,14.552419806,6.4428662048,35.79646513,2,0.1990074503,8.1095536014,35.995472581
13,103,2003,606,280,1196,459,-2,326,1194,1545,42632,14.477000442,6.6890431085,28.571769849,25,-0.047778879,7.7879573335,28.52399097
13,103,2004,640,302,1378,447,14,338,1392,1660,44292,14.72550734,6.9485987759,31.705857991,-70,0.3221204731,7.7769085638,32.027978464
13,103,2005,662,272,1859,453,10,390,1869,2223,46515,14.58037376,5.9907275871,40.94398009,-36,0.2202473378,8.5896461727,41.164227427
13,103,2006,723,279,1691,445,12,444,1703,2118,48633,15.197376718,5.8645478623,35.544625215,-29,0.2522386177,9.3328288561,35.796863833
13,103,2007,676,304,1753,445,7,372,1760,2151,50784,13.599283825,6.1156542644,35.265598439,19,0.1408209864,7.4836295603,35.406419425
13,103,2008,747,332,857,461,10,415,867,1276,52060,14.526856209,6.4563805375,16.666018436,-6,0.1944692933,8.0704756719,16.860487729
13,105,2001,269,240,52,250,20,29,72,82,20583,13.095122189,11.683380391,2.5313990848,-19,0.9736150326,1.4117417973,3.5050141174
13,105,2002,257,242,56,256,20,15,76,73,20656,12.463929775,11.736463057,2.7158757487,-18,0.9699556245,0.7274667184,3.6858313732
13,105,2003,230,224,-42,264,12,6,-30,-51,20605,11.148542207,10.857710671,-2.035820751,-27,0.5816630717,0.2908315358,-1.454157679
13,105,2004,278,242,86,264,14,36,100,120,20725,13.452697798,11.710621824,4.1616259376,-16,0.6774739898,1.7420759739,4.8390999274
13,105,2005,272,244,-127,264,14,28,-113,-102,20623,13.156621844,11.802263713,-6.142981523,-17,0.6771790655,1.354358131,-5.465802457
13,105,2006,266,262,-35,266,15,4,-20,-26,20597,12.906356138,12.712275594,-1.698204755,-10,0.7278020378,0.1940805434,-0.970402717
13,105,2007,285,225,-154,268,11,60,-143,-77,20520,13.862879101,10.944378238,-7.490818883,6,0.5350584916,2.9185008634,-6.955760391
13,105,2008,268,254,-62,270,13,14,-49,-26,20494,13.068708246,12.386014532,-3.023357878,9,0.6339298776,0.6826937143,-2.389428
13,107,2001,318,256,-242,820,101,62,-141,-97,21759,14.582139172,11.739080592,-11.09709962,-18,4.6314341396,2.8430585808,-6.465665482
13,107,2002,338,273,-221,849,97,65,-124,-73,21686,15.559903326,12.567614225,-10.17378294,-14,4.4654160433,2.9922891012,-5.708366901
13,107,2003,409,279,-45,853,81,130,36,136,21822,18.80114002,12.825227544,-2.068585088,-30,3.723453158,5.9759124759,1.6548680702
13,107,2004,336,261,-244,703,74,75,-170,-117,21705,15.438693225,11.992556344,-11.21143198,-22,3.4001883888,3.4461368806,-7.811243596
13,107,2005,374,240,85,828,79,134,164,278,21983,17.121406336,10.986998718,3.8912287127,-20,3.6165537447,6.1344076177,7.5077824574
13,107,2006,373,260,173,926,79,113,252,353,22336,16.832509759,11.733116722,7.8070353573,-12,3.5650623886,5.0993930368,11.372097746
13,107,2007,365,264,-106,877,68,101,-38,52,22388,16.322332528,11.805741884,-4.740184241,-11,3.0408729094,4.5165906448,-1.699311332
13,107,2008,369,270,276,1006,68,99,344,437,22825,16.322739035,11.943467587,12.208877978,-6,3.0079844293,4.3792714485,15.216862407
13,109,2001,191,107,126,598,39,84,165,239,10802,17.879709806,10.016381933,11.794991809,-10,3.650830798,7.8633278727,15.445822607
13,109,2002,181,113,154,623,39,68,193,255,11057,16.560684386,10.338990805,14.090306052,-6,3.56832426,6.2216935816,17.658630312
13,109,2003,203,129,81,654,34,74,115,179,11236,18.211994797,11.573139551,7.2668550666,-10,3.0502848428,6.638855246,10.317139909
13,109,2004,174,104,-135,671,34,70,-101,-43,11193,15.51562709,9.2737081457,-12.03798654,-12,3.0317892015,6.2419189442,-9.006197334
13,109,2005,226,102,-91,639,32,124,-59,54,11247,20.142602496,9.0909090909,-8.110516934,-11,2.8520499109,11.051693405,-5.258467023
13,109,2006,207,119,-44,592,33,88,-11,72,11319,18.346184525,10.546840379,-3.899672073,-5,2.9247540548,7.7993441461,-0.974918018
13,109,2007,191,105,4,611,28,86,32,117,11436,16.787519227,9.2287409361,0.3515710833,-1,2.4609975829,7.5587782905,2.8125686662
13,109,2008,211,115,84,590,29,96,113,210,11646,18.282644485,9.9644744823,7.2783987523,1,2.5127805216,8.3181700026,9.7911792739
13,111,2001,236,239,390,143,6,-3,396,380,20328,11.719137948,11.868110041,19.366372033,-13,0.2979441851,-0.148972093,19.664316218
13,111,2002,238,254,567,151,5,-16,572,553,20881,11.550874809,12.327404208,27.518260574,-3,0.2426654372,-0.776529399,27.760926011
13,111,2003,245,274,310,140,1,-29,311,273,21154,11.65695254,13.036755085,14.749613417,-9,0.0475793981,-1.379802545,14.797192816
13,111,2004,256,279,428,166,6,-23,434,383,21537,11.993160151,13.070670633,20.051064627,-28,0.281089691,-1.077510482,20.332154318
13,111,2005,257,293,266,165,4,-36,270,212,21749,11.874509079,13.537864437,12.290347918,-22,0.1848172619,-1.663355357,12.47516518
13,111,2006,227,268,476,177,6,-41,482,431,22180,10.334858522,12.201506977,21.671333288,-10,0.2731680667,-1.866648455,21.944501354
13,111,2007,287,304,331,154,4,-17,335,324,22504,12.845761346,13.606660102,14.815146361,6,0.1790350013,-0.760898756,14.994181362
13,111,2008,281,286,94,142,6,-5,100,114,22618,12.45512167,12.676743052,4.1664819822,19,0.2659456584,-0.221621382,4.4324276406
13,113,2001,920,549,1615,576,214,371,1829,2121,94194,9.878292988,5.8947639679,17.340699104,-79,2.2977768472,3.9835290202,19.638475951
13,113,2002,876,541,1307,620,184,335,1491,1756,95950,9.2140693369,5.6904240996,13.747475597,-70,1.9353752945,3.5236452373,15.682850892
13,113,2003,927,609,1641,614,110,318,1751,2026,97976,9.5603477615,6.280746264,16.923981312,-43,1.1344533482,3.2796014975,18.058434661
13,113,2004,934,647,1537,654,194,287,1731,1912,99888,9.4408280435,6.5398455505,15.535923665,-106,1.9609428698,2.900982493,17.496866535
13,113,2005,970,586,2118,622,168,384,2286,2596,102484,9.586306406,5.7913150041,20.931749452,-74,1.6603087384,3.794991402,22.59205819
13,113,2006,916,649,1703,633,186,267,1889,2096,104580,8.8475060851,6.2685932852,16.449020593,-60,1.7965459954,2.5789127999,18.245566588
13,113,2007,991,600,717,646,159,391,876,1230,105810,9.4205998384,5.7036931413,6.8159133039,-37,1.5114786824,3.7169066971,8.3273919863
13,113,2008,1031,677,153,617,168,354,321,655,106465,9.7138146273,6.3785184313,1.441526322,-20,1.582852432,3.335296196,3.024378754
13,115,2001,1390,979,-227,3666,251,411,24,340,91136,15.280434448,10.762262823,-2.495437856,-95,2.7592726953,4.5181716246,0.2638348394
13,115,2002,1326,973,946,4229,241,353,1187,1443,92579,14.435402662,10.592493808,10.29856027,-97,2.6236289906,3.8429088534,12.922189261
13,115,2003,1450,1032,334,4480,217,418,551,863,93442,15.589637729,11.095521473,3.5909924148,-106,2.3330699222,4.4941162557,5.924062337
13,115,2004,1403,998,-121,4490,203,405,82,423,93865,14.980753522,10.65630222,-1.291996562,-64,2.1675644797,4.3244513019,0.8755679179
13,115,2005,1326,960,-160,4460,212,366,52,328,94193,14.102032352,10.209616182,-1.701602697,-90,2.2546235736,3.8924161695,0.5530208765
13,115,2006,1461,985,173,4440,211,476,384,813,95006,15.444056258,10.41231719,1.8287623085,-47,2.2304557635,5.0317390684,4.059218072
13,115,2007,1479,1002,-295,4058,196,477,-99,358,95364,15.538162526,10.526868729,-3.09922782,-20,2.059147975,5.0112937963,-1.040079845
13,115,2008,1432,1009,-41,4092,198,423,157,616,95980,14.967806673,10.546450372,-0.428547537,36,2.0695710344,4.4213563007,1.6410234969
13,117,2001,2085,584,6280,677,390,1501,6670,8203,108701,19.933173677,5.5832006845,60.038527909,32,3.7285073064,14.349972992,63.767035215
13,117,2002,2137,628,5517,804,374,1509,5891,7440,116141,19.00890403,5.5861449373,49.074461177,40,3.3267805837,13.422759093,52.401241761
13,117,2003,2186,617,4914,842,322,1569,5236,6977,123118,18.273084816,5.157590728,41.076824696,172,2.6916437835,13.115494088,43.76846848
13,117,2004,2293,673,5455,865,292,1620,5747,7115,130233,18.101369247,5.3127873977,43.062786411,-252,2.3051024073,12.788581849,45.367888818
13,117,2005,2386,614,6170,898,308,1772,6478,8169,138402,17.763880358,4.5712583989,45.935935377,-81,2.2930742457,13.192621959,48.229009623
13,117,2006,2346,639,7540,918,309,1707,7849,9453,147855,16.390865551,4.4645196449,52.679934464,-103,2.158899171,11.926345906,54.838833636
13,117,2007,2486,749,8228,929,283,1737,8511,10256,158111,16.250171588,4.8959688331,53.78375375,8,1.8498787447,11.354202755,55.633632495
13,117,2008,2620,768,7929,778,285,1852,8214,9949,168060,16.065192798,4.7091862857,48.618669348,-117,1.7475495982,11.356006512,50.366218947
13,119,2001,256,243,335,593,9,13,344,345,20681,12.482629154,11.848745642,16.334690494,-12,0.4388424312,0.6338835117,16.773532925
13,119,2002,277,237,149,591,9,40,158,181,20862,13.335580001,11.409864478,7.1732903257,-17,0.4332859928,1.9257155237,7.6065763185
13,119,2003,270,253,184,587,7,17,191,190,21052,12.883523405,12.072338598,8.7798826168,-18,0.3340172735,0.811184807,9.1138998903
13,119,2004,252,223,172,618,6,29,178,186,21238,11.917711043,10.546228423,8.1343107118,-21,0.2837550248,1.37148262,8.4180657366
13,119,2005,295,241,191,594,7,54,198,232,21470,13.814741969,11.285941744,8.9444600543,-20,0.3278074365,2.5288002248,9.2722674909
13,119,2006,292,207,76,603,6,85,82,156,21626,13.551141637,9.6064599963,3.5270094672,-11,0.2784481158,3.944681641,3.8054575831
13,119,2007,321,248,86,622,7,73,93,167,21793,14.786153527,11.423570326,3.9613993874,1,0.322439485,3.3625832009,4.2838388724
13,119,2008,304,232,-44,623,6,72,-38,31,21824,13.939518995,10.63805397,-2.01756196,-3,0.2751220854,3.3014650251,-1.742439874
13,121,2001,13504,6083,-6355,31245,5625,7421,-730,29654,846806,16.231178912,7.3114826216,-7.63841395,22963,6.7609879576,8.9196962904,-0.877425993
13,121,2002,13062,6042,-15207,31157,5270,7020,-9937,16101,862907,15.27975748,7.0678529086,-17.78895054,19018,6.1647773632,8.2119045711,-11.62417318
13,121,2003,12973,5859,-12178,34216,4586,7114,-7592,19021,881928,14.870173971,6.7158212668,-13.95891302,19499,5.2566575063,8.1543527038,-8.702255514
13,121,2004,12817,5822,-11996,34166,4245,6995,-7751,23874,905802,14.338854301,6.5132878007,-13.42037109,24630,4.7490392845,7.8255665005,-8.671331801
13,121,2005,12826,5533,-127,32438,4436,7293,4309,28440,934242,13.940970977,6.0139866221,-0.138040177,16838,4.8216238307,7.9269843547,4.6835836534
13,121,2006,13378,5888,18104,32350,4442,7490,22546,30039,964281,14.093060764,6.2027165328,19.071667818,3,4.6794271126,7.8903442308,23.75109493
13,121,2007,14448,6154,15884,33191,4034,8294,19918,28191,992472,14.767321169,6.2900120761,16.235058794,-21,4.1231570873,8.4773090932,20.358215881
13,121,2008,14829,6360,10126,33004,4047,8469,14173,22460,1014932,14.774305521,6.3365421211,10.088651811,-182,4.0320732648,8.4377633999,14.120725076
13,123,2001,366,201,392,191,109,165,501,651,24386,15.211653956,8.3539411068,16.292263253,-15,4.5302466699,6.8577128489,20.822509923
13,123,2002,358,236,533,202,108,122,641,754,25140,14.457052861,9.5303476962,21.524047975,-9,4.3613455559,4.926705165,25.885393531
13,123,2003,344,240,512,240,82,104,594,697,25837,13.496282637,9.4160111423,20.087490437,-1,3.2171371403,4.080271495,23.304627577
13,123,2004,402,205,416,242,74,197,490,653,26490,15.364916773,7.8353431307,15.900013377,-34,2.8283677643,7.5295736427,18.728381142
13,123,2005,393,244,472,253,79,149,551,677,27167,14.648601301,9.0948058967,17.593231079,-23,2.944629778,5.5537954041,20.537860857
13,123,2006,400,259,585,206,81,141,666,790,27957,14.512734925,9.3969958639,21.224874828,-17,2.9388288223,5.115739061,24.16370365
13,123,2007,444,257,107,206,75,187,182,353,28310,15.781897027,9.1350169726,3.8032950042,-16,2.6658609842,6.646880054,6.4691559884
13,123,2008,411,260,34,221,74,151,108,227,28537,14.459865956,9.1473604588,1.1961932908,-32,2.6034795152,5.3125054972,3.799672806
13,125,2001,28,33,-6,104,0,-5,-6,-14,2548,10.95890411,12.915851272,-2.348336595,-3,0,-1.956947162,-2.348336595
13,125,2002,33,40,19,106,-1,-7,18,9,2557,12.928501469,15.670910872,7.4436826641,-2,-0.391772772,-2.742409403,7.0519098923
13,125,2003,33,43,11,104,-1,-10,10,-3,2554,12.913324203,16.826452749,4.3044414009,-3,-0.391312855,-3.913128546,3.9131285463
13,125,2004,39,41,62,114,0,-2,62,56,2610,15.104570101,15.879163439,24.012393493,-4,0,-0.774593338,24.012393493
13,125,2005,28,53,31,104,0,-25,31,4,2614,10.719754977,20.290964778,11.868300153,-2,0,-9.571209801,11.868300153
13,125,2006,45,36,84,104,0,9,84,92,2706,16.917293233,13.533834586,31.578947368,-1,0,3.3834586466,31.578947368
13,125,2007,35,22,43,104,0,13,43,55,2761,12.804097311,8.0482897384,15.730748125,-1,0,4.7558075727,15.730748125
13,125,2008,38,28,25,104,0,10,25,35,2796,13.676444125,10.077379881,8.9976606082,0,0,3.5990642433,8.9976606082
13,127,2001,962,682,343,1342,131,280,474,694,68349,14.146642746,10.029116791,5.043969295,-60,1.926413929,4.1175259551,6.970383224
13,127,2002,928,682,342,1553,122,246,464,654,69003,13.512726426,9.9306890326,4.9799056439,-56,1.7764575689,3.582037393,6.7563632128
13,127,2003,1032,751,536,1499,96,281,632,842,69845,14.865176308,10.817584697,7.7206729661,-71,1.3828070984,4.047591611,9.1034800645
13,127,2004,1008,781,360,1270,110,227,470,635,70480,14.366648851,11.131302334,5.1309460182,-62,1.5677890611,3.235346517,6.6987350793
13,127,2005,1025,733,550,1359,105,292,655,888,71368,14.452089561,10.335006486,7.7547797643,-59,1.480457955,4.1170830748,9.2352377192
13,127,2006,1066,752,1537,1346,111,314,1648,1923,73291,14.738108241,10.39686435,21.249974077,-39,1.534643541,4.3412438908,22.784617618
13,127,2007,1112,760,900,1295,98,352,998,1375,74666,15.031394256,10.273255067,12.16569679,25,1.3247092061,4.7581391891,13.490405996
13,127,2008,1137,761,720,1340,102,376,822,1218,75884,15.104616407,10.10959814,9.5649285952,20,1.355031551,4.9950182664,10.919960146
13,129,2001,833,388,534,403,217,445,751,1162,45541,18.527580071,8.6298932384,11.877224199,-34,4.8265124555,9.8976868327,16.703736655
13,129,2002,804,415,438,450,207,389,645,998,46539,17.463075586,9.0139009557,9.5134665508,-36,4.4960903562,8.4491746308,14.009556907
13,129,2003,751,356,434,435,177,395,611,964,47503,15.971587163,7.5710852598,9.229918547,-42,3.7642755365,8.4005019034,12.994194083
13,129,2004,840,399,527,477,164,441,691,1084,48587,17.483609116,8.3047143303,10.968883339,-48,3.4134665418,9.1788947861,14.38234988
13,129,2005,837,441,408,478,171,396,579,927,49514,17.064046238,8.9907340394,8.3179580229,-48,3.4862029949,8.0733121987,11.804161018
13,129,2006,912,445,616,448,173,467,789,1229,50743,18.193243365,8.8771856329,12.288418764,-27,3.4511305944,9.3160577316,15.739549358
13,129,2007,899,420,439,490,157,479,596,1077,51820,17.530688455,8.1900880434,8.5605920264,2,3.0615329115,9.3406004115,11.622124938
13,129,2008,891,420,351,434,159,471,510,980,52800,17.03307207,8.0290575416,6.7099980883,-1,3.0395717836,9.0040145288,9.7495698719
13,131,2001,398,235,-219,246,120,163,-99,46,23695,16.813112538,9.9273403177,-9.251436296,-18,5.0692801622,6.8857722203,-4.182156134
13,131,2002,373,249,-168,270,110,124,-58,45,23740,15.72678402,10.498577,-7.083377253,-21,4.6379255824,5.2282070201,-2.445451671
13,131,2003,385,266,-75,248,98,119,23,104,23844,16.181909886,11.180228648,-3.152320108,-38,4.1190316073,5.0016812374,0.9667114997
13,131,2004,399,246,-87,242,91,153,4,141,23985,16.684438311,10.286646177,-3.637960233,-16,3.8052227728,6.3977921345,0.1672625395
13,131,2005,412,276,15,242,94,136,109,223,24208,17.097918785,11.453945594,0.6224970431,-22,3.9009814703,5.6439731911,4.5234785135
13,131,2006,397,252,193,241,95,145,288,421,24629,16.258164916,10.320044229,7.9038433974,-12,3.890492864,5.9381206872,11.794336261
13,131,2007,427,245,18,248,87,182,105,288,24917,17.236507488,9.8897993784,0.7265975053,1,3.5118879425,7.3467081096,4.2384854479
13,131,2008,427,254,-76,252,89,173,13,198,25115,17.069075791,10.153501759,-3.038055644,12,3.5577230572,6.9155740326,0.5196674129
13,133,2001,202,170,269,215,24,32,293,314,14764,13.828986103,11.638255631,18.415828028,-11,1.6430478538,2.1907304717,20.058875881
13,133,2002,220,163,187,224,24,57,211,257,15021,14.772536512,10.945106597,12.556656035,-11,1.6115494376,3.8274299144,14.168205473
13,133,2003,205,174,79,240,19,31,98,112,15133,13.596869404,11.540757445,5.2397691849,-17,1.2601976521,2.0561119586,6.4999668369
13,133,2004,195,188,165,208,17,7,182,174,15307,12.812089356,12.3521682,10.840998686,-15,1.1169513798,0.4599211564,11.957950066
13,133,2005,188,163,89,193,18,25,107,117,15424,12.235202239,10.608180664,5.7921968045,-15,1.1714555335,1.6270215743,6.963652338
13,133,2006,187,155,-57,210,17,32,-40,-14,15410,12.129467471,10.053836674,-3.697217357,-6,1.102678861,2.0756307972,-2.594538496
13,133,2007,190,159,184,241,18,31,202,233,15643,12.237142949,10.240556468,11.850706856,0,1.1593082794,1.9965864812,13.010015135
13,133,2008,188,170,-39,245,17,18,-22,-8,15635,12.021228979,10.870260247,-2.493765586,-4,1.0870260247,1.150968732,-1.406739561
13,135,2001,11060,2541,11649,6535,5781,8519,17430,25558,621901,18.157282121,4.1715781075,19.124247688,-391,9.4907095787,13.985704013,28.614957266
13,135,2002,11491,2623,9094,6459,5429,8868,14523,22971,644872,18.142161224,4.1412313019,14.357742074,-420,8.5713857179,14.000929922,22.929127792
13,135,2003,11973,2638,8402,6567,4799,9335,13201,22106,666978,18.253611312,4.021801273,12.809391318,-430,7.3163852575,14.231810039,20.125776575
13,135,2004,12810,2801,11779,6691,4346,10009,16125,25324,692302,18.84821376,4.1212995115,17.331234183,-810,6.3945618268,14.726914249,23.72579601
13,135,2005,13320,2776,10005,6931,4579,10544,14584,24516,716818,18.905416146,3.9400476893,14.200351993,-612,6.4990916317,14.965368457,20.699443624
13,135,2006,13682,2927,14421,7000,4620,10755,19041,29351,746169,18.704199012,4.0014026099,19.714460894,-445,6.3158455953,14.702796402,26.030306489
13,135,2007,13599,3127,10631,7631,4205,10472,14836,25297,771466,17.921305189,4.1208854566,14.009956281,-11,5.5415168996,13.800419732,19.55147318
13,135,2008,13584,3213,3366,7817,4212,10371,7578,18033,789499,17.404618297,4.1166842306,4.312716813,84,5.3966616804,13.287934066,9.7093784934
13,137,2001,550,352,549,1919,149,198,698,871,36989,15.046438782,9.6297208202,15.01908162,-25,4.0762170517,5.4167179613,19.095298672
13,137,2002,511,325,273,1958,145,186,418,573,37562,13.708736301,8.7188635967,7.3238454213,-31,3.8899545278,4.9898727046,11.213799949
13,137,2003,535,391,401,1969,107,144,508,621,38183,14.126344973,10.324113803,10.588157634,-31,2.8252689947,3.8022311704,13.413426629
13,137,2004,599,317,117,2030,107,282,224,477,38660,15.590229429,8.250588863,3.045170022,-29,2.7848990799,7.3396405658,5.8300691019
13,137,2005,596,309,282,1486,109,287,391,645,39305,15.288911691,7.9266337459,7.2340152633,-33,2.796126467,7.3622779452,10.03014173
13,137,2006,606,331,1126,2073,115,275,1241,1491,40796,15.130897242,8.2645659854,28.114505437,-25,2.8713748892,6.8663312568,30.985880326
13,137,2007,648,367,949,2367,102,281,1051,1333,42129,15.628580042,8.8513717214,22.888151945,1,2.4600542659,6.7772083208,25.34820621
13,137,2008,684,382,529,2319,104,302,633,927,43056,16.059165346,8.9687151494,12.420027,-8,2.4417444386,7.0904501966,14.861771439
13,139,2001,2858,1021,2245,2414,1771,1837,4016,5919,146798,19.869506426,7.0982386496,15.607782339,66,12.312419832,12.771267776,27.920202171
13,139,2002,2929,1046,1244,2504,1668,1883,2912,4826,151624,19.629920046,7.0102070223,8.3371869366,31,11.178800491,12.619713024,19.515987427
13,139,2003,2933,1068,751,2295,1478,1865,2229,4063,155687,19.088154996,6.9506135478,4.8875569049,-31,9.6189202469,12.137541448,14.506477152
13,139,2004,2935,1140,643,2164,1335,1795,1978,3812,159499,18.623923651,7.2338238374,4.0801304626,39,8.4711884411,11.390099814,12.551318904
13,139,2005,3111,1032,1938,2207,1408,2079,3346,5448,164947,19.177305314,6.3616133347,11.946518065,23,8.6794104412,12.81569198,20.625928506
13,139,2006,3016,1116,3198,2271,1403,1900,4601,6497,171444,17.93151422,6.6351358984,19.013588354,-4,8.3414835712,11.296378322,27.355071925
13,139,2007,3162,1179,3920,2244,1288,1983,5208,7176,178620,18.065268065,6.7359111477,22.395904749,-15,7.3586544175,11.329356918,29.754559166
13,139,2008,3385,1191,2749,2481,1290,2194,4039,6194,184814,18.627866408,6.554147383,15.127918687,-39,7.098950566,12.073719025,22.226869253
13,141,2001,140,95,-104,1465,0,45,-104,-70,9978,13.981823629,9.4876660342,-10.38649755,-11,0,4.4941575951,-10.38649755
13,141,2002,113,134,-230,1257,-1,-21,-231,-256,9722,11.472081218,13.604060914,-23.35025381,-4,-0.101522843,-2.131979695,-23.45177665
13,141,2003,101,108,-81,1268,-2,-7,-83,-99,9623,10.44197467,11.165675885,-8.374256914,-9,-0.206771776,-0.723701215,-8.58102869
13,141,2004,115,107,-102,1294,1,8,-101,-104,9519,12.015463379,11.179605057,-10.65719361,-11,0.1044822903,0.835858322,-10.55271132
13,141,2005,115,112,-70,1304,0,3,-70,-72,9447,12.126964041,11.810608457,-7.381630286,-5,0,0.3163555837,-7.381630286
13,141,2006,117,105,-30,1364,0,12,-30,-24,9423,12.40063593,11.128775835,-3.179650238,-6,0,1.2718600954,-3.179650238
13,141,2007,109,90,125,1560,-1,19,124,135,9558,11.48516938,9.4831673779,13.171065803,-8,-0.105368526,2.002002002,13.065697276
13,141,2008,109,110,-110,1554,0,-1,-110,-118,9440,11.474892094,11.580166333,-11.58016633,-7,0,-0.105274239,-11.58016633
13,143,2001,399,266,343,525,11,133,354,469,26302,15.306416035,10.204277357,13.158147118,-18,0.4219813945,5.1021386784,13.580128513
13,143,2002,382,283,362,353,10,99,372,456,26758,14.398793818,10.667169242,13.644930268,-15,0.3769317753,3.731624576,14.021862043
13,143,2003,389,298,461,384,9,91,470,551,27309,14.389553702,11.023359905,17.052915827,-10,0.3329202656,3.3661937966,17.385836092
13,143,2004,366,281,356,377,9,85,365,422,27731,13.299418605,10.210755814,12.936046512,-28,0.3270348837,3.0886627907,13.263081395
13,143,2005,372,305,329,409,8,67,337,379,28110,13.323543633,10.92387314,11.7834566,-25,0.2865278201,2.399670493,12.06998442
13,143,2006,402,306,54,381,10,96,64,146,28256,14.263917965,10.857609197,1.9160486818,-14,0.35482383,3.4063087677,2.2708725118
13,143,2007,399,289,348,500,8,110,356,479,28735,14.002210875,10.141952238,12.212454598,13,0.2807460827,3.8602586373,12.493200681
13,143,2008,377,316,165,407,10,61,175,244,28979,13.064421111,10.95054926,5.7178500884,8,0.346536369,2.1138718509,6.0643864574
13,145,2001,295,206,436,221,12,89,448,524,24320,12.262033419,8.562640286,18.122869731,-13,0.4987945798,3.6993931333,18.621664311
13,145,2002,285,207,569,256,6,78,575,646,24966,11.565150347,8.3999513046,23.089721219,-7,0.2434768494,3.1651990423,23.333198068
13,145,2003,289,197,677,266,-10,92,667,774,25740,11.399045478,7.7702835956,26.702954285,15,-0.394430639,3.6287618822,26.308523646
13,145,2004,310,194,686,249,17,116,703,780,26520,11.863758132,7.4244163796,26.253348641,-39,0.6505931879,4.4393417528,26.903941829
13,145,2005,301,227,757,274,8,74,765,818,27338,11.177540941,8.4295740651,28.110958446,-21,0.2970775001,2.7479668759,28.408035946
13,145,2006,321,215,834,255,13,106,847,938,28276,11.543855864,7.7318660769,29.992447945,-15,0.4675081814,3.8119897867,30.459956126
13,145,2007,351,220,591,272,6,131,597,738,29014,12.253447373,7.6802234247,20.631872927,10,0.2094606389,4.5732239483,20.841333566
13,145,2008,359,232,286,257,10,127,296,433,29447,12.281692068,7.9369152084,9.7843006449,10,0.3421084142,4.3447768598,10.126409059
13,147,2001,289,288,-64,537,12,1,-52,-73,22980,12.556209676,12.512762583,-2.780613907,-22,0.5213651076,0.0434470923,-2.2592488
13,147,2002,268,264,137,530,12,4,149,135,23115,11.628159236,11.454604621,5.9442455798,-18,0.5206638464,0.1735546155,6.4649094262
13,147,2003,280,265,3,324,11,15,14,-5,23110,12.114656571,11.465657112,0.1297998918,-34,0.4759329367,0.6489994592,0.6057328286
13,147,2004,280,304,491,681,14,-24,505,448,23558,11.999657153,13.028199194,21.042255936,-33,0.5999828576,-1.028542042,21.642238793
13,147,2005,294,247,261,698,12,47,273,300,23858,12.400877341,10.418424161,11.008942129,-20,0.5061582588,1.9824531804,11.515100388
13,147,2006,261,288,282,712,13,-27,295,257,24115,10.88112063,12.006753799,11.756613095,-11,0.5419715256,-1.125633169,12.298584621
13,147,2007,261,281,48,714,12,-20,60,43,24158,10.813498229,11.642118783,1.9886893294,3,0.4971723324,-0.828620554,2.4858616618
13,147,2008,278,270,97,718,13,8,110,120,24278,11.479065158,11.148732348,4.005285325,2,0.5367908167,0.3303328103,4.5420761417
13,149,2001,171,99,16,106,2,72,18,78,11163,15.372168285,8.8996763754,1.4383315354,-12,0.1797914419,6.4724919094,1.6181229773
13,149,2002,137,99,3,109,1,38,4,31,11194,12.255669365,8.8562866216,0.2683723219,-11,0.0894574406,3.3993827437,0.3578297625
13,149,2003,143,103,-123,116,1,40,-122,-89,11105,12.825687251,9.2380824252,-11.03188484,-7,0.0896901206,3.5876048253,-10.94219472
13,149,2004,141,116,52,113,2,25,54,72,11177,12.65595548,10.411991742,4.6674445741,-7,0.179517099,2.2439637375,4.8469616731
13,149,2005,133,103,34,112,2,30,36,56,11233,11.869701026,9.192324855,3.0343596609,-10,0.1784917448,2.6773761714,3.2128514056
13,149,2006,136,95,61,118,2,41,63,98,11331,12.054600248,8.4204928204,5.4068427584,-6,0.1772735331,3.6341074278,5.5841162914
13,149,2007,133,101,3,130,0,32,3,34,11365,11.720126895,8.9002467395,0.2643637645,-1,0,2.8198801551,0.2643637645
13,149,2008,135,92,69,132,0,43,69,111,11476,11.820848474,8.0556893306,6.0417669979,-1,0,3.7651591436,6.0417669979
13,151,2001,2016,747,7480,774,100,1269,7580,8880,130460,15.997460721,5.9276305348,59.355657832,31,0.7935248373,10.069830186,60.149182669
13,151,2002,2192,760,7736,961,80,1432,7816,9336,139796,16.221656503,5.6242969629,57.24942277,88,0.5920312593,10.597359541,57.841454029
13,151,2003,2328,838,7763,898,32,1490,7795,9659,149455,16.096746424,5.79427556,53.676564645,374,0.2212611192,10.302470864,53.897825764
13,151,2004,2559,847,7027,1025,103,1712,7130,8499,157954,16.64882941,5.5105738609,45.717594475,-343,0.6701170102,11.138255549,46.387711485
13,151,2005,2611,884,7330,981,84,1727,7414,9020,166974,16.071252708,5.4412054363,45.117687611,-121,0.5170376206,10.630047272,45.634725231
13,151,2006,2798,951,8306,1229,103,1847,8409,10142,177116,16.263186957,5.5276235869,48.278066785,-114,0.5986805778,10.73556337,48.876747363
13,151,2007,3026,1004,6148,1154,75,2022,6223,8251,185367,16.695955397,5.5395701316,33.921590806,6,0.4138125098,11.156385265,34.335403315
13,151,2008,3318,1047,3828,1288,83,2271,3911,6135,191502,17.608240529,5.5563073641,20.31475128,-47,0.4404713574,12.051933165,20.755222637
13,153,2001,1668,774,1137,2846,104,894,1241,2025,113274,14.858165979,6.8946165872,10.12813832,-110,0.9264084303,7.9635493914,11.05454675
13,153,2002,1659,864,2488,2842,-152,795,2336,3090,116364,14.448828156,7.5248869961,21.668887553,-41,-1.323822712,6.9239411596,20.345064841
13,153,2003,1766,841,3295,3083,-713,925,2582,3595,119959,14.945646425,7.1173774876,27.885563403,88,-6.034114327,7.828268937,21.851449076
13,153,2004,1856,819,2470,3429,453,1037,2923,3801,123760,15.230654976,6.7208547549,20.269244499,-159,3.7173958534,8.5098002207,23.986640352
13,153,2005,1922,867,1042,2949,62,1055,1104,2042,125802,15.402986032,6.9481731994,8.3506303043,-117,0.4968705171,8.4548128321,8.8475008214
13,153,2006,1972,865,869,3000,273,1107,1142,2184,127986,15.540529891,6.8167131622,6.8482355352,-65,2.1514019575,8.7238167289,8.9996374927
13,153,2007,2020,899,1804,2812,28,1121,1832,2986,130972,15.600985488,6.9432108682,13.932761297,33,0.216251284,8.6577746198,14.149012581
13,153,2008,2024,940,974,2857,124,1084,1098,2189,133161,15.325612476,7.1176263473,7.3750724067,7,0.9389209224,8.2079861282,8.3139933291
13,155,2001,126,111,3,364,18,15,21,25,9984,12.636012636,11.131725417,0.3008574437,-11,1.8051446623,1.5042872186,2.106002106
13,155,2002,150,128,-52,374,18,22,-34,-21,9963,15.039855617,12.834010127,-5.213816614,-9,1.8047826741,2.2058454905,-3.40903394
13,155,2003,115,114,38,448,17,1,55,46,10009,11.516122572,11.415982375,3.8053274584,-10,1.7023833367,0.1001401963,5.5077107951
13,155,2004,127,110,-331,375,15,17,-316,-314,9695,12.890783597,11.165245635,-33.59723914,-15,1.5225334957,1.7255379618,-32.07470564
13,155,2005,122,113,400,750,16,9,416,415,10110,12.320121182,11.411259783,40.393839939,-10,1.6157535976,0.9088613986,42.009593537
13,155,2006,109,92,74,865,15,17,89,100,10210,10.728346457,9.0551181102,7.2834645669,-6,1.4763779528,1.6732283465,8.7598425197
13,155,2007,116,99,-350,557,16,17,-334,-306,9904,11.534254748,9.843889828,-34.8016307,11,1.5909316894,1.69036492,-33.21069902
13,155,2008,109,91,293,923,15,18,308,327,10231,10.826918301,9.0389868388,29.103551031,1,1.4899428855,1.7879314626,30.593493916
13,157,2001,663,405,1422,843,64,258,1486,1728,43621,15.506232898,9.472133218,33.257712187,-16,1.4968309283,6.0340996796,34.754543116
13,157,2002,699,385,1460,909,63,314,1523,1832,45453,15.694815547,8.6444978333,32.781732043,-5,1.4145541909,7.0503177134,34.196286234
13,157,2003,733,395,1085,1008,51,338,1136,1479,46932,15.868376901,8.551171727,23.488661579,5,1.1040753369,7.317205174,24.592736916
13,157,2004,793,467,2073,1029,51,326,2124,2355,49287,16.483230963,9.7070225215,43.089202756,-95,1.0600816886,6.7762084412,44.149284445
13,157,2005,768,432,2281,1031,50,336,2331,2636,51923,15.176365972,8.5367058591,45.074597372,-31,0.9880446596,6.6396601126,46.062642031
13,157,2006,899,439,3031,1026,54,460,3085,3507,55430,16.748483973,8.1786256555,56.467914264,-38,1.006026846,8.5698583179,57.47394111
13,157,2007,1028,447,3039,1036,45,581,3084,3667,59097,17.952098632,7.8060195412,53.070455002,2,0.7858408934,10.146079091,53.856295895
13,157,2008,1103,494,1906,974,46,609,1952,2523,61620,18.274145315,8.184431356,31.577988187,-38,0.7621130412,10.089713959,32.340101228
13,159,2001,158,114,97,80,11,44,108,141,11628,13.670776552,9.863724854,8.3928185161,-11,0.9517629245,3.807051698,9.3445814406
13,159,2002,174,106,317,62,11,68,328,394,12022,14.714587738,8.9640591966,26.807610994,-2,0.9302325581,5.7505285412,27.737843552
13,159,2003,184,102,311,81,10,82,321,411,12433,15.048047434,8.3418523819,25.434471478,8,0.8178286649,6.7061950521,26.252300143
13,159,2004,176,132,131,69,9,44,140,171,12604,14.059192395,10.544394296,10.464512521,-13,0.7189359748,3.5147980988,11.183448496
13,159,2005,215,108,303,69,10,107,313,408,13012,16.78638351,8.4322298563,23.657089319,-12,0.7807620237,8.354153654,24.437851343
13,159,2006,167,105,321,74,9,62,330,385,13397,12.647203605,7.9518346018,24.309894354,-7,0.681585823,4.695369003,24.991480177
13,159,2007,185,106,147,74,10,79,157,237,13634,13.687987866,7.8428471015,10.876401169,1,0.739891236,5.8451407643,11.616292405
13,159,2008,184,106,121,69,9,78,130,208,13842,13.393507061,7.7158247198,8.8076867084,0,0.6551171932,5.677682341,9.4628039016
13,161,2001,228,166,-85,102,33,62,-52,-2,12721,17.921710423,13.048262852,-6.681339412,-12,2.5939317717,4.8734475711,-4.08740764
13,161,2002,220,146,-26,93,32,74,6,68,12789,17.248137985,11.446491572,-2.038416307,-12,2.5088200706,5.8016464132,0.4704037632
13,161,2003,204,164,-50,89,31,40,-19,4,12793,15.948713939,12.821515128,-3.908998515,-17,2.423579079,3.1271988117,-1.485419436
13,161,2004,231,158,-30,87,27,73,-3,60,12853,18.014505186,12.321609608,-2.339546128,-10,2.1055915152,5.6928955783,-0.233954613
13,161,2005,224,152,62,92,31,72,93,154,13007,17.324052591,11.755607115,4.7950502707,-11,2.3975251353,5.5684454756,7.192575406
13,161,2006,239,141,52,105,31,98,83,174,13181,18.252634795,10.76829082,3.9712845578,-7,2.3674965633,7.4843439743,6.3387811211
13,161,2007,250,142,-54,108,26,108,-28,79,13260,18.910026096,10.740894822,-4.084565637,-1,1.966642714,8.1691312734,-2.117922923
13,161,2008,240,148,107,103,26,92,133,226,13486,17.946608839,11.067075451,8.0011964406,1,1.9442159575,6.8795333882,9.9454123981
13,163,2001,278,211,-223,494,4,67,-219,-164,17082,16.196690748,12.293171755,-12.99230948,-12,0.23304591,3.9035189932,-12.75926357
13,163,2002,270,206,-132,485,4,64,-128,-79,17003,15.842746076,12.087428488,-7.745342526,-15,0.2347073493,3.7553175884,-7.510635177
13,163,2003,271,215,-200,485,2,56,-198,-159,16844,16.013236033,12.704227849,-11.81788637,-17,0.1181788637,3.3090081839,-11.69970751
13,163,2004,284,189,-169,473,3,95,-166,-85,16759,16.903252686,11.248995625,-10.05862572,-14,0.1785554861,5.6542570604,-9.880070232
13,163,2005,231,181,-173,474,3,50,-170,-135,16624,13.839379325,10.843842674,-10.36455681,-15,0.179732199,2.9955366504,-10.18482461
13,163,2006,246,200,-143,546,3,46,-140,-101,16523,14.842972215,12.067457085,-8.628231816,-7,0.1810118563,2.7755151296,-8.44721996
13,163,2007,261,224,-147,544,3,37,-144,-108,16415,15.847956767,13.601311555,-8.925860708,-1,0.1821604226,2.2466452122,-8.743700285
13,163,2008,250,203,-28,544,3,47,-25,28,16443,15.216994339,12.356199403,-1.704303366,6,0.1826039321,2.8607949358,-1.521699434
13,165,2001,150,82,-61,132,16,68,-45,13,8607,17.440846462,9.5343293995,-7.092610895,-10,1.860356956,7.906517063,-5.232253939
13,165,2002,124,107,-44,136,13,17,-31,-21,8586,14.424475077,12.446926075,-5.118362124,-7,1.5122433549,1.9775490025,-3.606118769
13,165,2003,127,104,-53,124,13,23,-40,-28,8558,14.815678955,12.132524498,-6.182921139,-11,1.5165655623,2.6831544564,-4.666355576
13,165,2004,109,88,-46,119,12,21,-34,-20,8538,12.751520824,10.294805803,-5.38137576,-7,1.4038371549,2.4567150211,-3.977538606
13,165,2005,133,103,3,128,13,30,16,39,8577,15.54192229,12.036225533,0.3505696757,-7,1.5191352615,3.5056967572,1.8697049372
13,165,2006,141,95,-4,124,12,46,8,50,8627,16.391536852,11.043943269,-0.465008138,-4,1.3950244129,5.3475935829,0.9300162753
13,165,2007,127,77,-102,128,10,50,-92,-39,8588,14.754574499,8.945686901,-11.8501307,3,1.1617775196,5.808887598,-10.68835318
13,165,2008,120,84,-88,132,9,36,-79,-41,8547,14.006419609,9.8044937263,-10.27137438,2,1.0504814707,4.2019258827,-9.220892909
13,167,2001,110,113,-75,536,2,-3,-73,-82,8476,12.915345779,13.267582482,-8.805917577,-6,0.2348244687,-0.352236703,-8.571093108
13,167,2002,120,97,416,974,2,23,418,446,8922,13.794689045,11.150706978,47.821588688,5,0.2299114841,2.6439820669,48.051500172
13,167,2003,104,97,-8,1060,1,7,-7,-14,8908,11.665731913,10.880538418,-0.897363993,-14,0.1121704992,0.7851934941,-0.785193494
13,167,2004,113,99,116,1178,2,14,118,123,9031,12.598249624,11.037404538,12.932716428,-9,0.2229778694,1.5608450861,13.155694297
13,167,2005,106,114,-119,1157,2,-8,-117,-130,8901,11.82244033,12.714699978,-13.27236226,-5,0.2230649119,-0.892259648,-13.04929735
13,167,2006,122,99,86,1242,2,23,88,107,9008,13.624434642,11.055893685,9.6041096655,-4,0.2233513876,2.5685409571,9.8274610531
13,167,2007,120,95,478,1754,1,25,479,507,9515,12.956864439,10.257517681,51.611510015,3,0.1079738703,2.6993467581,51.719483885
13,167,2008,115,88,12,1815,1,27,13,35,9550,12.063991608,9.2315761867,1.2588512982,-5,0.1049042748,2.8324154209,1.363755573
13,169,2001,326,185,326,387,10,141,336,460,24160,13.62306728,7.7308817384,13.62306728,-17,0.4178854994,5.8921855412,14.040952779
13,169,2002,331,179,369,409,10,152,379,517,24677,13.555296189,7.3305076069,15.111493335,-14,0.4095255646,6.2247885824,15.5210189
13,169,2003,331,206,581,411,7,125,588,722,25399,13.219905743,8.2274942088,23.204728812,9,0.2795750459,4.9924115345,23.484303858
13,169,2004,321,190,599,433,11,131,610,706,26105,12.465051258,7.3780677229,23.260329295,-35,0.4271512892,5.0869835353,23.687480584
13,169,2005,356,221,432,454,9,135,441,553,26658,13.494304721,8.3770824252,16.375111347,-23,0.3411481531,5.1172222959,16.7162595
13,169,2006,346,193,105,433,11,153,116,255,26913,12.917436673,7.2053909765,3.9200313603,-14,0.410669952,5.7120456964,4.3307013123
13,169,2007,252,201,180,437,9,51,189,248,27161,9.3205607131,7.4342567593,6.6575433665,8,0.3328771683,1.8863039538,6.9904205348
13,169,2008,279,217,296,421,11,62,307,381,27542,10.200537448,7.9337513482,10.822075572,12,0.4021717273,2.2667860995,11.224247299
13,171,2001,221,156,303,982,12,65,315,372,16342,13.679128497,9.6558554098,18.754642238,-8,0.7427581084,4.0232730874,19.497400347
13,171,2002,198,180,-219,622,11,18,-208,-203,16139,12.191742865,11.083402605,-13.4848065,-13,0.6773190481,1.1083402605,-12.80748745
13,171,2003,186,153,89,619,4,33,93,108,16247,11.48644476,9.4485271414,5.4962020626,-18,0.2470203174,2.0379176187,5.74322238
13,171,2004,193,173,38,627,5,20,43,52,16299,11.860136422,10.631106741,2.335156394,-11,0.3072574203,1.2290296811,2.6424138143
13,171,2005,229,180,243,866,5,49,248,282,16581,13.929440389,10.948905109,14.781021898,-15,0.304136253,2.9805352798,15.085158151
13,171,2006,213,203,4,826,5,10,9,12,16593,12.841381805,12.23850003,0.24115271,-7,0.3014408874,0.6028817749,0.5425935974
13,171,2007,221,162,260,836,4,59,264,316,16909,13.193242194,9.6710644141,15.521461405,-7,0.2387917139,3.5221777804,15.760253119
13,171,2008,230,168,40,771,4,62,44,91,17000,13.565720015,9.9088737503,2.3592556548,-15,0.2359255655,3.656846265,2.5951812203
13,173,2001,72,70,-151,272,6,2,-145,-147,7105,10.029950547,9.7513408094,-21.03503517,-4,0.8358292122,0.2786097374,-20.19920596
13,173,2002,90,62,30,268,2,28,32,53,7158,12.620065905,8.6938231789,4.2066886349,-7,0.280445909,3.9262427259,4.4871345439
13,173,2003,113,60,157,257,-11,53,146,200,7358,15.56902728,8.2667401488,21.631303389,1,-1.515569027,7.3022871314,20.115734362
13,173,2004,130,88,-96,267,13,42,-83,-48,7310,17.725661304,11.99890919,-13.08971912,-7,1.7725661304,5.7267521134,-11.31715299
13,173,2005,107,62,52,198,4,45,56,95,7405,14.54298335,8.4267753993,7.0676180768,-6,0.543662929,6.1162079511,7.6112810058
13,173,2006,118,68,182,261,10,50,192,237,7642,15.684189539,9.0383465143,24.190868612,-5,1.329168605,6.6458430252,25.520037217
13,173,2007,104,57,245,279,2,47,247,296,7938,13.350449294,7.3170731707,31.450577664,2,0.2567394095,6.0333761232,31.707317073
13,173,2008,111,59,281,266,5,52,286,339,8277,13.691026827,7.2772124576,34.659266112,1,0.6167129201,6.4138143694,35.275979032
13,175,2001,672,450,-23,1342,31,222,8,183,45141,14.916924716,9.9890120867,-0.510549507,-47,0.6881319438,4.9279126294,0.1775824371
13,175,2002,659,443,263,1467,27,216,290,462,45603,14.524376267,9.7637309354,5.7965264921,-44,0.5950806665,4.7606453319,6.3916071586
13,175,2003,688,518,458,1599,13,170,471,599,46202,14.988290398,11.28478841,9.9776700615,-42,0.2832089755,3.7035019879,10.260879037
13,175,2004,678,523,-124,1537,31,155,-93,31,46233,14.669767945,11.316059934,-2.682966409,-31,0.6707416022,3.353708011,-2.012224807
13,175,2005,701,486,194,1525,25,215,219,390,46623,15.098647368,10.467821142,4.1785129663,-44,0.5384681658,4.6308262256,4.7169811321
13,175,2006,709,468,182,1540,28,241,210,428,47051,15.137604885,9.9921002626,3.8858167688,-23,0.5978179644,5.1455046224,4.4836347332
13,175,2007,720,500,102,1475,23,220,125,319,47370,15.250844621,10.59086432,2.1605363214,-26,0.4871797587,4.659980301,2.6477160801
13,175,2008,714,496,206,1434,26,218,232,478,47848,14.997164402,10.41819824,4.3269129786,28,0.5461152303,4.5789661619,4.873028209
13,177,2001,325,135,249,866,21,190,270,1863,26745,12.590311271,5.229821605,9.6461154047,1403,0.8135278052,7.3604896663,10.45964321
13,177,2002,338,126,287,843,18,212,305,982,27727,12.410045528,4.6262299897,10.537523865,465,0.6608899985,7.7838155383,11.198413864
13,177,2003,296,138,298,878,6,158,304,1110,28837,10.466020791,4.8794286118,10.536737147,648,0.2121490701,5.5865921788,10.748886217
13,177,2004,341,148,883,899,22,193,905,1082,29919,11.607325209,5.0377833753,30.056504868,-16,0.7488596909,6.569541834,30.805364559
13,177,2005,331,135,728,884,17,196,745,945,30864,10.891203132,4.4420314891,23.954066104,4,0.5593669283,6.4491716434,24.513433032
13,177,2006,340,163,1057,901,20,177,1077,1256,32120,10.796392735,5.1759176934,33.564079766,2,0.6350819256,5.6204750413,34.199161692
13,177,2007,352,150,637,919,14,202,651,859,32979,10.814298223,4.6083657199,19.570193091,6,0.4301141339,6.2059325028,20.000307224
13,177,2008,368,156,546,910,17,212,563,782,33761,11.027869344,4.6748576566,16.362001798,7,0.5094396164,6.3530116871,16.871441414
13,179,2001,1434,284,-2165,3668,-10,1150,-2175,-1031,60410,23.536942659,4.6614307638,-35.53520283,-6,-0.164134886,18.875511896,-35.69933772
13,179,2002,1420,266,576,4285,-570,1154,6,1115,61525,23.291097716,4.3629802764,9.4476565383,-45,-9.349243449,18.92811744,0.0984130889
13,179,2003,1385,266,-101,5353,-1796,1119,-1897,-863,60662,22.670169494,4.3539820112,-1.653203696,-85,-29.39756275,18.316187483,-31.05076645
13,179,2004,1281,294,-406,4624,856,987,450,1385,62047,20.878664157,4.7918245605,-6.617281536,-52,13.951706884,16.086839596,7.3344253478
13,179,2005,1514,272,-253,7663,-46,1242,-299,889,62936,24.227294912,4.3525919525,-4.048550603,-54,-0.73610011,19.87470296,-4.784650712
13,179,2006,1062,282,-3832,3833,446,780,-3386,-2616,60320,17.232426819,4.5758421497,-62.17952879,-10,7.2369702083,12.656584669,-54.94255858
13,179,2007,1413,333,-890,3861,-90,1080,-980,110,60430,23.403726708,5.5155279503,-14.74120083,10,-1.49068323,17.888198758,-16.23188406
13,179,2008,1297,298,-3100,2902,125,999,-2975,-1939,58491,21.812800094,5.0117304765,-52.13545127,37,2.1022359381,16.801069618,-50.03321533
13,181,2001,88,99,46,79,-1,-11,45,26,8377,10.521281683,11.836441894,5.49976088,-8,-0.119560019,-1.31516021,5.3802008608
13,181,2002,91,97,-6,74,-3,-6,-9,-23,8354,10.878010878,11.595242364,-0.717231486,-8,-0.358615743,-0.717231486,-1.07584723
13,181,2003,76,101,11,80,-7,-25,4,-33,8321,9.1154422789,12.113943028,1.3193403298,-12,-0.83958021,-2.99850075,0.4797601199
13,181,2004,78,99,-86,64,3,-21,-83,-111,8210,9.4368156796,11.977496824,-10.40469421,-7,0.3629544492,-2.540681145,-10.04173976
13,181,2005,94,76,-48,58,-1,18,-49,-38,8172,11.476010255,9.2784763765,-5.860090343,-7,-0.122085215,2.1975338786,-5.982175559
13,181,2006,77,101,-18,63,1,-24,-17,-45,8127,9.4484324192,12.393398368,-2.208724462,-4,0.1227069145,-2.944965949,-2.086017547
13,181,2007,84,74,-55,61,-1,10,-56,-45,8082,10.364612252,9.1307298414,-6.786353261,1,-0.123388241,1.233882411,-6.909741502
13,181,2008,84,87,-10,54,1,-3,-9,-8,8074,10.398613518,10.769992572,-1.237930181,4,0.1237930181,-0.371379054,-1.114137163
13,183,2001,172,69,-85,29,40,103,-45,46,10397,16.579911317,6.6512434933,-8.193560825,-12,3.8557933295,9.9286678234,-4.337767496
13,183,2002,153,52,68,1,10,101,78,169,10566,14.597147355,4.9611219768,6.4876210466,-10,0.9540619186,9.636025378,7.4416829652
13,183,2003,154,58,-123,27,-63,96,-186,-98,10468,14.642959019,5.5148806694,-11.69535039,-8,-5.990301417,9.1280783493,-17.6856518
13,183,2004,153,72,117,26,80,81,197,267,10735,14.431920011,6.79149177,11.036174126,-11,7.5461019667,7.6404282413,18.582276093
13,183,2005,186,63,5,47,32,123,37,151,10886,17.205494658,5.8276675454,0.4625132973,-9,2.9600851024,11.377827113,3.4225983997
13,183,2006,135,64,133,66,58,71,191,256,11142,12.257127293,5.810786272,12.075540222,-6,5.266025059,6.4463410205,17.341565281
13,183,2007,190,65,7,68,23,125,30,154,11296,16.935555754,5.7937427578,0.6239415278,-1,2.0500935912,11.141812996,2.674035119
13,183,2008,149,69,42,68,36,80,78,156,11452,13.100052752,6.0664673817,3.6926323193,-2,3.1651134166,7.0335853701,6.8577457359
13,185,2001,1428,695,-420,6767,61,733,-359,289,92524,15.457974984,7.5233141552,-4.54646323,-85,0.6603196597,7.9346608284,-3.886143571
13,185,2002,1369,667,1183,7015,-74,702,1109,1749,94273,14.657622981,7.1414423144,12.666156309,-62,-0.792303945,7.5161806667,11.873852364
13,185,2003,1455,744,549,6836,-369,711,180,782,95055,15.370151272,7.8593763205,5.7994591397,-109,-3.897997127,7.5107749514,1.901462013
13,185,2004,1617,737,879,6966,250,880,1129,1920,96975,16.841118575,7.6758839765,9.1548195594,-89,2.6037598292,9.1652345988,11.758579389
13,185,2005,1532,700,772,7183,37,832,809,1558,98533,15.671992962,7.1608322933,7.8973750435,-83,0.3785011355,8.5111606686,8.275876179
13,185,2006,1719,727,719,7542,150,992,869,1807,100340,17.287414581,7.3111986041,7.2307452495,-54,1.5085003998,9.976215977,8.7392456492
13,185,2007,1792,796,320,7528,23,996,343,1299,101639,17.744418974,7.8820075354,3.1686462454,-40,0.2277464489,9.8624114388,3.3963926943
13,185,2008,1839,781,1825,7863,74,1058,1899,2944,104583,17.835148529,7.5743616103,17.699372521,-13,0.7176731871,10.260786919,18.417045708
13,187,2001,295,162,587,1390,36,133,623,750,21914,13.696086169,7.5212405404,27.252890106,-6,1.6713867868,6.1748456289,28.924276893
13,187,2002,310,151,547,1437,25,159,572,724,22638,13.9163225,6.7785957982,24.555575507,-7,1.1222840725,7.1377267014,25.67785958
13,187,2003,318,165,734,1607,-5,153,729,904,23542,13.772195756,7.145950628,31.788653097,22,-0.216543958,6.6262451278,31.572109138
13,187,2004,298,206,442,1680,44,92,486,548,24090,12.512596574,8.6496472959,18.558951965,-30,1.8474974807,3.8629492778,20.406449446
13,187,2005,330,166,536,1617,27,164,563,711,24801,13.499417071,6.7906158598,21.926325909,-16,1.1044977603,6.7088012109,23.030823669
13,187,2006,297,207,945,1635,36,90,981,1054,25855,11.726152874,8.1727732154,37.310486418,-17,1.4213518636,3.5533796589,38.731838282
13,187,2007,330,201,520,1698,23,129,543,656,26511,12.603597754,7.676736814,19.860214643,-16,0.8784325708,4.9268609403,20.738647214
13,187,2008,326,203,409,1629,28,123,437,545,27056,12.171672858,7.5792932216,15.270595703,-15,1.0454197547,4.5923796367,16.316015457
13,189,2001,356,251,-48,297,6,105,-42,44,21295,16.734828186,11.79899403,-2.256381328,-19,0.2820476661,4.935834156,-1.974333662
13,189,2002,296,229,-176,341,4,67,-172,-123,21172,13.940235948,10.784844703,-8.288788942,-18,0.1883815669,3.155391245,-8.100407375
13,189,2003,287,277,31,335,-3,10,28,9,21181,13.552758955,13.080537388,1.4638868557,-29,-0.14166647,0.4722215664,1.3222203858
13,189,2004,339,238,-10,384,6,101,-4,83,21264,15.973612911,11.214512899,-0.471198021,-14,0.2827188126,4.7591000118,-0.188479208
13,189,2005,331,234,47,411,3,97,50,127,21391,15.519868714,10.971750088,2.2037275818,-20,0.1406634627,4.5481186262,2.3443910444
13,189,2006,339,227,37,368,5,112,42,143,21534,15.794991264,10.57658707,1.7239370996,-11,0.2329644729,5.2184041934,1.9569015725
13,189,2007,333,244,-122,374,2,89,-120,-30,21504,15.47469678,11.33881686,-5.66940843,1,0.0929411218,4.1358799201,-5.576467308
13,189,2008,337,255,160,389,4,82,164,252,21756,15.580212668,11.789181692,7.3971336107,6,0.1849283403,3.7910309755,7.582061951
13,191,2001,157,99,138,160,0,58,138,189,11087,14.282465317,9.0061405504,12.554014101,-7,0,5.2763247669,12.554014101
13,191,2002,149,126,-185,9,0,23,-185,-169,10918,13.542376733,11.45194274,-16.81436037,-7,0,2.0904339923,-16.81436037
13,191,2003,147,105,-9,107,-1,42,-10,16,10934,13.454146074,9.6101043383,-0.823723229,-16,-0.091524803,3.8440417353,-0.915248032
13,191,2004,129,108,21,104,2,21,23,36,10970,11.778670562,9.8612125639,1.9174579985,-8,0.1826150475,1.9174579985,2.100073046
13,191,2005,137,113,-77,123,0,24,-77,-61,10909,12.523424288,10.329539741,-7.038712921,-8,0,2.1938845468,-7.038712921
13,191,2006,140,110,191,127,1,30,192,216,11125,12.707633657,9.984569302,17.336843061,-6,0.0907688118,2.7230643551,17.427611873
13,191,2007,150,106,254,120,0,44,254,291,11416,13.30908123,9.405084069,22.536710882,-7,0,3.9039971607,22.536710882
13,191,2008,142,119,30,133,2,23,32,39,11455,12.417471908,10.406191247,2.623409558,-16,0.1748939705,2.0112806611,2.7983035285
13,193,2001,250,161,-67,989,20,89,-47,29,14064,17.794227553,11.459482544,-4.768852984,-13,1.4235382042,6.3347450087,-3.34531478
13,193,2002,185,143,-127,991,18,42,-109,-77,13987,13.190260597,10.195714948,-9.054935653,-10,1.2833767067,2.994545649,-7.771558946
13,193,2003,193,141,-163,979,11,52,-152,-113,13874,13.854491942,10.12167546,-11.70094397,-13,0.7896342558,3.7328164818,-10.91130972
13,193,2004,179,140,-178,959,14,39,-164,-138,13736,12.966316552,10.141253169,-12.89387903,-13,1.0141253169,2.8250633828,-11.87975371
13,193,2005,177,167,-218,932,12,10,-206,-202,13534,12.98129813,12.247891456,-15.98826549,-6,0.8800880088,0.733406674,-15.10817748
13,193,2006,176,169,-13,1058,13,7,0,0,13534,13.004285503,12.487069602,-0.960543816,-7,0.9605438156,0.5172159007,0
13,193,2007,187,176,-59,1102,11,11,-48,-50,13484,13.842623436,13.028351469,-4.367458731,-13,0.8142719668,0.8142719668,-3.553186764
13,193,2008,186,159,12,1110,12,27,24,36,13520,13.775736928,11.77603318,0.8887572212,-15,0.8887572212,1.9997037476,1.7775144423
13,195,2001,362,242,123,162,28,120,151,248,26106,13.932722654,9.3141405588,4.7340466477,-23,1.0776691556,4.6185820953,5.8117158032
13,195,2002,353,234,350,164,27,119,377,482,26588,13.398109842,8.8814665806,13.284244886,-14,1.0247846055,4.5166432611,14.309029491
13,195,2003,379,239,204,166,20,140,224,340,26928,14.16398834,8.9319082144,7.623888183,-24,0.7474400179,5.2320801256,8.3713282009
13,195,2004,338,274,-59,212,19,64,-40,6,26934,12.550592254,10.174148751,-2.190783855,-18,0.7055066652,2.3764435038,-1.48527719
13,195,2005,332,234,177,213,21,98,198,276,27210,12.263593381,8.6436170213,6.5381205674,-20,0.7757092199,3.6199763593,7.3138297872
13,195,2006,334,251,232,198,21,83,253,321,27531,12.202919201,9.1704572441,8.4762792057,-15,0.7672494109,3.0324619572,9.2435286166
13,195,2007,354,239,281,201,18,115,299,410,27941,12.763195847,8.6169599077,10.131237381,-4,0.64897606,4.1462359389,10.780213441
13,195,2008,356,254,136,208,18,102,154,259,28200,12.68235336,9.048645375,4.8449439803,3,0.6412425856,3.6337079853,5.486186566
13,197,2001,95,73,-78,98,28,22,-50,-34,7144,13.266303589,10.194106968,-10.89233347,-6,3.9100684262,3.0721966206,-6.982265047
13,197,2002,104,77,-115,86,27,27,-88,-68,7076,14.627285513,10.829817159,-16.17440225,-7,3.7974683544,3.7974683544,-12.3769339
13,197,2003,82,93,-52,91,16,-11,-36,-55,7021,11.633680925,13.194296659,-7.377456196,-8,2.269986522,-1.560615734,-5.107469674
13,197,2004,113,80,-75,95,19,33,-56,-30,6991,16.129032258,11.4187839,-10.70510991,-7,2.7119611761,4.7102483585,-7.99314873
13,197,2005,118,76,-48,101,18,42,-30,8,6999,16.86919228,10.864903503,-6.862044317,-4,2.573266619,6.0042887777,-4.288777698
13,197,2006,88,83,-7,100,20,5,13,14,7013,12.560662289,11.846988296,-0.999143591,-4,2.8546959749,0.7136739937,1.8555523837
13,197,2007,104,56,-87,92,16,48,-71,-33,6980,14.864575145,8.004002001,-12.43478882,-10,2.2868577146,6.8605731437,-10.14793111
13,197,2008,107,78,-54,104,18,29,-36,-16,6964,15.347102697,11.187607573,-7.745266781,-9,2.5817555938,4.1594951234,-5.163511188
13,199,2001,306,232,8,440,1,74,9,62,22589,13.565032361,10.284599699,0.3546413689,-21,0.0443301711,3.2804326625,0.39897154
13,199,2002,350,262,202,473,1,88,203,275,22864,15.400523618,11.528391965,8.8883022023,-16,0.0440014961,3.8721316525,8.9323036983
13,199,2003,313,261,-149,431,0,52,-149,-124,22740,13.726866064,11.446364354,-6.534514516,-27,0,2.2805017104,-6.534514516
13,199,2004,307,281,53,519,1,26,54,65,22805,13.481172467,12.339444505,2.3273685366,-15,0.0439126139,1.1417279614,2.3712811505
13,199,2005,326,280,-19,469,1,46,-18,7,22812,14.292917114,12.276125129,-0.833022777,-21,0.043843304,2.0167919854,-0.789179473
13,199,2006,305,251,108,485,1,54,109,151,22963,13.326051338,10.966684872,4.7187329328,-12,0.0436919716,2.3593664664,4.7624249044
13,199,2007,308,250,-295,460,1,58,-294,-222,22741,13.478032557,10.939961491,-12.90915456,14,0.043759846,2.538071066,-12.86539471
13,199,2008,298,281,66,435,1,17,67,99,22840,13.075623615,12.329698778,2.8959434852,15,0.0438779316,0.7459248371,2.9398214168
13,201,2001,101,74,-7,133,2,27,-5,14,6383,15.840652447,11.606022585,-1.097867001,-8,0.3136762861,4.234629862,-0.784190715
13,201,2002,84,80,-34,140,2,4,-32,-33,6350,13.194062672,12.565773973,-5.340453939,-5,0.3141443493,0.6282886987,-5.026309589
13,201,2003,79,93,-97,144,2,-14,-95,-110,6240,12.549642573,14.773629865,-15.40905481,-1,0.3177124702,-2.223987292,-15.09134234
13,201,2004,90,94,-90,142,1,-4,-89,-101,6139,14.540754504,15.187010259,-14.5407545,-8,0.1615639389,-0.646255756,-14.37919056
13,201,2005,77,69,-51,141,2,8,-49,-45,6094,12.58889888,11.280961334,-8.338101856,-4,0.3269843865,1.307937546,-8.011117469
13,201,2006,78,81,30,165,1,-3,31,25,6119,12.77327438,13.264554164,4.9127978384,-3,0.1637599279,-0.491279784,5.0765577663
13,201,2007,100,68,8,164,2,32,10,37,6156,16.293279022,11.079429735,1.3034623218,-5,0.3258655804,5.2138492872,1.6293279022
13,201,2008,89,69,11,170,1,20,12,29,6185,14.423466494,11.182238068,1.7826756341,-3,0.1620614213,3.2412284256,1.9447370553
13,205,2001,358,242,-184,1912,26,116,-158,-62,23920,14.947183834,10.103962256,-7.682351468,-20,1.0855496639,4.8432215774,-6.596801804
13,205,2002,325,261,-228,1920,26,64,-202,-156,23764,13.631406761,10.947068199,-9.562956128,-18,1.0905125409,2.6843385622,-8.472443587
13,205,2003,326,229,-190,1957,20,97,-170,-98,23666,13.746573898,9.6563356525,-8.011806873,-25,0.8433480919,4.0902382458,-7.168458781
13,205,2004,322,235,-162,1956,24,87,-138,-72,23594,13.626745662,9.9449851883,-6.855691917,-21,1.0156580618,3.681760474,-5.840033855
13,205,2005,346,236,-237,1920,22,110,-215,-123,23471,14.703070222,10.028683735,-10.07117816,-18,0.9348772974,4.6743864868,-9.136300861
13,205,2006,378,215,90,1895,24,163,114,265,23736,16.01457411,9.1088186074,3.8129938357,-12,1.0167983562,6.9057555024,4.8297921918
13,205,2007,351,238,268,2121,18,113,286,399,24135,14.664410603,9.943389526,11.196757954,0,0.7520210566,4.7210210775,11.94877901
13,205,2008,345,257,-178,2177,20,88,-158,-62,24073,14.312977099,10.662130767,-7.384666445,8,0.8297378029,3.6508463326,-6.554928643
13,207,2001,294,208,96,633,17,86,113,180,22013,13.41057337,9.4877525886,4.3789627332,-19,0.7754413173,3.9228207818,5.1544040505
13,207,2002,260,196,503,679,15,64,518,571,22584,11.659977129,8.7898289123,22.557571137,-11,0.6726909882,2.8701482162,23.230262125
13,207,2003,306,198,494,699,9,108,503,612,23196,13.368283093,8.6500655308,21.581476627,1,0.3931847969,4.7182175623,21.974661424
13,207,2004,252,202,-1,721,14,50,13,48,23244,10.852713178,8.6993970715,-0.043066322,-15,0.6029285099,2.1533161068,0.5598621878
13,207,2005,280,212,257,691,12,68,269,320,23564,11.963766877,9.0582806358,10.981028884,-17,0.5127328662,2.9054862417,11.49376175
13,207,2006,257,199,676,879,14,58,690,734,24298,10.739208558,8.3155739417,28.24787932,-14,0.5850152522,2.4236346162,28.832894572
13,207,2007,294,241,755,1316,9,53,764,805,25103,11.902593065,9.7568875124,30.566182871,-12,0.3643650938,2.1457055525,30.930547965
13,207,2008,278,224,102,904,11,54,113,149,25252,11.041604607,8.8968324893,4.0512362228,-18,0.436898024,2.144772118,4.4881342468
13,209,2001,111,73,192,862,15,38,207,242,8510,13.231612826,8.7018714984,22.887114078,-3,1.7880557873,4.5297413279,24.675169865
13,209,2002,107,70,-50,869,15,37,-35,-5,8505,12.57713782,8.2280340876,-5.877167205,-7,1.7631501616,4.349103732,-4.114017044
13,209,2003,116,72,189,968,11,44,200,246,8751,13.44459898,8.3449235049,21.9054242,2,1.2749188688,5.0996754752,23.180343069
13,209,2004,121,86,164,1021,11,35,175,199,8950,13.671543981,9.7169651432,18.530026552,-11,1.2428676346,3.9545788374,19.772894187
13,209,2005,113,80,-130,895,12,33,-118,-92,8858,12.690925427,8.9847259659,-14.60017969,-7,1.3477088949,3.7061994609,-13.2524708
13,209,2006,100,86,123,929,12,14,135,144,9002,11.198208287,9.6304591265,13.773796193,-5,1.3437849944,1.5677491601,15.117581187
13,209,2007,122,56,-81,898,10,66,-71,-9,8993,13.559322034,6.2239510975,-9.002500695,-4,1.1114198388,7.3353709364,-7.891080856
13,209,2008,130,78,-122,924,10,52,-112,-63,8930,14.506500028,8.7039000167,-13.61379233,-3,1.1158846175,5.8026000112,-12.49790772
13,211,2001,224,127,384,183,13,97,397,488,16002,14.215001904,8.0593984008,24.368574692,-6,0.8249777891,6.155603503,25.193552481
13,211,2002,224,153,292,197,12,71,304,369,16371,13.838692738,9.4523213789,18.039724462,-6,0.7413585395,4.3863713588,18.781083001
13,211,2003,207,137,160,172,12,70,172,230,16601,12.556108213,8.3100812811,9.7052044159,-12,0.7278903312,4.2460269319,10.433094747
13,211,2004,211,126,208,209,11,85,219,287,16888,12.601152617,7.5248589089,12.42198931,-17,0.656932127,5.0762937084,13.078921437
13,211,2005,226,150,318,221,12,76,330,389,17277,13.229913654,8.7809161423,18.615542222,-17,0.7024732914,4.4489975121,19.318015513
13,211,2006,213,159,379,208,11,54,390,435,17712,12.17525508,9.0885706936,21.663951528,-9,0.6287690417,3.0866843865,22.292720569
13,211,2007,227,155,294,206,12,72,306,384,18096,12.67873101,8.6572832887,16.420911528,6,0.6702412869,4.0214477212,17.091152815
13,211,2008,240,139,287,209,11,101,298,395,18491,13.119414,7.5983272747,15.688632574,-4,0.601306475,5.5210867248,16.289939049
13,213,2001,572,267,669,197,69,305,738,1017,37791,15.342318782,7.1615369141,17.944075639,-26,1.8507342587,8.1807818682,19.794809897
13,213,2002,617,255,178,225,67,362,245,572,38363,16.204007669,6.6969561678,4.6747380308,-35,1.7595924049,9.5070515009,6.4343304357
13,213,2003,649,249,458,229,54,400,512,885,39248,16.724433392,6.4166162013,11.802450684,-27,1.3915553208,10.307817191,13.194006004
13,213,2004,584,292,241,207,50,292,291,550,39798,14.77620626,7.3881031298,6.0977152544,-33,1.2650861524,7.3881031298,7.3628014068
13,213,2005,701,307,-92,197,54,394,-38,322,40120,17.542981556,7.6828749468,-2.302359919,-34,1.3513851698,9.8601066093,-0.950974749
13,213,2006,678,307,67,187,55,371,122,472,40592,16.800475766,7.6072950738,1.6602240063,-21,1.362870453,9.1931806918,3.0230944593
13,213,2007,597,288,-399,194,48,309,-351,-58,40534,14.717846313,7.1000665631,-9.836550551,-16,1.1833444272,7.61777975,-8.653206124
13,213,2008,600,285,-567,179,49,315,-518,-230,40304,14.844503822,7.0511393157,-14.02805611,-27,1.2123011455,7.7933645068,-12.81575497
13,215,2001,3070,1794,-1285,9566,253,1276,-1032,93,186582,16.457993251,9.6174722774,-6.888769162,-151,1.356310193,6.8405209732,-5.532458969
13,215,2002,2902,1836,-1463,9637,-184,1066,-1647,-729,185853,15.583927397,9.8594385597,-7.856404473,-148,-0.988091882,5.724488837,-8.844496355
13,215,2003,2939,1815,-3035,6229,-1159,1124,-4194,-3132,182721,15.947950751,9.848768497,-16.46887735,-62,-6.289103409,6.0991822538,-22.75798076
13,215,2004,3071,1812,1971,9359,842,1259,2813,3883,186604,16.630339132,9.8124957693,10.673526027,-189,4.5596696676,6.8178433629,15.233195695
13,215,2005,3022,1763,523,10445,166,1259,689,1778,188382,16.11793507,9.4030177127,2.7894374723,-170,0.885366387,6.7149173569,3.6748038593
13,215,2006,2968,1816,1604,12029,541,1152,2145,3196,191578,15.622697126,9.5589009369,8.4429939994,-101,2.8476681756,6.0637961891,11.290662175
13,215,2007,3174,1856,-6372,7058,116,1318,-6256,-4771,186807,16.776563553,9.8101140373,-33.67998203,167,0.6131321273,6.9664495157,-33.0668499
13,215,2008,3109,1842,-1421,7028,279,1267,-1142,177,186984,16.634964459,9.8557750187,-7.603179317,52,1.4928128286,6.7791894401,-6.110366488
13,217,2001,1176,518,3327,1059,72,658,3399,4062,66946,18.115997843,7.9796657167,51.251636756,5,1.1091427251,10.136332127,52.360779481
13,217,2002,1212,548,3524,1091,67,664,3591,4296,71242,17.54132052,7.9312241294,51.002981446,41,0.9696934611,9.6100963904,51.972674907
13,217,2003,1326,544,3469,1232,58,782,3527,4471,75713,18.046340717,7.4036269606,47.211731482,162,0.7893572862,10.642713756,48.001088769
13,217,2004,1427,546,4211,1245,57,881,4268,4962,80675,18.249482057,6.9826329386,53.853236821,-187,0.7289561859,11.266849119,54.582193007
13,217,2005,1419,597,4200,1354,58,822,4258,5022,85697,17.058158825,7.1766883851,50.489265021,-58,0.6972327074,9.8814704397,51.186497728
13,217,2006,1553,625,3954,1441,57,928,4011,4880,90577,17.620295676,7.0912329669,44.861976242,-59,0.6467204466,10.529062709,45.508696688
13,217,2007,1590,686,4183,1562,51,904,4234,5146,95723,17.069243156,7.3644659152,44.906065486,8,0.5475040258,9.704777241,45.453569512
13,217,2008,1733,690,1767,1583,52,1043,1819,2819,98542,17.841608113,7.1036985561,18.191645433,-43,0.5353511955,10.737909557,18.726996628
13,219,2001,315,152,121,248,38,163,159,298,26665,11.879619852,5.7323879922,4.5632825464,-24,1.433096998,6.14723186,5.9963795444
13,219,2002,325,157,240,236,35,168,275,419,27084,12.093248246,5.8419691529,8.9303987051,-24,1.3023498112,6.2512790936,10.232748516
13,219,2003,347,164,641,270,25,183,666,849,27933,12.614282858,5.9617936274,23.301888507,0,0.9088100042,6.6524892306,24.210698511
13,219,2004,342,181,440,272,35,161,475,604,28537,12.112626173,6.4104834425,15.583495661,-32,1.2395962458,5.7021427307,16.823091907
13,219,2005,388,177,510,257,31,211,541,728,29265,13.425140999,6.1243555586,17.64644822,-24,1.0726272447,7.30078544,18.719075465
13,219,2006,322,181,842,271,33,141,875,1001,30266,10.817893199,6.0808654315,28.287782836,-15,1.1086660731,4.737027767,29.396448909
13,219,2007,351,182,756,266,29,169,785,959,31225,11.416304825,5.9195654649,24.588964239,5,0.9432274642,5.4967393602,25.532191703
13,219,2008,401,187,745,267,31,214,776,996,32221,12.640670807,5.8947766605,23.484538032,6,0.9772089651,6.7458941462,24.461746997
13,221,2001,160,117,142,137,5,43,147,178,12885,12.503907471,9.1434823382,11.097217881,-12,0.3907471085,3.3604251329,11.487964989
13,221,2002,168,115,150,138,5,53,155,199,13084,12.9385036,8.8567137741,11.552235358,-9,0.3850745119,4.0817898263,11.937309869
13,221,2003,172,112,85,117,4,60,89,138,13222,13.076864594,8.5151676424,6.4624040143,-11,0.3041131301,4.5616969513,6.7665171444
13,221,2004,157,111,125,116,3,46,128,159,13381,11.803180092,8.3449235049,9.3974363794,-15,0.2255384731,3.4582565876,9.6229748525
13,221,2005,189,121,-15,116,4,68,-11,46,13427,14.100268577,9.0271560728,-1.119068935,-11,0.2984183826,5.0731125037,-0.820650552
13,221,2006,137,115,221,116,3,22,224,238,13665,10.113686697,8.4895910232,16.314779271,-8,0.2214675919,1.624095674,16.536246863
13,221,2007,159,124,211,116,4,35,215,246,13911,11.531766754,8.9933275312,15.30316217,-4,0.2901073397,2.5384392225,15.59326951
13,221,2008,160,109,157,116,3,51,160,195,14106,11.421636863,7.7809901131,11.207481172,-16,0.2141556912,3.6406467502,11.421636863
13,223,2001,1602,453,4350,719,51,1149,4401,5576,88571,18.675028852,5.2807665855,50.709348006,26,0.5945233904,13.394262266,51.303871396
13,223,2002,1673,446,3997,722,42,1227,4039,5292,93863,18.340879441,4.8894394685,43.818586448,26,0.4604404881,13.451439973,44.279026936
13,223,2003,1806,473,3813,627,15,1333,3828,5307,99170,18.711826475,4.9007164578,39.506198422,146,0.1554138412,13.811110017,39.661612263
13,223,2004,1816,578,4547,743,55,1238,4602,5628,104798,17.806714779,5.667555695,44.585425165,-212,0.5393002824,12.139159084,45.124725447
13,223,2005,1930,573,4941,757,42,1357,4983,6272,111070,17.88129783,5.3087998221,45.777975429,-68,0.3891266885,12.572498008,46.167102118
13,223,2006,1923,567,7265,717,57,1356,7322,8594,119664,16.668544731,4.9147503185,62.972947203,-84,0.4940754288,11.753794413,63.467022632
13,223,2007,2064,606,6416,768,45,1458,6461,7930,127594,16.695111988,4.9017625314,51.897208584,11,0.3639922672,11.793349457,52.261200851
13,223,2008,2161,667,4080,797,50,1494,4130,5541,133135,16.576598691,5.1164235662,31.296863793,-83,0.3835399975,11.460175124,31.680403791
13,225,2001,356,218,-48,1085,72,138,24,137,23969,14.895085877,9.1211480931,-2.008326186,-25,3.0124892785,5.7739377837,1.0041630928
13,225,2002,373,201,21,1023,68,172,89,237,24206,15.485210171,8.3445770628,0.8718214842,-24,2.8230409964,7.1406331085,3.6948624805
13,225,2003,315,223,104,1135,46,92,150,214,24420,12.956031753,9.1720478756,4.2775469913,-28,1.8919919385,3.7839838769,6.1695389298
13,225,2004,325,217,13,1121,57,108,70,161,24581,13.265035407,8.8569621028,0.5306014163,-17,2.326483133,4.4080733046,2.8570845493
13,225,2005,319,231,-224,856,54,88,-170,-103,24478,13.004749383,9.4172323121,-9.131861636,-21,2.2014309301,3.5875170713,-6.930430706
13,225,2006,365,217,435,1104,57,148,492,626,25104,14.723084991,8.753176556,17.546690331,-14,2.2992214917,5.9699084345,19.845911823
13,225,2007,437,237,822,1720,49,200,871,1084,26188,17.039694299,9.2412072058,32.051781954,13,1.9106293379,7.7984870935,33.962411292
13,225,2008,449,242,301,1705,52,207,353,548,26736,16.967727307,9.1451893281,11.374801602,-12,1.9650820044,7.822537979,13.339883607
13,227,2001,345,221,986,220,20,124,1006,1127,24486,14.421569652,9.2381649075,41.216428049,-3,0.8360330233,5.1834047445,42.052461072
13,227,2002,350,224,941,223,19,126,960,1089,25575,13.982940812,8.9490821198,37.594135155,3,0.7590739298,5.0338586924,38.353209085
13,227,2003,367,248,945,239,18,119,963,1116,26691,14.043546474,9.4899169632,36.161175525,34,0.6887842957,4.5536295106,36.849959821
13,227,2004,323,212,708,246,17,111,725,796,27487,11.92365905,7.8260548562,26.136069992,-40,0.6275610026,4.0976041936,26.763630994
13,227,2005,330,243,573,234,19,87,592,662,28149,11.862822633,8.7353512114,20.598173844,-17,0.6830110001,3.1274714214,21.281184844
13,227,2006,345,254,975,262,19,91,994,1068,29217,12.028030541,8.8554195865,33.992260224,-17,0.6624132762,3.1726109542,34.6546735
13,227,2007,362,302,1173,251,12,60,1185,1236,30453,12.133400369,10.122339534,39.316239316,-9,0.4022121669,2.0110608346,39.718451483
13,227,2008,368,298,651,249,12,70,663,723,31176,11.9424297,9.6707718769,21.126417758,-10,0.3894270554,2.2716578234,21.515844813
13,229,2001,241,163,28,125,21,78,49,110,15814,15.292848531,10.343295894,1.7767624849,-17,1.3325718637,4.9495526366,3.1093343486
13,229,2002,224,185,140,131,20,39,160,182,15996,14.083621503,11.631562402,8.8022634392,-17,1.2574662056,2.4520591009,10.059729645
13,229,2003,229,158,178,118,15,71,193,252,16248,14.204193028,9.800272919,11.040813795,-12,0.9304056569,4.4039201092,11.971219452
13,229,2004,251,204,434,126,17,47,451,475,16723,15.225501198,12.374510934,26.326165418,-23,1.0312092445,2.8509902642,27.357374663
13,229,2005,258,154,316,135,16,104,332,421,17144,15.236070511,9.0943986772,18.661233649,-15,0.9448725898,6.1416718339,19.606106239
13,229,2006,282,178,137,108,18,104,155,250,17394,16.329839597,10.307487405,7.933290868,-9,1.042330187,6.0223521918,8.9756210551
13,229,2007,302,184,310,119,11,118,321,437,17831,17.146912704,10.447125621,17.601135557,-2,0.624556423,6.699787083,18.22569198
13,229,2008,302,178,153,133,13,124,166,296,18127,16.797374715,9.9004394015,8.5099282496,6,0.723065799,6.8969353134,9.2329940486
13,231,2001,164,118,199,323,1,46,200,238,14036,11.784148883,8.4788388302,14.299058705,-8,0.0718545664,3.3053100525,14.370913272
13,231,2002,196,116,493,307,0,80,493,574,14610,13.684284019,8.0988619703,34.420163374,1,0,5.5854220485,34.420163374
13,231,2003,181,120,343,346,0,61,343,409,15019,12.217759627,8.1001721287,23.152992001,5,0,4.1175874987,23.152992001
13,231,2004,185,132,527,344,1,53,528,554,15573,12.094665272,8.629707113,34.453451883,-27,0.065376569,3.464958159,34.518828452
13,231,2005,177,138,369,346,1,39,370,397,15970,11.222775259,8.7499603716,23.396633167,-12,0.0634055099,2.4728148876,23.460038677
13,231,2006,184,125,523,358,1,59,524,573,16543,11.318549503,7.6892319995,32.171746686,-10,0.061513856,3.6293175038,32.233260542
13,231,2007,214,137,523,357,1,77,524,612,17155,12.701050507,8.1310463529,31.040417829,11,0.0593507033,4.5700041545,31.099768532
13,231,2008,240,128,302,366,1,112,303,414,17569,13.823292247,7.372422532,17.394309411,-1,0.057597051,6.4508697155,17.451906462
13,233,2001,629,409,177,827,146,220,323,509,38758,16.336177231,10.62241095,4.5969846897,-34,3.7918630774,5.713766281,8.3888477671
13,233,2002,737,426,194,891,138,311,332,608,39366,18.867441503,10.905739593,4.9664635707,-35,3.5328452204,7.9617019098,8.4993087912
13,233,2003,652,455,-70,934,125,197,55,196,39562,16.52138658,11.529495236,-1.773768498,-56,3.1674437462,4.991891344,1.3936752483
13,233,2004,683,497,43,931,111,186,154,313,39875,17.196016969,12.513060664,1.0826189307,-27,2.7946674723,4.682956305,3.8772864031
13,233,2005,692,462,20,817,118,230,138,330,40205,17.282717283,11.538461538,0.4995004995,-38,2.9470529471,5.7442557443,3.4465534466
13,233,2006,712,433,252,889,118,279,370,628,40833,17.572003258,10.686344678,6.2193045238,-21,2.9122140231,6.8856585799,9.1315185469
13,233,2007,756,445,132,852,107,311,239,549,41382,18.390804598,10.825275193,3.2110928663,-1,2.6029313386,7.5655294046,5.8140242048
13,233,2008,731,452,228,827,108,279,336,636,42018,17.529976019,10.839328537,5.4676258993,21,2.5899280576,6.690647482,8.0575539568
13,235,2001,125,93,-22,1130,21,32,-1,21,9602,13.032372413,9.6960850753,-2.293697545,-10,2.1894385654,3.3362873377,-0.104258979
13,235,2002,132,106,17,1079,19,26,36,52,9654,13.710012464,11.009555463,1.7656834233,-10,1.9734108849,2.7004570004,3.7390943083
13,235,2003,113,116,-7,1149,16,-3,9,-8,9646,11.70984456,12.020725389,-0.725388601,-14,1.6580310881,-0.310880829,0.932642487
13,235,2004,105,123,53,1148,17,-18,70,46,9692,10.85944772,12.721067329,5.4814355156,-6,1.7581962974,-1.861619609,7.239631813
13,235,2005,114,110,-72,1133,18,4,-54,-58,9634,11.797578392,11.383628273,-7.451102142,-8,1.8627755355,0.413950119,-5.588326607
13,235,2006,127,131,95,1193,17,-4,112,103,9737,13.112384492,13.52537298,9.8084765887,-5,1.7552010738,-0.412988488,11.563677662
13,235,2007,135,117,35,1227,15,18,50,63,9800,13.819931412,11.977273891,3.5829451809,-5,1.5355479347,1.8426575216,5.1184931156
13,235,2008,134,105,-58,1215,16,29,-42,-13,9787,13.682544545,10.721396845,-5.9222954,0,1.6337366621,2.9611477,-4.288558738
13,237,2001,274,170,110,274,51,104,161,246,19104,14.43548812,8.9563247458,5.7952689532,-19,2.6868974237,5.4791633739,8.4821663769
13,237,2002,250,198,44,268,50,52,94,129,19233,13.042230743,10.329446749,2.2954326108,-17,2.6084461486,2.7127839946,4.9038787594
13,237,2003,247,187,-34,154,41,60,7,37,19270,12.830169078,9.7135288159,-1.766096148,-30,2.1297041789,3.1166402618,0.3636080305
13,237,2004,243,187,163,155,36,56,199,236,19506,12.533525892,9.6451413245,8.4072622241,-19,1.8568186507,2.8883845678,10.264080875
13,237,2005,259,172,-2,137,37,87,35,108,19614,13.241308793,8.7934560327,-0.102249489,-14,1.8916155419,4.4478527607,1.7893660532
13,237,2006,265,181,131,137,37,84,168,241,19855,13.428260154,9.1717550483,6.638121057,-11,1.8748891535,4.2565051053,8.5130102105
13,237,2007,260,172,219,137,33,88,252,317,20172,12.991230919,8.5941989157,10.942613736,-23,1.6488870013,4.3970320034,12.591500737
13,237,2008,270,184,138,137,32,86,170,213,20385,13.314594275,9.0736494317,6.8052370737,-43,1.5780259881,4.2409448431,8.3832630619
13,239,2001,39,33,19,0,4,6,23,27,2630,14.905407988,12.612268297,7.2616090197,-2,1.5287597936,2.2931396904,8.7903688133
13,239,2002,35,32,-49,0,4,3,-45,-44,2586,13.420245399,12.26993865,-18.78834356,-2,1.5337423313,1.1503067485,-17.25460123
13,239,2003,39,28,-70,0,1,11,-69,-62,2524,15.264187867,10.95890411,-27.39726027,-4,0.3913894325,4.3052837573,-27.00587084
13,239,2004,27,42,9,0,0,-15,9,-8,2516,10.714285714,16.666666667,3.5714285714,-2,0,-5.952380952,3.5714285714
13,239,2005,29,40,88,0,1,-11,89,76,2592,11.354737666,15.661707126,34.455755677,-2,0.3915426782,-4.30696946,34.847298356
13,239,2006,36,34,46,0,0,2,46,47,2639,13.764098643,12.999426496,17.587459377,-1,0,0.7646721468,17.587459377
13,239,2007,38,18,-4,0,1,20,-3,14,2653,14.361300076,6.8027210884,-1.511715797,-3,0.3779289494,7.5585789872,-1.133786848
13,239,2008,38,17,29,0,0,21,29,50,2703,14.189693801,6.3480209111,10.828976848,0,0,7.8416728902,10.828976848
13,241,2001,191,175,244,373,54,16,298,299,15383,12.538156038,11.487839302,16.017330226,-15,3.5448189845,1.0503167361,19.562149211
13,241,2002,162,162,121,386,53,0,174,163,15546,10.475605419,10.475605419,7.8243719487,-11,3.427204242,0,11.251576191
13,241,2003,180,155,196,405,39,25,235,253,15799,11.485085341,9.8899345988,12.505981815,-7,2.4884351571,1.5951507417,14.994416972
13,241,2004,205,192,71,433,37,13,108,107,15906,12.931714241,12.111654313,4.4787888346,-14,2.3340167166,0.8200599275,6.8128055512
13,241,2005,195,162,148,477,39,33,187,204,16110,12.181409295,10.11994003,9.2453773113,-16,2.4362818591,2.0614692654,11.68165917
13,241,2006,160,177,104,507,39,-17,143,118,16228,9.895479003,10.946873647,6.432061352,-8,2.412023007,-1.051394644,8.844084359
13,241,2007,197,177,141,510,30,20,171,199,16427,12.065533609,10.840606339,8.6357372531,8,1.8373909049,1.2249272699,10.473128158
13,241,2008,204,175,30,476,30,29,60,87,16514,12.385780638,10.62505692,1.8214383291,-2,1.8214383291,1.7607237182,3.6428766583
13,243,2001,93,117,-48,334,5,-24,-43,-73,7684,12.045851953,15.154458908,-6.217213911,-6,0.6476264491,-3.108606956,-5.569587462
13,243,2002,108,131,-79,368,4,-23,-75,-102,7582,14.14908948,17.162321499,-10.34979693,-4,0.5240403511,-3.013232019,-9.825756583
13,243,2003,88,102,-101,357,4,-14,-97,-114,7468,11.694352159,13.554817276,-13.42192691,-3,0.5315614618,-1.860465116,-12.89036545
13,243,2004,108,104,-38,366,5,4,-33,-36,7432,14.496644295,13.959731544,-5.100671141,-7,0.6711409396,0.5369127517,-4.429530201
13,243,2005,97,96,-99,348,5,1,-94,-100,7332,13.140070442,13.004605798,-13.41099973,-7,0.6773232186,0.1354646437,-12.73367651
13,243,2006,123,95,-34,313,5,28,-29,-3,7329,16.779210149,12.959552554,-4.638155651,-2,0.6820817134,3.819657595,-3.956073938
13,243,2007,106,77,-89,361,4,29,-85,-53,7276,14.515576857,10.544334132,-12.18760698,3,0.5477576173,3.9712427251,-11.63984937
13,243,2008,104,103,-122,353,4,1,-118,-115,7161,14.407425365,14.268892429,-16.90101822,2,0.5541317448,0.1385329362,-16.34688647
13,245,2001,3286,1917,-1414,11060,106,1369,-1308,-113,199534,16.463709445,9.6046655527,-7.084505525,-174,0.5310874015,6.8590438924,-6.553418124
13,245,2002,3253,1921,-1408,10965,-260,1332,-1668,-511,199023,16.323888428,9.6397754901,-7.065488751,-175,-1.30470673,6.6841129374,-8.37019548
13,245,2003,3089,1957,-556,10304,-1062,1132,-1618,-765,198258,15.550705924,9.8519687576,-2.799026382,-279,-5.346341758,5.6987371659,-8.14536814
13,245,2004,3131,1958,-2070,10034,630,1173,-1440,-453,197805,15.810615988,9.8873159068,-10.4528825,-186,3.181312064,5.923300081,-7.271570432
13,245,2005,3089,1792,-2288,9514,58,1297,-2230,-1081,196724,15.659178413,9.084249827,-11.5986404,-148,0.2940214788,6.5749285857,-11.30461893
13,245,2006,3202,1836,-1169,9676,376,1366,-793,479,197203,16.256819157,9.3215240387,-5.935109805,-94,1.9089831365,6.9352951181,-4.026126668
13,245,2007,3370,1907,-1020,9961,17,1463,-1003,440,197643,17.069946258,9.6594621701,-5.166571271,-20,0.0861095212,7.4104840875,-5.08046175
13,245,2008,3255,1921,370,10901,155,1334,525,1843,199486,16.392658305,9.6744382808,1.8633743695,-16,0.7806027764,6.7182200242,2.643977146
13,247,2001,1010,504,290,1049,403,506,693,1134,71692,14.200351494,7.086115993,4.0773286467,-65,5.6660808436,7.1142355009,9.7434094903
13,247,2002,1007,520,458,1069,375,487,833,1261,72953,13.92374434,7.190016938,6.3327456877,-59,5.1851083688,6.7337274016,11.517854056
13,247,2003,1021,519,880,1132,328,502,1208,1667,74620,13.837219546,7.0338069972,11.926300882,-43,4.4452576013,6.8034125484,16.371558483
13,247,2004,1100,526,862,1099,307,574,1169,1664,76284,14.578805068,6.9713195144,11.42448179,-79,4.0688119599,7.6074855537,15.49329375
13,247,2005,1132,509,604,1188,322,623,926,1477,77761,14.697004122,6.6084585673,7.8418643903,-72,4.1805965789,8.0885455549,12.022460969
13,247,2006,1128,580,860,1217,322,548,1182,1688,79449,14.350232174,7.3786654793,10.940779849,-42,4.0964315247,6.9715666942,15.037211373
13,247,2007,1228,559,1223,1207,292,669,1515,2201,81650,15.245283956,6.9398320288,15.183210324,17,3.6251000937,8.3054519271,18.808310418
13,247,2008,1282,586,579,1266,295,696,874,1572,83222,15.551458101,7.1085448105,7.0236304527,2,3.5785336503,8.4429132903,10.602164103
13,249,2001,48,46,7,11,7,2,14,11,3795,12.666578704,12.138804592,1.8472093944,-5,1.8472093944,0.5277741127,3.6944187888
13,249,2002,38,40,-1,9,7,-2,6,1,3796,10.011856145,10.538795943,-0.263469899,-3,1.8442892899,-0.526939797,1.5808193914
13,249,2003,66,38,-30,13,2,28,-28,-4,3792,17.395888245,10.015814444,-7.907221929,-4,0.5271481286,7.3800738007,-7.380073801
13,249,2004,56,40,8,11,5,16,13,27,3819,14.715543293,10.511102352,2.1022204704,-2,1.313887794,4.2044409407,3.4161082644
13,249,2005,51,45,116,11,3,6,119,122,3941,13.144329897,11.597938144,29.896907216,-3,0.7731958763,1.5463917526,30.670103093
13,249,2006,65,50,23,13,4,15,27,39,3980,16.412069183,12.624668602,5.8073475571,-3,1.0099734882,3.7874005807,6.8173210453
13,249,2007,61,16,81,15,2,45,83,126,4106,15.087806085,3.9574573337,20.034627752,-2,0.4946821667,11.130348751,20.529309918
13,249,2008,62,19,104,13,3,43,107,149,4255,14.830761871,4.5449108958,24.877407009,-1,0.7176175099,10.285850975,25.595024519
13,251,2001,196,165,-289,316,6,31,-283,-260,15109,12.861736334,10.827482118,-18.96449898,-8,0.3937266225,2.0342542162,-18.57077236
13,251,2002,187,159,184,492,6,28,190,210,15319,12.291310635,10.450900486,12.094123833,-8,0.3943736033,1.8404101485,12.488497437
13,251,2003,196,186,-173,476,5,10,-168,-171,15148,12.866380018,12.209932058,-11.35654971,-13,0.32822398,0.6564479601,-11.02832573
13,251,2004,183,163,8,470,8,20,16,27,15175,12.07004584,10.750915147,0.5276522771,-9,0.5276522771,1.3191306929,1.0553045543
13,251,2005,190,158,-27,479,6,32,-21,-3,15172,12.521830823,10.412890895,-1.779418064,-14,0.3954262365,2.1089399282,-1.383991828
13,251,2006,209,175,-180,485,7,34,-173,-145,15027,13.841517931,11.589787741,-11.92092453,-6,0.4635915097,2.2517301897,-11.45733302
13,251,2007,202,159,-35,467,6,43,-29,16,15043,13.435317592,10.575324243,-2.327901563,2,0.3990688394,2.8599933489,-1.928832724
13,251,2008,200,172,52,558,7,28,59,90,15133,13.255567338,11.399787911,3.446447508,3,0.4639448568,1.8557794274,3.9103923648
13,253,2001,130,127,-70,296,1,3,-69,-73,9288,13.941766315,13.620033246,-7.507104939,-7,0.1072443563,0.3217330688,-7.399860582
13,253,2002,122,104,0,311,-5,18,-5,4,9292,13.132400431,11.194833154,0,-9,-0.538213132,1.9375672766,-0.538213132
13,253,2003,113,126,-95,310,-18,-13,-113,-135,9157,12.249986449,13.659276926,-10.29866117,-9,-1.951325275,-1.409290476,-12.24998645
13,253,2004,120,100,28,300,11,20,39,51,9208,13.06833651,10.890280425,3.0492785189,-8,1.1979308467,2.1780560849,4.2472093656
13,253,2005,108,110,-112,294,1,-2,-111,-121,9087,11.806504509,12.025143482,-12.24378245,-8,0.1093194862,-0.218638972,-12.13446297
13,253,2006,121,117,-27,294,6,4,-21,-21,9066,13.331129841,12.890431334,-2.974714923,-4,0.6610477607,0.4406985071,-2.313667162
13,253,2007,124,106,-30,345,-1,18,-31,-13,9053,13.687289586,11.700424968,-3.311441029,0,-0.110381368,1.9868646173,-3.421822396
13,253,2008,126,105,18,302,3,21,21,38,9091,13.888888889,11.574074074,1.9841269841,-4,0.3306878307,2.3148148148,2.3148148148
13,255,2001,938,595,118,900,103,343,221,505,58987,15.970170854,10.130332258,2.0090406831,-59,1.7536541556,5.8398385957,3.7626948386
13,255,2002,908,575,464,1314,98,333,562,851,59838,15.282979171,9.6780980433,7.8098043341,-44,1.6494845361,5.6048811277,9.4592888702
13,255,2003,901,610,193,1273,85,291,278,494,60332,14.995423151,10.152284264,3.2121161688,-75,1.4146625614,4.8431388866,4.6267787301
13,255,2004,970,633,-10,1297,78,337,68,366,60698,16.029083698,10.460216475,-0.165248286,-39,1.2889366273,5.568867223,1.1236883417
13,255,2005,987,573,94,1275,82,414,176,535,61233,16.189484216,9.3987583141,1.5418556397,-55,1.3450230048,6.7907259024,2.8868786445
13,255,2006,1005,626,448,1206,85,379,533,879,62112,16.295755807,10.150391179,7.2641777129,-33,1.3782480036,6.1453646277,8.6424257165
13,255,2007,988,644,438,1243,75,344,513,848,62960,15.798899834,10.298068313,7.0039657157,-9,1.1993091979,5.500831521,8.2032749136
13,255,2008,983,633,500,1162,77,350,577,953,63913,15.495810771,9.9784824194,7.8818976457,26,1.2138122374,5.517328352,9.0957098831
13,257,2001,356,317,60,954,8,39,68,83,25559,13.951209954,12.422847066,2.3513275203,-24,0.313510336,1.5283628882,2.6648378564
13,257,2002,302,339,71,905,8,-37,79,18,25577,11.811639549,13.258760951,2.7769086358,-24,0.3128911139,-1.447121402,3.0897997497
13,257,2003,329,290,-278,919,7,39,-271,-251,25326,12.926546569,11.39422038,-10.9227354,-19,0.2750329057,1.532326189,-10.64770249
13,257,2004,308,317,-169,894,6,-9,-163,-193,25133,12.207931192,12.564656454,-6.698507699,-21,0.2378168414,-0.356725262,-6.460690858
13,257,2005,336,322,-79,898,7,14,-72,-77,25056,13.389388113,12.831496942,-3.148100181,-19,0.2789455857,0.5578911714,-2.869154596
13,257,2006,334,318,102,909,6,16,108,111,25167,13.300678972,12.663520698,4.0618839974,-13,0.2389343528,0.6371582741,4.3008183502
13,257,2007,382,309,-25,908,4,73,-21,54,25221,15.16234024,12.264824958,-0.992299754,2,0.1587679606,2.8975152814,-0.833531793
13,257,2008,361,301,208,924,3,60,211,272,25493,14.236699925,11.870489411,8.2028631147,1,0.1183105257,2.3662105139,8.3211736404
13,259,2001,64,58,-87,264,2,6,-85,-82,5173,12.274645186,11.1238972,-16.6858458,-3,0.3835826621,1.1507479862,-16.30226314
13,259,2002,52,82,-44,272,2,-30,-42,-76,5097,10.126582278,15.968841285,-8.568646543,-4,0.3894839338,-5.842259007,-8.17916261
13,259,2003,50,63,-96,269,2,-13,-94,-110,4987,9.9166997223,12.49504165,-19.04006347,-3,0.3966679889,-2.578341928,-18.64339548
13,259,2004,62,70,-76,268,1,-8,-75,-87,4900,12.541721452,14.160008091,-15.37372307,-4,0.2022858299,-1.618286639,-15.17143724
13,259,2005,63,75,-87,253,2,-12,-85,-101,4799,12.991030003,15.465511908,-17.93999381,-4,0.4124136509,-2.474481905,-17.52758016
13,259,2006,62,80,-84,250,1,-18,-83,-103,4696,13.059505003,16.850974197,-17.69352291,-2,0.2106371775,-3.791469194,-17.48288573
13,259,2007,64,53,-68,248,2,11,-66,-54,4642,13.707431998,11.351467124,-14.5641465,1,0.4283572499,2.3559648747,-14.13578925
13,259,2008,52,48,19,248,1,4,20,24,4666,11.173184358,10.313708638,4.0825096691,0,0.21486893,0.8594757198,4.2973785991
13,261,2001,507,339,-215,1590,35,168,-180,-43,33212,15.255690794,10.200550649,-6.46937578,-31,1.0531541968,5.0551401447,-5.416221584
13,261,2002,542,333,-343,1645,34,209,-309,-121,33091,16.349184803,10.044794353,-10.34643983,-21,1.0255946186,6.3043904499,-9.320845211
13,261,2003,455,386,-148,1656,30,69,-118,-87,33004,13.768061124,11.680157349,-4.4784023,-38,0.9077842499,2.0879037749,-3.57061805
13,261,2004,503,385,-416,1667,25,118,-391,-309,32695,15.312257416,11.720117506,-12.66381528,-36,0.7610465913,3.5921399108,-11.90276869
13,261,2005,513,327,-511,1676,31,186,-480,-319,32376,15.76739254,10.050560157,-15.70592122,-25,0.9528053972,5.7168323831,-14.75311583
13,261,2006,529,325,-69,1785,28,204,-41,147,32523,16.302254272,10.015562643,-2.126380992,-16,0.8628792431,6.2866916285,-1.263501749
13,261,2007,541,361,-107,1877,25,180,-82,90,32613,16.611397691,11.084500123,-3.285433554,-8,0.7676246622,5.5268975682,-2.517808892
13,261,2008,503,358,-321,1885,25,145,-296,-164,32449,15.462174541,11.004887646,-9.86751099,-13,0.7684977406,4.4572868956,-9.099013249
13,263,2001,87,96,63,15,2,-9,65,51,6586,13.261184361,14.633031019,9.6029266062,-5,0.3048548129,-1.371846658,9.9077814191
13,263,2002,98,89,11,18,2,9,13,15,6601,14.863122772,13.49814211,1.6683096989,-7,0.3033290362,1.3649806628,1.9716387351
13,263,2003,73,81,-104,16,2,-8,-102,-114,6487,11.155256724,12.377750611,-15.89242054,-4,0.3056234719,-1.222493888,-15.58679707
13,263,2004,70,83,57,21,1,-13,58,40,6527,10.757645612,12.755494083,8.7597971415,-5,0.1536806516,-1.997848471,8.9134777931
13,263,2005,75,78,71,23,2,-3,73,64,6591,11.434669919,11.892056716,10.824820857,-6,0.3049245312,-0.457386797,11.129745388
13,263,2006,62,84,-3,19,1,-22,-2,-27,6564,9.4260737362,12.770809578,-0.456100342,-3,0.1520334474,-3.344735842,-0.304066895
13,263,2007,74,72,31,17,2,2,33,35,6599,11.243637469,10.939755375,4.7101724531,0,0.3038820937,0.3038820937,5.0140545468
13,263,2008,70,73,-189,22,1,-3,-188,-185,6414,10.758472297,11.219549681,-29.0478752,6,0.1536924614,-0.461077384,-28.89418274
13,265,2001,17,23,-40,23,1,-6,-39,-46,2033,8.2684824903,11.186770428,-19.45525292,-1,0.486381323,-2.918287938,-18.9688716
13,265,2002,24,21,5,23,1,3,6,7,2040,11.784925117,10.311809477,2.4551927326,-2,0.4910385465,1.4731156396,2.9462312792
13,265,2003,17,16,-124,23,1,1,-123,-119,1921,8.5836909871,8.0787679879,-62.61045191,3,0.5049229992,0.5049229992,-62.10552891
13,265,2004,22,39,-1,23,0,-17,-1,-20,1901,11.512297227,20.408163265,-0.523286238,-2,0,-8.895866039,-0.523286238
13,265,2005,21,24,-44,23,1,-3,-43,-46,1855,11.182108626,12.779552716,-23.42917998,0,0.5324813632,-1.597444089,-22.89669862
13,265,2006,20,37,36,23,0,-17,36,18,1873,10.729613734,19.849785408,19.313304721,-1,0,-9.120171674,19.313304721
13,265,2007,28,12,-13,23,1,16,-12,3,1876,14.937316618,6.4017071219,-6.935182715,-1,0.5334755935,8.5356094959,-6.401707122
13,265,2008,25,7,-29,23,0,18,-29,-13,1863,13.372559508,3.7443166622,-15.51216903,-2,0,9.6282428457,-15.51216903
13,267,2001,302,212,-314,3732,89,90,-225,-151,22161,13.581274031,9.5338744856,-14.1209273,-16,4.0024284397,4.0473995458,-10.11849886
13,267,2002,342,228,-217,3734,80,114,-137,-38,22123,15.445759191,10.297172794,-9.80037937,-15,3.6130430855,5.1485863969,-6.187336284
13,267,2003,326,212,-6,3801,62,114,56,137,22260,14.690309353,9.5532073091,-0.270373792,-33,2.7938625149,5.1371020436,2.5234887232
13,267,2004,329,226,333,3905,68,103,401,478,22738,14.622872128,10.044890884,14.800657807,-26,3.0223565492,4.5779812436,17.823014356
13,267,2005,344,229,-76,3798,68,115,-8,91,22829,15.09864595,10.051133496,-3.335747361,-16,2.9846160599,5.0475124542,-0.351131301
13,267,2006,337,243,66,3934,71,94,137,219,23048,14.691457593,10.593543606,2.8772587571,-12,3.0952329054,4.0979139874,5.9724916625
13,267,2007,374,222,-129,3653,57,152,-72,74,23122,16.200996318,9.616634178,-5.588044185,-6,2.4691358025,6.5843621399,-3.118908382
13,267,2008,350,232,173,3571,60,118,233,347,23469,15.024360928,9.959004958,7.426326973,-4,2.5756047305,5.06535597,10.001931704
13,269,2001,101,111,-57,430,1,-10,-56,-74,8744,11.502106822,12.640929279,-6.491288008,-8,0.1138822458,-1.138822458,-6.377405762
13,269,2002,117,105,50,441,0,12,50,54,8798,13.339413978,11.971268955,5.7006042641,-8,0,1.3681450234,5.7006042641
13,269,2003,115,109,18,446,-3,6,15,8,8806,13.065212452,12.383549193,2.0449897751,-13,-0.340831629,0.6816632584,1.7041581459
13,269,2004,120,103,-17,466,2,17,-15,-4,8802,13.630168105,11.699227624,-1.930940482,-6,0.2271694684,1.9309404816,-1.703771013
13,269,2005,101,110,-80,413,0,-9,-80,-95,8707,11.536923868,12.564966589,-9.138157519,-6,0,-1.028042721,-9.138157519
13,269,2006,103,104,-79,412,2,-1,-77,-82,8625,11.885529656,12.000923148,-9.116085853,-4,0.2307869836,-0.115393492,-8.885298869
13,269,2007,112,89,58,434,0,23,58,83,8708,12.923325449,10.269428258,6.692436393,2,0,2.6538971903,6.692436393
13,269,2008,116,92,30,438,2,24,32,58,8766,13.27686849,10.529930182,3.4336728854,2,0.2289115257,2.7469383083,3.6625844111
13,271,2001,184,156,-105,1552,11,28,-94,-75,11723,15.6455933,13.264742145,-8.928191829,-9,0.935334382,2.3808511543,-7.992857447
13,271,2002,165,174,-152,1461,9,-9,-143,-158,11565,14.170388183,14.943318447,-13.05393336,-6,0.7729302645,-0.772930265,-12.28100309
13,271,2003,162,175,1133,2759,6,-13,1139,1194,12759,13.320177602,14.389080743,93.159019898,68,0.4933399112,-1.068903141,93.652359809
13,271,2004,187,159,422,3249,8,28,430,437,13196,14.409554999,12.251974571,32.517819303,-21,0.6164515508,2.1575804277,33.134270853
13,271,2005,169,132,0,3288,8,37,8,35,13231,12.789949673,9.9897831763,0,-10,0.6054414046,2.8001664964,0.6054414046
13,271,2006,151,189,34,3339,8,-38,42,-3,13228,11.413885634,14.286254205,2.5700139839,-7,0.6047091727,-2.87236857,3.1747231566
13,271,2007,161,133,121,3442,7,28,128,143,13371,12.10571826,10.000375954,9.0980863942,-13,0.5263355765,2.1053423061,9.6244219708
13,271,2008,154,153,-10,3482,7,1,-3,-16,13355,11.524358303,11.449524807,-0.748334955,-14,0.5238344683,0.0748334955,-0.224500486
13,273,2001,193,120,-81,221,4,73,-77,-15,10953,17.608685735,10.948405638,-7.390173806,-11,0.3649468546,6.6602800967,-7.025226951
13,273,2002,152,128,-147,213,4,24,-143,-126,10827,13.957759412,11.753902663,-13.49862259,-7,0.3673094582,2.2038567493,-13.13131313
13,273,2003,159,149,75,393,1,10,76,76,10903,14.634146341,13.713759779,6.9028992177,-10,0.0920386562,0.9203865624,6.9949378739
13,273,2004,153,133,-118,428,2,20,-116,-105,10798,14.100732685,12.257499654,-10.87507488,-9,0.1843233031,1.8432330307,-10.69075158
13,273,2005,168,135,-276,358,2,33,-274,-248,10550,15.739179314,12.647554806,-25.85722316,-7,0.1873711823,3.0916245082,-25.66985198
13,273,2006,156,108,-159,391,2,48,-157,-113,10437,14.866345833,10.292085577,-15.1522371,-4,0.1905941773,4.5742602563,-14.96164292
13,273,2007,148,114,-204,369,1,34,-203,-162,10275,14.291232136,11.00811124,-19.69872538,7,0.0965623793,3.2831208961,-19.602163
13,273,2008,142,149,23,396,1,-7,24,18,10293,13.807856865,14.488525865,2.2364838584,1,0.0972384286,-0.680669,2.333722287
13,275,2001,629,489,-71,1323,28,140,-43,55,42868,14.68236832,11.414432605,-1.657310255,-42,0.653587143,3.267935715,-1.003723112
13,275,2002,595,484,-69,1397,26,111,-43,26,42894,13.875609244,11.287050209,-1.609104265,-42,0.6063291434,2.5885590355,-1.002775122
13,275,2003,585,459,405,1474,10,126,415,497,43391,13.559714898,10.63916092,9.3874949296,-44,0.2317899983,2.9205539781,9.6192849279
13,275,2004,582,467,-177,1418,22,115,-155,-74,43317,13.42436684,10.771785764,-4.082668266,-34,0.5074502929,2.6525810767,-3.575217973
13,275,2005,611,427,721,1511,18,184,739,889,44206,13.962044263,9.7574351885,16.475669253,-34,0.4113204529,4.2046090742,16.886989706
13,275,2006,669,442,226,1531,20,227,246,450,44656,15.057054759,9.9480092728,5.086538678,-23,0.4501361662,5.1090454863,5.5366748441
13,275,2007,691,491,318,1536,17,200,335,526,45182,15.383245397,10.930786527,7.079409604,-9,0.378459004,4.4524588704,7.4578686079
13,275,2008,712,475,341,1540,19,237,360,596,45778,15.655233069,10.444151275,7.4978012313,-1,0.417766051,5.2110817942,7.9155672823
13,277,2001,612,385,-283,1479,172,227,-111,83,38517,15.90622604,10.006367689,-7.355330015,-33,4.4703772531,5.8998583514,-2.884952762
13,277,2002,606,326,-22,1436,157,280,135,377,38894,15.656689618,8.422575603,-0.568394673,-38,4.0562710726,7.2341140148,3.4878764
13,277,2003,591,371,20,1560,119,220,139,300,39194,15.136768774,9.5021001947,0.5122425981,-59,3.0478434587,5.634668579,3.5600860568
13,277,2004,671,343,292,1626,139,328,431,727,39921,16.962649308,8.6709220755,7.3816596094,-32,3.5138722113,8.2917272325,10.895531821
13,277,2005,661,371,61,1573,133,290,194,449,40370,16.465108169,9.241384464,1.5194729173,-35,3.3129491475,7.223723705,4.8324220647
13,277,2006,722,351,486,1626,138,371,624,973,41343,17.671606721,8.5910442647,11.895292059,-22,3.3776755229,9.0805624564,15.272967582
13,277,2007,709,355,186,2065,123,354,309,645,41988,17.016476461,8.5202385667,4.4641249955,-18,2.9520826583,8.4962378947,7.4162076538
13,277,2008,700,374,-1,2103,127,326,126,446,42434,16.58335505,8.8602496979,-0.023690507,-6,3.0086944161,7.7231053517,2.9850039089
13,279,2001,450,295,-289,439,107,155,-182,-46,26056,17.255262855,11.311783427,-11.08171326,-19,4.1029180567,5.9434794279,-6.978795199
13,279,2002,397,273,-145,441,101,124,-44,59,26115,15.219183071,10.465584328,-5.558643691,-21,3.8718828468,4.7535987426,-1.686760844
13,279,2003,416,290,-132,443,92,126,-40,58,26173,15.911872705,11.092411261,-5.048959608,-28,3.5189718482,4.8194614443,-1.52998776
13,279,2004,424,276,7,440,81,148,88,218,26391,16.132714405,10.501483905,0.2663419831,-18,3.0819572331,5.6312305,3.3482992162
13,279,2005,439,277,238,441,89,162,327,467,26858,16.488572555,10.403951248,8.9391350072,-22,3.34278578,6.0846213074,12.281920787
13,279,2006,484,288,89,397,87,196,176,358,27216,17.901394385,10.652069386,3.2917853312,-14,3.2178126271,7.2493249991,6.5095979584
13,279,2007,496,272,237,415,79,224,316,530,27746,18.04883374,9.8977475347,8.6241403151,-10,2.8747134384,8.151086205,11.498853754
13,279,2008,485,295,98,418,79,190,177,356,28102,17.368571838,10.564389056,3.5095258559,-11,2.8291075777,6.8041827818,6.3386334336
13,281,2001,93,132,232,487,14,-39,246,203,9573,9.8189304756,13.936546482,24.49453624,-4,1.4781185662,-4.117616006,25.972654807
13,281,2002,80,111,125,488,14,-31,139,102,9675,8.3125519534,11.533665835,12.988362427,-6,1.4546965919,-3.221113882,14.443059019
13,281,2003,77,150,308,510,12,-73,320,256,9931,7.8547383454,15.301438335,31.418953382,9,1.2241150668,-7.44669999,32.643068448
13,281,2004,86,142,253,505,11,-56,264,193,10124,8.5764148591,14.161057093,25.230615807,-15,1.0969832959,-5.584642234,26.327599102
13,281,2005,84,145,187,464,12,-61,199,131,10255,8.2437803621,14.230335149,18.35222533,-7,1.1776829089,-5.986554787,19.529908239
13,281,2006,90,130,380,558,12,-40,392,345,10600,8.6310237353,12.467034284,36.442100216,-7,1.1508031647,-3.836010549,37.59290338
13,281,2007,92,152,326,615,10,-60,336,272,10872,8.5692995529,14.157973174,30.365126677,-4,0.9314456036,-5.588673621,31.29657228
13,281,2008,105,160,221,568,9,-55,230,170,11042,9.5829150315,14.602537191,20.169754495,-5,0.821392717,-5.019622159,20.991147212
13,283,2001,85,79,34,499,13,6,47,47,6929,12.309029035,11.440156397,4.9236116139,-6,1.8825573818,0.8688726378,6.8061689957
13,283,2002,77,75,-16,537,13,2,-3,-6,6923,11.117528155,10.82876119,-2.31013572,-5,1.8769852729,0.2887669651,-0.433150448
13,283,2003,101,69,17,556,10,32,27,48,6971,14.538649777,9.9323448971,2.4470994674,-11,1.4394702749,4.6063048798,3.8865697423
13,283,2004,81,69,29,626,9,12,38,45,7016,11.582183456,9.8663044255,4.1467076571,-5,1.2869092729,1.7158790305,5.43361693
13,283,2005,93,95,-286,392,10,-2,-276,-281,6735,13.526288997,13.817176933,-41.59697477,-3,1.4544396771,-0.290887935,-40.14253509
13,283,2006,91,71,112,460,9,20,121,136,6871,13.376451565,10.436572101,16.463325004,-5,1.3229457592,2.9398794649,17.786270763
13,283,2007,99,50,38,476,7,49,45,90,6961,14.314632736,7.2296124928,5.4945054945,-4,1.012145749,7.0850202429,6.5066512435
13,283,2008,91,71,87,469,6,20,93,115,7076,12.965733419,10.116121678,12.395811071,2,0.8548835221,2.8496117404,13.250694593
13,285,2001,913,668,435,1732,79,245,514,710,59633,15.402004116,11.268936199,7.3383042613,-49,1.3327035325,4.1330679173,8.6710077938
13,285,2002,930,650,-102,1870,73,280,-29,194,59827,15.570065294,10.8823037,-1.707684581,-57,1.2221664155,4.6877615938,-0.485518165
13,285,2003,922,669,91,1957,64,253,155,321,60148,15.369868723,11.152323401,1.5169827047,-87,1.0668889352,4.2175453219,2.5838716399
13,285,2004,934,637,733,2201,63,297,796,1029,61177,15.396661859,10.500721203,12.083247476,-64,1.0385328663,4.8959406553,13.121780342
13,285,2005,957,631,689,2538,65,326,754,1026,62203,15.513049117,10.228562166,11.168746961,-54,1.0536553736,5.2844869509,12.222402334
13,285,2006,961,624,64,2469,67,337,131,438,62641,15.395213226,9.9964756016,1.0252795489,-30,1.0733395277,5.3987376246,2.0986190766
13,285,2007,1007,662,344,2419,59,345,403,741,63382,15.981209779,10.506018743,5.4593209176,-7,0.9363370178,5.4751910366,6.3956579355
13,285,2008,1031,662,406,2565,61,369,467,851,64233,16.15797516,10.374955922,6.3628883752,15,0.9560004702,5.7830192376,7.3188888454
13,287,2001,159,106,-32,120,12,53,-20,24,9523,16.717485017,11.144990012,-3.364525287,-9,1.2616969824,5.5724950058,-2.102828304
13,287,2002,150,105,40,201,11,45,51,88,9611,15.678896206,10.975227344,4.1810389882,-8,1.1497857218,4.7036688617,5.3308247099
13,287,2003,125,110,-138,144,11,15,-127,-119,9492,13.086949694,11.516515731,-14.44799246,-7,1.1516515731,1.5704339633,-13.29634089
13,287,2004,150,104,-83,202,10,46,-73,-37,9455,15.83364121,10.977991239,-8.761281469,-10,1.0555760806,4.855649971,-7.705705389
13,287,2005,148,112,-54,206,11,36,-43,-14,9441,15.66469094,11.854360711,-5.715495343,-7,1.1642675699,3.8103302286,-4.551227773
13,287,2006,146,93,-188,226,11,53,-177,-127,9314,15.569181552,9.9173553719,-20.0479872,-3,1.1730205279,5.6518261797,-18.87496668
13,287,2007,173,84,-130,164,11,89,-119,-36,9278,18.610154905,9.0361445783,-13.98450947,-6,1.1833046472,9.574010327,-12.80120482
13,287,2008,147,96,-109,163,10,51,-99,-50,9228,15.886739436,10.375013509,-11.77996326,-2,1.0807305739,5.5117259267,-10.69923268
13,289,2001,115,108,-33,140,-1,7,-34,-37,10534,10.897891495,10.234541578,-3.127221038,-10,-0.094764274,0.6633499171,-3.221985312
13,289,2002,128,113,183,144,-2,15,181,190,10724,12.042525167,10.631291749,17.2170477,-6,-0.188164456,1.411233418,17.028883244
13,289,2003,122,96,45,147,-5,26,40,55,10779,11.347253872,8.928986653,4.1854624936,-11,-0.465051388,2.4182672185,3.7204111054
13,289,2004,137,111,-121,146,2,26,-119,-104,10675,12.77151114,10.347720705,-11.2799478,-11,0.1864454181,2.4237904354,-11.09350238
13,289,2005,131,103,-226,144,-1,28,-227,-207,10468,12.391808163,9.743177411,-21.37823393,-8,-0.094593955,2.6486307525,-21.47282789
13,289,2006,128,103,-168,150,1,25,-167,-146,10322,12.313612314,9.9086099086,-16.16161616,-4,0.0962000962,2.405002405,-16.06541607
13,289,2007,116,88,-89,159,-1,28,-90,-61,10261,11.271437594,8.5507457611,-8.647913327,1,-0.097167565,2.7206918331,-8.745080892
13,289,2008,115,101,-22,159,1,14,-21,-4,10257,11.209669558,9.8450141339,-2.144458524,3,0.0974753875,1.3646554245,-2.046983137
13,291,2001,190,192,450,472,3,-2,453,439,17844,10.780447672,10.893926069,25.532639224,-12,0.1702175948,-0.113478397,25.702856819
13,291,2002,171,205,548,462,3,-34,551,511,18355,9.4477748004,11.326279731,30.277079477,-6,0.1657504351,-1.878504931,30.442829912
13,291,2003,162,235,703,507,2,-73,705,655,19010,8.671216379,12.578616352,37.628797003,23,0.1070520541,-3.907399973,37.735849057
13,291,2004,181,271,473,528,1,-90,474,355,19365,9.4332247557,14.123778502,24.651465798,-29,0.0521172638,-4.690553746,24.703583062
13,291,2005,203,226,478,490,2,-23,480,443,19808,10.36428152,11.538559722,24.404564368,-14,0.102111148,-1.174278202,24.506675516
13,291,2006,171,294,700,485,1,-123,701,566,20374,8.5112737046,14.633417948,34.841471306,-12,0.0497735304,-6.122144244,34.891244836
13,291,2007,216,276,704,511,1,-60,705,636,21010,10.438816934,13.338488305,34.022810748,-9,0.0483278562,-2.899671371,34.071138604
13,291,2008,199,289,436,485,0,-90,436,341,21351,9.3954344798,13.644625953,20.584972026,-5,0,-4.249191473,20.584972026
13,293,2001,376,369,63,468,42,7,105,86,27701,13.594620001,13.341528672,2.2778219683,-26,1.5185479789,0.2530913298,3.7963699472
13,293,2002,369,355,-174,467,40,14,-134,-143,27558,13.355290541,12.848585751,-6.297616678,-23,1.4477279719,0.5067047902,-4.849888706
13,293,2003,345,384,68,494,37,-39,105,31,27589,12.512013346,13.926414855,2.4661359639,-35,1.341868098,-1.414401509,3.8080040619
13,293,2004,312,404,-30,526,32,-92,2,-111,27478,11.331650535,14.673034667,-1.089581782,-21,1.1622205677,-3.341384132,0.0726387855
13,293,2005,317,379,18,519,36,-62,54,-32,27446,11.543223363,13.8008885,0.6554511689,-24,1.3109023378,-2.257665137,1.9663535067
13,293,2006,387,357,-19,489,34,30,15,33,27479,14.091943559,12.999544834,-0.691852526,-12,1.2380518889,1.0923987255,0.5461993628
13,293,2007,356,331,40,514,33,25,73,102,27581,12.931347621,12.023247367,1.4529604068,4,1.1986923356,0.9081002543,2.6516527425
13,293,2008,331,361,-67,541,32,-30,-35,-51,27530,12.012120992,13.100832865,-2.431456515,14,1.1612926639,-1.088711872,-1.270163851
13,295,2001,746,669,414,1201,37,77,451,475,61590,12.159243715,10.904201133,6.747891284,-53,0.6030724094,1.2550425818,7.3509636934
13,295,2002,802,690,291,1311,35,112,326,384,61974,12.981127189,11.168301447,4.7101097407,-54,0.5665080444,1.8128257421,5.2766177851
13,295,2003,762,695,207,1360,22,67,229,222,62196,12.273496014,11.194330354,3.3341386808,-74,0.3543529033,1.07916566,3.6884915841
13,295,2004,747,649,342,1275,28,98,370,416,62612,11.970386514,10.399974361,5.4804179219,-52,0.4486891866,1.5704121531,5.9291071085
13,295,2005,734,729,575,1274,26,5,601,548,63160,11.671914258,11.592405305,9.1435295614,-58,0.4134465541,0.0795089527,9.5569761155
13,295,2006,751,646,525,1339,28,105,553,626,63786,11.831802499,10.177555811,8.2712334378,-32,0.44113245,1.6542466876,8.7123658879
13,295,2007,830,739,497,1284,23,91,520,635,64421,12.947810962,11.528231688,7.7530868049,24,0.3587947616,1.4195792741,8.1118815665
13,295,2008,820,706,217,1285,25,114,242,378,64799,12.691533818,10.927101068,3.3586132178,22,0.3869370067,1.7644327503,3.7455502244
13,297,2001,1015,488,2179,537,56,527,2235,2733,64294,16.129673036,7.7549561003,34.627150292,-29,0.8899129951,8.3747169362,35.517063287
13,297,2002,1022,504,2012,568,56,518,2068,2558,66852,15.585683132,7.6860903116,30.683360529,-28,0.8540100346,7.8995928202,31.537370564
13,297,2003,1060,531,1763,693,39,529,1802,2336,69188,15.583651867,7.8065274919,25.918847398,5,0.5733607762,7.7771243752,26.492208174
13,297,2004,1075,557,2074,756,38,518,2112,2526,71714,15.25883238,7.9062043122,29.438900796,-104,0.5393819818,7.3526280677,29.978282778
13,297,2005,1088,583,3235,886,38,505,3273,3742,75456,14.78562207,7.9228103554,43.96276415,-36,0.5164095943,6.8628117143,44.479173745
13,297,2006,1147,559,2950,815,39,588,2989,3524,78980,14.854049574,7.2392447357,38.203527675,-53,0.5050635862,7.6148048383,38.708591261
13,297,2007,1207,647,3431,866,33,560,3464,3970,82950,14.907676156,7.9911072686,42.376335454,-54,0.4075835237,6.9165688878,42.783918977
13,297,2008,1331,689,2306,871,35,642,2341,2863,85813,15.773599663,8.1652968956,27.328265082,-120,0.4147828612,7.6083027678,27.743047943
13,299,2001,500,457,-73,2313,58,43,-15,-6,35429,14.111537593,12.89794536,-2.060284489,-34,1.6369383608,1.213592233,-0.423346128
13,299,2002,505,430,-397,2074,54,75,-343,-292,35137,14.312841879,12.187172293,-11.25187767,-24,1.5304821019,2.1256695859,-9.721395573
13,299,2003,464,437,-14,2132,45,27,31,10,35147,13.203574071,12.435262649,-0.3983837,-48,1.280519037,0.7683114222,0.8821353366
13,299,2004,515,431,-344,2047,48,84,-296,-246,34901,14.704202832,12.305847419,-9.821836455,-34,1.3704888077,2.3983554134,-8.451347647
13,299,2005,527,430,-105,2048,49,97,-56,11,34912,15.097474682,12.318622606,-3.008035753,-30,1.4037500179,2.7788520763,-1.604285735
13,299,2006,544,430,399,2261,54,114,453,548,35460,15.460694594,12.220769624,11.339737396,-19,1.5347013017,3.2399249702,12.874438697
13,299,2007,530,458,247,2448,48,72,295,355,35815,14.871974746,12.851631007,6.9309014381,-12,1.346895826,2.020343739,8.2777972641
13,299,2008,516,442,-59,2479,50,74,-9,64,35879,14.394510001,12.330181047,-1.645883895,-1,1.3948168605,2.0643289536,-0.251067035
13,301,2001,94,85,54,114,1,9,55,61,6357,14.85813641,13.435548882,8.5355251719,-3,0.158065281,1.4225875286,8.6935904529
13,301,2002,106,97,-111,112,1,9,-110,-107,6250,16.816054573,15.388276354,-17.60926469,-6,0.1586420243,1.4277782185,-17.45062267
13,301,2003,81,72,-70,113,1,9,-69,-66,6184,13.028792022,11.581148464,-11.2594499,-6,0.1608492842,1.447643558,-11.09860061
13,301,2004,63,72,-39,113,0,-9,-39,-51,6133,10.229763741,11.691158561,-6.332710887,-3,0,-1.46139482,-6.332710887
13,301,2005,103,90,-75,108,1,13,-74,-67,6066,16.886630052,14.755307812,-12.29608984,-6,0.1639478646,2.1313222395,-12.13214198
13,301,2006,86,95,-131,99,0,-9,-131,-142,5924,14.34528774,15.846538782,-21.85154295,-2,0,-1.501251043,-21.85154295
13,301,2007,79,51,-64,83,1,28,-63,-43,5881,13.384159255,8.6404066074,-10.84286319,-8,0.1694197374,4.7437526472,-10.67344346
13,301,2008,77,71,-46,83,0,6,-46,-37,5844,13.134328358,12.1108742,-7.846481876,3,0,1.0234541578,-7.846481876
13,303,2001,281,216,-90,1490,5,65,-85,-40,21120,13.292336802,10.217596973,-4.257332072,-20,0.2365184484,3.0747398297,-4.020813623
13,303,2002,227,235,-193,1496,5,-8,-188,-211,20909,10.802065241,11.182754765,-9.184134764,-15,0.2379309524,-0.380689524,-8.946203812
13,303,2003,260,221,49,1609,5,39,54,66,20975,12.415242097,10.552955783,2.339795626,-27,0.2387546557,1.8622863146,2.5785502817
13,303,2004,255,233,-76,1618,4,22,-72,-65,20910,12.176196729,11.125701325,-3.628984123,-15,0.1909991644,1.0504954041,-3.437984959
13,303,2005,277,227,-1030,717,5,50,-1025,-986,19924,13.567125435,11.118185826,-50.44815595,-11,0.2448939609,2.4489396091,-50.20326199
13,303,2006,264,220,575,1371,4,44,579,612,20536,13.049925853,10.874938211,28.423133959,-11,0.1977261493,2.1749876421,28.620860109
13,303,2007,294,237,346,1700,5,57,351,409,20945,14.175164533,11.426918348,16.682336491,1,0.2410742268,2.748246185,16.923410718
13,303,2008,294,234,-15,1691,4,60,-11,61,21006,14.016352411,11.155872327,-0.715120021,12,0.1906986723,2.8604800839,-0.524421349
13,305,2001,370,250,136,2182,20,120,156,253,26847,13.847046275,9.3561123482,5.0897251174,-23,0.7484889879,4.4909339271,5.8382141053
13,305,2002,385,248,229,2346,16,137,245,363,27210,14.24422369,9.1754999353,8.4725382467,-19,0.5919677378,5.0687237546,9.0645059844
13,305,2003,424,249,310,2439,5,175,315,473,27683,15.448235658,9.0721949975,11.294700599,-17,0.1821725903,6.3760406609,11.47687319
13,305,2004,396,306,228,2450,21,90,249,314,27997,14.224137931,10.99137931,8.1896551724,-25,0.7543103448,3.2327586207,8.9439655172
13,305,2005,391,255,152,2413,17,136,169,276,28273,13.897280967,9.0634441088,5.4025235472,-29,0.6042296073,4.833836858,6.0067531544
13,305,2006,441,269,79,2282,21,172,100,259,28532,15.526802218,9.4709972714,2.7814452953,-13,0.7393715342,6.0558049467,3.5208168295
13,305,2007,442,280,274,2343,15,162,289,457,28989,15.368300273,9.7355748335,9.5269553728,6,0.5215486518,5.6327254394,10.048504025
13,305,2008,437,281,341,2511,18,156,359,520,29509,14.940681733,9.607166057,11.65851824,5,0.6154056549,5.3335156757,12.273923895
13,307,2001,33,21,-106,2,7,12,-99,-89,2288,14.147909968,9.0032154341,-45.44480171,-2,3.0010718114,5.1446945338,-42.4437299
13,307,2002,26,35,-36,2,7,-9,-29,-41,2247,11.466372657,15.435501654,-15.87651599,-3,3.0871003308,-3.969128997,-12.78941566
13,307,2003,24,24,26,2,7,0,33,33,2280,10.603048376,10.603048376,11.486635741,0,3.0925557765,0,14.579191518
13,307,2004,20,22,-4,2,6,-2,2,-1,2279,8.7738539153,9.6512393069,-1.754770783,-1,2.6321561746,-0.877385392,0.8773853915
13,307,2005,28,27,-42,2,7,1,-35,-35,2244,12.381162945,11.938978554,-18.57174442,-1,3.0952907362,0.4421843909,-15.47645368
13,307,2006,28,28,-37,2,6,0,-31,-33,2211,12.570145903,12.570145903,-16.61054994,-2,2.6936026936,0,-13.91694725
13,307,2007,25,13,14,2,6,12,20,23,2234,11.248593926,5.8492688414,6.2992125984,-9,2.6996625422,5.3993250844,8.9988751406
13,307,2008,25,6,-78,2,5,19,-73,-70,2164,11.368804002,2.7285129604,-35.47066849,-16,2.2737608004,8.6402910414,-33.19690769
13,309,2001,64,63,472,1583,11,1,483,489,6672,9.9572150914,9.8016336056,73.434461299,5,1.7113963438,0.1555814858,75.145857643
13,309,2002,64,65,-141,1526,11,-1,-130,-136,6536,9.6910963053,9.842519685,-21.35069655,-5,1.6656571775,-0.15142338,-19.68503937
13,309,2003,74,56,-64,1545,9,18,-55,-43,6493,11.359275462,8.5962084581,-9.824238238,-6,1.3815335022,2.7630670044,-8.442704736
13,309,2004,81,51,-138,1462,8,30,-130,-108,6385,12.579593105,7.9204845473,-21.43189936,-8,1.2424289486,4.6591085572,-20.18947041
13,309,2005,80,59,149,1580,9,21,158,177,6562,12.35807523,9.114080482,23.016915115,-2,1.3902834634,3.2439947478,24.407198579
13,309,2006,66,46,208,1760,8,20,216,233,6795,9.8824586359,6.8877742008,31.144718125,-3,1.1978737741,2.9946844351,32.342591899
13,309,2007,76,37,-66,1763,8,39,-58,-18,6777,11.199528441,5.4524020041,-9.725906278,1,1.1788977306,5.7471264368,-8.547008547
13,309,2008,78,41,62,1765,7,37,69,100,6877,11.425223378,6.0055661345,9.0815878131,-6,1.0253405595,5.4196572433,10.106928373
13,311,2001,272,185,706,532,15,87,721,804,20930,13.250194856,9.01208106,34.392049883,-4,0.7307092751,4.2381137958,35.122759158
13,311,2002,285,212,912,536,13,73,925,997,21927,13.300044333,9.8933663112,42.560141867,-1,0.6066686889,3.4066780223,43.166810556
13,311,2003,279,189,592,500,9,90,601,701,22628,12.523846931,8.4838963079,26.57389743,10,0.4039950623,4.0399506228,26.977892492
13,311,2004,297,238,621,510,10,59,631,657,23285,12.937512251,10.36743406,27.05116198,-33,0.4356064731,2.5700781914,27.486768453
13,311,2005,287,225,426,510,10,62,436,481,23766,12.199528172,9.56409003,18.108010457,-17,0.425070668,2.6354381416,18.533081125
13,311,2006,304,228,624,551,10,76,634,695,24461,12.607045846,9.4552843843,25.87762042,-15,0.4147054555,3.1517614614,26.292325876
13,311,2007,299,238,411,538,9,61,420,475,24936,12.10599834,9.6362127255,16.640686681,-6,0.3643945989,2.4697856145,17.00508128
13,311,2008,321,243,288,542,9,78,297,363,25299,12.779934309,9.6745297104,11.466109286,-12,0.3583159152,3.1054045984,11.824425202
13,313,2001,1728,685,-543,794,977,1043,434,1406,85493,20.379761764,8.0787828753,-6.404057082,-71,11.522585211,12.300978889,5.1185281283
13,313,2002,1816,654,-1090,811,916,1162,-174,932,86425,21.126350935,7.6082783653,-12.68046394,-56,10.656243093,13.518072569,-2.024220849
13,313,2003,1707,772,-1106,816,816,935,-290,584,87009,19.684721566,8.9025219968,-12.75413125,-61,9.4099196236,10.782199569,-3.344211631
13,313,2004,1831,700,-247,1081,726,1131,479,1547,88556,20.858371543,7.9742545496,-2.813772677,-63,8.2704411472,12.884116994,5.4566684704
13,313,2005,1851,736,-347,1138,771,1115,424,1456,90012,20.731598047,8.2433582725,-3.88647462,-83,8.635365799,12.488239774,4.7488911787
13,313,2006,1844,689,-571,1138,769,1155,198,1305,91317,20.33872133,7.5994463103,-6.29794462,-48,8.4818203376,12.739275019,2.1838757176
13,313,2007,1881,719,-537,1146,708,1162,171,1316,92633,20.451209568,7.8173416689,-5.838543082,-17,7.6977439522,12.633867899,1.8592008698
13,313,2008,1887,699,-660,1098,710,1188,50,1202,93835,20.239397645,7.4972649463,-7.07896261,-36,7.6152476564,12.742132698,0.5362850462
13,315,2001,108,102,210,1590,1,6,211,212,8786,12.442396313,11.751152074,24.193548387,-5,0.1152073733,0.6912442396,24.30875576
13,315,2002,105,88,-141,1592,1,17,-140,-127,8659,12.03783319,10.088850674,-16.16509028,-4,0.1146460304,1.9489825165,-16.05044425
13,315,2003,93,98,32,1617,0,-5,32,18,8677,10.729118597,11.30595293,3.6917397323,-9,0,-0.576834333,3.6917397323
13,315,2004,107,106,41,1691,0,1,41,35,8712,12.306630629,12.191615389,4.7156248203,-7,0,0.1150152395,4.7156248203
13,315,2005,103,100,-104,1672,0,3,-104,-109,8603,11.89719896,11.550678602,-12.01270575,-8,0,0.3465203581,-12.01270575
13,315,2006,108,106,31,1775,0,2,31,30,8633,12.531909956,12.299837549,3.5971223022,-3,0,0.2320724066,3.5971223022
13,315,2007,93,84,-26,1785,0,9,-26,-18,8615,10.783858998,9.7402597403,-3.014842301,-1,0,1.0435992579,-3.014842301
13,315,2008,97,87,126,1979,0,10,126,135,8750,11.171897495,10.020155485,14.511949323,-1,0,1.1517420098,14.511949323
13,317,2001,134,144,-70,138,10,-10,-60,-80,10590,12.605832549,13.546566322,-6.585136406,-10,0.9407337723,-0.940733772,-5.644402634
13,317,2002,130,147,27,155,10,-17,37,11,10601,12.269359634,13.873814355,2.5482516163,-9,0.9437968949,-1.604454721,3.4920485112
13,317,2003,120,133,17,162,10,-13,27,-1,10600,11.320220744,12.546577992,1.6036979388,-15,0.9433517287,-1.226357247,2.5470496675
13,317,2004,127,148,-145,162,8,-21,-137,-169,10431,12.077409538,14.074461509,-13.78916837,-11,0.7607817032,-1.997051971,-13.02838667
13,317,2005,132,140,-97,157,9,-8,-88,-104,10327,12.717988245,13.488775412,-9.345794393,-8,0.8671355622,-0.770787166,-8.47865883
13,317,2006,131,137,-5,137,8,-6,3,-7,10320,12.689494842,13.270693079,-0.484331864,-4,0.7749309827,-0.581198237,0.2905991185
13,317,2007,130,112,-76,172,8,18,-68,-52,10268,12.628715757,10.880124344,-7.382941519,-2,0.7771517389,1.7485914125,-6.60578978
13,317,2008,120,134,19,183,7,-14,26,14,10282,11.678832117,13.04136253,1.8491484185,2,0.6812652068,-1.362530414,2.5304136253
13,319,2001,149,110,34,100,15,39,49,78,10300,14.521001852,10.720202709,3.3135172011,-10,1.461845824,3.8007991424,4.775363025
13,319,2002,156,104,-118,94,14,52,-104,-58,10242,15.188394509,10.125596339,-11.48865738,-6,1.3630610457,5.0627981696,-10.12559634
13,319,2003,128,112,-78,97,8,16,-70,-63,10179,12.536114784,10.969100436,-7.639194946,-9,0.783507174,1.567014348,-6.855687772
13,319,2004,153,113,-92,88,13,40,-79,-47,10132,15.065727931,11.126975531,-9.05913052,-8,1.2800945301,3.9387524002,-7.77903599
13,319,2005,150,106,-85,115,11,44,-74,-39,10093,14.833127318,10.482076638,-8.405438813,-9,1.08776267,4.3510506799,-7.317676143
13,319,2006,178,91,-158,107,13,87,-145,-61,10032,17.689440994,9.0434782609,-15.70186335,-3,1.2919254658,8.6459627329,-14.40993789
13,319,2007,183,86,-76,92,8,97,-68,29,10061,18.21529886,8.5601950928,-7.56482357,0,0.7962972179,9.6551037675,-6.768526352
13,319,2008,169,100,-120,103,10,69,-110,-35,10026,16.826803405,9.9566884054,-11.94802609,6,0.9956688405,6.8701149998,-10.95235725
13,321,2001,302,198,-88,207,7,104,-81,1,21970,13.74633014,9.0124945948,-4.005553153,-22,0.3186235463,4.7338355447,-3.686929607
13,321,2002,299,182,-313,216,6,117,-307,-205,21765,13.673259403,8.3228535498,-14.31347891,-15,0.2743797874,5.3504058534,-14.03909912
13,321,2003,264,200,-84,236,2,64,-82,-46,21719,12.142397204,9.1987857603,-3.863490019,-28,0.0919878576,2.9436114433,-3.771502162
13,321,2004,245,207,-92,211,8,38,-84,-61,21658,11.296309104,9.5442285082,-4.241879337,-15,0.3688590728,1.7520805957,-3.873020264
13,321,2005,296,226,-293,205,5,70,-288,-236,21422,13.74187558,10.492107707,-13.60259981,-18,0.2321262767,3.2497678737,-13.37047354
13,321,2006,269,212,-27,201,7,57,-20,26,21448,12.549568463,9.8903662235,-1.259622113,-11,0.3265686961,2.6592022393,-0.933053417
13,321,2007,233,188,-240,218,4,45,-236,-190,21258,10.91181567,8.804383459,-11.23963846,1,0.1873273076,2.1074322109,-11.05231115
13,321,2008,227,198,17,213,6,29,23,48,21306,10.666290762,9.3036368762,0.7987971055,-4,0.2819283902,1.3626538859,1.0807254957
15,0,2001,17303,8489,-6518,36300,5145,8814,-1373,6476,1217955,14.244470111,6.9884590403,-5.365858879,-965,4.2355544542,7.2560110709,-1.130304425
15,0,2002,17269,8788,-724,35728,2766,8481,2042,9436,1227391,14.12397264,7.1875309261,-0.592145242,-1087,2.2622565477,6.9364417142,1.6701113053
15,0,2003,17829,8470,5019,35391,-2002,9359,3017,10942,1238333,14.461472574,6.8701930954,4.0710152474,-1434,-1.623863823,7.5912794782,2.4471514249
15,0,2004,18409,8913,-1972,37492,6800,9496,4828,13199,1251532,14.787147094,7.1594243061,-1.584021624,-1125,5.4621435299,7.6277227882,3.8781219062
15,0,2005,18016,8846,1058,38001,3865,9170,4923,12936,1264468,14.321144674,7.0317965024,0.8410174881,-1157,3.0723370429,7.2893481717,3.913354531
15,0,2006,18374,8924,-3461,36898,5420,9450,1959,10796,1275264,14.469243211,7.0275131392,-2.725484421,-613,4.2681668775,7.4417300723,1.5426824563
15,0,2007,19256,9174,-11849,34199,3263,10082,-8586,2092,1277356,15.087243695,7.1879088936,-9.283794689,596,2.5565889165,7.8993348011,-6.727205773
15,0,2008,19182,9355,-3752,34199,4098,9827,346,10842,1288198,14.953495424,7.2927718536,-2.924904329,669,3.1946316468,7.6607235708,0.2697273182
15,1,2001,2008,1233,641,2807,461,775,1102,1746,150806,13.392648716,8.2236732407,4.2752429418,-131,3.0747067023,5.1689754757,7.3499496442
15,1,2002,1915,1262,1254,2889,433,653,1687,2234,153040,12.605069673,8.306839649,8.2541813945,-106,2.8501280254,4.2982300244,11.10430942
15,1,2003,2083,1246,1987,2874,342,837,2329,3087,156127,13.474918086,8.0603686681,12.853894497,-79,2.2123965365,5.4145494183,15.066291034
15,1,2004,2214,1216,2579,2863,349,998,2928,3738,159865,14.013012988,7.6963973771,16.323198056,-188,2.2089166814,6.3166156105,18.532114737
15,1,2005,2274,1179,3291,2895,362,1095,3653,4597,164462,14.022884311,7.2704400189,20.294332572,-151,2.2323149167,6.7524442923,22.526647488
15,1,2006,2275,1228,3276,2943,366,1047,3642,4599,169061,13.642237567,7.3638099921,19.644822096,-90,2.1947511866,6.2784275747,21.839573283
15,1,2007,2574,1374,1920,2900,315,1200,2235,3486,172547,15.069904686,8.0443080958,11.240954544,51,1.8442191049,7.0255965902,13.085173649
15,1,2008,2657,1334,1498,2900,320,1323,1818,3237,175784,15.255604583,7.6593814504,8.6010145523,96,1.8373328817,7.5962231326,10.438347434
15,3,2001,12751,5928,-8112,31400,3937,6823,-4175,1970,877024,14.555288064,6.766822025,-9.259861718,-678,4.494092158,7.7884660386,-4.76576956
15,3,2002,12756,6184,-2161,30665,1635,6572,-526,5254,882278,14.501205592,7.0300607855,-2.456656106,-792,1.8586916857,7.4711448063,-0.59796442
15,3,2003,13088,6034,2296,30403,-2930,7054,-634,5298,887576,14.789920525,6.8186415377,2.5945642974,-1122,-3.311007575,7.9712789869,-0.716443277
15,3,2004,13500,6393,-5942,32491,5902,7107,-40,6303,893879,15.15615045,7.1772792465,-6.670951554,-764,6.6260444412,7.9788712036,-0.044907112
15,3,2005,13048,6335,-3024,32735,2925,6713,-99,5794,899673,14.549898748,7.0641944031,-3.372079538,-820,3.2616840772,7.4857043453,-0.110395461
15,3,2006,13362,6380,-6571,31762,4475,6982,-2096,4461,904134,14.815332239,7.0739275322,-7.285701852,-425,4.9617281671,7.7414047068,-2.323973685
15,3,2007,13677,6365,-13868,29063,2435,7312,-11433,-3609,900525,15.157434175,7.0539642115,-15.36910851,512,2.6985707549,8.103469963,-12.67053776
15,3,2008,13521,6603,-6191,29063,3260,6918,-2931,4509,905034,14.977079121,7.3140783547,-6.857709995,522,3.6110700343,7.663000766,-3.24663996
15,5,2001,0,3,-4,0,1,-3,-3,-7,138,0,21.201413428,-28.26855124,-1,7.0671378092,-21.20141343,-21.20141343
15,5,2002,0,0,-6,0,1,0,-5,-5,133,0,0,-44.2804428,0,7.3800738007,0,-36.900369
15,5,2003,0,3,-2,0,1,-3,-1,-4,129,0,22.900763359,-15.26717557,0,7.6335877863,-22.90076336,-7.633587786
15,5,2004,0,6,-4,0,0,-6,-4,-10,119,0,48.387096774,-32.25806452,0,0,-48.38709677,-32.25806452
15,5,2005,0,0,-1,0,1,0,0,0,119,0,0,-8.403361345,0,8.4033613445,0,0
15,5,2006,0,2,2,0,0,-2,2,0,119,0,16.806722689,16.806722689,0,0,-16.80672269,16.806722689
15,5,2007,0,0,-2,0,1,0,-1,-1,118,0,0,-16.87763713,0,8.4388185654,0,-8.438818565
15,5,2008,0,0,-1,0,0,0,-1,-1,117,0,0,-8.510638298,0,0,0,-8.510638298
15,7,2001,764,449,-190,607,148,315,-42,216,58722,13.034428635,7.6602859385,-3.241546388,-57,2.5249940287,5.3741426963,-0.71655236
15,7,2002,779,451,272,668,138,328,410,687,59409,13.188748085,7.6355909964,4.6050570976,-51,2.3363892628,5.5531570883,6.9414463604
15,7,2003,764,396,158,675,109,368,267,554,59963,12.800321683,6.6347217103,2.647186945,-81,1.8262239051,6.1655999732,4.4734108501
15,7,2004,819,436,534,586,114,383,648,974,60937,13.548387097,7.2125723739,8.8337468983,-57,1.8858560794,6.3358147229,10.719602978
15,7,2005,780,448,258,717,116,332,374,652,61589,12.731991577,7.3127336239,4.2113510602,-54,1.8934756705,5.4192579534,6.1048267307
15,7,2006,800,463,-66,645,118,337,52,361,61950,12.951375679,7.4956086742,-1.068488494,-28,1.9103279126,5.4557670048,0.8418394191
15,7,2007,856,469,308,643,97,387,405,811,62761,13.727738531,7.5213894524,4.9394199389,19,1.5555965392,6.2063490791,6.4950164781
15,7,2008,885,446,366,643,100,439,466,928,63689,13.997627521,7.0541716093,5.7888493476,23,1.5816528272,6.9434559114,7.3705021748
15,9,2001,1780,876,1147,1486,598,904,1745,2551,131265,13.693413699,6.7390058428,8.8237896138,-98,4.6003715685,6.954407856,13.424161182
15,9,2002,1819,891,-83,1506,559,928,476,1266,132531,13.790959681,6.7552199427,-0.629274136,-138,4.2381233984,7.0357397383,3.6088492623
15,9,2003,1894,791,580,1439,476,1103,1056,2007,134538,14.183600493,5.9235628246,4.3434468246,-152,3.5646218767,8.2600376682,7.9080687013
15,9,2004,1876,862,861,1552,435,1014,1296,2194,136732,13.83123825,6.3552917757,6.3479190474,-116,3.207136801,7.475946474,9.5550558484
15,9,2005,1914,884,534,1654,461,1030,995,1893,138625,13.901952738,6.4207556009,3.878601234,-132,3.3483804661,7.4811971368,7.2269817001
15,9,2006,1937,851,-102,1548,461,1086,359,1375,140000,13.903992822,6.108568865,-0.732166891,-70,3.309107223,7.7954239569,2.576940332
15,9,2007,2149,966,-207,1593,415,1183,208,1405,141405,15.273360459,6.8655496526,-1.471189211,14,2.9494856168,8.4078108065,1.4782964055
15,9,2008,2119,972,576,1593,418,1147,994,2169,143574,14.871271216,6.8215552725,4.0424031244,28,2.9335494896,8.049715944,6.9759526141
16,0,2001,20695,9748,7422,32878,2733,10947,10155,21258,1320732,15.796467911,7.4406363469,5.6652034229,156,2.0860955207,8.3558315644,7.7512989437
16,0,2002,20714,9819,6847,33291,2376,10895,9223,20676,1341408,15.561916353,7.3767720706,5.1439819093,558,1.7850300886,8.1851442824,6.9290119979
16,0,2003,21242,9906,9068,33452,1512,11336,10580,21602,1363010,15.709110056,7.3257906137,6.7060639295,-314,1.118170342,8.3833194425,7.8242342715
16,0,2004,22273,10358,13170,33634,2360,11915,15530,27319,1390329,16.178901327,7.5239554592,9.5665662674,-126,1.7142821861,8.6549458675,11.280848453
16,0,2005,22790,10372,20215,34138,2095,12418,22310,33798,1424127,16.194959168,7.3705184945,14.365120649,-930,1.4887424071,8.8244406734,15.853863056
16,0,2006,23548,10437,22049,34192,2273,13111,24322,37056,1461183,16.322682831,7.2345779136,15.283626369,-377,1.5755672701,9.0881049177,16.85919364
16,0,2007,24435,10703,19975,34542,1859,13732,21834,34962,1496145,16.525052345,7.2382907814,13.508816066,-604,1.2572159733,9.2867615631,14.76603204
16,0,2008,24733,10773,12767,34542,1934,13960,14701,27671,1523816,16.379681724,7.1345292207,8.4550760755,-990,1.2808112423,9.2451525036,9.7358873178
16,1,2001,4884,1837,6691,8297,776,3047,7467,10333,313472,15.84143001,5.958375702,21.702499631,-181,2.5169839656,9.8830543081,24.219483597
16,1,2002,4836,1877,3988,8516,685,2959,4673,7395,320867,15.247367732,5.9179713056,12.573718469,-237,2.1597284733,9.3293964268,14.733446942
16,1,2003,5038,1872,2043,8439,514,3166,2557,5329,326196,15.57189949,5.7861444712,6.3146865143,-394,1.5887170183,9.7857550192,7.9034035326
16,1,2004,5140,2009,3656,8534,645,3131,4301,7126,333322,15.587140912,6.0923280335,11.086884664,-306,1.9559739082,9.4948128785,13.042858572
16,1,2005,5287,2077,9845,8973,604,3210,10449,13427,346749,15.548376567,6.108185763,28.952859334,-232,1.7762851232,9.4401908036,30.729144457
16,1,2006,5604,2178,10285,9096,638,3426,10923,14120,360869,15.839054405,6.155863757,29.06935663,-229,1.8032328177,9.6831906481,30.872589448
16,1,2007,5786,2252,8380,9858,556,3534,8936,12289,373158,15.76508766,6.1360140703,22.832947562,-181,1.5149306497,9.6290735899,24.347878212
16,1,2008,5914,2241,3795,9858,572,3673,4367,7762,380920,15.685380027,5.9436822186,10.065271762,-278,1.5170844395,9.7416978084,11.582356202
16,3,2001,19,33,-16,38,3,-14,-13,-30,3428,5.5184432181,9.5846645367,-4.647110078,-3,0.8713331397,-4.066221319,-3.775776939
16,3,2002,25,27,12,38,3,-2,15,10,3438,7.2822604136,7.8648412467,3.4954849985,-3,0.8738712496,-0.582580833,4.3693562482
16,3,2003,24,26,9,38,2,-2,11,7,3445,6.973703327,7.554845271,2.6151387476,-2,0.5811419439,-0.581141944,3.1962806916
16,3,2004,26,34,22,38,1,-8,23,13,3458,7.5329566855,9.8507895118,6.3740402723,-2,0.2897291033,-2.317832826,6.6637693756
16,3,2005,34,34,56,38,2,0,58,57,3515,9.7519001864,9.7519001864,16.061953248,-1,0.5736411874,0,16.635594436
16,3,2006,27,36,-47,38,1,-9,-46,-58,3457,7.7452667814,10.327022375,-13.48250143,-3,0.2868617326,-2.581755594,-13.1956397
16,3,2007,43,18,52,38,1,25,53,66,3523,12.320916905,5.1575931232,14.899713467,-12,0.2865329513,7.1633237822,15.186246418
16,3,2008,37,21,-21,38,0,16,-21,-24,3499,10.538308174,5.9812019368,-5.981201937,-19,0,4.5571062375,-5.981201937
16,5,2001,1404,556,-472,2274,69,848,-403,1022,76698,18.428340793,7.2978329636,-6.19528266,577,0.905666321,11.130507829,-5.289616339
16,5,2002,1386,590,-832,2254,64,796,-768,503,77201,18.011812942,7.6673662597,-10.81228598,475,0.8317143061,10.344446683,-9.980571674
16,5,2003,1409,616,-1219,2174,48,793,-1171,117,77318,18.237239433,7.9731295181,-15.77799494,495,0.6212828196,10.264109915,-15.15671212
16,5,2004,1467,573,-580,2145,61,894,-519,862,78180,18.868409883,7.3698697089,-7.459903021,487,0.7845760074,11.498540174,-6.675327014
16,5,2005,1535,558,-619,2114,55,977,-564,411,78591,19.582703434,7.1186635283,-7.896868681,-2,0.7016603836,12.464039905,-7.195208297
16,5,2006,1418,598,-82,2153,59,820,-23,796,79387,17.951866716,7.5706743977,-1.038119232,-1,0.7469394473,10.381192318,-0.291179785
16,5,2007,1510,585,-436,2204,51,925,-385,536,79923,18.956750989,7.3441717406,-5.473604921,-4,0.6402611261,11.612579248,-4.833343795
16,5,2008,1527,569,-113,2204,54,958,-59,889,80812,19.00021775,7.0799763586,-1.406040999,-10,0.6719133978,11.920241391,-0.734127601
16,7,2001,77,51,-80,56,3,26,-77,-58,6367,12.038774234,7.9737335835,-12.50781739,-7,0.469043152,4.0650406504,-12.03877423
16,7,2002,77,53,-228,56,3,24,-225,-199,6168,12.285600319,8.4563222976,-36.3781412,2,0.4786597527,3.8292780215,-35.89948145
16,7,2003,89,68,-47,56,1,21,-46,-31,6137,14.465664364,11.052417716,-7.639171069,-6,0.1625355547,3.4132466477,-7.476635514
16,7,2004,90,77,-81,56,0,13,-81,-74,6063,14.754098361,12.62295082,-13.27868852,-6,0,2.131147541,-13.27868852
16,7,2005,75,64,-130,56,1,11,-129,-121,5942,12.494793836,10.662224073,-21.65764265,-3,0.1665972511,1.8325697626,-21.4910454
16,7,2006,85,62,-61,56,0,23,-61,-41,5901,14.354470996,10.47032002,-10.30144389,-3,0,3.8841509753,-10.30144389
16,7,2007,66,52,-63,56,1,14,-62,-55,5846,11.236911552,8.853324253,-10.72614284,-7,0.1702562356,2.3835872989,-10.55588661
16,7,2008,76,61,-55,56,0,15,-55,-48,5798,13.053933356,10.477499141,-9.446925455,-8,0,2.576434215,-9.446925455
16,9,2001,129,95,-252,142,2,34,-250,-219,8974,14.201574283,10.458523697,-27.74261023,-3,0.2201794462,3.7430505862,-27.52243078
16,9,2002,118,97,-69,142,2,21,-67,-53,8921,13.188041352,10.841017044,-7.711651299,-7,0.2235261246,2.3470243085,-7.488125175
16,9,2003,103,114,-2,142,2,-11,0,-23,8898,11.560693642,12.795330827,-0.224479488,-12,0.2244794882,-1.234637185,0
16,9,2004,119,78,-26,142,1,41,-25,8,8906,13.367782521,8.762075938,-2.920691979,-8,0.1123343069,4.6057065828,-2.808357672
16,9,2005,107,100,142,142,2,7,144,143,9049,11.918685603,11.138958507,15.81732108,-8,0.2227791701,0.7797270955,16.040100251
16,9,2006,127,88,112,142,1,39,113,147,9196,13.921622362,9.6464784873,12.277336257,-5,0.1096190737,4.275143875,12.38695533
16,9,2007,124,102,7,142,1,22,8,28,9224,13.463626493,11.074918567,0.7600434311,-2,0.108577633,2.3887079262,0.8686210641
16,9,2008,119,102,112,142,0,17,112,128,9352,12.812230835,10.981912145,12.058570198,-1,0,1.8303186908,12.058570198
16,11,2001,777,298,-244,403,77,479,-167,275,42019,18.552344114,7.1153134439,-5.825961343,-37,1.8385205878,11.43703067,-3.987440755
16,11,2002,728,280,-522,403,74,448,-448,-25,41994,17.330651209,6.6656350803,-12.42664826,-25,1.7616321284,10.665016128,-10.66501613
16,11,2003,804,290,-144,403,58,514,-86,367,42361,19.062296248,6.8757038705,-3.414142612,-61,1.3751407741,12.186592377,-2.039001837
16,11,2004,738,279,-399,403,62,459,-337,86,42447,17.404018489,6.5795679653,-9.409489671,-36,1.4621262145,10.824450524,-7.947363456
16,11,2005,828,287,-174,403,61,541,-113,388,42835,19.417931099,6.7306113834,-4.080579724,-40,1.4305480641,12.687319716,-2.65003166
16,11,2006,819,295,-372,403,62,524,-310,194,43029,19.0766794,6.8713314078,-8.664865368,-20,1.4441442281,12.205347992,-7.22072114
16,11,2007,789,293,-223,403,56,496,-167,330,43359,18.266425892,6.7833495393,-5.162754086,1,1.2964763625,11.483076353,-3.866277724
16,11,2008,814,276,-47,403,57,538,10,544,43903,18.656459857,6.3257775435,-1.077215741,-4,1.3064105796,12.330682313,0.2291948385
16,13,2001,267,88,410,353,101,179,511,681,19798,13.722215084,4.5226776307,21.071566234,-9,5.1908004625,9.1995374534,26.262366697
16,13,2002,272,68,186,353,99,204,285,474,20272,13.576241577,3.3940603943,9.2837534315,-15,4.9413526329,10.182181183,14.225106064
16,13,2003,265,85,151,353,82,180,233,394,20666,12.946406761,4.1526210367,7.3770091358,-19,4.0060579413,8.7937857248,11.383067077
16,13,2004,266,89,57,353,75,177,132,294,20960,12.780473742,4.2761735454,2.7386729448,-15,3.6035170326,8.504300197,6.3421899774
16,13,2005,294,71,-172,353,78,223,-94,109,21069,13.990340003,3.3786195246,-8.184824764,-20,3.711722858,10.611720479,-4.473101906
16,13,2006,306,86,-33,353,77,220,44,254,21323,14.436686167,4.057369315,-1.556897528,-10,3.6327608983,10.379316852,2.0758633704
16,13,2007,298,80,-161,353,66,218,-95,122,21445,13.935652825,3.7411148522,-7.52899364,-1,3.0864197531,10.194537972,-4.442573887
16,13,2008,264,95,57,353,65,169,122,286,21731,12.22901612,4.400592922,2.6403557532,-5,3.0109319993,7.8284231981,5.6512877525
16,15,2001,75,43,39,76,11,32,50,75,6822,11.054609772,6.3379762694,5.7483970816,-7,1.6213427666,4.7166335028,7.3697398482
16,15,2002,62,26,124,76,10,36,134,166,6988,8.9790007241,3.7653874004,17.958001448,-4,1.4482259232,5.2136133237,19.406227371
16,15,2003,58,37,141,76,0,21,141,163,7151,8.2042577269,5.2337506189,19.944833439,1,0,2.970507108,19.944833439
16,15,2004,70,29,22,76,7,41,29,64,7215,9.7452317973,4.037310316,3.0627871363,-6,0.9745231797,5.7079214813,4.037310316
16,15,2005,53,45,1,76,4,8,5,10,7225,7.3407202216,6.2326869806,0.1385041551,-3,0.5540166205,1.108033241,0.6925207756
16,15,2006,50,49,214,76,6,1,220,216,7441,6.8184917496,6.6821219146,29.183144688,-5,0.81821901,0.136369835,30.001363698
16,15,2007,58,27,80,76,1,31,81,101,7542,7.7421077221,3.6040846292,10.678769272,-11,0.1334846159,4.1380230928,10.812253888
16,15,2008,62,35,-52,76,2,27,-50,-38,7504,8.2413930613,4.6523993088,-6.912136116,-15,0.2658513891,3.5889937525,-6.646284727
16,17,2001,375,306,37,310,14,69,51,85,37083,10.124053401,8.2612275752,0.9989066022,-35,0.3779646603,1.8628258258,1.3768712625
16,17,2002,397,334,647,310,14,63,661,706,37789,10.604765466,8.9218933647,17.282829362,-18,0.3739715782,1.6828721017,17.65680094
16,17,2003,383,327,720,310,9,56,729,788,38577,10.030641909,8.5640206375,18.856559202,3,0.23570699,1.4666212712,19.092266192
16,17,2004,367,338,515,310,13,29,528,517,39094,9.4501165171,8.7033770648,13.261062687,-40,0.3347452717,0.7467394523,13.595807959
16,17,2005,400,370,788,310,11,30,799,797,39891,10.128505412,9.3688675065,19.953155662,-32,0.2785338988,0.7596379059,20.231689561
16,17,2006,409,336,395,310,12,73,407,459,40350,10.194289702,8.3747710024,9.8453409105,-21,0.2990989644,1.8195186999,10.144439875
16,17,2007,417,345,580,310,10,72,590,646,40996,10.25250166,8.4822855457,14.260074251,-16,0.2458633492,1.7702161139,14.5059376
16,17,2008,420,358,138,310,11,62,149,172,41168,10.223455528,8.7142787596,3.3591353878,-39,0.2677571686,1.5091767684,3.6268925564
16,19,2001,1483,599,-114,1125,108,884,-6,793,83651,17.812850957,7.1948062867,-1.369295353,-85,1.2972271769,10.61804467,-0.072068176
16,19,2002,1511,623,87,1145,102,888,189,986,84637,17.957311276,7.4039741396,1.033941814,-91,1.212207644,10.553337136,2.2461494581
16,19,2003,1578,618,616,1145,88,960,704,1573,86210,18.472668528,7.2345431878,7.2111304266,-91,1.0301614895,11.23812534,8.2412919162
16,19,2004,1703,646,1455,1145,92,1057,1547,2506,88716,19.471090633,7.3859803574,16.635605913,-98,1.0518733636,12.085110275,17.687479277
16,19,2005,1783,599,778,1142,92,1184,870,1977,90693,19.876371865,6.6774799481,8.6729205335,-77,1.0255895747,13.198891917,9.6985101082
16,19,2006,1813,632,1508,1144,93,1181,1601,2728,93421,19.694319824,6.865311709,16.381155154,-54,1.0102436534,12.829008115,17.391398807
16,19,2007,1909,691,1656,1145,85,1218,1741,2935,96356,20.118349431,7.2822312504,17.452062157,-24,0.8957882146,12.836118181,18.347850372
16,19,2008,1951,660,1424,1145,86,1291,1510,2779,99135,19.959998158,6.7522290029,14.568445606,-22,0.8798359004,13.207769156,15.448281507
16,21,2001,138,93,-111,212,0,45,-111,-75,9833,13.981054658,9.4220150955,-11.24563092,-9,0,4.5590395623,-11.24563092
16,21,2002,121,78,4,212,0,43,4,38,9871,12.281770199,7.9171741778,0.4060089322,-9,0,4.3645960211,0.4060089322
16,21,2003,140,92,102,212,-2,48,100,139,10010,14.083798602,9.2550676525,10.261053267,-9,-0.201197123,4.8287309491,10.059856144
16,21,2004,117,105,215,212,2,12,217,217,10227,11.562978702,10.377032169,21.248208727,-12,0.1976577556,1.1859465336,21.445866482
16,21,2005,131,111,135,212,0,20,135,149,10376,12.716594671,10.775129835,13.104887638,-6,0,1.9414648352,13.104887638
16,21,2006,139,104,191,212,1,35,192,221,10597,13.255137558,9.9175129929,18.213894054,-6,0.0953607019,3.3376245649,18.309254756
16,21,2007,141,104,222,212,0,37,222,249,10846,13.151144896,9.7001352423,20.706057921,-10,0,3.4510096535,20.706057921
16,21,2008,145,100,82,212,1,45,83,116,10962,13.29787234,9.1709464417,7.5201760822,-12,0.0917094644,4.1269258988,7.6118855466
16,23,2001,28,20,-61,21,7,8,-54,-47,2852,9.7374369675,6.9553121196,-21.21370196,-1,2.4343592419,2.7821248479,-18.77934272
16,23,2002,53,25,14,21,7,28,21,46,2898,18.434782609,8.6956521739,4.8695652174,-3,2.4347826087,9.7391304348,7.3043478261
16,23,2003,34,30,-88,21,3,4,-85,-78,2820,11.892270024,10.493179433,-30.779993,3,1.0493179433,1.3990905911,-29.73067506
16,23,2004,38,32,-45,21,2,6,-43,-40,2780,13.571428571,11.428571429,-16.07142857,-3,0.7142857143,2.1428571429,-15.35714286
16,23,2005,47,27,-20,21,3,20,-17,0,2780,16.90647482,9.7122302158,-7.194244604,-3,1.0791366906,7.1942446043,-6.115107914
16,23,2006,28,30,-48,21,2,-2,-46,-48,2732,10.159651669,10.885341074,-17.41654572,0,0.7256894049,-0.725689405,-16.69085631
16,23,2007,43,16,-2,21,3,27,1,24,2756,15.670553936,5.8309037901,-0.728862974,-4,1.0932944606,9.8396501458,0.3644314869
16,23,2008,39,9,-30,21,2,30,-28,-5,2751,14.163791538,3.268567278,-10.89522426,-7,0.726348284,10.89522426,-10.16887598
16,25,2001,10,5,22,3,1,5,23,28,1006,10.080645161,5.0403225806,22.177419355,0,1.0080645161,5.0403225806,23.185483871
16,25,2002,11,4,14,3,1,7,15,21,1027,10.821446139,3.9350713232,13.772749631,-1,0.9837678308,6.8863748155,14.756517462
16,25,2003,8,9,1,3,1,-1,2,0,1027,7.7896786758,8.7633885102,0.9737098345,-1,0.9737098345,-0.973709834,1.9474196689
16,25,2004,15,9,-17,3,0,6,-17,-11,1016,14.684287812,8.8105726872,-16.64219285,0,0,5.8737151248,-16.64219285
16,25,2005,14,4,32,3,1,10,33,41,1057,13.506994694,3.8591413411,30.873130728,-2,0.9647853353,9.6478533526,31.837916064
16,25,2006,14,4,-4,3,0,10,-4,6,1063,13.20754717,3.7735849057,-3.773584906,0,0,9.4339622642,-3.773584906
16,25,2007,18,3,19,3,1,15,20,33,1096,16.67438629,2.7790643817,17.600741084,-2,0.9263547939,13.895321908,18.527095878
16,25,2008,19,2,15,3,0,17,15,30,1126,17.101710171,1.800180018,13.501350135,-2,0,15.301530153,13.501350135
16,27,2001,2618,960,3985,2850,410,1658,4395,5998,139050,19.242783956,7.0561774629,29.290486656,-55,3.0135757914,12.186606493,32.304062447
16,27,2002,2849,1000,3713,2870,379,1849,4092,5899,144949,20.063450928,7.0422783179,26.147979394,-42,2.6690234825,13.02117261,28.817002877
16,27,2003,2915,974,3745,2838,313,1941,4058,6046,150995,19.699672911,6.5823263861,25.308842213,47,2.1152650501,13.117346525,27.424107264
16,27,2004,3078,1109,3536,2832,313,1969,3849,5610,156605,20.013003901,7.210663199,22.990897269,-208,2.0351105332,12.802340702,25.026007802
16,27,2005,3186,1108,4348,2863,322,2078,4670,6634,163239,19.922212078,6.9283775841,27.188254274,-114,2.0134815723,12.993834494,29.201735846
16,27,2006,3358,1141,5445,2883,326,2217,5771,7877,171116,20.086435076,6.8250811263,32.570172422,-111,1.950023179,13.26135395,34.5201956
16,27,2007,3494,1154,5004,2867,288,2340,5292,7566,178682,19.977244009,6.598093757,28.610798232,-66,1.6466646465,13.379150252,30.257462879
16,27,2008,3532,1185,2767,2867,292,2347,3059,5257,183939,19.480394131,6.5357494464,15.261112842,-149,1.61049691,12.944644684,16.871609752
16,29,2001,104,63,1,63,5,41,6,40,7342,14.203769462,8.604206501,0.1365747064,-7,0.6828735318,5.5995629609,0.8194482382
16,29,2002,97,68,-204,63,5,29,-199,-174,7168,13.370089593,9.3728463129,-28.11853894,-4,0.6891798759,3.9972432805,-27.42935906
16,29,2003,107,55,-119,63,3,52,-116,-65,7103,14.995445309,7.7079391774,-16.67717749,-1,0.420433046,7.2875061313,-16.25674445
16,29,2004,108,61,-48,63,2,47,-46,-5,7098,15.210196465,8.5909442997,-6.760087318,-6,0.2816703049,6.6192521653,-6.478417013
16,29,2005,95,61,-187,63,3,34,-184,-155,6943,13.531799729,8.6888398262,-26.63627947,-5,0.4273199915,4.8429599031,-26.20895948
16,29,2006,91,58,-155,63,2,33,-153,-123,6820,13.223861077,8.428394972,-22.52415898,-3,0.2906343094,4.7954661048,-22.23352467
16,29,2007,105,58,-29,63,3,47,-26,19,6839,15.374478366,8.4925690021,-4.246284501,-2,0.4392708105,6.8819093638,-3.807013691
16,29,2008,104,60,-57,63,2,44,-55,-13,6826,15.22136846,8.7815587267,-8.34248079,-2,0.2927186242,6.4398097329,-8.049762166
16,31,2001,384,194,-151,322,55,190,-96,76,21467,17.919641607,9.0531522703,-7.046525736,-18,2.5666153344,8.8664893369,-4.479910402
16,31,2002,375,173,-395,322,54,202,-341,-147,21320,17.52868862,8.0865683502,-18.46355201,-8,2.5241311613,9.4421202702,-15.93942085
16,31,2003,391,186,-395,322,47,205,-348,-149,21171,18.403897296,8.7547951331,-18.59217246,-6,2.2122331788,9.6491021628,-16.37993928
16,31,2004,399,182,-467,322,42,217,-425,-234,20937,18.951268168,8.6444381115,-22.18105823,-26,1.9948703334,10.306830056,-20.1861879
16,31,2005,419,188,-316,322,47,231,-269,-54,20883,20.038259206,8.9909134385,-15.11238642,-16,2.2477283596,11.047345768,-12.86465806
16,31,2006,374,168,-400,322,46,206,-354,-158,20725,17.977312055,8.0753701211,-19.22707172,-10,2.2111132475,9.9019419342,-17.01595847
16,31,2007,395,203,-43,322,42,192,-1,190,20915,18.972142171,9.7502401537,-2.065321806,-1,2.0172910663,9.2219020173,-0.04803074
16,31,2008,400,178,176,322,41,222,217,433,21348,18.929086908,8.4234436741,8.3287982396,-6,1.9402314081,10.505643234,10.269029648
16,33,2001,17,9,-88,0,17,8,-71,-62,962,17.119838872,9.0634441088,-88.6203424,1,17.119838872,8.0563947633,-71.50050352
16,33,2002,17,10,-44,0,17,7,-27,-20,942,17.857142857,10.504201681,-46.21848739,0,17.857142857,7.3529411765,-28.36134454
16,33,2003,14,4,-92,0,9,10,-83,-68,874,15.418502203,4.4052863436,-101.3215859,5,9.9118942731,11.013215859,-91.40969163
16,33,2004,17,4,-1,0,8,13,7,20,894,19.230769231,4.5248868778,-1.131221719,0,9.0497737557,14.705882353,7.9185520362
16,33,2005,21,5,-34,0,9,16,-25,-11,883,23.635340461,5.6274620146,-38.2667417,-2,10.129431626,18.007878447,-28.13731007
16,33,2006,22,3,-10,0,8,19,-2,16,899,24.691358025,3.367003367,-11.22334456,-1,8.9786756453,21.324354658,-2.244668911
16,33,2007,20,3,-26,0,5,17,-21,-4,895,22.296544036,3.3444816054,-28.98550725,0,5.5741360089,18.95206243,-23.41137124
16,33,2008,18,1,-2,0,4,17,2,15,910,19.944598338,1.108033241,-2.216066482,-4,4.432132964,18.836565097,2.216066482
16,35,2001,73,99,-283,622,0,-26,-283,-312,8575,8.3610124843,11.338907342,-32.41324018,-3,0,-2.977894857,-32.41324018
16,35,2002,67,95,-150,625,0,-28,-150,-183,8392,7.897683739,11.198208287,-17.68138151,-5,0,-3.300524548,-17.68138151
16,35,2003,75,88,-36,634,-1,-13,-37,-59,8333,8.9686098655,10.523168909,-4.304932735,-9,-0.119581465,-1.554559043,-4.4245142
16,35,2004,71,86,-43,649,0,-15,-43,-65,8268,8.5537015842,10.360821637,-5.180410819,-7,0,-1.807120053,-5.180410819
16,35,2005,52,79,10,654,0,-27,10,-23,8245,6.2980681887,9.568218979,1.2111669594,-6,0,-3.27015079,1.2111669594
16,35,2006,74,93,34,649,0,-19,34,11,8256,8.9691533846,11.272044119,4.1209623659,-4,0,-2.302890734,4.1209623659
16,35,2007,71,85,-25,652,0,-14,-25,-39,8217,8.6201663328,10.319917441,-3.035269835,0,0,-1.699751108,-3.035269835
16,35,2008,69,89,-17,652,0,-20,-17,-41,8176,8.4182272921,10.858293174,-2.074056,-4,0,-2.440065882,-2.074056
16,37,2001,38,26,-135,71,2,12,-133,-122,4214,8.8888888889,6.081871345,-31.57894737,-1,0.4678362573,2.8070175439,-31.11111111
16,37,2002,31,36,-85,71,2,-5,-83,-90,4124,7.4358359319,8.635164308,-20.38858239,-2,0.4797313504,-1.199328376,-19.90885104
16,37,2003,34,33,-39,71,0,1,-39,-41,4083,8.2856098453,8.041915438,-9.504081881,-3,0,0.2436944072,-9.504081881
16,37,2004,27,39,13,71,1,-12,14,-2,4081,6.6144047036,9.5541401274,3.1847133758,-4,0.244977952,-2.939735424,3.4296913278
16,37,2005,26,30,-55,71,1,-4,-54,-61,4020,6.4189606221,7.4064930256,-13.57857055,-3,0.2468831009,-0.987532403,-13.33168745
16,37,2006,42,35,65,71,1,7,66,70,4090,10.357583231,8.6313193588,16.029593095,-3,0.2466091245,1.7262638718,16.276202219
16,37,2007,47,28,47,71,1,19,48,66,4156,11.399466408,6.7911714771,11.399466408,-1,0.2425418385,4.6082949309,11.642008246
16,37,2008,37,42,105,71,1,-5,106,98,4254,8.7990487515,9.9881093936,24.970273484,-3,0.2378121284,-1.189060642,25.208085612
16,39,2001,524,165,-290,4035,51,359,-239,97,29189,17.981846571,5.6622226798,-9.951785316,-23,1.7501415556,12.319623891,-8.20164376
16,39,2002,518,145,-118,4040,-112,373,-230,117,29306,17.710915463,4.9576886913,-4.034532866,-26,-3.829387127,12.753226772,-7.863919993
16,39,2003,514,143,-364,4054,-414,371,-778,-425,28881,17.667176517,4.9151872411,-12.5113857,-18,-14.22998264,12.751989276,-26.74136835
16,39,2004,534,156,-424,4049,260,378,-164,183,29064,18.431271033,5.3844162568,-14.63456726,-31,8.9740270947,13.046854776,-5.660540167
16,39,2005,526,156,-847,3872,20,370,-827,-474,28590,18.24678253,5.4115932979,-29.38217643,-17,0.6937940126,12.835189232,-28.68838242
16,39,2006,542,157,-799,3792,154,385,-645,-270,28320,19.047619048,5.5174837463,-28.07942365,-10,5.4120541205,13.530135301,-22.66736953
16,39,2007,544,167,163,3861,13,377,176,544,28864,19.026301063,5.8407946279,5.7008953553,-9,0.4546726357,13.185506435,6.155567991
16,39,2008,507,144,-277,3861,64,363,-213,133,28997,17.524757609,4.977445948,-9.574670331,-17,2.2121981991,12.547311661,-7.362472131
16,41,2001,197,88,-23,76,26,109,3,101,11452,17.278428277,7.7182826821,-2.017278428,-11,2.2804017015,9.5601455949,0.2631232733
16,41,2002,249,90,38,76,25,159,63,210,11662,21.54538375,7.7874881024,3.2880505321,-12,2.1631911396,13.757895648,5.4512416717
16,41,2003,190,91,-95,76,21,99,-74,15,11677,16.281760144,7.7981061742,-8.140880072,-10,1.7995629633,8.4836539698,-6.341317109
16,41,2004,229,102,90,76,22,127,112,229,11906,19.420769198,8.6502989442,7.6326167154,-10,1.8657507527,10.770470254,9.4983674681
16,41,2005,226,73,-60,76,22,153,-38,103,12009,18.900271796,6.1049550491,-5.017771273,-12,1.8398494669,12.795316747,-3.177921806
16,41,2006,214,77,-161,76,22,137,-139,-6,12003,17.824421123,6.4134599367,-13.40996169,-4,1.8324171248,11.410961186,-11.57754456
16,41,2007,211,88,18,76,17,123,35,155,12158,17.46616448,7.2844667025,1.4900045528,-3,1.4072265221,10.181697777,2.8972310749
16,41,2008,220,87,145,76,17,133,162,296,12454,17.87745815,7.0697220868,11.782870145,1,1.381439948,10.807736064,13.164310093
16,43,2001,212,110,-75,326,42,102,-33,57,11841,17.947089947,9.3121693122,-6.349206349,-12,3.5555555556,8.6349206349,-2.793650794
16,43,2002,211,91,-81,326,40,120,-41,68,11909,17.768421053,7.6631578947,-6.821052632,-11,3.3684210526,10.105263158,-3.452631579
16,43,2003,208,91,116,405,35,117,151,262,12171,17.275747508,7.5581395349,9.634551495,-6,2.9069767442,9.7176079734,12.541528239
16,43,2004,242,98,24,408,36,144,60,196,12367,19.724508925,7.9876110522,1.9561496454,-8,2.9342244682,11.736897873,4.8903741136
16,43,2005,230,84,-270,432,36,146,-234,-97,12270,18.671104436,6.819012055,-21.91825303,-9,2.9224337379,11.852092381,-18.9958193
16,43,2006,223,93,-48,428,37,130,-11,112,12382,18.09183839,7.5450267727,-3.894207367,-7,3.001784845,10.546811618,-0.892422521
16,43,2007,230,71,-51,438,26,159,-25,119,12501,18.486516899,5.7067073906,-4.099184182,-15,2.0897801712,12.779809508,-2.009404011
16,43,2008,254,100,-114,438,26,154,-88,50,12551,20.27782213,7.9833945394,-9.101069775,-16,2.0756825802,12.294427591,-7.025387195
16,45,2001,191,167,90,199,25,24,115,127,15335,12.506957404,10.935402547,5.8933307141,-12,1.6370363095,1.5715548571,7.5303670235
16,45,2002,197,156,-5,199,23,41,18,44,15379,12.828026307,10.15823403,-0.325584424,-15,1.4976883506,2.6697922771,1.1721039265
16,45,2003,191,171,124,199,17,20,141,145,15524,12.361259425,11.06688671,8.0251108307,-16,1.1002168074,1.2943727146,9.1253276381
16,45,2004,198,174,139,199,23,24,162,172,15696,12.68417681,11.146700833,8.9045483664,-14,1.4734144779,1.5374759769,10.377962844
16,45,2005,210,180,271,199,22,30,293,314,16010,13.246704094,11.354317795,17.094556235,-9,1.3877499527,1.8923862991,18.482306188
16,45,2006,236,172,178,199,24,64,202,255,16265,14.624322231,10.658404338,11.03020914,-11,1.4872192099,3.9659178931,12.51742835
16,45,2007,251,189,125,199,18,62,143,190,16455,15.342298289,11.552567237,7.6405867971,-15,1.1002444988,3.7897310513,8.7408312958
16,45,2008,226,189,18,199,19,37,37,58,16513,13.710264499,11.465663674,1.0919679689,-16,1.1526328561,2.244600825,2.244600825
16,47,2001,225,125,-223,203,65,100,-158,-68,14133,15.881979248,8.8233218042,-15.7408061,-10,4.5881273382,7.0586574434,-11.15267876
16,47,2002,213,168,-60,203,62,45,2,35,14168,15.052471644,11.872372001,-4.240132857,-12,4.3814706194,3.1800996431,0.1413377619
16,47,2003,246,145,-99,203,49,101,-50,31,14199,17.344097014,10.223146614,-6.979941481,-20,3.4547185109,7.1209504001,-3.52522297
16,47,2004,266,142,-179,203,46,124,-133,-23,14176,18.748898678,10.008810573,-12.61674009,-14,3.2422907489,8.7400881057,-9.374449339
16,47,2005,249,123,-223,203,47,126,-176,-59,14117,17.601526879,8.6947301453,-15.76361644,-9,3.3223765596,8.9067967342,-12.44123988
16,47,2006,216,141,-127,203,46,75,-81,-13,14104,15.307749548,9.9925587329,-9.000389781,-7,3.2599837001,5.3151908154,-5.740406081
16,47,2007,248,141,-71,203,42,107,-29,66,14170,17.54261866,9.9738275447,-5.022281955,-12,2.9709273538,7.5687911155,-2.051354601
16,47,2008,246,119,-23,203,41,127,18,125,14295,17.284384332,8.3611452661,-1.616019673,-20,2.8807307219,8.9232390655,1.2647110487
16,49,2001,161,147,-91,552,7,14,-84,-82,15367,10.449117342,9.5404984424,-5.906022845,-12,0.4543094496,0.9086188993,-5.451713396
16,49,2002,154,143,-26,630,7,11,-19,-25,15342,10.029633007,9.313230649,-1.693314663,-17,0.4558924094,0.7164023576,-1.237422254
16,49,2003,139,173,-108,651,6,-34,-102,-151,15191,9.104902892,11.332001441,-7.074313038,-15,0.393017391,-2.227098549,-6.681295647
16,49,2004,173,163,75,697,5,10,80,78,15269,11.359159554,10.702560735,4.9244911359,-12,0.3282994091,0.6565988181,5.252790545
16,49,2005,133,150,-74,665,6,-17,-68,-98,15171,8.7385019711,9.8554533509,-4.862023653,-13,0.394218134,-1.11695138,-4.467805519
16,49,2006,168,151,50,665,5,17,55,64,15235,11.050450569,9.9322502138,3.2888245741,-8,0.3288824574,1.1182003552,3.6177070315
16,49,2007,143,152,80,673,6,-9,86,80,15315,9.3617021277,9.9509001637,5.2373158756,3,0.3927986907,-0.589198036,5.6301145663
16,49,2008,166,161,112,673,5,5,117,133,15448,10.792185418,10.467119592,7.2814744986,11,0.3250658258,0.3250658258,7.6065403244
16,51,2001,371,126,-230,81,51,245,-179,53,19265,19.284247732,6.5493671544,-11.95519401,-13,2.6509343244,12.734880578,-9.304259688
16,51,2002,341,130,152,81,51,211,203,398,19663,17.519523222,6.6789971229,7.8092889437,-16,2.6202219482,10.840526099,10.429510892
16,51,2003,369,126,92,81,31,243,123,343,20006,18.603947667,6.352567496,4.6383826161,-23,1.5629332728,12.251380171,6.201315889
16,51,2004,397,132,215,81,34,265,249,495,20501,19.601550349,6.5173920557,10.615449182,-19,1.6787221962,13.084158294,12.294171378
16,51,2005,445,126,389,81,32,319,421,721,21222,21.331160271,6.0398341442,18.646789541,-19,1.5339261319,15.291326127,20.180715672
16,51,2006,451,121,271,81,33,330,304,622,21844,20.944596666,5.6192820322,12.585334138,-12,1.5325314633,15.325314633,14.117865602
16,51,2007,497,109,514,81,21,388,535,933,22777,22.276506578,4.8855919858,23.03847964,10,0.9412608413,17.390914592,23.979740481
16,51,2008,514,136,674,81,22,378,696,1083,23860,22.042584214,5.8322790917,28.904089028,9,0.9434569119,16.210305123,29.84754594
16,53,2001,313,136,-226,113,84,177,-142,21,18448,16.976271186,7.3762711864,-12.25762712,-14,4.5559322034,9.6,-7.701694915
16,53,2002,313,157,-136,113,79,156,-57,85,18533,16.927611476,8.490846651,-7.355128309,-14,4.2724642384,8.4367648252,-3.082664071
16,53,2003,345,139,-98,113,65,206,-33,150,18683,18.540412726,7.469905417,-5.266552021,-23,3.4931212382,11.070507309,-1.773430782
16,53,2004,332,131,33,113,62,201,95,283,18966,17.636590613,6.9590161757,1.7530346092,-13,3.2935801748,10.677574438,5.0466147839
16,53,2005,362,130,-46,113,65,232,19,234,19200,18.969763664,6.8123460672,-2.410522455,-17,3.4061730336,12.157417597,0.995650579
16,53,2006,395,159,112,113,65,236,177,403,19603,20.359250573,8.1952426359,5.7727495297,-10,3.3502564235,12.164007938,9.1230059531
16,53,2007,392,162,95,113,58,230,153,383,19986,19.803480765,8.1840915406,4.7993129405,0,2.9301068479,11.619389224,7.7294197883
16,53,2008,387,150,180,113,58,237,238,482,20468,19.132842241,7.4158303258,8.898996391,7,2.8674543926,11.717011915,11.766450784
16,55,2001,1532,849,1541,1400,52,683,1593,2176,111719,13.847836502,7.6741600456,13.929188021,-100,0.470031004,6.173676456,14.399219025
16,55,2002,1463,905,1793,1580,46,558,1839,2306,114025,12.961584804,8.0179318166,15.885250549,-91,0.4075412857,4.9436529875,16.292791835
16,55,2003,1515,873,2287,1588,29,642,2316,2927,116952,13.118189257,7.5591942055,19.802837512,-31,0.2511072531,5.5589950515,20.053944765
16,55,2004,1569,946,4201,1589,46,623,4247,4669,121621,13.153206775,7.9304866854,35.217732099,-201,0.3856262025,5.2227200899,35.603358301
16,55,2005,1580,1023,4595,1601,39,557,4634,5121,126742,12.723312249,8.2379420445,37.002291001,-70,0.3140564416,4.4853702041,37.316347443
16,55,2006,1592,933,3168,1598,42,659,3210,3788,130530,12.376006717,7.2530240368,24.627631456,-81,0.3265026898,5.1229826798,24.954134146
16,55,2007,1766,1014,2984,1600,35,752,3019,3681,134211,13.34134116,7.6603170646,22.542787101,-90,0.2644093661,5.6810240952,22.807196467
16,55,2008,1778,1070,2670,1600,38,708,2708,3264,137475,13.088639091,7.8767400602,19.655042954,-152,0.2797346937,5.2118990305,19.934777648
16,57,2001,411,199,177,4144,75,212,252,432,35318,11.708734545,5.6691926386,5.0424477238,-32,2.1366303914,6.0395419064,7.1790781152
16,57,2002,445,222,-414,4008,68,223,-346,-145,35173,12.62572527,6.2986764268,-11.74618036,-22,1.9293243109,6.3270488431,-9.816856053
16,57,2003,388,222,117,4193,52,166,169,287,35460,10.986366146,6.2860136197,3.3128990698,-48,1.4723995866,4.7003525264,4.7852986564
16,57,2004,428,239,149,4255,65,189,214,375,35835,12.006452065,6.7045374851,4.1798162564,-28,1.8234097763,5.3019145803,6.0032260327
16,57,2005,391,213,-90,4529,60,178,-30,115,35950,10.893640733,5.9343874068,-2.507487637,-33,1.6716584245,4.9592533259,-0.835829212
16,57,2006,436,175,-181,4366,64,261,-117,127,36077,12.106571147,4.8592888778,-5.025893068,-17,1.777111361,7.2472822691,-3.248781707
16,57,2007,407,234,-575,3877,56,173,-519,-329,35748,11.333101288,6.5158371041,-16.01113818,17,1.5593456317,4.8172641838,-14.45179255
16,57,2008,425,224,-111,3877,59,201,-52,158,35906,11.862561755,6.2522678427,-3.098222011,9,1.6468026907,5.6102939124,-1.451419321
16,59,2001,73,86,-121,27,8,-13,-113,-132,7603,9.5188420915,11.213978354,-15.77780675,-6,1.0431607772,-1.695136263,-14.73464598
16,59,2002,56,83,21,27,8,-27,29,-4,7599,7.3674516511,10.91961584,2.7627943692,-6,1.052493093,-3.552164189,3.8152874622
16,59,2003,73,103,37,27,6,-30,43,3,7602,9.6046312743,13.551740017,4.8681007828,-10,0.7894217486,-3.947108743,5.6575225314
16,59,2004,70,88,79,27,5,-18,84,60,7662,9.1719077568,11.530398323,10.35115304,-6,0.6551362683,-2.358490566,11.006289308
16,59,2005,83,78,40,27,6,5,46,44,7706,10.801665799,10.15096304,5.2056220718,-7,0.7808433108,0.650702759,5.9864653826
16,59,2006,77,81,28,27,5,-4,33,25,7731,9.9760316124,10.494267021,3.627647859,-4,0.6477942605,-0.518235408,4.2754421196
16,59,2007,79,84,-41,27,5,-5,-36,-39,7692,10.244440122,10.892822408,-5.316734747,2,0.6483822862,-0.648382286,-4.668352461
16,59,2008,84,93,116,27,4,-9,120,116,7808,10.838709677,12,14.967741935,5,0.5161290323,-1.161290323,15.483870968
16,61,2001,37,44,-148,34,1,-7,-147,-153,3588,10.096875426,12.007095102,-40.38750171,1,0.272888525,-1.910219675,-40.11461318
16,61,2002,40,39,62,34,1,1,63,61,3649,11.05430427,10.777946663,17.134171618,-3,0.2763576067,0.2763576067,17.410529225
16,61,2003,38,35,-20,34,1,3,-19,-18,3631,10.43956044,9.6153846154,-5.494505495,-2,0.2747252747,0.8241758242,-5.21978022
16,61,2004,49,49,-11,34,0,0,-11,-14,3617,13.520971302,13.520971302,-3.035320088,-3,0,0,-3.035320088
16,61,2005,42,45,-13,34,1,-3,-12,-19,3598,11.642411642,12.474012474,-3.603603604,-4,0.2772002772,-0.831600832,-3.326403326
16,61,2006,45,44,14,34,0,1,14,15,3613,12.48093191,12.203577867,3.8829565941,0,0,0.2773540424,3.8829565941
16,61,2007,36,36,-45,34,1,0,-44,-48,3565,10.030649206,10.030649206,-12.53831151,-4,0.2786291446,0,-12.25968236
16,61,2008,47,36,22,34,0,11,22,29,3594,13.130325464,10.057270569,6.1461097919,-4,0,3.0730548959,6.1461097919
16,63,2001,74,32,4,36,25,42,29,67,4114,18.135032472,7.8421762039,0.9802720255,-4,6.1267001593,10.292856268,7.1069721848
16,63,2002,73,32,-26,36,25,41,-1,36,4150,17.666989351,7.7444336883,-6.292352372,-4,6.050338819,9.9225556631,-0.242013553
16,63,2003,71,33,20,36,11,38,31,65,4215,16.975493126,7.8900179319,4.7818290496,-4,2.6300059773,9.0854751943,7.4118350269
16,63,2004,75,39,-35,36,10,36,-25,9,4224,17.774617846,9.2428012798,-8.294821661,-2,2.3699490461,8.5318165659,-5.924872615
16,63,2005,83,43,122,36,11,40,133,170,4394,19.262009747,9.9791134834,28.312833604,-3,2.5527964725,9.2828962636,30.865630077
16,63,2006,82,38,-70,36,10,44,-60,-18,4376,18.700114025,8.6659064994,-15.96351197,-2,2.2805017104,10.034207526,-13.68301026
16,63,2007,84,28,38,36,9,56,47,97,4473,18.985196067,6.3283986891,8.5885410781,-6,2.0341281501,12.656797378,10.622669228
16,63,2008,80,15,-30,36,8,65,-22,30,4503,17.825311943,3.3422459893,-6.684491979,-13,1.7825311943,14.483065954,-4.901960784
16,65,2001,515,102,-179,1438,36,413,-143,643,28108,18.534180267,3.6708473539,-6.441977219,373,1.2955931837,14.863332913,-5.146384035
16,65,2002,534,121,170,1450,34,413,204,1524,29632,18.496709387,4.1912019397,5.8884655352,907,1.177693107,14.305507447,7.0661586422
16,65,2003,610,108,844,1450,30,502,874,1425,31057,20.102489743,3.5591293315,27.813936628,49,0.9886470365,16.543360411,28.802583664
16,65,2004,749,117,1168,1450,29,632,1197,2488,33545,23.18813659,3.6221788799,36.159871211,659,0.8978050215,19.56595771,37.057676233
16,65,2005,866,136,801,1450,29,730,830,1561,35106,25.229057115,3.9620690157,23.335421188,1,0.8448529519,21.266988099,24.18027414
16,65,2006,963,118,113,1450,30,845,143,1390,36496,26.898689981,3.2959973185,3.1563364152,402,0.83796542,23.602692662,3.9943018351
16,65,2007,942,130,-363,1450,25,812,-338,478,36974,25.643119641,3.5388593984,-9.88158432,4,0.6805498843,22.104260242,-9.201034436
16,65,2008,930,132,-346,1450,26,798,-320,482,37456,24.989923418,3.5469568722,-9.297326347,4,0.6986430203,21.442966546,-8.598683327
16,67,2001,336,194,-799,144,77,142,-722,-581,19506,16.972697194,9.7997120703,-40.36066982,-1,3.8895764403,7.1729851236,-36.47109338
16,67,2002,325,159,-386,144,76,166,-310,-149,19357,16.725420065,8.1825901243,-19.86465275,-5,3.9111751537,8.5428299411,-15.9534776
16,67,2003,318,167,-474,144,65,151,-409,-254,19103,16.536661466,8.6843473739,-24.64898596,4,3.3801352054,7.8523140926,-21.26885075
16,67,2004,340,190,-493,144,61,150,-432,-307,18796,17.942425922,10.02664978,-26.01651759,-25,3.2190822977,7.9157761419,-22.79743529
16,67,2005,339,175,-474,144,63,164,-411,-260,18536,18.161362906,9.3753348334,-25.39376406,-13,3.37512054,8.7860280724,-22.01864352
16,67,2006,319,202,-215,144,61,117,-154,-45,18491,17.230669511,10.910956869,-11.61314716,-8,3.294892916,6.3197126421,-8.318254247
16,67,2007,324,176,-193,144,60,148,-133,18,18509,17.513513514,9.5135135135,-10.43243243,3,3.2432432432,8,-7.189189189
16,67,2008,330,167,-80,144,59,163,-21,136,18645,17.763901599,8.9896108091,-4.306400388,-6,3.1759702858,8.7742907897,-1.130430102
16,69,2001,437,417,-413,661,27,20,-386,-393,37006,11.746522411,11.208924131,-11.10140448,-27,0.7257576776,0.5375982797,-10.3756468
16,69,2002,462,399,72,676,25,63,97,118,37124,12.464589235,10.764872521,1.9425333873,-42,0.6744907595,1.6997167139,2.6170241468
16,69,2003,431,426,570,708,15,5,585,568,37692,11.521599658,11.387938409,15.237382378,-22,0.4009837468,0.1336612489,15.638366125
16,69,2004,485,443,65,704,19,42,84,100,37792,12.850405384,11.737586773,1.7222192783,-26,0.5034179429,1.1128186106,2.2256372211
16,69,2005,447,394,210,675,19,53,229,259,38051,11.787508406,10.389884366,5.5377556268,-23,0.5010350329,1.3976240391,6.0387906597
16,69,2006,450,427,423,791,20,23,443,443,38494,11.757789536,11.156835848,11.052322163,-23,0.5225684238,0.6009536874,11.574890587
16,69,2007,482,428,308,744,13,54,321,326,38820,12.4686344,11.071733451,7.9675091187,-49,0.3362909693,1.3969009494,8.303800088
16,69,2008,492,442,156,744,14,50,170,155,38975,12.648627804,11.363198149,4.0105405232,-65,0.3599203034,1.2854296549,4.3704608265
16,71,2001,69,38,6,46,3,31,9,35,4171,16.612495486,9.1489105574,1.4445648248,-5,0.7222824124,7.4635849284,2.1668472373
16,71,2002,55,43,-66,46,2,12,-64,-53,4118,13.27059959,10.375196043,-15.92471951,-1,0.4825672578,2.8954035469,-15.44215225
16,71,2003,44,48,-37,46,-1,-4,-38,-45,4073,10.743498962,11.720180686,-9.034305946,-3,-0.244170431,-0.976681724,-9.278476377
16,71,2004,59,33,-33,46,2,26,-31,-8,4065,14.49987712,8.1101007619,-8.110100762,-3,0.4915212583,6.3897763578,-7.618579504
16,71,2005,60,51,38,46,0,9,38,43,4108,14.682491129,12.48011746,9.2989110486,-4,0,2.2023736694,9.2989110486
16,71,2006,49,40,-35,46,1,9,-34,-27,4081,11.967273171,9.7692025888,-8.548052265,-2,0.2442300647,2.1980705825,-8.303822201
16,71,2007,62,26,-19,46,1,36,-18,11,4092,15.1719075,6.3624128227,-4.649455524,-7,0.2447081855,8.8094946776,-4.404747339
16,71,2008,67,38,11,46,1,29,12,38,4130,16.297737777,9.2434930674,2.6757479932,-3,0.2432498176,7.0542447093,2.9189978108
16,73,2001,189,82,-21,74,62,107,41,138,10822,17.576490282,7.6257788524,-1.952943365,-10,5.7658327908,9.9507114294,3.8128894262
16,73,2002,177,81,-194,74,60,96,-134,-42,10780,16.38737154,7.4993056199,-17.96129988,-4,5.5550411999,8.8880659198,-12.40625868
16,73,2003,188,90,-38,74,41,98,3,83,10863,17.372822622,8.316776787,-3.511527977,-18,3.7887538696,9.0560458347,0.2772258929
16,73,2004,184,76,-237,74,40,108,-197,-104,10759,17.019702155,7.0298769772,-21.92211636,-15,3.6999352511,9.9898251781,-18.22218111
16,73,2005,162,94,-165,74,40,68,-125,-64,10695,15.102078866,8.7629346509,-15.38174699,-7,3.7289083621,6.3391442155,-11.65283863
16,73,2006,172,84,-123,74,40,88,-83,0,10695,16.08228144,7.8541374474,-11.50070126,-5,3.7400654511,8.2281439925,-7.760635811
16,73,2007,172,80,-48,74,32,92,-16,68,10763,16.031316991,7.4564265076,-4.473855905,-8,2.982570603,8.5748904837,-1.491285302
16,73,2008,165,89,17,74,32,76,49,114,10877,15.249537893,8.2255083179,1.5711645102,-11,2.9574861368,7.0240295749,4.528650647
16,75,2001,328,187,70,117,23,141,93,215,20849,15.81370682,9.015741388,3.3748764554,-19,1.1088879782,6.7979654316,4.4837644336
16,75,2002,301,184,94,117,21,117,115,213,21062,14.363770848,8.780511083,4.4856958794,-19,1.0021235475,5.5832597647,5.4878194269
16,75,2003,313,173,66,117,16,140,82,193,21255,14.793109152,8.1763830139,3.119313751,-29,0.756197273,6.6167261384,3.8755110239
16,75,2004,323,182,-96,117,13,141,-83,40,21295,15.18213866,8.5546415981,-4.512338425,-18,0.6110458284,6.6274970623,-3.901292597
16,75,2005,303,180,258,117,16,123,274,380,21675,14.102862462,8.3779380963,12.008377938,-17,0.7447056086,5.7249243658,12.753083547
16,75,2006,320,168,261,117,16,152,277,416,22091,14.623223507,7.6771923411,11.927066673,-13,0.7311611753,6.9460311657,12.658227848
16,75,2007,342,187,428,117,13,155,441,598,22689,15.274676195,8.3519428316,19.115676641,2,0.5806163466,6.9227333631,19.696292988
16,75,2008,354,194,107,117,13,160,120,277,22966,15.507611434,8.4985215201,4.6873288796,-3,0.5694885555,7.0090899135,5.2568174351
16,77,2001,109,47,-170,54,30,62,-140,-18,7482,14.550794286,6.2741957015,-22.69389935,60,4.0048057669,8.276598585,-18.68909358
16,77,2002,109,38,-170,54,30,71,-140,-20,7462,14.587794433,5.0856531049,-22.751606,49,4.0149892934,9.5021413276,-18.7366167
16,77,2003,119,67,-192,54,27,52,-165,-60,7402,16.011840689,9.0150699677,-25.83423036,53,3.6329386437,6.9967707212,-22.20129171
16,77,2004,132,54,21,54,23,78,44,173,7575,17.62702811,7.211056954,2.8042999266,51,3.07137611,10.415971156,5.8756760366
16,77,2005,127,65,-112,54,27,62,-85,-22,7553,16.79005817,8.5933368588,-14.80698043,1,3.569539926,8.1967213115,-11.23744051
16,77,2006,129,36,-15,54,24,93,9,103,7656,16.96363995,4.7340390558,-1.972516273,1,3.1560260372,12.229600894,1.183509764
16,77,2007,127,36,-124,54,24,91,-100,-8,7648,16.596968113,4.7046523785,-16.20491375,1,3.136434919,11.892315734,-13.06847883
16,77,2008,134,60,-61,54,23,74,-38,35,7683,17.48092101,7.8272780641,-7.957732698,-1,3.0004565912,9.6536429457,-4.957276107
16,79,2001,146,203,-254,197,7,-57,-247,-313,13413,10.759423708,14.960020635,-18.71844946,-9,0.5158627805,-4.200596927,-18.20258668
16,79,2002,124,157,-396,197,6,-33,-390,-423,12990,9.3928720221,11.892587963,-29.9965913,0,0.4544938075,-2.499715941,-29.54209749
16,79,2003,111,146,-126,197,3,-35,-123,-171,12819,8.601650587,11.313882754,-9.764035801,-13,0.2324770429,-2.712232167,-9.531558759
16,79,2004,127,153,-93,197,4,-26,-89,-126,12693,9.9560990906,11.994355597,-7.290686736,-11,0.3135779241,-2.038256507,-6.977108812
16,79,2005,113,168,169,197,4,-55,173,108,12801,8.8648309406,13.179571664,13.258021495,-10,0.3137993253,-4.314740723,13.571820821
16,79,2006,130,158,119,197,4,-28,123,89,12890,10.120275583,12.300027247,9.263944572,-6,0.3113930949,-2.179751664,9.5753376669
16,79,2007,127,172,-33,197,4,-45,-29,-82,12808,9.8840376683,13.38625574,-2.568293252,-8,0.311308273,-3.502218071,-2.256984979
16,79,2008,123,148,140,197,4,-25,144,105,12913,9.5641693558,11.508106217,10.886046421,-14,0.3110298977,-1.943936861,11.197076319
16,81,2001,138,35,143,31,53,103,196,295,6399,22.074702072,5.5986563225,22.874510118,-4,8.4779652883,16.476045749,31.352475406
16,81,2002,125,27,173,31,53,98,226,322,6721,19.054878049,4.1158536585,26.37195122,-2,8.0792682927,14.93902439,34.451219512
16,81,2003,151,30,96,31,36,121,132,249,6970,22.058286466,4.3824410196,14.023811263,-4,5.2589292236,17.675845446,19.282740486
16,81,2004,143,22,29,31,33,121,62,177,7147,20.259261883,3.1168095204,4.1085216406,-6,4.6752142807,17.142452362,8.7837359212
16,81,2005,133,27,113,31,36,106,149,249,7396,18.290586536,3.7131265901,15.540122396,-6,4.9508354535,14.577459946,20.490957849
16,81,2006,136,39,235,31,35,97,270,362,7758,17.949056355,5.1471558664,31.014913554,-5,4.6192424442,12.801900488,35.634155998
16,81,2007,162,20,362,31,27,142,389,536,8294,20.184400698,2.4919013207,45.103413905,5,3.364066783,17.692499377,48.467480688
16,81,2008,170,24,366,31,26,146,392,539,8833,19.851696152,2.802592398,42.739534069,1,3.0361417645,17.049103754,45.775675833
16,83,2001,1006,604,-451,1433,202,402,-249,98,64423,15.627427222,9.3826700221,-7.005934073,-55,3.1379128219,6.2447572001,-3.868021251
16,83,2002,985,629,334,1450,187,356,521,809,65232,15.194169141,9.702672477,5.1521345108,-68,2.884578304,5.4914966642,8.0367128148
16,83,2003,1000,618,958,1452,157,382,1115,1464,66696,15.159784125,9.368746589,14.523073191,-33,2.3800861076,5.7910375356,16.903159299
16,83,2004,1091,665,558,1456,163,426,721,1092,67788,16.224978436,9.8896523006,8.298384938,-55,2.424080188,6.3353261355,10.722465126
16,83,2005,1100,656,803,1447,162,444,965,1363,69151,16.065547434,9.5809082876,11.727849626,-46,2.3660169857,6.4846391459,14.093866612
16,83,2006,1157,658,1282,1456,164,499,1446,1902,71053,16.504521982,9.3863227868,18.287638013,-43,2.3394482326,7.1181991955,20.627086246
16,83,2007,1236,690,1152,1452,152,546,1304,1788,72841,17.17931255,9.5903929281,16.011786454,-62,2.1126662682,7.5889196214,18.124452722
16,83,2008,1236,680,810,1452,155,556,965,1443,74284,16.802039082,9.2438402719,11.01104503,-78,2.1070518267,7.5581988105,13.118096856
16,85,2001,65,63,3,72,5,2,8,2,7640,8.5089671423,8.2471527687,0.3927215604,-8,0.654535934,0.2618143736,1.0472574944
16,85,2002,72,52,-140,72,4,20,-136,-121,7519,9.4993073422,6.8606108582,-18.47087539,-5,0.5277392968,2.6386964839,-17.94313609
16,85,2003,75,54,91,72,3,21,94,113,7632,9.9003366114,7.1282423602,12.012408422,-2,0.3960134645,2.7720942512,12.408421886
16,85,2004,84,74,149,72,4,10,153,151,7783,10.898475511,9.60103795,19.331819656,-12,0.5189750243,1.2974375608,19.850794681
16,85,2005,78,69,333,72,4,9,337,344,8127,9.8051539912,8.6737900691,41.860465116,-2,0.5028284098,1.1313639221,42.363293526
16,85,2006,101,59,499,72,4,42,503,538,8665,12.029537875,7.0271557885,59.433063364,-7,0.4764173416,5.0023820867,59.909480705
16,85,2007,102,54,223,72,3,48,226,260,8925,11.597498579,6.1398521887,25.35531552,-14,0.3411028994,5.45764639,25.69641842
16,85,2008,118,71,-90,72,3,47,-87,-63,8862,13.268117164,7.9833586327,-10.11975038,-23,0.3373250126,5.2847585315,-9.782425367
16,87,2001,136,127,-76,147,35,9,-41,-40,9928,13.671089666,12.766385203,-7.639726578,-8,3.5182951347,0.9047044632,-4.121431444
16,87,2002,139,104,-104,147,34,35,-70,-41,9887,14.029775423,10.497098158,-10.49709816,-6,3.4317436286,3.5326772647,-7.065354529
16,87,2003,126,110,-46,147,34,16,-12,-6,9881,12.747875354,11.129097531,-4.65398624,-10,3.4399028733,1.6187778227,-1.214083367
16,87,2004,138,111,-8,147,28,27,20,39,9920,13.938689965,11.211554972,-0.808039998,-8,2.8281399929,2.7271349932,2.0200999949
16,87,2005,115,115,19,147,32,0,51,44,9964,11.567089117,11.567089117,1.9110842889,-7,3.218668276,0,5.1297525649
16,87,2006,145,110,33,147,32,35,65,94,10058,14.484067526,10.987913295,3.2963739886,-6,3.1964838677,3.4961542303,6.4928578564
16,87,2007,135,130,9,147,27,5,36,35,10093,13.398838767,12.90258548,0.8932559178,-6,2.6797677535,0.4962532877,3.5730236713
16,87,2008,133,120,78,147,27,13,105,113,10206,13.104093798,11.823242524,7.6851076408,-5,2.660229568,1.2808512735,10.345337209
17,0,2001,185576,106433,-69865,325334,62524,79143,-7341,72708,12510596,14.876735596,8.5322218376,-5.600741111,906,5.0122484396,6.3445137588,-0.588492672
17,0,2002,181621,106063,-79082,326239,58018,75558,-21064,54632,12565228,14.485745314,8.4593830296,-6.307429818,138,4.6274052649,6.0263622842,-1.680024553
17,0,2003,181675,105776,-78604,328441,47843,75899,-30761,45819,12611047,14.432238288,8.4028316341,-6.244291501,681,3.8006416755,6.0294066537,-2.443649825
17,0,2004,183465,104596,-72343,333891,49193,78869,-23150,54671,12665718,14.516493705,8.2760590606,-5.724071098,-1048,3.8923493572,6.2404346442,-1.831721741
17,0,2005,179568,104605,-85236,337316,50089,74963,-35147,38345,12704063,14.156054402,8.2464251465,-6.719490405,-1471,3.948713629,5.9096292554,-2.770776776
17,0,2006,178971,102012,-72434,340823,51035,76959,-21399,55610,12759673,14.056931787,8.0123356604,-5.689188735,50,4.0084455792,6.0445961268,-1.680743156
17,0,2007,182343,102845,-56984,345341,45254,79498,-11730,66136,12825809,14.253630242,8.0393248015,-4.454401133,-1632,3.5374748852,6.2143054409,-0.916926247
17,0,2008,186726,103250,-52349,345341,45909,83476,-6440,75754,12901563,14.515746109,8.0264707954,-4.069517866,-1282,3.5688837554,6.4892753135,-0.500634111
17,1,2001,826,821,-132,2814,17,5,-115,-176,68044,12.123524922,12.050137967,-1.937415605,-66,0.2495156461,0.0733869547,-1.687899959
17,1,2002,840,859,-207,2767,15,-19,-192,-270,67774,12.369494471,12.649280655,-3.048196852,-59,0.2208838298,-0.279786184,-2.827313022
17,1,2003,795,875,-427,2728,7,-80,-420,-568,67206,11.779522892,12.964883686,-6.326863239,-68,0.1037190695,-1.185360794,-6.22314417
17,1,2004,774,837,-355,2740,17,-63,-338,-456,66750,11.556033324,12.496640688,-5.300247843,-55,0.2538146854,-0.940607364,-5.046433157
17,1,2005,854,858,83,2633,15,-4,98,35,66785,12.790654136,12.850563523,1.2431197813,-59,0.2246602014,-0.059909387,1.4677799828
17,1,2006,817,800,138,2653,16,17,154,139,66924,12.220568548,11.966284992,2.0641841611,-32,0.2393256998,0.2542835561,2.303509861
17,1,2007,857,807,-224,2609,14,50,-210,-148,66776,12.819745699,12.071802543,-3.35078534,12,0.2094240838,0.7479431563,-3.141361257
17,1,2008,882,819,14,2609,16,63,30,121,66897,13.196382216,12.253783487,0.2094663844,28,0.2393901536,0.9425987297,0.448856538
17,3,2001,139,124,-149,568,1,15,-148,-140,9444,14.61004835,13.033424427,-15.66113096,-7,0.1051082615,1.5766239226,-15.5560227
17,3,2002,129,120,-44,581,1,9,-43,-44,9400,13.691360645,12.736149437,-4.66992146,-10,0.1061345786,0.9552112078,-4.563786882
17,3,2003,144,130,-390,385,1,14,-389,-360,9040,15.618221258,14.09978308,-42.29934924,15,0.1084598698,1.5184381779,-42.19088937
17,3,2004,137,155,-71,403,0,-18,-71,-99,8941,15.238307102,17.240420444,-7.897224848,-10,0,-2.002113342,-7.897224848
17,3,2005,117,117,-304,406,1,0,-303,-308,8633,13.315124616,13.315124616,-34.5965631,-5,0.1138044839,0,-34.48275862
17,3,2006,123,125,-216,400,0,-2,-216,-220,8413,14.431538191,14.666197348,-25.34318902,-2,0,-0.234659158,-25.34318902
17,3,2007,108,118,-159,395,1,-10,-158,-163,8250,12.962851827,14.163115885,-19.08419852,5,0.1200264058,-1.200264058,-18.96417212
17,3,2008,117,113,-101,395,0,4,-101,-98,8152,14.266552859,13.778807463,-12.31557127,-1,0,0.4877453969,-12.31557127
17,5,2001,184,179,-31,2358,3,5,-28,-40,17610,10.43675553,10.153148043,-1.758366421,-17,0.1701644923,0.2836074872,-1.588201929
17,5,2002,196,191,196,2384,2,5,198,188,17798,11.070944419,10.788522368,11.070944419,-15,0.1129688206,0.2824220515,11.18391324
17,5,2003,208,177,248,2560,1,31,249,271,18069,11.598405219,9.8697967491,13.828867761,-9,0.0557615636,1.7286084702,13.884629325
17,5,2004,225,185,159,2685,2,40,161,183,18252,12.38952672,10.186944192,8.7552655489,-18,0.1101291264,2.202582528,8.8653946753
17,5,2005,186,167,-125,2598,3,19,-122,-118,18134,10.223712417,9.1793546969,-6.870774474,-15,0.1648985874,1.04435772,-6.705875886
17,5,2006,210,145,-76,2494,2,65,-74,-18,18116,11.586206897,8,-4.193103448,-9,0.1103448276,3.5862068966,-4.082758621
17,5,2007,217,187,187,2633,2,30,189,218,18334,11.906721536,10.260631001,10.260631001,-1,0.109739369,1.646090535,10.37037037
17,5,2008,225,184,-129,2633,3,41,-126,-81,18253,12.299450625,10.0582174,-7.051685025,4,0.163992675,2.2412332249,-6.88769235
17,7,2001,613,285,696,319,143,328,839,1134,43189,14.382243912,6.6866876261,16.329595045,-33,3.355074844,7.6955562855,19.684669889
17,7,2002,633,315,891,319,140,318,1031,1334,44523,14.433600876,7.1825975921,20.316490332,-15,3.1922655965,7.2510032835,23.508755928
17,7,2003,661,293,1095,319,127,368,1222,1600,46123,14.584206694,6.4647088675,24.159918805,10,2.8021093043,8.1194978267,26.962028109
17,7,2004,627,321,1284,319,111,306,1395,1630,47753,13.358046785,6.8388086412,27.355234565,-71,2.3648216797,6.5192381439,29.720056244
17,7,2005,703,364,1381,319,123,339,1504,1803,49556,14.448817684,7.4813223854,28.383808281,-40,2.5280292676,6.9674952985,30.911837548
17,7,2006,756,336,1464,319,120,420,1584,1975,51531,14.957412922,6.6477390762,28.965148832,-29,2.3741925272,8.3096738453,31.339341359
17,7,2007,773,341,1161,319,110,432,1271,1719,53250,14.754583369,6.5088136208,22.160506199,16,2.099617297,8.2457697483,24.260123496
17,7,2008,844,333,249,319,111,511,360,892,54142,15.718116806,6.201579261,4.6372169249,21,2.067193087,9.5165375447,6.7044100119
17,9,2001,56,45,-34,1972,2,11,-32,-28,6935,8.058713484,6.4757519067,-4.89279033,-7,0.2878111959,1.5829615772,-4.604979134
17,9,2002,52,60,-90,1972,2,-8,-88,-101,6834,7.5531992156,8.7152298642,-13.0728448,-5,0.2905076621,-1.162030649,-12.78233713
17,9,2003,74,67,18,1972,-1,7,17,16,6850,10.815551008,9.7924583455,2.6308097048,-8,-0.146156095,1.023092663,2.4846536101
17,9,2004,52,57,-57,1972,0,-5,-57,-68,6782,7.6291079812,8.3626760563,-8.362676056,-6,0,-0.733568075,-8.362676056
17,9,2005,61,77,-76,1972,1,-16,-75,-96,6686,9.0585090585,11.434511435,-11.28601129,-5,0.1485001485,-2.376002376,-11.13751114
17,9,2006,55,68,-56,1972,0,-13,-56,-73,6613,8.2712985939,10.226332807,-8.421685841,-4,0,-1.955034213,-8.421685841
17,9,2007,60,55,-72,1972,0,5,-72,-74,6539,9.1240875912,8.3637469586,-10.94890511,-7,0,0.7603406326,-10.94890511
17,9,2008,62,48,29,1972,1,14,30,34,6573,9.4569859671,7.3215375229,4.4234289201,-10,0.1525320317,2.1354484442,4.5759609518
17,11,2001,451,410,-337,500,19,41,-318,-303,35170,12.768427162,11.607661056,-9.540931161,-26,0.5379160002,1.1607661056,-9.003015161
17,11,2002,394,404,-136,500,19,-10,-117,-162,35008,11.228590156,11.513579754,-3.875858531,-35,0.541480236,-0.284989598,-3.334378295
17,11,2003,462,429,-26,500,11,33,-15,-31,34977,13.202829178,12.259769951,-0.743016361,-49,0.3143530757,0.943059227,-0.428663285
17,11,2004,445,423,-174,500,15,22,-159,-166,34811,12.75290881,12.122427925,-4.986530636,-29,0.4298733307,0.630480885,-4.556657305
17,11,2005,397,391,-9,500,15,6,6,-22,34789,11.408045977,11.235632184,-0.25862069,-34,0.4310344828,0.1724137931,0.1724137931
17,11,2006,406,373,111,500,15,33,126,143,34932,11.6464193,10.69978916,3.1841195623,-16,0.4302864273,0.9466301401,3.6144059896
17,11,2007,403,391,-42,500,10,12,-32,-10,34922,11.538351419,11.194777679,-1.202508088,10,0.2863114496,0.3435737395,-0.916196639
17,11,2008,449,390,-84,500,12,59,-72,11,34933,12.855200057,11.165986687,-2.404981748,24,0.3435688211,1.6892133706,-2.061412927
17,13,2001,48,67,-25,55,1,-19,-24,-48,5042,9.474930912,13.225424398,-4.93485985,-5,0.197394394,-3.750493486,-4.737465456
17,13,2002,43,63,-45,55,1,-20,-44,-66,4976,8.5845478139,12.577360751,-8.983829108,-2,0.1996406468,-3.992812937,-8.784188461
17,13,2003,58,58,123,55,1,0,124,122,5098,11.51479055,11.51479055,24.419297201,-2,0.1985308716,0,24.617828072
17,13,2004,50,69,30,55,0,-19,30,8,5106,9.8000784006,13.524108193,5.8800470404,-3,0,-3.724029792,5.8800470404
17,13,2005,55,73,34,55,1,-18,35,13,5119,10.75794621,14.278728606,6.6503667482,-4,0.195599022,-3.520782396,6.8459657702
17,13,2006,59,59,8,55,0,0,8,5,5124,11.520062482,11.520062482,1.5620423704,-3,0,0,1.5620423704
17,13,2007,57,60,16,55,1,-3,17,13,5137,11.110028262,11.694766592,3.1186044245,-1,0.1949127765,-0.58473833,3.3135172011
17,13,2008,61,58,-36,55,0,3,-36,-36,5101,11.91638992,11.330337957,-7.032623559,-3,0,0.5860519633,-7.032623559
17,15,2001,161,182,-162,248,11,-21,-151,-184,16443,9.7369216813,11.006954944,-9.797399456,-12,0.6652555186,-1.270033263,-9.132143937
17,15,2002,168,204,-36,248,11,-36,-25,-76,16367,10.24078025,12.435233161,-2.194452911,-15,0.6705272783,-2.194452911,-1.523925632
17,15,2003,169,189,-2,248,9,-20,7,-35,16332,10.336707545,11.559986544,-0.1223279,-22,0.5504755497,-1.223278999,0.4281476498
17,15,2004,168,179,-127,248,7,-11,-120,-143,16189,10.331785615,11.008271578,-7.810337935,-12,0.4304910673,-0.676485963,-7.379846868
17,15,2005,148,195,-119,248,9,-47,-110,-173,16016,9.1911193914,12.10992082,-7.390156808,-16,0.5589194224,-2.918801428,-6.831237385
17,15,2006,144,225,57,248,8,-81,65,-24,15992,8.9977505624,14.058985254,3.5616095976,-8,0.4998750312,-5.061234691,4.0614846288
17,15,2007,159,190,-100,248,6,-31,-94,-115,15877,9.9783488657,11.92381311,-6.27569111,10,0.3765414666,-1.945464244,-5.899149644
17,15,2008,173,189,-39,248,5,-16,-34,-36,15841,10.908632322,11.917523173,-2.459171448,14,0.3152783908,-1.008890851,-2.143893058
17,17,2001,178,149,-150,212,121,29,-29,-10,13666,13.020261868,10.898983249,-10.97213079,-10,8.8508521688,2.121278619,-2.121278619
17,17,2002,205,168,-278,212,110,37,-168,-136,13530,15.075746433,12.354758053,-20.44418297,-5,8.0894249154,2.7209883806,-12.35475805
17,17,2003,204,160,5,212,87,44,92,117,13647,15.012694558,11.774662398,0.3679581999,-19,6.4024726791,3.2380321595,6.7704308791
17,17,2004,197,149,-169,212,86,48,-83,-49,13598,14.461369059,10.93778675,-12.40594605,-14,6.3130849697,3.5235823087,-6.092861075
17,17,2005,191,163,-89,212,89,28,0,17,13615,14.037408591,11.979568589,-6.540991438,-11,6.5409914379,2.0578400029,0
17,17,2006,183,129,-240,212,89,54,-151,-103,13512,13.492092749,9.5108194787,-17.69454787,-6,6.5617281675,3.9812732702,-11.1328197
17,17,2007,188,152,-24,212,78,36,54,83,13595,13.870955842,11.214815361,-1.77076032,-7,5.7549710407,2.6561404803,3.9842107205
17,17,2008,203,140,-152,212,80,63,-72,-21,13574,14.943501785,10.3058633,-11.18922301,-12,5.8890647429,4.637638485,-5.300158269
17,19,2001,2369,1179,-663,15242,1039,1190,376,1401,181320,13.115970313,6.5275344024,-3.670700007,-165,5.7524242953,6.5884359109,2.0817242878
17,19,2002,2298,1180,-140,16003,981,1118,841,1781,183101,12.611786917,6.4760263541,-0.76834211,-178,5.3838829266,6.1357605626,4.6155408168
17,19,2003,2241,1167,547,16643,851,1074,1398,2222,185323,12.165331249,6.3350921764,2.9694048162,-250,4.6196773283,5.8302390724,7.5890821445
17,19,2004,2288,1185,-637,17166,805,1103,168,1136,186459,12.30828819,6.3747034553,-3.426739326,-135,4.3304947523,5.9335847351,0.9037554266
17,19,2005,2371,1216,-248,17840,835,1155,587,1561,188020,12.662926359,6.4943561588,-1.324506848,-181,4.4595291058,6.1685702002,3.1350222576
17,19,2006,2528,1159,607,18918,838,1369,1445,2718,190738,13.348892961,6.1200027458,3.2052128272,-96,4.4249890431,7.2288902149,7.6302018703
17,19,2007,2450,1174,237,19536,765,1276,1002,2277,193015,12.768629822,6.1185189432,1.235169497,-1,3.9869395158,6.6501108786,5.2221090128
17,19,2008,2543,1193,-1546,19536,770,1350,-776,621,193636,13.153981239,6.1709396846,-7.996875735,47,3.9829199976,6.9830415543,-4.013955738
17,21,2001,389,452,-120,1795,13,-63,-107,-202,35153,11.034208884,12.821240143,-3.403869065,-32,0.368752482,-1.787031259,-3.035116583
17,21,2002,393,436,-63,1753,12,-43,-51,-129,35024,11.200250794,12.425723528,-1.795460051,-35,0.3419923907,-1.225472733,-1.45346766
17,21,2003,399,415,-13,1804,6,-16,-7,-74,34950,11.404235859,11.861548575,-0.371566582,-51,0.1714922686,-0.457312716,-0.200074313
17,21,2004,425,396,53,1775,13,29,66,70,35020,12.148063456,11.319136773,1.5149349721,-25,0.3715878234,0.8289266829,1.8865227955
17,21,2005,425,423,-203,1725,12,2,-191,-223,34797,12.174685249,12.117392612,-5.815202601,-34,0.3437558188,0.0572926365,-5.471446782
17,21,2006,395,412,-133,1799,12,-17,-121,-151,34646,11.376236626,11.86584681,-3.830479674,-13,0.3456071886,-0.489610184,-3.484872485
17,21,2007,407,418,-89,1807,8,-11,-81,-83,34563,11.761476109,12.079353841,-2.571919837,9,0.2311838056,-0.317877733,-2.340736031
17,21,2008,413,399,-104,1807,10,14,-94,-62,34501,11.959921232,11.554500174,-3.011699293,18,0.2895864705,0.4054210587,-2.722112823
17,23,2001,194,224,-76,247,2,-30,-74,-120,16873,11.456918443,13.228606862,-4.488277328,-16,0.1181125613,-1.771688419,-4.370164767
17,23,2002,187,201,59,247,2,-14,61,33,16906,11.071967791,11.900885165,3.4932946505,-14,0.1184167678,-0.828917375,3.6117114183
17,23,2003,182,236,-7,247,1,-54,-6,-84,16822,10.792220114,13.9943074,-0.415085389,-24,0.0592979127,-3.202087287,-0.355787476
17,23,2004,180,223,39,247,2,-43,41,-13,16809,10.704409622,13.261574143,2.3192887514,-11,0.1189378847,-2.557164521,2.4382266361
17,23,2005,201,207,44,247,3,-6,47,27,16836,11.948283549,12.304948729,2.6155446575,-14,0.1783325903,-0.356665181,2.7938772477
17,23,2006,188,188,-23,247,2,0,-21,-29,16807,11.17617335,11.17617335,-1.367297803,-8,0.1188954612,0,-1.248402342
17,23,2007,191,215,54,247,2,-24,56,28,16835,11.354854051,12.781641995,3.2102728732,-4,0.1188989953,-1.426787944,3.3291718685
17,23,2008,203,219,18,247,2,-16,20,-1,16834,12.058570198,13.008999376,1.0692328254,-5,0.1188036473,-0.950429178,1.1880364727
17,25,2001,201,175,-212,339,7,26,-205,-187,14223,14.039744351,12.223658017,-14.80808857,-8,0.4889463207,1.816086334,-14.31914225
17,25,2002,179,190,-57,339,7,-11,-50,-72,14151,12.617184747,13.392542468,-4.017762741,-11,0.4934094594,-0.775357722,-3.524353281
17,25,2003,165,200,-33,339,6,-35,-27,-81,14070,11.693419794,14.173842174,-2.338683959,-19,0.4252152652,-2.48042238,-1.913468694
17,25,2004,182,191,-73,339,5,-9,-68,-90,13980,12.976827094,13.618538324,-5.204991087,-13,0.3565062389,-0.64171123,-4.848484848
17,25,2005,181,178,-46,339,6,3,-40,-48,13932,12.969332187,12.75437088,-3.296073373,-11,0.4299226139,0.214961307,-2.86615076
17,25,2006,157,166,-60,339,5,-9,-55,-70,13862,11.297402317,11.945024106,-4.317478593,-6,0.3597898827,-0.647621789,-3.95768871
17,25,2007,175,173,-122,339,5,2,-117,-111,13751,12.675189222,12.530329917,-8.836417629,4,0.3621482635,0.1448593054,-8.474269366
17,25,2008,177,184,16,339,4,-7,20,16,13767,12.864306999,13.373064903,1.162875209,3,0.2907188022,-0.508757904,1.4535940112
17,27,2001,405,321,36,2365,14,84,50,100,35629,11.383119256,9.0221760027,1.0118328227,-34,0.3934905422,2.360943253,1.4053233649
17,27,2002,371,311,65,2366,6,60,71,97,35726,10.398710672,8.7169784878,1.8218765328,-34,0.1681732184,1.6817321841,1.9900497512
17,27,2003,399,358,150,2386,-25,41,125,125,35851,11.148832726,10.003213323,4.1912904983,-41,-0.698548416,1.1456194029,3.492742082
17,27,2004,403,323,41,2390,26,80,67,122,35973,11.221875696,8.9942080642,1.1416796614,-25,0.7239919804,2.227667632,1.8656716418
17,27,2005,435,298,-77,2385,12,137,-65,39,36012,12.085851219,8.2795026742,-2.139334584,-33,0.3334027922,3.8063485448,-1.805931791
17,27,2006,390,343,246,2381,18,47,264,293,36305,10.785845652,9.4860129707,6.803379565,-18,0.4978082609,1.2998326811,7.3011878258
17,27,2007,469,339,-47,2381,5,130,-42,89,36394,12.902515853,9.3261255313,-1.293002655,1,0.1375534739,3.5763903217,-1.155449181
17,27,2008,466,348,178,2381,10,118,188,317,36711,12.748785993,9.5205526298,4.8697079543,11,0.2735790986,3.228233363,5.1432870529
17,29,2001,588,496,-862,3952,35,92,-827,-765,52319,11.157177689,9.4114968265,-16.35627069,-30,0.6641177196,1.745680863,-15.69215297
17,29,2002,589,487,-388,3747,34,102,-354,-290,52029,11.289147851,9.3341511097,-7.436654272,-38,0.6516655806,1.9549967417,-6.784988692
17,29,2003,561,512,312,4268,27,49,339,336,52365,10.747744123,9.808992854,5.9773550204,-52,0.5172711075,0.9387512692,6.4946261279
17,29,2004,577,518,-4,4569,31,59,27,55,52420,11.013026674,9.8869112946,-0.076346805,-31,0.5916877416,1.1261153791,0.5153409362
17,29,2005,541,486,-377,4632,32,55,-345,-334,52086,10.353472528,9.3009013837,-7.214896752,-44,0.6124050294,1.0525711442,-6.602491723
17,29,2006,553,492,167,4931,32,61,199,235,52321,10.593159462,9.424655435,3.1990192228,-25,0.6129857193,1.1685040275,3.8120049422
17,29,2007,586,480,-166,5102,25,106,-141,-38,52283,11.204160453,9.1774693128,-3.173874804,-3,0.4779931934,2.0266911399,-2.695881611
17,29,2008,587,483,-249,5102,27,104,-222,-111,52172,11.239289646,9.2480015318,-4.767603274,7,0.5169690297,1.9912881145,-4.250634244
17,31,2001,85324,46263,-81329,95376,42837,39061,-38492,1478,5378570,15.865876038,8.6025388302,-15.12301149,909,7.9654790193,7.2633372079,-7.15753247
17,31,2002,82689,45316,-96596,97326,40501,37373,-56095,-17945,5360625,15.399478266,8.4393662653,-17.98943031,777,7.5426510088,6.9601120009,-10.4467793
17,31,2003,81852,44125,-97061,101217,35509,37727,-61552,-20979,5339646,15.299051772,8.2474546673,-18.14178351,2846,6.637028165,7.0515971044,-11.50475535
17,31,2004,82171,43298,-94832,103925,32249,38873,-62583,-23162,5316484,15.422296838,8.1264023618,-17.79858166,548,6.0526663995,7.2958944758,-11.74591526
17,31,2005,79244,42620,-98870,104812,33991,36624,-64879,-27775,5288709,14.944376778,8.0375717821,-18.6455824,480,6.4102558058,6.9068049964,-12.2353266
17,31,2006,78357,41388,-89804,106936,34239,36969,-55565,-18563,5270146,14.841950193,7.8394863837,-17.01017771,33,6.485362286,7.0024638088,-10.52481543
17,31,2007,79196,41599,-65984,108598,31139,37597,-34845,1259,5271405,15.025492928,7.8923869931,-12.51884092,-1493,5.9078592894,7.1331059348,-6.610981629
17,31,2008,79854,41819,-43031,108598,31177,38035,-11854,23259,5294664,15.115176704,7.9157158637,-8.145129471,-2922,5.9013432526,7.1994608402,-2.243786218
17,33,2001,232,232,-88,1568,9,0,-79,-96,20303,11.399931207,11.399931207,-4.324111837,-17,0.4422387106,0,-3.881873127
17,33,2002,185,235,-154,1568,9,-50,-145,-210,20093,9.1593227052,11.634815328,-7.624517279,-15,0.4455886721,-2.475492623,-7.178928607
17,33,2003,181,243,-83,1568,8,-62,-75,-160,19933,9.0441213211,12.14210763,-4.147304252,-23,0.3997401689,-3.097986309,-3.747564083
17,33,2004,203,249,-43,1568,6,-46,-37,-96,19837,10.208700025,12.522001509,-2.162433995,-13,0.3017349761,-2.313301484,-1.860699019
17,33,2005,188,230,-8,1568,8,-42,0,-61,19776,9.491833489,11.612349481,-0.403907808,-19,0.403907808,-2.120515992,0
17,33,2006,189,207,-80,1568,7,-18,-73,-100,19676,9.5812633073,10.493764575,-4.055561188,-9,0.354861604,-0.912501267,-3.700699584
17,33,2007,184,242,-43,1568,5,-58,-38,-92,19584,9.3734080489,12.328069282,-2.190524707,4,0.2547121752,-2.954661233,-1.935812532
17,33,2008,195,233,-9,1568,4,-38,-5,-29,19555,9.9644855515,11.906282736,-0.459899333,14,0.2043997036,-1.941797184,-0.25549963
17,35,2001,122,130,-91,135,4,-8,-87,-104,11152,10.888968226,11.602998929,-8.12209925,-9,0.3570153517,-0.714030703,-7.765083899
17,35,2002,125,135,-81,135,4,-10,-77,-96,11056,11.257204611,12.15778098,-7.294668588,-9,0.3602305476,-0.900576369,-6.93443804
17,35,2003,121,131,-122,135,2,-10,-120,-138,10918,11.013015382,11.923181942,-11.10403204,-8,0.1820333121,-0.91016656,-10.92199873
17,35,2004,120,133,3,135,1,-13,4,-15,10903,10.99857935,12.190092113,0.2749644838,-6,0.0916548279,-1.191512763,0.3666193117
17,35,2005,144,124,-65,135,2,20,-63,-53,10850,13.239553165,11.400726337,-5.976187193,-10,0.1838826828,1.8388268285,-5.79230451
17,35,2006,134,127,32,135,1,7,33,35,10885,12.330342765,11.686220382,2.9445594663,-5,0.0920174833,0.6441223833,3.0365769496
17,35,2007,126,125,-61,135,2,1,-59,-58,10827,11.606484893,11.514369934,-5.619012528,0,0.1842299189,0.0921149595,-5.434782609
17,35,2008,131,131,15,135,1,0,16,19,10846,12.088774051,12.088774051,1.3842107692,3,0.0922807179,0,1.4764914871
17,37,2001,1175,602,637,8043,324,573,961,1483,90804,13.046495489,6.6842470507,7.0728660652,-51,3.5975017349,6.3622484386,10.6703678
17,37,2002,1153,612,791,8442,302,541,1093,1591,92395,12.587404953,6.6812591772,8.6354183156,-43,3.296961228,5.9061457759,11.932379544
17,37,2003,1140,571,1512,9186,263,569,1775,2346,94741,12.183652531,6.1025136799,16.159370725,2,2.8107900137,6.0811388509,18.970160739
17,37,2004,1177,623,1527,9586,245,554,1772,2274,97015,12.276017439,6.4978410063,15.926489914,-52,2.5553307328,5.7781764325,18.481820647
17,37,2005,1205,676,1696,9346,254,529,1950,2440,99455,12.266503792,6.8814577289,17.264722349,-39,2.5856364839,5.385046063,19.850358833
17,37,2006,1260,609,2204,9837,259,651,2463,3118,102573,12.473518522,6.0288672857,21.818757796,4,2.5640010296,6.4446512365,24.382758826
17,37,2007,1396,642,1586,10156,240,754,1826,2607,105180,13.439035778,6.1804161673,15.268130905,27,2.3104359504,7.2586196108,17.578566856
17,37,2008,1422,622,75,10156,242,800,317,1141,106321,13.446744933,5.8817688805,0.7092165049,24,2.2884052558,7.5649760521,2.9976217607
17,39,2001,234,193,-99,266,9,41,-90,-63,16725,13.964730105,11.51791842,-5.908155044,-14,0.537105004,2.446811685,-5.37105004
17,39,2002,198,189,-182,266,9,9,-173,-175,16550,11.900826446,11.35987979,-10.9391435,-11,0.5409466566,0.5409466566,-10.39819684
17,39,2003,203,240,4,266,5,-37,9,-53,16497,12.285532726,14.524767755,0.2420794626,-25,0.3025993282,-2.239235029,0.5446787908
17,39,2004,231,208,-86,266,4,23,-82,-70,16427,14.032316851,12.635159762,-5.224152594,-11,0.2429838416,1.3971570891,-4.981168752
17,39,2005,166,194,20,266,5,-28,25,-20,16407,10.111469818,11.817018944,1.2182493756,-17,0.3045623439,-1.705549126,1.5228117196
17,39,2006,182,201,102,266,4,-19,106,80,16487,11.065847875,12.221073752,6.201738919,-7,0.2432054478,-1.155225877,6.4449443668
17,39,2007,197,195,-107,266,4,2,-103,-96,16391,11.983697305,11.862035404,-6.508911734,5,0.2433238032,0.1216619016,-6.265587931
17,39,2008,200,208,-43,266,3,-8,-40,-37,16354,12.215605436,12.704229653,-2.626355169,11,0.1832340815,-0.488624217,-2.443121087
17,41,2001,297,188,-122,300,33,109,-89,-1,19925,14.905523073,9.4351459185,-6.122807458,-21,1.6561692304,5.4703771549,-4.466638227
17,41,2002,298,228,-171,300,32,70,-139,-83,19842,14.987301028,11.466794075,-8.600095557,-14,1.6093746071,3.520506953,-6.99072095
17,41,2003,321,197,-220,300,20,124,-200,-95,19747,16.21662583,9.952259466,-11.11419839,-19,1.0103816717,6.2643663644,-10.10381672
17,41,2004,292,167,-118,300,21,125,-97,13,19760,14.782190498,8.4541979902,-5.973624927,-15,1.0631027413,6.3279925077,-4.910522186
17,41,2005,294,203,-181,300,22,91,-159,-82,19678,14.909478168,10.294639688,-9.178964451,-14,1.1156752371,4.6148384807,-8.063289213
17,41,2006,262,224,-92,300,21,38,-71,-43,19635,13.328924274,11.395721517,-4.680385623,-10,1.0683488922,1.9332027574,-3.612036731
17,41,2007,289,197,-200,300,21,92,-179,-94,19541,14.753930978,10.057177864,-10.21033286,-7,1.07208495,4.6967531142,-9.138247907
17,41,2008,307,199,-203,300,22,108,-181,-93,19448,15.748031496,10.208007387,-10.41319346,-20,1.1285234297,5.5400241094,-9.284670035
17,43,2001,13506,5712,-5510,15348,5721,7794,211,7890,914555,14.831816035,6.2727182877,-6.050888965,-115,6.2826017724,8.5590977477,0.2317128079
17,43,2002,12945,5599,-7623,15332,5377,7346,-2246,4992,919547,14.11589977,6.1054401555,-8.312514789,-108,5.8633598349,8.0104596146,-2.449154954
17,43,2003,13002,5754,-9498,15408,4737,7248,-4761,2110,921657,14.123367101,6.2502579834,-10.31716203,-377,5.1455460666,7.8731091177,-5.171615964
17,43,2004,12851,5604,-8453,15618,4278,7247,-4175,3120,924777,13.919804336,6.0700788655,-9.15602724,48,4.6337968213,7.8497254708,-4.522230418
17,43,2005,12422,5695,-10824,15709,4519,6727,-6305,379,925156,13.429675561,6.1569797393,-11.70204543,-43,4.8855823427,7.272695822,-6.816463083
17,43,2006,12102,5740,-10681,16097,4497,6362,-6184,317,925473,13.078796452,6.2032962847,-11.54310237,139,4.8599692321,6.8755001678,-6.68313314
17,43,2007,11889,5701,-9671,16547,4089,6188,-5582,755,926228,12.841166041,6.1575815966,-10.44553089,149,4.4164797664,6.6835844448,-6.029051127
17,43,2008,11977,5722,-6147,16547,4094,6255,-2053,4300,930528,12.900995069,6.1634377376,-6.621225406,98,4.4098416809,6.7375573312,-2.211383725
17,45,2001,194,211,-62,793,-1,-17,-63,-97,19560,9.8936685621,10.760639519,-3.161894077,-17,-0.050998292,-0.866970956,-3.212892368
17,45,2002,226,218,-218,792,-1,8,-219,-222,19338,11.620134711,11.208802509,-11.20880251,-11,-0.051416525,0.4113322022,-11.26021903
17,45,2003,200,297,-95,760,-3,-97,-98,-216,19122,10.400416017,15.444617785,-4.940197608,-21,-0.15600624,-5.044201768,-5.096203848
17,45,2004,198,250,-14,760,1,-52,-13,-77,19045,10.375455236,13.100322268,-0.733618047,-12,0.0524012891,-2.724867032,-0.681216758
17,45,2005,227,231,-76,760,1,-4,-75,-98,18947,11.949884186,12.160454833,-4.000842283,-19,0.0526426616,-0.210570646,-3.948199621
17,45,2006,217,252,-14,760,1,-35,-13,-55,18892,11.469647718,13.319590898,-0.739977272,-7,0.0528555194,-1.84994318,-0.687121753
17,45,2007,212,242,-37,760,-1,-30,-38,-61,18831,11.239827161,12.830368741,-1.961667948,7,-0.053018053,-1.590541579,-2.014686001
17,45,2008,228,249,-135,760,1,-21,-134,-139,18692,12.152546438,13.271859926,-7.195586707,16,0.0533006423,-1.119313488,-7.142286065
17,47,2001,92,94,-108,72,1,-2,-107,-113,6854,13.313074307,13.602488966,-15.62839158,-4,0.1447073294,-0.289414659,-15.48368425
17,47,2002,79,72,-56,72,1,7,-55,-53,6801,11.570853167,10.545587697,-8.202123764,-5,0.1464664958,1.0252654705,-8.055657268
17,47,2003,77,78,3,72,1,-1,4,-8,6793,11.328527291,11.475651023,0.4413711932,-11,0.1471237311,-0.147123731,0.5884949242
17,47,2004,77,86,-70,72,0,-9,-70,-85,6708,11.406562477,12.739797052,-10.36960225,-6,0,-1.333234575,-10.36960225
17,47,2005,71,90,-36,72,1,-19,-35,-59,6649,10.631129745,13.476079958,-5.390431983,-5,0.1497342218,-2.844950213,-5.240697761
17,47,2006,63,91,-94,72,0,-28,-94,-124,6525,9.564293305,13.815090329,-14.27053287,-2,0,-4.250797024,-14.27053287
17,47,2007,73,78,30,72,1,-5,31,23,6548,11.168056299,11.932991662,4.5896121778,-3,0.1529870726,-0.764935363,4.7425992504
17,47,2008,76,79,-41,72,0,-3,-41,-47,6501,11.648402176,12.108207525,-6.284006437,-3,0,-0.459805349,-6.284006437
17,49,2001,454,312,-21,467,14,142,-7,99,34359,13.232486629,9.0936912517,-0.612075373,-36,0.4080502485,4.1387953774,-0.204025124
17,49,2002,452,354,-128,467,13,98,-115,-46,34313,13.164026095,10.309878844,-3.727865797,-29,0.37861137,2.8541472507,-3.349254427
17,49,2003,461,334,31,467,11,127,42,116,34429,13.412469815,9.7174943993,0.9019231329,-53,0.3200372407,3.6949754153,1.2219603736
17,49,2004,473,321,-34,467,12,152,-22,106,34535,13.717301781,9.3092048025,-0.986021692,-24,0.3480076562,4.4080969781,-0.638014036
17,49,2005,453,313,-255,467,13,140,-242,-130,34405,13.141862489,9.0803597331,-7.397737163,-28,0.3771395416,4.061502756,-7.020597621
17,49,2006,477,286,-314,467,12,191,-302,-126,34279,13.889697746,8.3279948751,-9.143323045,-15,0.3494263584,5.5617028711,-8.793896686
17,49,2007,466,344,-245,467,12,122,-233,-105,34174,13.615181219,10.050691715,-7.158196135,6,0.350605525,3.5644895037,-6.80759061
17,49,2008,485,335,-69,467,13,150,-56,101,34275,14.171134713,9.7883095443,-2.016099578,7,0.379844848,4.3828251691,-1.63625473
17,51,2001,233,245,-254,1673,1,-12,-253,-279,21513,10.760882115,11.315090636,-11.73074703,-14,0.0461840434,-0.554208521,-11.68456298
17,51,2002,248,242,-5,1743,1,6,-4,-19,21494,11.533006255,11.25398191,-0.232520287,-21,0.0465040575,0.2790243449,-0.18601623
17,51,2003,243,265,-378,1384,1,-22,-377,-402,21092,11.412201193,12.445404593,-17.75231297,-3,0.0469637909,-1.0332034,-17.70534918
17,51,2004,243,264,-442,857,2,-21,-440,-489,20603,11.65607387,12.663388896,-21.20158292,-28,0.0959347644,-1.007315026,-21.10564816
17,51,2005,257,227,532,1378,3,30,535,546,21149,12.310787507,10.8737306,25.483809159,-19,0.1437056907,1.4370569075,25.62751485
17,51,2006,236,235,-52,1393,2,1,-50,-57,21092,11.173977889,11.126630525,-2.462062925,-8,0.0946947279,0.0473473639,-2.367368197
17,51,2007,247,220,-143,1299,2,27,-141,-113,20979,11.742055097,10.458510613,-6.798031898,1,0.0950773692,1.2835444843,-6.702954529
17,51,2008,257,233,-33,1299,3,24,-30,2,20981,12.249761678,11.105815062,-1.572926597,8,0.142993327,1.1439466158,-1.42993327
17,53,2001,191,210,-38,403,7,-19,-31,-63,14146,13.472050785,14.812202433,-2.680303297,-13,0.4937400811,-1.340151649,-2.186563216
17,53,2002,168,224,9,403,7,-56,16,-54,14092,11.898859693,15.865146257,0.6374389121,-14,0.4957858205,-3.966286564,1.1332247326
17,53,2003,155,201,8,403,4,-46,12,-51,14041,11.019087904,14.28926883,0.5687271176,-17,0.2843635588,-3.270180926,0.8530906764
17,53,2004,168,210,63,403,5,-42,68,16,14057,11.958146487,14.947683109,4.4843049327,-10,0.3558972169,-2.989536622,4.8402021496
17,53,2005,174,204,-40,403,6,-30,-34,-73,13984,12.410399059,14.550123034,-2.852965301,-9,0.4279447951,-2.139723976,-2.425020506
17,53,2006,171,212,66,403,5,-41,71,23,14007,12.218212997,15.147726055,4.7158015076,-7,0.35725769,-2.929513058,5.0730591976
17,53,2007,157,194,151,403,4,-37,155,107,14114,11.166032502,13.797517869,10.739305146,-11,0.2844849045,-2.631485367,11.02379005
17,53,2008,187,207,-34,403,5,-20,-29,-64,14050,13.279363727,14.699616532,-2.414429768,-15,0.3550632012,-1.420252805,-2.059366567
17,55,2001,473,564,-108,565,3,-91,-105,-231,38786,12.158914181,14.498155598,-2.776242561,-35,0.0771178489,-2.339241417,-2.699124712
17,55,2002,477,593,204,565,1,-116,205,59,38845,12.288905205,15.277402069,5.2556324149,-30,0.025762904,-2.988496863,5.2813953189
17,55,2003,477,584,270,565,-2,-107,268,119,38964,12.260792453,15.011116966,6.9400712,-42,-0.051407935,-2.750324513,6.8886632652
17,55,2004,489,558,290,565,4,-69,294,193,39157,12.519040975,14.285531419,7.4243801283,-32,0.1024052431,-1.766490444,7.5267853714
17,55,2005,477,540,329,565,4,-63,333,238,39395,12.144821265,13.748854262,8.3766167634,-32,0.1018433649,-1.604032997,8.4784601283
17,55,2006,466,583,150,565,4,-117,154,16,39411,11.826510672,14.795827729,3.8068167398,-21,0.1015151131,-2.969317057,3.9083318529
17,55,2007,492,516,11,565,1,-24,12,-9,39402,12.485249895,13.094286476,0.279141766,3,0.0253765242,-0.60903658,0.3045182901
17,55,2008,502,555,138,565,3,-53,141,86,39488,12.726581316,14.070224363,3.4985422741,-2,0.0760552668,-1.343643047,3.5745975409
17,57,2001,431,498,-291,2562,0,-67,-291,-391,37849,11.328838597,13.089934156,-7.648937429,-33,0,-1.761095559,-7.648937429
17,57,2002,401,470,-260,2562,0,-69,-260,-356,37493,10.644793077,12.476440763,-6.901860848,-27,0,-1.831647687,-6.901860848
17,57,2003,395,475,156,2562,-3,-80,153,28,37521,10.531367478,12.664302664,4.1592236116,-45,-0.079985069,-2.132935185,4.0792385421
17,57,2004,408,475,-47,2562,2,-67,-45,-140,37381,10.894235134,12.683239433,-1.254973165,-28,0.0534031134,-1.789004299,-1.201570052
17,57,2005,392,468,-140,2562,2,-76,-138,-247,37134,10.521371536,12.561229283,-3.757632691,-33,0.053680467,-2.039857747,-3.703952224
17,57,2006,397,455,-114,2562,2,-58,-112,-187,36947,10.717997867,12.28385146,-3.077712234,-17,0.0539949515,-1.565853593,-3.023717282
17,57,2007,414,501,-61,2562,0,-87,-61,-136,36811,11.225900919,13.584967054,-1.654057865,12,0,-2.359066135,-1.654057865
17,57,2008,412,452,-67,2562,2,-40,-65,-92,36719,11.20631035,12.294301646,-1.822385421,13,0.0543995648,-1.087991296,-1.767985856
17,59,2001,72,70,-121,71,4,2,-117,-118,6309,11.306532663,10.992462312,-19.00125628,-3,0.6281407035,0.3140703518,-18.37311558
17,59,2002,75,102,-102,71,4,-27,-98,-128,6181,12.009607686,16.333066453,-16.33306645,-3,0.6405124099,-4.323458767,-15.69255404
17,59,2003,56,89,14,71,1,-33,15,-26,6155,9.0791180285,14.429312581,2.2697795071,-8,0.1621271077,-5.350194553,2.4319066148
17,59,2004,73,84,-23,71,0,-11,-23,-38,6117,11.897001304,13.68970013,-3.748370274,-4,0,-1.792698827,-3.748370274
17,59,2005,55,72,-17,71,1,-17,-16,-40,6077,9.0208299164,11.809086436,-2.78825652,-7,0.1640150894,-2.78825652,-2.62424143
17,59,2006,62,92,36,71,0,-30,36,3,6080,10.19988484,15.135312988,5.9225137781,-3,0,-4.935428148,5.9225137781
17,59,2007,77,85,-43,71,1,-8,-42,-54,6026,12.720964811,14.042623492,-7.103915414,-4,0.1652073352,-1.321658682,-6.938708079
17,59,2008,65,89,-21,71,0,-24,-21,-44,5982,10.826115923,14.823451033,-3.497668221,1,0,-3.99733511,-3.497668221
17,61,2001,190,161,-170,324,0,29,-170,-151,14595,12.951160492,10.974404417,-11.58788044,-10,0,1.9767560751,-11.58788044
17,61,2002,165,167,14,343,0,-2,14,-4,14591,11.306790927,11.443842938,0.9593640787,-16,0,-0.137052011,0.9593640787
17,61,2003,155,173,-222,190,-2,-18,-224,-247,14344,10.713668567,11.95783653,-15.34473821,-5,-0.138240885,-1.244167963,-15.48297909
17,61,2004,175,182,-156,190,1,-7,-155,-174,14170,12.274672091,12.765658975,-10.94199341,-12,0.0701409834,-0.490986884,-10.87185242
17,61,2005,163,168,-45,190,1,-5,-44,-60,14110,11.52758133,11.881188119,-3.182461103,-11,0.0707213579,-0.353606789,-3.111739745
17,61,2006,165,157,-234,190,0,8,-234,-232,13878,11.790767472,11.219093897,-16.72145205,-6,0,0.5716735744,-16.72145205
17,61,2007,180,184,-149,190,0,-4,-149,-154,13724,13.04253315,13.33236722,-10.79631911,-1,0,-0.28983407,-10.79631911
17,61,2008,169,170,-68,190,1,-1,-67,-80,13644,12.350190003,12.42326805,-4.96930722,-12,0.0730780474,-0.073078047,-4.896229173
17,63,2001,487,316,335,347,39,171,374,516,38191,12.838425645,8.3304774207,8.8313605568,-29,1.0281285424,4.5079482245,9.8594890992
17,63,2002,491,310,242,347,39,181,281,431,38622,12.784294325,8.0715503886,6.301016755,-31,1.0154531134,4.7127439366,7.3164698684
17,63,2003,527,334,583,347,36,193,619,795,39417,13.506067479,8.5598226528,14.941247325,-17,0.9226156153,4.9462448263,15.86386294
17,63,2004,584,361,1266,347,31,223,1297,1453,40870,14.547809733,8.9927385505,31.536861509,-67,0.7722296262,5.5550711821,32.309091136
17,63,2005,621,327,2298,347,34,294,2332,2589,43459,14.728029503,7.7553392072,54.500824153,-37,0.8063655445,6.9726902963,55.307189697
17,63,2006,694,313,1665,347,32,381,1697,2053,45512,15.600588956,7.0360004945,37.427925953,-25,0.7193355138,8.5645884614,38.147261467
17,63,2007,750,351,1034,347,30,399,1064,1475,46987,16.216391529,7.5892712354,22.356998454,12,0.6486556611,8.6271202932,23.005654115
17,63,2008,801,338,462,347,29,463,491,971,47958,16.872926431,7.1199115277,9.7319500764,17,0.6108799831,9.7530149034,10.34283006
17,65,2001,99,110,-93,205,1,-11,-92,-112,8492,11.581656528,12.868507253,-10.87973795,-9,0.1169864296,-1.286850725,-10.76275152
17,65,2002,77,92,-101,205,1,-15,-100,-121,8371,9.1324200913,10.911462966,-11.97888869,-6,0.1186028583,-1.779042875,-11.86028583
17,65,2003,87,97,-29,205,1,-10,-28,-51,8320,10.424779821,11.623030376,-3.474926607,-13,0.1198250554,-1.198250554,-3.355101552
17,65,2004,95,105,74,205,0,-10,74,55,8375,11.38065289,12.578616352,8.8649296196,-9,0,-1.197963462,8.8649296196
17,65,2005,75,102,-61,205,1,-27,-60,-94,8281,9.0057636888,12.247838617,-7.3246878,-7,0.1200768492,-3.242074928,-7.204610951
17,65,2006,85,107,44,205,0,-22,44,17,8298,10.253935702,12.90789553,5.3079196574,-5,0,-2.653959829,5.3079196574
17,65,2007,85,96,-69,205,1,-11,-68,-74,8224,10.289311221,11.620869144,-8.352499697,5,0.1210507203,-1.331557923,-8.231448977
17,65,2008,84,99,51,205,0,-15,51,43,8267,10.187374932,12.006549027,6.1851919229,7,0,-1.819174095,6.1851919229
17,67,2001,236,215,-156,360,2,21,-154,-148,19941,11.791156633,10.741943542,-7.794154384,-15,0.0999250562,1.0492130902,-7.694229328
17,67,2002,194,218,-305,360,2,-24,-303,-344,19597,9.8133441246,11.027366078,-15.42819566,-17,0.1011684961,-1.214021954,-15.32702716
17,67,2003,217,235,-169,360,0,-18,-169,-202,19395,11.130488305,12.053754616,-8.668444809,-15,0,-0.923266311,-8.668444809
17,67,2004,194,221,-127,360,3,-27,-124,-168,19227,10.046087722,11.44425457,-6.576562581,-17,0.155351872,-1.398166848,-6.421210709
17,67,2005,201,198,-166,360,3,3,-163,-177,19050,10.502390469,10.345638373,-8.67361601,-17,0.1567520966,0.1567520966,-8.516863913
17,67,2006,231,195,-132,360,2,36,-130,-103,18947,12.158854646,10.263968208,-6.947916941,-9,0.1052714688,1.8948864384,-6.842645472
17,67,2007,221,222,-111,360,0,-1,-111,-102,18845,11.695596952,11.748518205,-5.874259102,10,0,-0.052921253,-5.874259102
17,67,2008,211,210,-170,360,2,1,-168,-154,18691,11.242540494,11.189258312,-9.057971014,13,0.1065643649,0.0532821824,-8.95140665
17,69,2001,39,80,13,221,11,-41,24,-23,4762,8.1701057924,16.759191369,2.7233685975,-6,2.3043888132,-8.589085577,5.0277574107
17,69,2002,40,60,-47,201,11,-20,-36,-58,4704,8.4512993873,12.676949081,-9.93027678,-2,2.3241073315,-4.225649694,-7.606169449
17,69,2003,49,45,32,237,8,4,40,39,4743,10.373663597,9.5268339155,6.774637451,-5,1.6936593628,0.8468296814,8.4682968138
17,69,2004,38,63,-40,230,5,-25,-35,-64,4679,8.0662279771,13.372956909,-8.490766292,-4,1.0613457865,-5.306728932,-7.429420505
17,69,2005,44,76,-26,221,7,-32,-19,-54,4625,9.4582975064,16.337059329,-5.588993981,-3,1.5047291488,-6.878761823,-4.084264832
17,69,2006,46,76,-92,212,6,-30,-86,-118,4507,10.074463425,16.644765659,-20.14892685,-2,1.3140604468,-6.570302234,-18.8348664
17,69,2007,46,46,-57,213,6,0,-51,-59,4448,10.273590173,10.273590173,-12.73031826,-8,1.3400335008,0,-11.39028476
17,69,2008,43,57,-52,213,5,-14,-47,-67,4381,9.7406274776,12.911994563,-11.77936346,-6,1.1326311021,-3.171367086,-10.64673236
17,71,2001,81,78,-24,77,1,3,-23,-28,8182,9.8828696925,9.5168374817,-2.928257687,-8,0.1220107369,0.3660322108,-2.80624695
17,71,2002,61,90,-42,77,1,-29,-41,-78,8104,7.4910966474,11.052437677,-5.157804249,-8,0.1228048631,-3.561341029,-5.034999386
17,71,2003,61,101,-114,77,1,-40,-113,-159,7945,7.6017197333,12.586453985,-14.20649262,-6,0.1246183563,-4.984734251,-14.08187426
17,71,2004,70,83,-9,77,0,-13,-9,-28,7917,8.826125331,10.465262892,-1.134787543,-6,0,-1.639137561,-1.134787543
17,71,2005,59,87,-101,77,1,-28,-100,-133,7784,7.5154448761,11.082096682,-12.86542258,-5,0.1273804216,-3.566651806,-12.73804216
17,71,2006,54,90,-130,77,0,-36,-130,-169,7615,7.0134424313,11.689070719,-16.88421326,-3,0,-4.675628288,-16.88421326
17,71,2007,62,84,-34,77,1,-22,-33,-54,7561,8.1707959937,11.070110701,-4.480759093,1,0.1317870322,-2.899314707,-4.348972061
17,71,2008,64,81,-70,77,0,-17,-70,-84,7477,8.5117701822,10.772709137,-9.309748637,3,0,-2.260938955,-9.309748637
17,73,2001,571,545,-497,587,22,26,-475,-487,50562,11.238940666,10.727185049,-9.782405448,-38,0.4330239836,0.511755617,-9.349381465
17,73,2002,552,565,-359,587,21,-13,-338,-393,50169,10.959883253,11.217996446,-7.127895087,-42,0.4169520803,-0.258113193,-6.710943007
17,73,2003,547,548,149,587,17,-1,166,104,50273,10.891857988,10.911769977,2.9668863623,-61,0.3385038131,-0.019911989,3.3053901754
17,73,2004,566,546,-333,587,22,20,-311,-333,49940,11.295939649,10.896789838,-6.645844352,-42,0.439064792,0.3991498109,-6.20677956
17,73,2005,560,527,-86,587,22,33,-64,-80,49860,11.22244489,10.561122244,-1.723446894,-49,0.4408817635,0.6613226453,-1.28256513
17,73,2006,600,519,-395,587,22,81,-373,-312,49548,12.071463061,10.441815548,-7.947046515,-20,0.4426203122,1.6296475133,-7.504426203
17,73,2007,552,512,-19,587,19,40,0,56,49604,11.134419881,10.32757786,-0.38324996,16,0.3832499597,0.8068420203,0
17,73,2008,585,522,-151,587,21,63,-130,-35,49569,11.79756587,10.527058776,-3.045183669,32,0.4235023646,1.2705070937,-2.621681304
17,75,2001,349,366,-374,686,37,-17,-337,-375,30945,11.210150165,11.756203325,-12.01316952,-21,1.1884686421,-0.54605316,-10.82470088
17,75,2002,366,408,-205,686,36,-42,-169,-235,30710,11.872516422,13.234936339,-6.649906739,-24,1.1677885005,-1.362419917,-5.482118239
17,75,2003,323,389,-73,686,24,-66,-49,-153,30557,10.544012274,12.69851633,-2.383012062,-38,0.7834560204,-2.154504056,-1.599556042
17,75,2004,374,400,-186,686,27,-26,-159,-211,30346,12.281825197,13.135641922,-6.108073494,-26,0.8866558298,-0.853816725,-5.221417664
17,75,2005,340,371,54,686,27,-31,81,22,30368,11.200052706,12.221233982,1.7788319004,-28,0.8894159502,-1.021181276,2.6682478506
17,75,2006,345,415,-123,686,26,-70,-97,-180,30188,11.394411784,13.706321421,-4.062355506,-13,0.8587092939,-2.311909637,-3.203646212
17,75,2007,345,379,72,686,23,-34,95,57,30245,11.417602965,12.542816011,2.3828040971,-4,0.761173531,-1.125213046,3.1439776281
17,75,2008,376,394,28,686,24,-18,52,40,30285,12.423591607,13.018338014,0.9251610772,6,0.792995209,-0.594746407,1.7181562861
17,77,2001,658,495,-663,6066,288,163,-375,-258,59351,11.062542031,8.3221250841,-11.1466039,-46,4.8419636853,2.7404169469,-6.304640215
17,77,2002,648,446,-1231,5267,261,202,-970,-784,58567,10.990688445,7.5645787751,-20.87891586,-16,4.4268050679,3.4261096694,-16.45211079
17,77,2003,680,452,-202,5453,217,228,15,169,58736,11.593906379,7.7065377697,-3.444072189,-74,3.699820124,3.8873686095,0.2557479348
17,77,2004,698,493,-419,5106,218,205,-201,-45,58691,11.888236947,8.3967060386,-7.13634854,-49,3.7129450637,3.4915309086,-3.423403476
17,77,2005,653,505,62,5427,226,148,288,385,59076,11.089694057,8.5762565065,1.0529265414,-51,3.8380870702,2.5134375504,4.8910136116
17,77,2006,704,405,-575,5342,229,299,-346,-71,59005,11.924018259,6.8596980039,-9.739077413,-24,3.8786934392,5.0643202547,-5.860383974
17,77,2007,697,486,-1212,4848,206,211,-1006,-772,58233,11.890342722,8.2908272062,-20.67589007,23,3.5142189393,3.5995155154,-17.16167113
17,77,2008,733,432,-508,4848,209,301,-299,31,58264,12.584015039,7.4164999957,-8.721254625,29,3.5880752294,5.1675150433,-5.133179395
17,79,2001,113,114,-22,78,1,-1,-21,-33,10037,11.239866713,11.33933456,-2.188292634,-11,0.099467847,-0.099467847,-2.088824787
17,79,2002,120,111,-64,78,1,9,-63,-63,9974,11.993403628,11.093898356,-6.396481935,-9,0.0999450302,0.8995052721,-6.296536905
17,79,2003,118,99,-84,78,1,19,-83,-72,9902,11.873616422,9.9617629302,-8.45240491,-8,0.100623868,1.9118534916,-8.351781042
17,79,2004,124,96,-4,78,0,28,-4,17,9919,12.511982241,9.6866959286,-0.40361233,-7,0,2.8252863125,-0.40361233
17,79,2005,121,93,-149,78,1,28,-148,-128,9791,12.278031456,9.4368340944,-15.11922882,-8,0.1014713343,2.8411973617,-15.01775748
17,79,2006,114,101,-90,78,0,13,-90,-81,9710,11.691708118,10.358443157,-9.230295882,-4,0,1.3332649608,-9.230295882
17,79,2007,114,112,-35,78,1,2,-34,-30,9680,11.758638473,11.55234657,-3.610108303,2,0.1031459515,0.206291903,-3.506962352
17,79,2008,121,105,-4,78,0,16,-4,18,9698,12.488388895,10.837031685,-0.412839302,6,0,1.6513572092,-0.412839302
17,81,2001,469,426,-59,2593,11,43,-48,-42,40014,11.714749594,10.640689397,-1.473710503,-37,0.2747595854,1.0740601973,-1.198950918
17,81,2002,474,398,-21,2545,9,76,-12,26,40040,11.842006646,9.9432882804,-0.524645864,-38,0.2248482274,1.8987183651,-0.299797637
17,81,2003,468,450,39,2591,0,18,39,4,40044,11.687727886,11.23819989,0.9739773238,-53,0,0.4495279956,0.9739773238
17,81,2004,471,423,-21,2601,10,48,-11,10,40054,11.760593273,10.562061475,-0.524357662,-27,0.2496941247,1.1985317985,-0.274663537
17,81,2005,468,425,52,2571,8,43,60,69,40123,11.674170897,10.601544084,1.2971300997,-34,0.1995584769,1.0726268132,1.4966885765
17,81,2006,500,436,-50,2583,10,64,-40,6,40129,12.460748642,10.865772816,-1.246074864,-18,0.2492149728,1.5949758261,-0.996859891
17,81,2007,485,415,-131,2568,7,70,-124,-43,40086,12.092501402,10.347191922,-3.266222028,11,0.1745309481,1.7453094808,-3.09169108
17,81,2008,489,393,-132,2568,9,96,-123,-3,40083,12.199229128,9.8042884407,-3.293043446,24,0.2245256895,2.3949406878,-3.068517756
17,83,2001,223,234,87,907,2,-11,89,54,21709,10.285029056,10.792362328,4.0125449682,-24,0.0922424131,-0.507333272,4.1047873812
17,83,2002,249,200,154,905,2,49,156,190,21899,11.41992295,9.1726288754,7.0629242341,-15,0.0917262888,2.2472940745,7.1546505228
17,83,2003,242,244,69,901,2,-2,71,41,21940,11.040397819,11.131640776,3.1478820229,-28,0.0912429572,-0.091242957,3.23912498
17,83,2004,236,231,203,917,1,5,204,190,22130,10.710233719,10.483321988,9.2126162923,-19,0.0453823463,0.2269117313,9.2579986385
17,83,2005,236,246,82,905,2,-10,84,55,22185,10.651021099,11.102335552,3.7007785174,-19,0.0902628907,-0.451314453,3.7910414081
17,83,2006,266,238,128,908,1,28,129,146,22331,11.950759278,10.692784617,5.7507413065,-11,0.0449276665,1.2579746608,5.795668973
17,83,2007,247,247,71,896,2,0,73,69,22400,11.043795131,11.043795131,3.1745322036,-4,0.0894234424,0,3.263955646
17,83,2008,262,232,179,896,1,30,180,222,22622,11.638754387,10.306072587,7.9516680734,12,0.0444227267,1.3326818,7.9960908001
17,85,2001,244,209,77,203,28,35,105,121,22399,10.922846207,9.3560444972,3.4469637621,-19,1.253441368,1.5668017101,4.7004051302
17,85,2002,208,214,-80,203,25,-6,-55,-82,22317,9.3031577064,9.5715180249,-3.578137579,-21,1.1181679936,-0.268360318,-2.459969586
17,85,2003,255,233,117,203,18,22,135,131,22448,11.392829219,10.409918463,5.2272981124,-26,0.8041997096,0.9829107562,6.031497822
17,85,2004,231,216,-139,203,17,15,-122,-126,22322,10.319410319,9.6493187402,-6.2095153,-19,0.7594371231,0.6700915792,-5.450078177
17,85,2005,206,247,-2,203,18,-41,16,-48,22274,9.2384967262,11.077226657,-0.089694143,-23,0.8072472868,-1.838729931,0.7175531438
17,85,2006,215,219,93,203,17,-4,110,96,22370,9.6317534271,9.8109488397,4.1662933429,-10,0.7615805035,-0.179195413,4.9278738464
17,85,2007,218,237,-153,203,15,-19,-138,-152,22218,9.7784157172,10.630662959,-6.862833049,5,0.6728267695,-0.852247241,-6.19000628
17,85,2008,236,233,-50,203,14,3,-36,-30,22188,10.629194253,10.494077377,-2.251947935,3,0.6305454218,0.1351168761,-1.621402513
17,87,2001,131,109,91,2811,1,22,92,101,13021,10.099841949,8.4036852858,7.0159207432,-13,0.0770980301,1.6961566632,7.0930187734
17,87,2002,130,125,-305,2383,0,5,-305,-303,12718,10.101402541,9.7128870585,-23.69944442,-3,0,0.3885154823,-23.69944442
17,87,2003,133,132,691,3011,0,1,691,731,13449,10.165475599,10.089043452,52.814613827,39,0,0.0764321474,52.814613827
17,87,2004,122,121,73,3091,1,1,74,63,13512,9.0501094173,8.9759281926,5.4152294054,-12,0.0741812247,0.0741812247,5.4894106302
17,87,2005,135,120,-24,2974,2,15,-22,-19,13493,9.998148491,8.8872431031,-1.777448621,-12,0.1481207184,1.1109053879,-1.629327902
17,87,2006,120,114,202,3089,1,6,203,202,13695,8.8274238635,8.3860526703,14.859496837,-7,0.0735618655,0.4413711932,14.933058702
17,87,2007,127,119,16,3095,1,8,17,29,13724,9.2636492943,8.6801123309,1.1670739268,4,0.0729421204,0.5835369634,1.2400160473
17,87,2008,133,117,-15,3095,2,16,-13,7,13731,9.6885813149,8.5230376981,-1.092697141,4,0.1456929521,1.1655436168,-0.947004189
17,89,2001,7997,2465,7571,6452,3112,5532,10683,16449,423969,19.235371725,5.9291223335,18.21070393,234,7.4853666134,13.306249391,25.696070543
17,89,2002,8190,2523,7946,6430,2942,5667,10888,16615,440584,18.946206884,5.8365421206,18.381753345,60,6.8058291395,13.109664763,25.187582485
17,89,2003,8214,2612,5305,6380,2594,5602,7899,14077,454661,18.350284,5.8352741428,11.851504337,576,5.795061687,12.515009858,17.646566024
17,89,2004,8696,2569,5057,6363,2340,6127,7397,13551,468212,18.845496618,5.5673965974,10.959254415,27,5.071120295,13.27810002,16.03037471
17,89,2005,8523,2646,649,6364,2468,5877,3117,9002,477214,18.029967443,5.597476693,1.3729260672,8,5.2209268626,12.43249075,6.5938529298
17,89,2006,8631,2655,1500,6380,2478,5976,3978,10065,487279,17.897486037,5.5054831917,3.1104424812,111,5.1384509789,12.392002845,8.2488934601
17,89,2007,8649,2697,2706,6380,2260,5952,4966,10863,498142,17.553918579,5.4738025676,5.4920688721,-55,4.586872007,12.080116011,10.078940879
17,89,2008,9057,2743,801,6380,2263,6314,3064,9437,507579,18.010959302,5.4547931285,1.5928870929,59,4.5002540466,12.556166173,6.0931411395
17,91,2001,1538,1154,162,4325,150,384,312,929,104805,14.740201552,11.059943167,1.5526090061,233,1.4376009316,3.6802583848,2.9902099377
17,91,2002,1567,1127,-175,4379,143,440,-32,591,105396,14.909538965,10.723069824,-1.665072954,183,1.360602471,4.1864691414,-0.304470483
17,91,2003,1538,1057,181,4535,119,481,300,672,106068,14.546211175,9.9969734801,1.7118753074,-109,1.1254870805,4.5492376953,2.8373623879
17,91,2004,1522,1111,310,4705,112,411,422,1331,107399,14.259815334,10.409103046,2.904430193,498,1.0493425213,3.8507122881,3.9537727143
17,91,2005,1503,1112,527,4987,119,391,646,1032,108431,13.927628226,10.304406246,4.8834731038,-5,1.1027197331,3.6232219803,5.986192837
17,91,2006,1549,1027,872,5198,117,522,989,1513,109944,14.18660561,9.4058385804,7.9862621637,2,1.0715512307,4.7807670292,9.0578133944
17,91,2007,1666,1042,838,5310,107,624,945,1594,111538,15.044111937,9.4093425199,7.5672063644,25,0.9662184737,5.6347694169,8.5334248381
17,91,2008,1686,1073,210,5310,109,613,319,986,112524,15.049405968,9.5777061706,1.8744811704,54,0.9729449884,5.4716997974,2.8474261588
17,93,2001,906,313,2113,192,75,593,2188,2951,58158,15.983769241,5.5219865038,37.277819433,170,1.3231597054,10.461782737,38.600979138
17,93,2002,1007,303,2861,192,75,704,2936,3567,61725,16.799713054,5.0549285553,47.729869957,-73,1.2512199394,11.744784498,48.981089896
17,93,2003,1122,316,3596,192,65,806,3661,5111,66836,17.454749107,4.9159542941,55.942315321,644,1.0111931301,12.538794813,56.953508451
17,93,2004,1223,352,4655,192,61,871,4716,5472,72308,17.578911056,5.0595066981,66.909101363,-115,0.876789513,12.519404358,67.785890876
17,93,2005,1440,392,5584,192,63,1048,5647,6723,79031,19.030124423,5.1804227595,73.794593595,28,0.8325679435,13.849701663,74.627161538
17,93,2006,1536,395,7206,192,63,1141,7269,8422,87453,18.452223637,4.74520074,86.566877298,12,0.7568294851,13.707022897,87.323706783
17,93,2007,1808,376,7467,192,61,1432,7528,9113,96566,19.650144822,4.0865345426,81.154663377,153,0.6629750189,15.563610279,81.817638396
17,93,2008,2073,395,5117,192,60,1678,5177,6894,103460,20.72730545,3.9494865667,51.163348765,39,0.5999220101,16.777818884,51.763270775
17,95,2001,653,728,-487,4393,15,-75,-472,-587,55170,11.773508704,13.125749367,-8.78054937,-40,0.2704481326,-1.352240663,-8.510101238
17,95,2002,590,677,-400,4288,14,-87,-386,-513,54657,10.744170377,12.328480246,-7.284183306,-40,0.2549464157,-1.584309869,-7.029236891
17,95,2003,644,726,-593,4276,9,-82,-584,-705,53952,11.859054038,13.369057813,-10.91990535,-39,0.1657321216,-1.510003775,-10.75417323
17,95,2004,608,716,-499,4290,13,-108,-486,-644,53308,11.336938281,13.350736528,-9.304493753,-50,0.2424016409,-2.013798247,-9.062092113
17,95,2005,590,697,-412,4306,13,-107,-399,-556,52752,11.125777862,13.143503677,-7.769187252,-50,0.245144258,-2.017725816,-7.524042995
17,95,2006,509,651,-302,4405,13,-142,-289,-453,52299,9.6905312658,12.393980067,-5.749588295,-22,0.2474988339,-2.703448801,-5.502089461
17,95,2007,584,674,-267,4534,10,-90,-257,-326,51973,11.20147307,12.927727482,-5.121221421,21,0.1918060457,-1.726254412,-4.929415375
17,95,2008,581,658,-75,4534,12,-77,-63,-116,51857,11.191370509,12.674564191,-1.444669171,24,0.2311470673,-1.483193682,-1.213522103
17,97,2001,10738,3674,1781,20898,3694,7064,5475,12677,660851,16.40610378,5.6133381715,2.7211092225,138,5.6438952656,10.792765608,8.3650044881
17,97,2002,10469,3858,2009,21298,2782,6611,4791,11452,672303,15.705612405,5.7877784562,3.0139053703,50,4.173561344,9.9178339487,7.1874667143
17,97,2003,10438,3836,-1819,17820,561,6602,-1258,5258,677561,15.465261686,5.6835355265,-2.69508632,-86,0.8311948463,9.7817261591,-1.863891474
17,97,2004,10498,3895,-1903,17932,4151,6603,2248,9019,686580,15.391370833,5.7105533812,-2.790034168,168,6.0858811516,9.6808174522,3.2958469836
17,97,2005,9973,3942,-890,18624,3195,6031,2305,8282,694862,14.438535965,5.7070799932,-1.288508674,-54,4.6256013644,8.7314559714,3.3370926901
17,97,2006,9987,3867,-3510,17754,3720,6120,210,6892,701754,14.301712138,5.5376710563,-5.026435327,562,5.3271622264,8.7640410822,0.3007268999
17,97,2007,10011,3999,-4091,17620,2632,6012,-1459,4632,706386,14.218756658,5.6798329712,-5.810501797,79,3.7382646612,8.5389236866,-2.072237136
17,97,2008,10327,4015,-3321,17620,2977,6312,-344,6067,712453,14.556972285,5.659556863,-4.68129224,99,4.1963887376,8.897415422,-0.484903502
17,99,2001,1502,1219,85,3430,97,283,182,358,111869,13.447936252,10.914137344,0.7610350076,-107,0.868475244,2.5337989077,1.6295102516
17,99,2002,1364,1241,-688,2946,92,123,-596,-557,111312,12.223262733,11.121018366,-6.165399384,-84,0.8244429409,1.1022443667,-5.340956443
17,99,2003,1418,1255,-1296,1730,78,163,-1218,-1119,110193,12.803322724,11.331572651,-11.70176745,-64,0.7042730412,1.4717500734,-10.99749441
17,99,2004,1349,1344,847,2604,84,5,931,837,111030,12.195838588,12.150635332,7.6574316414,-99,0.7594147082,0.0452032564,8.4168463496
17,99,2005,1366,1340,161,2599,86,26,247,167,111197,12.293735685,12.059740716,1.4489688472,-106,0.7739833594,0.2339949691,2.2229522065
17,99,2006,1330,1369,433,2527,87,-39,520,428,111625,11.937779932,12.287835133,3.8865103087,-53,0.7808923715,-0.350055201,4.6674026802
17,99,2007,1443,1264,163,2679,71,179,234,443,112068,12.90161069,11.301202988,1.4573544992,30,0.6347985856,1.6004077016,2.0921530848
17,99,2008,1490,1247,24,2679,73,243,97,406,112474,13.271459237,11.107053469,0.2137684709,66,0.6502124324,2.1644057682,0.8639809033
17,101,2001,149,217,-40,588,5,-68,-35,-117,15273,9.7185533053,14.153866223,-2.609007599,-14,0.3261259498,-4.435312918,-2.282881649
17,101,2002,159,207,803,1396,5,-48,808,772,16045,10.153905102,13.219234945,51.28041382,12,0.3193051919,-3.065329842,51.599719011
17,101,2003,179,276,449,1776,2,-97,451,367,16412,11.029978125,17.007117109,27.667375297,13,0.123239979,-5.977138984,27.790615276
17,101,2004,154,247,161,2011,1,-93,162,54,16466,9.3679664213,15.025244845,9.7937830768,-15,0.0608309508,-5.657278423,9.8546140276
17,101,2005,172,206,317,2257,2,-34,319,270,16736,10.360821637,12.408891031,19.095235227,-15,0.1204746702,-2.048069393,19.215709897
17,101,2006,171,235,-69,2269,1,-64,-68,-139,16597,10.260102601,14.100141001,-4.1400414,-7,0.0600006,-3.8400384,-4.0800408
17,101,2007,140,208,208,2584,2,-68,210,147,16744,8.3980684443,12.47713026,12.47713026,5,0.1199724063,-4.079061816,12.597102666
17,101,2008,158,230,10,2584,1,-72,11,-63,16681,9.4540014959,13.762154076,0.5983545251,-2,0.0598354525,-4.30815258,0.6581899776
17,103,2001,379,394,-107,3077,16,-15,-91,-139,35916,10.532019841,10.9488544,-2.97341985,-33,0.4446235289,-0.416834558,-2.528796321
17,103,2002,353,381,-399,2696,15,-28,-384,-433,35483,9.8880936708,10.672418381,-11.17662712,-21,0.420173952,-0.78432471,-10.75645317
17,103,2003,365,377,-355,2395,14,-12,-341,-378,35105,10.341701139,10.681702272,-10.05836686,-25,0.3966679889,-0.340001133,-9.661698872
17,103,2004,382,356,-36,2391,14,26,-22,-19,35086,10.884586343,10.143750623,-1.025772535,-23,0.3989115414,0.7408357197,-0.626860994
17,103,2005,367,362,-191,2298,16,5,-175,-201,34885,10.490060168,10.347143817,-5.45940461,-31,0.4573323234,0.1429163511,-5.002072287
17,103,2006,386,336,-9,2376,15,50,6,39,34924,11.058746007,9.6262659542,-0.257846409,-17,0.4297440158,1.4324800527,0.1718976063
17,103,2007,418,361,95,2388,11,57,106,165,35089,11.940639596,10.31237056,2.7137817263,2,0.3142273578,1.6282690358,3.028009084
17,103,2008,413,345,-44,2388,12,68,-32,40,35129,11.763365519,9.8265402034,-1.25323991,4,0.3417927027,1.9368253154,-0.911447207
17,105,2001,550,376,-172,3579,16,174,-156,-18,39632,13.874523852,9.4851290331,-4.338942004,-36,0.403622512,4.3893948185,-3.935319492
17,105,2002,511,432,-592,3208,15,79,-577,-519,39113,12.978601816,10.972125214,-15.03587529,-21,0.3809765699,2.0064766017,-14.65489872
17,105,2003,496,412,-617,2891,10,84,-607,-533,38580,12.768203056,10.605846087,-15.88302678,-10,0.2574234487,2.1623569691,-15.62560334
17,105,2004,548,440,-195,2934,15,108,-180,-104,38476,14.223421927,11.420265781,-5.061254153,-32,0.3893272425,2.8031561462,-4.67192691
17,105,2005,514,482,-233,2864,14,32,-219,-221,38255,13.397453441,12.563370737,-6.073164692,-34,0.3649111832,0.8340827045,-5.708253509
17,105,2006,484,392,-419,2887,14,92,-405,-331,37924,12.706913979,10.291550165,-11.00040694,-18,0.367555363,2.4153638142,-10.63285157
17,105,2007,533,414,-204,2903,11,119,-193,-86,37838,14.07037829,10.928961749,-5.385285499,-12,0.2903830416,3.1414165413,-5.094902458
17,105,2008,542,419,-286,2903,13,123,-273,-157,37681,14.354003628,11.09654524,-7.574252837,-7,0.3442842199,3.257458388,-7.229968617
17,107,2001,333,333,-253,4266,7,0,-246,-269,30880,10.736913379,10.736913379,-8.15747473,-23,0.2257008818,0,-7.931773848
17,107,2002,329,351,-129,4341,7,-22,-122,-169,30711,10.683379065,11.397769155,-4.188923706,-25,0.2273059376,-0.714390089,-3.961617769
17,107,2003,346,340,-207,4246,4,6,-203,-226,30485,11.307928623,11.111837375,-6.765148049,-29,0.1307274985,0.1960912478,-6.63442055
17,107,2004,331,300,-50,4233,7,31,-43,-33,30452,10.863678881,9.8462346358,-1.641039106,-21,0.2297454748,1.0174442457,-1.411293631
17,107,2005,333,352,-201,4199,7,-19,-194,-239,30213,10.97832358,11.604714415,-6.626555675,-26,0.2307755708,-0.626390835,-6.395780104
17,107,2006,322,349,-264,4148,7,-27,-257,-298,29915,10.7104843,11.608568387,-8.781266631,-14,0.2328366152,-0.898084087,-8.548430016
17,107,2007,332,313,-128,4248,6,19,-122,-98,29817,11.116319561,10.480144646,-4.285809951,5,0.2008973415,0.6361749146,-4.08491261
17,107,2008,348,311,-82,4248,7,37,-75,-29,29788,11.676872746,10.435366161,-2.751447026,9,0.2348796242,1.241506585,-2.516567402
17,109,2001,312,307,-109,4941,73,5,-36,-61,32791,9.5059640784,9.3536249105,-3.320993861,-30,2.2241518517,0.1523391679,-1.096842009
17,109,2002,274,305,0,5135,71,-31,71,7,32798,8.3550595374,9.300339996,0,-33,2.1649971794,-0.945280459,2.1649971794
17,109,2003,291,304,174,5609,57,-13,231,184,32982,8.8476740651,9.2429309821,5.2903618121,-34,1.7330495591,-0.395256917,7.0234113712
17,109,2004,282,298,-186,5727,58,-16,-128,-168,32814,8.5719496626,9.0583014165,-5.653839139,-24,1.7630251079,-0.486351754,-3.890814031
17,109,2005,296,302,61,6008,61,-6,122,83,32897,9.0091461095,9.191763936,1.8566145699,-33,1.8566145699,-0.182617827,3.7132291397
17,109,2006,292,296,1,6159,60,-4,61,42,32939,8.8705267635,8.9920408287,0.0303785163,-15,1.8227109788,-0.121514065,1.8530894951
17,109,2007,292,278,13,6244,54,14,67,78,33017,8.8543877737,8.4298623325,0.3942021954,-3,1.6374552732,0.4245254412,2.0316574686
17,109,2008,305,276,-322,6244,56,29,-266,-229,32788,9.2698123243,8.3884203328,-9.786490388,8,1.7019983284,0.8813919915,-8.08449206
17,111,2001,4084,1449,4117,1519,800,2635,4917,8112,269982,15.357655889,5.4488842761,15.481750562,560,3.008355708,9.9087716132,18.49010627
17,111,2002,4217,1583,4414,1519,760,2634,5174,8300,278282,15.383100112,5.7745903433,16.101732012,492,2.7723870252,9.608509769,18.874119038
17,111,2003,4116,1627,5009,1519,660,2489,5669,8776,287058,14.561149043,5.7558283511,17.720309902,618,2.3348781264,8.805320692,20.055188028
17,111,2004,4295,1669,4309,1519,605,2626,4914,7538,294596,14.76822991,5.7388069196,14.816368494,-2,2.0802745275,9.0294229903,16.896643021
17,111,2005,4276,1655,4196,1519,638,2621,4834,7509,302105,14.332136196,5.547166839,14.0639952,54,2.138424437,8.7849693565,16.202419637
17,111,2006,4293,1718,3717,1519,636,2575,4353,6920,309025,14.049383928,5.6223716721,12.164351284,-8,2.0813902116,8.427012256,14.245741495
17,111,2007,4315,1831,2756,1519,574,2484,3330,5644,314669,13.836913615,5.8714690217,8.8376671894,-170,1.8406462143,7.965444593,10.678313404
17,111,2008,4594,1915,878,1519,577,2679,1455,3972,318641,14.507902923,6.047591227,2.7727337323,-162,1.8221723958,8.4603116957,4.5949061281
17,113,2001,2015,990,552,11587,287,1025,839,1718,152598,13.279381042,6.5243609092,3.6378254766,-146,1.8914056373,6.7550201333,5.529231114
17,113,2002,2076,1022,1775,12119,266,1054,2041,2997,155595,13.472077562,6.63220774,11.518756104,-98,1.7261910556,6.8398698218,13.24494716
17,113,2003,2128,1028,519,12178,227,1100,746,1632,157227,13.605181221,6.5724277704,3.3181809464,-214,1.4513045758,7.0327534508,4.7694855221
17,113,2004,2179,1068,-88,12054,226,1111,138,1142,158369,13.808793521,6.7681466178,-0.557675002,-107,1.4322108012,7.040646903,0.8745357989
17,113,2005,2242,1006,-345,11868,234,1236,-111,980,159349,14.113144361,6.3326597801,-2.171737201,-145,1.4730043624,7.7804845807,-0.698732839
17,113,2006,2166,1032,994,11930,235,1134,1229,2281,161630,13.496210032,6.4303272177,6.1935516031,-82,1.4642702482,7.0658828148,7.6578218513
17,113,2007,2251,1059,659,11966,215,1192,874,2062,163692,13.838596836,6.5104727009,4.051370642,-4,1.3217673566,7.3281241355,5.3731379987
17,113,2008,2363,1053,33,11966,218,1310,251,1606,165298,14.365178273,6.4014103772,0.2006140004,45,1.3252682452,7.9637678957,1.5258822457
17,115,2001,1466,1154,-1445,3631,53,312,-1392,-1163,113318,12.870995922,10.131738945,-12.68662286,-83,0.4653224992,2.7392569765,-12.22130036
17,115,2002,1411,1129,-1593,3734,48,282,-1545,-1320,111998,12.524632072,10.021480942,-14.14014096,-57,0.4260682774,2.50315113,-13.71407268
17,115,2003,1465,1197,-1559,3823,28,268,-1531,-1315,110683,13.157835648,10.750804963,-14.00209268,-52,0.2514808179,2.4070306852,-13.75061186
17,115,2004,1349,1245,-719,3938,49,104,-670,-656,110027,12.224185583,11.281772462,-6.515336867,-90,0.4440215668,0.9424131213,-6.071315301
17,115,2005,1374,1213,-496,3954,45,161,-451,-392,109635,12.510129198,11.044240697,-4.516029172,-102,0.4097203886,1.4658885014,-4.106308783
17,115,2006,1422,1168,-805,3858,46,254,-759,-553,109082,13.003104468,10.680468368,-7.361110476,-48,0.4206348843,2.3226361005,-6.940475592
17,115,2007,1428,1196,-722,3750,40,232,-682,-418,108664,13.116199609,10.985276423,-6.631579914,32,0.3674005493,2.1309231857,-6.264179365
17,115,2008,1429,1163,-679,3750,43,266,-636,-336,108328,13.170992479,10.71928919,-6.258295237,34,0.3963279752,2.4517032886,-5.861967261
17,117,2001,585,600,-102,1239,3,-15,-99,-157,48832,11.960621952,12.267304567,-2.085441776,-43,0.0613365228,-0.306682614,-2.024105253
17,117,2002,583,600,4,1264,2,-17,6,-58,48774,11.945986927,12.294326168,0.0819621745,-47,0.0409810872,-0.348339241,0.1229432617
17,117,2003,528,603,89,1274,-2,-75,87,-55,48719,10.83154688,12.37011888,1.8257721067,-67,-0.041028587,-1.538572,1.78474352
17,117,2004,585,573,-55,1307,6,12,-49,-71,48648,12.016391591,11.769901507,-1.129746218,-34,0.123245042,0.2464900839,-1.006501176
17,117,2005,575,598,-147,1288,5,-23,-142,-211,48437,11.84529021,12.319101818,-3.028274193,-46,0.1030025236,-0.473811608,-2.925271669
17,117,2006,523,590,-225,1297,5,-67,-220,-307,48130,10.831857674,12.219495273,-4.659977011,-20,0.1035550447,-1.387637599,-4.556421966
17,117,2007,594,578,6,1302,3,16,9,30,48160,12.337729775,12.005400353,0.1246235331,5,0.0623117665,0.3323294215,0.1869352996
17,117,2008,597,561,-82,1302,5,36,-77,-22,48138,12.399011402,11.651332323,-1.703046792,19,0.1038443166,0.7476790795,-1.599202476
17,119,2001,3388,2623,276,5760,97,765,373,1317,260434,13.042030523,10.097180065,1.0624558513,179,0.373399339,2.9448504574,1.4358551903
17,119,2002,3394,2811,106,5742,71,583,177,864,261298,13.010511144,10.775647267,0.4063388866,104,0.2721703863,2.2348638765,0.678509273
17,119,2003,3360,2697,739,5719,-5,663,734,1659,262957,12.818189621,10.288886134,2.8192387292,262,-0.019074687,2.5293034878,2.8001640423
17,119,2004,3371,2730,235,5728,116,641,351,1002,263959,12.795208344,10.362182967,0.8919827828,10,0.4402978843,2.4330253779,1.3322806671
17,119,2005,3436,2643,30,5739,83,793,113,866,264825,12.99585464,9.9965203183,0.113467881,-40,0.3139278042,2.9993343218,0.4273956852
17,119,2006,3317,2591,334,5743,98,726,432,1159,265984,12.497904143,9.762456929,1.2584564316,1,0.3692476955,2.7354472136,1.6277041271
17,119,2007,3494,2639,104,5743,64,855,168,1069,267053,13.109784124,9.9017516608,0.3902168142,46,0.2401334241,3.208032463,0.6303502384
17,119,2008,3619,2597,-183,5743,76,1022,-107,1025,268078,13.525660072,9.7060345971,-0.683944679,110,0.2840425989,3.8196254749,-0.39990208
17,121,2001,561,530,-321,969,1,31,-320,-321,41367,13.509120462,12.762627175,-7.729817591,-32,0.0240804286,0.7464932876,-7.705737162
17,121,2002,494,508,-427,969,0,-14,-427,-470,40897,12.01011378,12.350481377,-10.38121171,-29,0,-0.340367597,-10.38121171
17,121,2003,501,534,-372,969,-3,-33,-375,-435,40462,12.315785592,13.127005003,-9.14465517,-27,-0.073747219,-0.81121941,-9.218402389
17,121,2004,452,510,-323,969,3,-58,-320,-415,40047,11.228558298,12.669391,-8.023947633,-37,0.0745258294,-1.440832702,-7.949421804
17,121,2005,520,502,-328,969,2,18,-326,-344,39703,13.040752351,12.589341693,-8.225705329,-36,0.0501567398,0.4514106583,-8.175548589
17,121,2006,530,499,29,969,2,31,31,44,39747,13.341724355,12.561359346,0.7300188798,-18,0.0503461296,0.7803650094,0.7803650094
17,121,2007,516,470,-214,969,-1,46,-215,-158,39589,13.007966119,11.848341232,-5.394776646,11,-0.025209237,1.1596248866,-5.419985883
17,121,2008,496,493,-106,969,1,3,-105,-84,39505,12.542038587,12.466179483,-2.680355021,18,0.0252863681,0.0758591044,-2.655068652
17,123,2001,133,177,-166,277,1,-44,-165,-217,12921,10.207605818,13.584558118,-12.74032004,-8,0.0767489159,-3.376952301,-12.66357113
17,123,2002,124,177,85,277,1,-53,86,21,12942,9.5889881298,13.68750725,6.5730967019,-12,0.0773305494,-4.09851912,6.6504272513
17,123,2003,165,184,3,277,-2,-19,1,-35,12907,12.766451313,14.236527525,0.2321172966,-17,-0.154744864,-1.470076212,0.0773724322
17,123,2004,131,172,145,277,2,-41,147,92,12999,10.113487223,13.278777117,11.194317919,-14,0.1544043851,-3.165289894,11.348722304
17,123,2005,137,185,-3,277,2,-48,-1,-61,12938,10.564059066,14.265335235,-0.231329761,-12,0.1542198404,-3.701276169,-0.07710992
17,123,2006,125,169,-65,277,2,-44,-63,-112,12826,9.7034621953,13.119080888,-5.045800342,-5,0.1552553951,-3.415618693,-4.890544946
17,123,2007,152,178,20,277,0,-26,20,-3,12823,11.85231393,13.879683418,1.5595149908,3,0,-2.027369488,1.5595149908
17,123,2008,156,168,-149,277,2,-12,-147,-153,12670,12.238653748,13.180088652,-11.68948339,6,0.1569058173,-0.941434904,-11.53257757
17,125,2001,188,200,-14,219,-1,-12,-15,-42,15967,11.758819114,12.509382037,-0.875656743,-15,-0.06254691,-0.750562922,-0.938203653
17,125,2002,181,200,-80,219,-2,-19,-82,-114,15853,11.376492772,12.570710245,-5.028284098,-13,-0.125707102,-1.194217473,-5.153991201
17,125,2003,194,190,-125,219,-5,4,-130,-139,15714,12.291316882,12.037887668,-7.919662939,-13,-0.316786518,0.2534292141,-8.236449457
17,125,2004,212,196,-56,219,2,16,-54,-48,15666,13.51179095,12.492033142,-3.569152326,-10,0.1274697259,1.0197578075,-3.4416826
17,125,2005,178,197,-176,219,1,-19,-175,-209,15457,11.438486007,12.659447997,-11.30996369,-15,0.0642611573,-1.22096199,-11.24570254
17,125,2006,165,185,-256,219,1,-20,-255,-281,15176,10.772696112,12.078477459,-16.71400124,-6,0.0652890673,-1.305781347,-16.64871217
17,125,2007,163,210,-24,219,-1,-47,-25,-65,15111,10.763693994,13.867335821,-1.58483838,7,-0.066034932,-3.103641827,-1.650873312
17,125,2008,184,194,-32,219,1,-10,-31,-35,15076,12.190678106,12.85321496,-2.120117932,6,0.0662536854,-0.662536854,-2.053864246
17,127,2001,199,233,-58,334,2,-34,-56,-102,15025,13.199787742,15.455027859,-3.847174317,-12,0.1326611833,-2.255240117,-3.714513133
17,127,2002,191,193,99,334,2,-2,101,81,15106,12.677972852,12.810726494,6.5713053002,-18,0.1327536424,-0.132753642,6.7040589426
17,127,2003,197,231,-5,334,1,-34,-4,-58,15048,13.066259866,15.321350401,-0.331630961,-20,0.0663261922,-2.255090535,-0.265304769
17,127,2004,181,184,209,334,0,-3,209,191,15239,11.952322779,12.150427576,13.801300888,-15,0,-0.198104797,13.801300888
17,127,2005,207,188,-24,334,1,19,-23,-19,15220,13.592041761,12.344463049,-1.5758889,-15,0.0656620375,1.2475787124,-1.510226862
17,127,2006,188,202,-111,334,0,-14,-111,-132,15088,12.405965422,13.329813911,-7.324798733,-7,0,-0.923848489,-7.324798733
17,127,2007,196,199,-12,334,1,-3,-11,-10,15078,12.994762315,13.193661738,-0.795597693,4,0.0662998077,-0.198899423,-0.729297885
17,127,2008,210,191,-37,334,0,19,-37,-8,15070,13.93127239,12.670823935,-2.454557516,10,0,1.2604484543,-2.454557516
17,129,2001,157,123,-35,182,3,34,-32,-10,12484,12.571062535,9.8486668268,-2.80246617,-12,0.240211386,2.7223957082,-2.562254784
17,129,2002,121,138,20,182,2,-17,22,-8,12476,9.6955128205,11.057692308,1.6025641026,-13,0.1602564103,-1.362179487,1.7628205128
17,129,2003,145,117,-8,182,-3,28,-11,0,12476,11.622314845,9.3780057711,-0.641231164,-17,-0.240461686,2.2443090734,-0.88169285
17,129,2004,122,133,60,182,4,-11,64,44,12520,9.7615618499,10.641702672,4.8007681229,-9,0.3200512082,-0.880140823,5.1208193311
17,129,2005,136,133,-119,182,3,3,-116,-121,12399,10.915365785,10.674585658,-9.550945062,-8,0.2407801276,0.2407801276,-9.310164934
17,129,2006,122,124,-55,182,3,-2,-52,-61,12338,9.863766827,10.025467923,-4.446780127,-7,0.2425516433,-0.161701096,-4.204228484
17,129,2007,143,123,99,182,1,20,100,116,12454,11.535979348,9.9225556631,7.986447241,-4,0.0806711843,1.6134236851,8.0671184253
17,129,2008,141,131,8,182,3,10,11,10,12464,11.317120154,10.514487519,0.642106108,-11,0.2407897905,0.802632635,0.8828958985
17,131,2001,202,192,-51,213,4,10,-47,-52,16904,11.931482575,11.340815121,-3.012404017,-15,0.2362669817,0.5906674542,-2.776137035
17,131,2002,196,152,-57,213,4,44,-53,-24,16880,11.60312574,8.9983424106,-3.374378404,-15,0.2367984845,2.6047833294,-3.137579919
17,131,2003,195,204,-95,213,1,-9,-94,-120,16760,11.59334126,12.128418549,-5.64803805,-17,0.0594530321,-0.535077289,-5.588585018
17,131,2004,170,151,-67,213,2,19,-65,-59,16701,10.161083052,9.0254325932,-4.004662144,-13,0.1195421536,1.1356504587,-3.88511999
17,131,2005,165,155,-131,213,3,10,-128,-133,16568,9.9191439478,9.3179837086,-7.875199134,-15,0.1803480718,0.6011602393,-7.694851063
17,131,2006,163,192,-10,213,2,-29,-8,-45,16523,9.8516212868,11.604363724,-0.604393944,-8,0.1208787888,-1.752742438,-0.483515155
17,131,2007,182,182,-74,213,1,0,-73,-70,16453,11.038330907,11.038330907,-4.488112567,3,0.0606501698,0,-4.427462397
17,131,2008,180,180,18,213,2,0,20,28,16481,10.930952815,10.930952815,1.0930952815,8,0.1214550313,0,1.2145503127
17,133,2001,365,246,421,384,8,119,429,607,28371,13.004364478,8.7645853745,14.999554645,59,0.2850271667,4.2397791039,15.284581812
17,133,2002,336,234,655,384,8,102,663,822,29193,11.673962893,8.1300813008,22.757278855,57,0.2779514975,3.5438815927,23.035230352
17,133,2003,377,268,559,384,5,109,564,738,29931,12.752858399,9.065692443,18.90941073,65,0.169136053,3.6871659563,19.078546783
17,133,2004,335,244,580,384,4,91,584,721,30652,11.059208029,8.0550649522,19.147285542,46,0.1320502451,3.0041430764,19.279335787
17,133,2005,382,240,441,384,5,142,446,639,31291,12.333919894,7.7490596193,14.238897051,51,0.1614387421,4.5848602748,14.400335793
17,133,2006,360,293,516,384,4,67,520,587,31878,11.397995852,9.2767021799,16.337127388,0,0.1266443984,2.1212936725,16.463771787
17,133,2007,411,270,296,384,5,141,301,446,32324,12.80333946,8.4109529298,9.2208965453,4,0.1557583876,4.39238653,9.3766549329
17,133,2008,412,264,314,384,4,148,318,480,32804,12.652008353,8.1071121484,9.6425500553,14,0.1228350326,4.5448962044,9.7653850878
17,135,2001,360,392,-164,2559,0,-32,-164,-171,30454,11.788012246,12.835835557,-5.370094468,25,0,-1.047823311,-5.370094468
17,135,2002,318,345,2,2559,-1,-27,1,-13,30441,10.444207242,11.330979555,0.065686838,13,-0.032843419,-0.886772313,0.032843419
17,135,2003,342,365,-258,2559,-4,-23,-262,-264,30177,11.283777096,12.042627602,-8.512323072,21,-0.131974001,-0.758850506,-8.644297073
17,135,2004,324,349,-15,2559,3,-25,-12,-31,30146,10.742171311,11.571042554,-0.497322746,6,0.0994645492,-0.828871243,-0.397858197
17,135,2005,315,370,-130,2559,2,-55,-128,-185,29961,10.481308333,12.311378042,-4.325619312,-2,0.0665479894,-1.830069709,-4.259071323
17,135,2006,327,357,38,2559,2,-30,40,9,29970,10.912549432,11.913700756,1.2681250104,-1,0.0667434216,-1.001151324,1.334868432
17,135,2007,340,343,-156,2559,0,-3,-156,-157,29813,11.374471003,11.474833983,-5.218874931,2,0,-0.100362979,-5.218874931
17,135,2008,328,345,-30,2559,2,-17,-28,-40,29773,11.009297486,11.579901319,-1.006947941,5,0.0671298627,-0.570603833,-0.939818078
17,137,2001,428,389,-341,3408,13,39,-328,-319,36300,11.739052922,10.669372866,-9.352843566,-30,0.3565600187,1.069680056,-8.996283547
17,137,2002,434,435,-211,3299,12,-1,-199,-229,36071,11.993754404,12.021389783,-5.831064929,-29,0.3316245457,-0.027635379,-5.499440384
17,137,2003,381,406,-31,3394,6,-25,-25,-101,35970,10.577310143,11.271359365,-0.860621035,-51,0.1665718133,-0.694049222,-0.694049222
17,137,2004,430,398,4,3476,13,32,17,25,35995,11.950253595,11.060932398,0.1111651497,-24,0.3612867366,0.8893211978,0.4724518863
17,137,2005,402,391,-301,3491,12,11,-289,-311,35684,11.21667434,10.909750415,-8.398554667,-33,0.3348260997,0.3069239247,-8.063728568
17,137,2006,372,407,-200,3481,12,-35,-188,-237,35447,10.459574588,11.443674347,-5.623427198,-14,0.3374056319,-0.98409976,-5.286021566
17,137,2007,406,404,-103,3481,8,2,-95,-82,35365,11.466982997,11.410495396,-2.90911145,11,0.2259504039,0.056487601,-2.683161046
17,137,2008,420,400,-161,3481,10,20,-151,-114,35251,11.895321174,11.328877308,-4.559873117,17,0.2832219327,0.5664438654,-4.276651184
17,139,2001,207,187,-52,469,2,20,-50,-44,14274,14.479574706,13.080581981,-3.637381086,-14,0.1398992725,1.3989927252,-3.497481813
17,139,2002,189,201,19,469,2,-12,21,-6,14268,13.24364095,14.084507042,1.3313713125,-15,0.1401443487,-0.840866092,1.4715156611
17,139,2003,162,198,72,469,0,-36,72,18,14286,11.346921622,13.86845976,5.0430762765,-18,0,-2.521538138,5.0430762765
17,139,2004,181,194,60,469,4,-13,64,42,14328,12.651149787,13.559795904,4.1937513105,-9,0.2795834207,-0.908646117,4.4733347313
17,139,2005,171,201,53,469,4,-30,57,15,14343,11.928429423,14.02113634,3.6971155523,-12,0.2790275889,-2.092706916,3.9761431412
17,139,2006,172,203,-63,469,4,-31,-59,-95,14248,12.031758246,14.200272813,-4.406981218,-5,0.2798083313,-2.168514568,-4.127172887
17,139,2007,189,185,62,469,2,4,64,68,14316,13.233440695,12.953367876,4.3411286935,0,0.1400364095,0.2800728189,4.4811651029
17,139,2008,192,199,60,469,4,-7,64,58,14374,13.384454514,13.872429418,4.1826420356,1,0.2788428024,-0.487974904,4.4614848379
17,141,2001,616,450,69,614,117,166,186,449,51604,11.989217489,8.7583569322,1.3429480629,97,2.2771728024,3.2308605572,3.6201208653
17,141,2002,550,472,252,614,113,78,365,518,52122,10.604862812,9.1009004493,4.8589553246,75,2.1788172686,1.5039623624,7.0377725932
17,141,2003,593,468,384,614,93,125,477,671,52793,11.304389268,8.9215078873,7.3202115999,69,1.7728637468,2.3828813802,9.0930753467
17,141,2004,576,486,265,614,87,90,352,550,53343,10.853998643,9.1580613552,4.9935931258,108,1.6394060451,1.695937288,6.6329991709
17,141,2005,594,480,286,614,94,114,380,583,53926,11.074961079,8.9494634983,5.3323886677,89,1.7526032684,2.1254975808,7.0849919362
17,141,2006,606,493,321,614,93,113,414,626,54552,11.172772359,9.0894006158,5.9182507052,99,1.7146333819,2.0833717436,7.6328840871
17,141,2007,656,474,71,614,81,182,152,342,54894,11.987646876,8.661805822,1.2974434881,8,1.4801820076,3.325841054,2.7776254957
17,141,2008,656,491,-1,614,83,165,82,273,55167,11.920662178,8.9223248926,-0.018171741,26,1.5082545134,2.9983372857,1.4900827723
17,143,2001,2600,1758,-1918,7066,270,842,-1648,-949,182207,14.232420907,9.6233061366,-10.49914742,-143,1.4779821712,4.6091147708,-9.021165252
17,143,2002,2609,1735,-764,7162,241,874,-523,192,182399,14.311338815,9.5171225926,-4.190825165,-159,1.3219749538,4.7942162224,-2.868850211
17,143,2003,2653,1814,-1414,7277,177,839,-1237,-569,181830,14.567758196,9.9607664409,-7.764346057,-171,0.9719160199,4.6069917552,-6.792430037
17,143,2004,2607,1831,-730,7390,232,776,-498,144,181974,14.331892997,10.065859639,-4.013149938,-134,1.2754120351,4.2660333586,-2.737737903
17,143,2005,2595,1846,-728,7450,217,749,-511,66,182040,14.257693385,10.142467048,-3.99984616,-172,1.1922618361,4.1152263374,-2.807584324
17,143,2006,2708,1699,-644,7502,226,1009,-418,505,182545,14.855246376,9.3201859649,-3.53278385,-86,1.2397657611,5.5350604112,-2.293018089
17,143,2007,2651,1738,-667,7481,204,913,-463,461,183006,14.504132118,9.50893309,-3.649285599,11,1.1161233316,4.9951990283,-2.533162267
17,143,2008,2738,1741,-608,7481,210,997,-398,649,183655,14.934776265,9.4965104006,-3.31641489,50,1.1454722482,5.4382658641,-2.170942642
17,145,2001,223,254,11,2504,4,-31,15,-38,23024,9.6775593456,11.022870286,0.4773683982,-22,0.1735885084,-1.34531094,0.6509569067
17,145,2002,253,276,-263,2464,3,-23,-260,-296,22728,11.059625809,12.065046337,-11.49676517,-13,0.131141808,-1.005420528,-11.36562336
17,145,2003,260,287,-43,2475,2,-27,-41,-97,22631,11.464097533,12.654599969,-1.895985361,-29,0.0881853656,-1.190502436,-1.807799996
17,145,2004,260,275,20,2506,3,-15,23,-7,22624,11.490443045,12.153353221,0.8838802342,-15,0.1325820351,-0.662910176,1.0164622694
17,145,2005,244,246,-13,2417,4,-2,-9,-32,22592,10.792639774,10.881104034,-0.575017693,-21,0.1769285209,-0.08846426,-0.398089172
17,145,2006,247,221,21,2471,3,26,24,39,22631,10.923645048,9.7737876744,0.9287309555,-11,0.1326758508,1.1498573735,1.0614068063
17,145,2007,243,240,-65,2476,2,3,-63,-59,22572,10.751498794,10.618764241,-2.875915315,1,0.088489702,0.132734553,-2.787425613
17,145,2008,270,249,-120,2476,3,21,-117,-88,22484,11.985085227,11.052911932,-5.326704545,8,0.1331676136,0.9321732955,-5.193536932
17,147,2001,189,146,-79,192,3,43,-76,-49,16324,11.560693642,8.9304829189,-4.832247607,-16,0.1835030737,2.6302107227,-4.648744533
17,147,2002,137,155,-134,192,3,-18,-131,-164,16160,8.4349218077,9.5431597094,-8.250215491,-15,0.184706317,-1.108237902,-8.065509174
17,147,2003,180,159,116,192,1,21,117,125,16285,11.095700416,9.8012020342,7.1505624904,-13,0.0616427801,1.2944983819,7.2122052705
17,147,2004,192,141,17,192,3,51,20,59,16344,11.76867204,8.6426185295,1.0420178369,-12,0.1838855006,3.1260535107,1.2259033375
17,147,2005,198,161,119,192,4,37,123,146,16490,12.060668819,9.806907474,7.2485837851,-14,0.2436498751,2.2537613449,7.4922336602
17,147,2006,179,155,-12,192,3,24,-9,7,16497,10.852760178,9.3976414951,-0.727559342,-8,0.1818898354,1.4551186831,-0.545669506
17,147,2007,185,171,-46,192,1,14,-45,-40,16457,11.227772046,10.37810281,-2.791770347,-9,0.0606906597,0.8496692359,-2.731079687
17,147,2008,209,158,15,192,3,51,18,48,16505,12.68126934,9.5867969177,0.9101389479,-21,0.1820277896,3.0944724228,1.0921667375
17,149,2001,187,219,-127,716,7,-32,-120,-165,17170,10.839008839,12.693812491,-7.361251992,-13,0.4057382988,-1.854803652,-6.955513694
17,149,2002,189,218,-142,709,7,-29,-135,-176,16994,11.064278188,12.761971666,-8.312843929,-12,0.409788081,-1.697693479,-7.903055848
17,149,2003,191,230,-145,721,3,-39,-142,-193,16801,11.303447256,13.611480988,-8.581151058,-12,0.1775410564,-2.308033733,-8.403610001
17,149,2004,177,204,43,630,4,-27,47,8,16809,10.532579589,12.139244273,2.5587622731,-12,0.2380243975,-1.606664683,2.7967866706
17,149,2005,180,219,-27,612,5,-39,-22,-74,16735,10.732172669,13.057476747,-1.6098259,-13,0.2981159075,-2.325304078,-1.311709993
17,149,2006,203,215,-211,579,4,-12,-207,-225,16510,12.212362761,12.934275831,-12.69363814,-6,0.2406376899,-0.72191307,-12.45300045
17,149,2007,200,205,153,672,4,-5,157,155,16665,12.057272042,12.358703843,9.2238131123,3,0.2411454408,-0.301431801,9.4649585531
17,149,2008,196,214,-136,672,5,-18,-131,-146,16519,11.81292189,12.897782064,-8.196721311,3,0.3013500482,-1.084860174,-7.895371263
17,151,2001,30,45,-71,287,2,-15,-69,-87,4331,6.8579266202,10.28688993,-16.23042633,-3,0.457195108,-3.42896331,-15.77323123
17,151,2002,37,47,-25,337,2,-10,-23,-39,4292,8.5817001044,10.901078511,-5.798446016,-6,0.4638756813,-2.319378407,-5.334570335
17,151,2003,24,40,316,652,2,-16,318,321,4613,5.3902302077,8.9837170129,70.971364402,19,0.4491858506,-3.593486805,71.420550253
17,151,2004,33,46,-356,287,1,-13,-355,-382,4231,7.4626865672,10.402532791,-80.50655812,-14,0.2261420172,-2.939846223,-80.2804161
17,151,2005,31,51,-100,287,2,-20,-98,-121,4110,7.4331614914,12.22874955,-23.97794029,-3,0.4795588059,-4.795588059,-23.49838149
17,151,2006,40,48,3,287,1,-8,4,-6,4104,9.7394691989,11.687363039,0.7304601899,-2,0.24348673,-1.94789384,0.9739469199
17,151,2007,30,41,14,287,2,-11,16,3,4107,7.3072707344,9.986603337,3.410059676,-2,0.4871513823,-2.679332603,3.8972110583
17,151,2008,43,40,-28,287,1,3,-27,-28,4079,10.50574151,9.7727827999,-6.84094796,-4,0.24431957,0.73295871,-6.59662839
17,153,2001,101,104,-135,291,2,-3,-133,-142,7182,13.925272301,14.338894251,-18.61298773,-6,0.2757479664,-0.41362195,-18.33723976
17,153,2002,94,95,-92,291,2,-1,-90,-96,7086,13.17633866,13.316512475,-12.89599103,-5,0.2803476311,-0.140173816,-12.6156434
17,153,2003,99,89,-145,291,1,10,-144,-136,6950,14.106583072,12.681675691,-20.66115702,-2,0.1424907381,1.424907381,-20.51866629
17,153,2004,96,96,-114,291,0,0,-114,-120,6830,13.933236575,13.933236575,-16.54571843,-6,0,0,-16.54571843
17,153,2005,85,90,-153,291,1,-5,-152,-163,6667,12.595391568,13.336296955,-22.67170482,-6,0.1481810773,-0.740905386,-22.52352375
17,153,2006,98,87,-123,291,0,11,-123,-115,6552,14.827142749,13.162871624,-18.60957712,-3,0,1.6642711249,-18.60957712
17,153,2007,81,67,-93,291,1,14,-92,-79,6473,12.437619962,10.287907869,-14.28023033,-1,0.1535508637,2.1497120921,-14.12667946
17,153,2008,87,78,-122,291,0,9,-122,-111,6362,13.556680951,12.15426568,-19.01051811,2,0,1.4024152707,-19.01051811
17,155,2001,61,58,-11,11,3,3,-8,-12,6063,10.051079255,9.556763882,-1.812489702,-7,0.4943153732,0.4943153732,-1.318174329
17,155,2002,63,54,3,11,3,9,6,10,6073,10.382333553,8.8991430455,0.4943968359,-5,0.4943968359,1.4831905076,0.9887936717
17,155,2003,63,54,4,11,1,9,5,6,6079,10.368663594,8.8874259381,0.6583278473,-8,0.1645819618,1.4812376564,0.8229098091
17,155,2004,54,52,-58,11,2,2,-56,-59,6020,8.9263575502,8.595751715,-9.587569221,-5,0.3306058352,0.3306058352,-9.256963385
17,155,2005,57,59,-36,11,3,-2,-33,-40,5980,9.5,9.8333333333,-6,-5,0.5,-0.333333333,-5.5
17,155,2006,64,55,-69,11,2,9,-67,-61,5919,10.757206488,9.2444743256,-11.59761324,-3,0.3361627027,1.5127321624,-11.26145054
17,155,2007,58,51,77,11,2,7,79,88,6007,9.7266476606,8.5527419084,12.912963274,2,0.3354016435,1.1739057521,13.248364917
17,155,2008,61,57,-13,11,2,4,-11,-4,6003,10.158201499,9.4920899251,-2.164862614,3,0.3330557868,0.6661115737,-1.831806828
17,157,2001,367,397,172,4271,0,-30,172,110,34008,10.809059582,11.692633935,5.0658262893,-32,0,-0.883574353,5.0658262893
17,157,2002,383,412,-692,3754,-1,-29,-693,-731,33277,11.384409601,12.246414505,-20.56922048,-9,-0.029724307,-0.862004905,-20.59894479
17,157,2003,381,383,-159,3692,-3,-2,-162,-204,33073,11.48455162,11.54483798,-4.792765637,-40,-0.09042954,-0.06028636,-4.883195177
17,157,2004,398,381,190,3908,3,17,193,181,33254,12.001145838,11.488534081,5.7291902242,-29,0.0904608983,0.5126117569,5.8196511225
17,157,2005,371,421,-144,3816,2,-50,-142,-220,33034,11.193579532,12.702148202,-4.34467777,-28,0.0603427468,-1.50856867,-4.284335023
17,157,2006,362,357,-58,3865,4,5,-54,-64,32970,10.96903218,10.817526211,-1.757469244,-15,0.1212047755,0.1515059693,-1.636264469
17,157,2007,370,346,-244,3817,2,24,-242,-207,32763,11.257663578,10.527436752,-7.423972738,11,0.0608522356,0.7302268267,-7.363120503
17,157,2008,392,360,-181,3817,4,32,-177,-122,32641,11.987034432,11.008501009,-5.534829674,23,0.1223166779,0.978533423,-5.412512996
17,159,2001,211,185,-185,288,0,26,-185,-170,16072,13.059355078,11.450145448,-11.45014545,-11,0,1.6092096305,-11.45014545
17,159,2002,168,190,119,288,0,-22,119,85,16157,10.425393279,11.790623352,7.3846535729,-12,0,-1.365230072,7.3846535729
17,159,2003,203,213,-76,288,-1,-10,-77,-104,16053,12.604781124,13.225706302,-4.719031357,-17,-0.062092518,-0.620925179,-4.781123875
17,159,2004,193,195,-98,288,2,-2,-96,-112,15941,12.064762143,12.189785585,-6.126148653,-14,0.1250234419,-0.125023442,-6.001125211
17,159,2005,200,221,-57,288,2,-21,-55,-90,15851,12.58178158,13.902868646,-3.58580775,-14,0.1258178158,-1.321087066,-3.459989935
17,159,2006,159,209,-108,288,1,-50,-107,-164,15687,10.083074386,13.253852495,-6.848880715,-7,0.0634155622,-3.170778109,-6.785465153
17,159,2007,188,200,-42,288,0,-12,-42,-48,15639,12.002809168,12.768945924,-2.681478644,6,0,-0.766136755,-2.681478644
17,159,2008,199,196,-120,288,1,3,-119,-107,15532,12.768278207,12.575791601,-7.699464246,9,0.064162202,0.1924866061,-7.635302044
17,161,2001,1979,1501,-1146,4695,287,478,-859,-507,148620,13.293165003,10.082385381,-7.697810557,-126,1.9278111954,3.2107796216,-5.769999362
17,161,2002,1904,1476,-1085,4668,277,428,-808,-487,148133,12.832220736,9.9476669149,-7.312478728,-107,1.8668724495,2.8845538209,-5.445606279
17,161,2003,1951,1511,-1652,4700,232,440,-1420,-1077,147056,13.218649746,10.23750885,-11.192829,-97,1.5718742907,2.9811408962,-9.62095471
17,161,2004,1922,1381,-852,4740,236,541,-616,-199,146857,13.07870016,9.3973386682,-5.797633994,-124,1.6059173973,3.6813614913,-4.191716596
17,161,2005,1971,1455,-942,4729,237,516,-705,-325,146532,13.436086561,9.9185722709,-6.421508646,-136,1.6156024936,3.5175142899,-4.805906152
17,161,2006,1995,1400,-923,4826,239,595,-684,-153,146379,13.621885146,9.5592176463,-6.302255634,-64,1.6318950125,4.0626674997,-4.670360621
17,161,2007,1888,1444,75,4906,224,444,299,757,147136,12.864759893,9.8393608504,0.5110471356,14,1.5263274449,3.0253990426,2.0373745805
17,161,2008,2057,1444,-1160,4906,227,613,-933,-250,146886,13.992150247,9.8223942426,-7.890566012,70,1.544102142,4.1697560047,-6.34646387
17,163,2001,3689,2523,-1683,4913,51,1166,-1632,-309,255895,14.40737045,9.8535634711,-6.572947809,157,0.1991802366,4.5538069787,-6.373767572
17,163,2002,3732,2584,168,4978,-212,1148,-44,1180,257075,14.550558512,10.074663236,0.6550090649,76,-0.826559058,4.4758952765,-0.171549993
17,163,2003,3621,2677,772,4990,-910,944,-138,616,257691,14.068528224,10.400842324,2.9994210962,-190,-3.535587043,3.6676859,-0.536165947
17,163,2004,3726,2602,-1082,5006,557,1124,-525,647,258338,14.441048856,10.084704542,-4.193562765,48,2.1587934011,4.356344314,-2.034769364
17,163,2005,3696,2542,-1013,5023,143,1154,-870,438,258776,14.294720313,9.8314878344,-3.917898181,154,0.5530695359,4.4632324787,-3.364828645
17,163,2006,3740,2493,-326,5059,330,1247,4,1694,260470,14.405503364,9.6023849967,-1.255666871,443,1.2710738263,4.8031183678,0.0154069555
17,163,2007,3874,2526,-368,5297,11,1348,-357,997,261467,14.84470348,9.6793291144,-1.410131874,6,0.042150681,5.1653743651,-1.367981193
17,163,2008,3927,2529,-802,5297,141,1398,-661,824,262291,14.995475009,9.6571317288,-3.062483055,87,0.538416597,5.3383432807,-2.524066458
17,165,2001,269,446,-67,1183,6,-177,-61,-261,26370,10.150751873,16.829871135,-2.528254184,-23,0.2264108224,-6.679119262,-2.301843361
17,165,2002,317,397,0,1183,6,-80,6,-99,26271,12.043844152,15.083300089,0,-25,0.2279591953,-3.039455937,0.2279591953
17,165,2003,343,406,-63,1183,4,-63,-59,-157,26114,13.095351723,15.500620407,-2.405268684,-35,0.152715472,-2.405268684,-2.252553212
17,165,2004,319,414,127,1183,7,-95,134,19,26133,12.211227439,15.847799874,4.8615231497,-20,0.2679579689,-3.636572435,5.1294811185
17,165,2005,317,381,-83,1183,7,-64,-76,-164,25969,12.168438832,14.625158343,-3.186058117,-24,0.2687036966,-2.456719512,-2.91735442
17,165,2006,298,386,98,1183,6,-88,104,4,25973,11.47433676,14.862731508,3.7734396057,-12,0.2310269146,-3.388394748,4.0044665203
17,165,2007,317,382,132,1183,5,-65,137,76,26049,12.18715159,14.686094345,5.0747760563,4,0.1922263658,-2.498942755,5.2670024221
17,165,2008,336,384,-72,1183,7,-48,-65,-105,25944,12.924816802,14.771219203,-2.7696036,8,0.2692670167,-1.8464024,-2.500336584
17,167,2001,2680,1862,-256,3261,95,818,-161,1192,190282,14.128612549,9.8162225995,-1.349598811,535,0.5008276836,4.3123899497,-0.848771127
17,167,2002,2434,1784,41,3351,77,650,118,1173,191455,12.752235178,9.3467492017,0.2148075769,405,0.4034191079,3.4054859759,0.6182266849
17,167,2003,2548,1795,-303,3261,18,753,-285,355,191810,13.29628325,9.3668871408,-1.581151423,-113,0.0939297875,3.9293961097,-1.487221635
17,167,2004,2598,1847,-489,3437,115,751,-374,417,192227,13.529946333,9.618864849,-2.546629622,40,0.5989006268,3.9110814843,-1.947728995
17,167,2005,2570,1858,-437,3261,90,712,-347,350,192577,13.357449507,9.6568642738,-2.271286161,-15,0.4677706053,3.700585233,-1.803515556
17,167,2006,2443,1854,52,3261,100,589,152,739,193316,12.661540893,9.6088812184,0.2695047591,-2,0.5182783829,3.0526596751,0.787783142
17,167,2007,2580,1792,-379,3261,72,788,-307,522,193838,13.328029673,9.2572981294,-1.957877227,41,0.3719450141,4.0707315435,-1.585932213
17,167,2008,2650,1825,67,3261,82,825,149,1087,194925,13.63298462,9.3887535594,0.3446830074,113,0.4218508449,4.2442310611,0.7665338522
17,169,2001,79,93,-141,105,1,-14,-140,-158,7031,11.111111111,13.080168776,-19.83122363,-4,0.1406469761,-1.969057665,-19.69057665
17,169,2002,71,98,0,105,1,-27,1,-32,6999,10.121168924,13.970064148,0,-6,0.142551675,-3.848895225,0.142551675
17,169,2003,68,102,18,105,-1,-34,17,-24,6975,9.7323600973,14.598540146,2.5762129669,-7,-0.143122943,-4.866180049,2.4330900243
17,169,2004,91,96,59,105,3,-5,62,51,7026,12.999071495,13.713306192,8.4279694308,-6,0.4285408185,-0.714234698,8.8565102493
17,169,2005,58,67,55,105,3,-9,58,42,7068,8.2304526749,9.5075918831,7.8047396055,-7,0.4257130694,-1.277139208,8.2304526749
17,169,2006,80,84,-55,105,3,-4,-52,-58,7010,11.365250746,11.933513283,-7.813609888,-2,0.426196903,-0.568262537,-7.387412985
17,169,2007,86,82,-21,105,1,4,-20,-17,6993,12.283082197,11.711776048,-2.999357281,-1,0.1428265372,0.5713061487,-2.856530743
17,169,2008,80,97,-64,105,3,-17,-61,-77,6916,11.503343159,13.94780358,-9.202674527,1,0.4313753685,-2.444460421,-8.771299159
17,171,2001,70,63,-30,56,0,7,-30,-28,5511,12.669683258,11.402714932,-5.429864253,-5,0,1.2669683258,-5.429864253
17,171,2002,52,58,-49,56,0,-6,-49,-58,5453,9.485589201,10.580080263,-8.93834367,-3,0,-1.094491062,-8.93834367
17,171,2003,60,63,-12,56,-1,-3,-13,-23,5430,11.026371405,11.577689975,-2.205274281,-7,-0.183772857,-0.55131857,-2.389047138
17,171,2004,75,57,-73,56,0,18,-73,-60,5370,13.888888889,10.555555556,-13.51851852,-5,0,3.3333333333,-13.51851852
17,171,2005,55,57,-29,56,1,-2,-28,-34,5336,10.274612367,10.648234635,-5.417522884,-4,0.1868111339,-0.373622268,-5.23071175
17,171,2006,68,60,-91,56,0,8,-91,-86,5250,12.847156622,11.335726431,-17.19251842,-3,0,1.5114301908,-17.19251842
17,171,2007,59,48,-44,56,0,11,-44,-35,5215,11.275680841,9.1734352604,-8.408982322,-2,0,2.1022455805,-8.408982322
17,171,2008,61,58,-38,56,1,3,-37,-34,5181,11.735282801,11.158137745,-7.31050404,0,0.1923816853,0.5771450558,-7.118122355
17,173,2001,226,233,-191,293,0,-7,-191,-217,22614,9.9460886786,10.254153372,-8.405765211,-19,0,-0.308064694,-8.405765211
17,173,2002,217,284,-35,293,0,-67,-35,-122,22492,9.6217798076,12.592559748,-1.551899969,-20,0,-2.970779941,-1.551899969
17,173,2003,237,232,-95,293,-2,5,-97,-119,22373,10.565028419,10.342137524,-4.234927003,-27,-0.089156358,0.2228908949,-4.324083361
17,173,2004,264,253,-206,293,2,11,-204,-213,22160,11.85637617,11.362360497,-9.251566254,-20,0.0898210316,0.4940156738,-9.161745223
17,173,2005,256,258,-102,293,2,-2,-100,-121,22039,11.583972488,11.674472273,-4.615489038,-19,0.0904997851,-0.090499785,-4.524989253
17,173,2006,250,220,-179,293,2,30,-177,-158,21881,11.384335155,10.018214936,-8.151183971,-11,0.0910746812,1.3661202186,-8.06010929
17,173,2007,252,230,-173,293,0,22,-173,-159,21722,11.558837695,10.549732817,-7.935233814,-8,0,1.0091048781,-7.935233814
17,173,2008,266,234,5,293,2,32,7,26,21748,12.238325282,10.766045549,0.2300437083,-13,0.0920174833,1.4722797331,0.3220611916
17,175,2001,86,99,4,117,-1,-13,3,-18,6302,13.627000475,15.686895896,0.6338139756,-8,-0.158453494,-2.059895421,0.4753604817
17,175,2002,64,92,-13,117,-1,-28,-14,-46,6256,10.192705845,14.652014652,-2.070393375,-4,-0.159261029,-4.459308807,-2.229654404
17,175,2003,64,90,-47,117,-2,-26,-49,-81,6175,10.296838549,14.479929209,-7.561740809,-6,-0.321776205,-4.18309066,-7.883517014
17,175,2004,73,77,-23,117,1,-4,-22,-32,6143,11.85257347,12.50202955,-3.734372463,-6,0.1623640201,-0.649456081,-3.572008443
17,175,2005,68,79,-31,117,1,-11,-30,-46,6097,11.111111111,12.908496732,-5.065359477,-5,0.1633986928,-1.797385621,-4.901960784
17,175,2006,53,76,64,117,0,-23,64,38,6135,8.665794637,12.426422498,10.464355788,-3,0,-3.760627861,10.464355788
17,175,2007,73,85,34,117,-1,-12,33,16,6151,11.883444571,13.836887514,5.5347550057,-5,-0.162786912,-1.953442943,5.3719680938
17,175,2008,80,84,-10,117,1,-4,-9,-16,6135,13.022952955,13.674100602,-1.627869119,-3,0.1627869119,-0.651147648,-1.465082207
17,177,2001,621,554,-536,820,62,67,-474,-441,48445,12.760579877,11.383834544,-11.01396266,-34,1.2740031439,1.3767453329,-9.73995952
17,177,2002,582,524,-493,820,59,58,-434,-406,48039,12.064176444,10.861904564,-10.21931097,-30,1.2230007048,1.2022718793,-8.996310269
17,177,2003,578,518,-77,820,47,60,-30,-33,48006,12.03602478,10.786610443,-1.603415066,-63,0.9787078973,1.249414337,-0.624707169
17,177,2004,557,493,-238,820,54,64,-184,-160,47846,11.622084046,10.286691983,-4.965989233,-40,1.126737053,1.3353920628,-3.83925218
17,177,2005,534,638,-423,820,54,-104,-369,-516,47330,11.221316298,13.406741195,-8.888795495,-43,1.1347398504,-2.185424897,-7.754055644
17,177,2006,572,488,-522,820,55,84,-467,-404,46926,12.137158377,10.354778476,-11.07621796,-21,1.1670344593,1.7823799015,-9.9091835
17,177,2007,602,504,-491,820,49,98,-442,-345,46581,12.876041366,10.779941609,-10.50188756,-1,1.0480498786,2.0960997572,-9.453837681
17,177,2008,567,511,-306,820,51,56,-255,-214,46367,12.200370099,10.995395275,-6.58432672,-15,1.0973877867,1.2049748246,-5.486938934
17,179,2001,1642,1233,-704,3172,50,409,-654,-351,128145,12.796084803,9.6087530831,-5.486262912,-106,0.3896493545,3.1873317202,-5.096613557
17,179,2002,1556,1283,-208,3202,44,273,-164,-11,128134,12.14301601,10.012525412,-1.623230932,-120,0.3433757741,2.1304905981,-1.279855158
17,179,2003,1578,1304,-472,3107,20,274,-452,-330,127804,12.331111441,10.189967883,-3.688393283,-152,0.156287851,2.1411435582,-3.532105432
17,179,2004,1636,1264,275,3117,43,372,318,601,128405,12.77082382,9.8669445648,2.146684933,-89,0.3356634623,2.9038792548,2.4823483953
17,179,2005,1616,1344,657,3338,37,272,694,845,129250,12.54390561,10.432555161,5.0998428131,-121,0.2872057596,2.1113504492,5.3870485727
17,179,2006,1627,1257,170,3114,39,370,209,515,129765,12.562978978,9.7060015829,1.3126652897,-64,0.3011408606,2.8569773951,1.6138061502
17,179,2007,1735,1327,650,3114,29,408,679,1104,130869,13.313688928,10.182861791,4.9878373505,17,0.2225342818,3.1308271369,5.2103716323
17,179,2008,1783,1316,136,3114,32,467,168,655,131524,13.590301571,10.030755394,1.0366130194,20,0.2439089457,3.5595461769,1.2805219651
17,181,2001,203,264,-73,915,19,-61,-54,-132,18124,11.15997801,14.513468939,-4.013194063,-17,1.0445299615,-3.353490929,-2.968664101
17,181,2002,223,284,51,915,19,-61,70,-6,18118,12.306164119,15.672424259,2.8144142156,-15,1.0485072568,-3.36626014,3.8629214723
17,181,2003,217,250,80,921,10,-33,90,31,18149,11.966801776,13.78663799,4.4117241569,-26,0.5514655196,-1.819836215,4.9631896766
17,181,2004,228,251,-31,918,10,-23,-21,-57,18092,12.58243426,13.851714909,-1.71076957,-13,0.5518611517,-1.269280649,-1.158908419
17,181,2005,218,214,28,915,12,4,40,27,18119,12.040540167,11.819612825,1.5464913976,-17,0.6627820276,0.2209273425,2.2092734252
17,181,2006,220,205,20,915,10,15,30,37,18156,12.129565817,11.302549966,1.1026878015,-8,0.5513439008,0.8270158511,1.6540317023
17,181,2007,231,244,40,915,7,-13,47,32,18188,12.711864407,13.427250715,2.2011886419,-2,0.3852080123,-0.715386309,2.5863966542
17,181,2008,244,229,-30,915,8,15,-22,3,18191,13.414332445,12.58968086,-1.649303169,10,0.4398141785,0.8246515847,-1.209488991
17,183,2001,1178,934,-576,3109,52,244,-524,-347,83452,14.086612337,11.16884204,-6.887851194,-67,0.6218198994,2.9177702973,-6.266031294
17,183,2002,1092,958,-655,3109,51,134,-604,-529,82923,13.126972201,11.516153268,-7.873779113,-59,0.6130728775,1.6108189331,-7.260706236
17,183,2003,1081,966,-612,3109,39,115,-573,-537,82386,13.078537769,11.687203963,-7.404315555,-79,0.4718436383,1.3913338052,-6.932471916
17,183,2004,1112,1005,-305,3109,43,107,-262,-216,82170,13.515155935,12.214686794,-3.706944748,-61,0.5226184399,1.3004691412,-3.184326308
17,183,2005,1080,967,-507,3109,43,113,-464,-427,81743,13.177722328,11.798942122,-6.186208537,-76,0.5246685742,1.3787802066,-5.661539963
17,183,2006,1151,959,-300,3109,43,192,-257,-102,81641,14.089506928,11.73921559,-3.672330216,-37,0.526367331,2.3502913382,-3.145962885
17,183,2007,1121,910,-742,3109,37,211,-705,-474,81167,13.770822073,11.178811852,-9.115031202,20,0.4545231193,2.5920102206,-8.660508083
17,183,2008,1095,963,-694,3109,39,132,-655,-487,80680,13.531298078,11.900127899,-8.576000791,36,0.4819366439,1.6311701792,-8.094064147
17,185,2001,134,128,-143,177,3,6,-140,-144,12759,10.443457252,9.9758397631,-11.14488349,-10,0.2338087444,0.4676174889,-10.91107474
17,185,2002,151,156,-110,177,3,-5,-107,-124,12635,11.892573049,12.286366858,-8.66346381,-12,0.2362762857,-0.39379381,-8.427187525
17,185,2003,146,124,-104,177,2,22,-102,-94,12541,11.598347633,9.850651414,-8.26183667,-14,0.1588814744,1.7476962186,-8.102955195
17,185,2004,138,113,-97,177,1,25,-96,-80,12461,11.039116871,9.0392768579,-7.75937925,-9,0.0799936005,1.9998400128,-7.679385649
17,185,2005,171,139,-70,177,2,32,-68,-46,12415,13.748191027,11.175430133,-5.627914456,-10,0.1607975559,2.572760894,-5.4671169
17,185,2006,129,123,-145,177,1,6,-144,-144,12271,10.451267925,9.9651624402,-11.74754922,-6,0.0810175808,0.4861054849,-11.66653164
17,185,2007,141,138,-146,177,2,3,-144,-144,12127,11.558324453,11.312402656,-11.96819411,-3,0.1639478646,0.2459217969,-11.80424625
17,185,2008,154,142,-88,177,1,12,-87,-80,12047,12.740961363,11.748159179,-7.280549351,-5,0.0827335153,0.9928021842,-7.197815835
17,187,2001,204,217,-215,1241,3,-13,-212,-238,18442,10.990787134,11.691180432,-11.58342762,-13,0.1616292226,-0.700393298,-11.42179839
17,187,2002,201,195,-113,1237,3,6,-110,-118,18324,10.934015123,10.607626612,-6.146983626,-14,0.1631942556,0.3263885111,-5.983789371
17,187,2003,205,206,-202,1236,3,-1,-199,-212,18112,11.252607311,11.307498079,-11.08793501,-12,0.1646723021,-0.054890767,-10.92326271
17,187,2004,190,200,-325,1337,4,-10,-321,-352,17760,10.593220339,11.150758252,-18.11998216,-21,0.223015165,-0.557537913,-17.89696699
17,187,2005,208,207,-46,1429,5,1,-41,-55,17705,11.729874524,11.673480897,-2.594106866,-15,0.2819681376,0.0563936275,-2.312138728
17,187,2006,220,202,-62,1510,4,18,-58,-48,17657,12.442735139,11.424693173,-3.506588994,-8,0.226231548,1.018041966,-3.280357446
17,187,2007,215,227,33,1527,4,-12,37,18,17675,12.170270576,12.849541492,1.8679950187,-7,0.2264236386,-0.679270916,2.0944186573
17,187,2008,217,196,-164,1527,5,21,-159,-134,17541,12.323943662,11.131303953,-9.313948205,4,0.2839618355,1.1926397092,-9.02998637
17,189,2001,173,167,79,262,2,6,81,73,15236,11.381953354,10.987203526,5.1975393927,-14,0.1315832758,0.3947498273,5.3291226685
17,189,2002,187,171,-155,262,2,16,-153,-150,15086,12.334278742,11.278939384,-10.22360003,-13,0.1319174197,1.0553393576,-10.09168261
17,189,2003,154,177,66,262,-2,-23,64,25,15111,10.199688711,11.723018843,4.3712951618,-16,-0.13246349,-1.523330132,4.238831672
17,189,2004,180,173,-106,262,2,7,-104,-108,15003,11.954572624,11.489672578,-7.03991499,-11,0.1328285847,0.4649000465,-6.907086405
17,189,2005,185,157,-200,262,2,28,-198,-183,14820,12.406531871,10.528786507,-13.41246689,-13,0.1341246689,1.8777453643,-13.27834222
17,189,2006,178,179,16,262,2,-1,18,11,14831,12.006340427,12.073791778,1.0792216114,-6,0.1349027014,-0.067451351,1.2141243128
17,189,2007,195,181,-115,262,0,14,-115,-94,14737,13.189935065,12.242965368,-7.778679654,7,0,0.946969697,-7.778679654
17,189,2008,190,165,-38,262,2,25,-36,-9,14728,12.896657051,11.199728491,-2.57933141,2,0.1357542847,1.6969285593,-2.443577125
17,191,2001,195,200,-79,207,3,-5,-76,-97,17027,11.419870575,11.712687769,-4.626511669,-16,0.1756903165,-0.292817194,-4.450821352
17,191,2002,206,179,-128,207,3,27,-125,-111,16916,12.137996052,10.547093657,-7.542055799,-13,0.1767669328,1.5909023952,-7.365288867
17,191,2003,211,223,-95,207,3,-12,-92,-122,16794,12.518540492,13.230495402,-5.6363097,-18,0.1779887274,-0.71195491,-5.458320973
17,191,2004,186,220,-71,207,2,-34,-69,-115,16679,11.113434709,13.144922774,-4.242225077,-12,0.1194992979,-2.031488065,-4.122725779
17,191,2005,189,228,23,207,3,-39,26,-29,16650,11.341474392,13.681778631,1.3801794233,-16,0.180023403,-2.34030424,1.5602028264
17,191,2006,175,207,-139,207,2,-32,-137,-177,16473,10.566675724,12.498867856,-8.392959575,-8,0.1207620083,-1.932192132,-8.272197567
17,191,2007,216,205,81,207,3,11,84,92,16565,13.075852049,12.409952176,4.9034445184,-3,0.1816090562,0.6658998729,5.0850535747
17,191,2008,199,200,-67,207,2,-1,-65,-71,16494,12.039081642,12.09957954,-4.053359146,-5,0.1209957954,-0.060497898,-3.93236335
17,193,2001,159,229,22,427,3,-70,25,-62,15266,10.39419494,14.970255606,1.4381904949,-17,0.1961168857,-4.576060665,1.6343073805
17,193,2002,181,242,-95,427,3,-61,-92,-165,15101,11.920835117,15.938354134,-6.256791912,-12,0.1975829025,-4.017519017,-6.05920901
17,193,2003,158,217,-78,427,3,-59,-75,-148,14953,10.5144074,14.440673454,-5.190656818,-14,0.1996406468,-3.926266054,-4.991016171
17,193,2004,172,201,103,427,2,-29,105,64,15017,11.478144811,13.413413413,6.8735402069,-12,0.1334668001,-1.935268602,7.007007007
17,193,2005,162,287,103,427,3,-125,106,-34,14983,10.8,19.133333333,6.8666666667,-15,0.2,-8.333333333,7.0666666667
17,193,2006,181,225,-127,427,2,-44,-125,-174,14809,12.150912997,15.104726101,-8.525778733,-5,0.134264232,-2.953813104,-8.391514501
17,193,2007,183,220,-126,427,3,-37,-123,-158,14651,12.423625255,14.935505771,-8.553971487,2,0.2036659878,-2.511880516,-8.350305499
17,193,2008,183,223,55,427,2,-40,57,20,14671,12.482095355,15.210422209,3.7514494236,3,0.1364163427,-2.728326854,3.8878657663
17,195,2001,789,643,-209,1254,46,146,-163,-71,60560,13.020768869,10.611349028,-3.449101006,-54,0.7591322788,2.4094198414,-2.689968727
17,195,2002,736,601,-601,1254,45,135,-556,-459,60101,12.199467931,9.9617937859,-9.961793786,-38,0.7458913816,2.2376741449,-9.215902404
17,195,2003,768,632,-674,1254,39,136,-635,-537,59564,12.835833368,10.562821209,-11.26478085,-38,0.6518196632,2.2730121589,-10.61296118
17,195,2004,717,635,-182,1254,42,82,-140,-103,59461,12.047889099,10.670027305,-3.058181054,-45,0.7057340895,1.3778617937,-2.352446965
17,195,2005,722,687,-270,1254,44,35,-226,-244,59217,12.167377273,11.577545965,-4.550127235,-53,0.7415022161,0.5898313082,-3.808625019
17,195,2006,706,639,-131,1254,43,67,-88,-46,59171,11.926884482,10.795013008,-2.213062135,-25,0.7264249755,1.1318714735,-1.486637159
17,195,2007,727,668,-256,1254,35,59,-221,-145,59026,12.301496654,11.303163363,-4.331751229,17,0.5922316133,0.998333291,-3.739519616
17,195,2008,764,646,-67,1254,37,118,-30,127,59153,12.929539089,10.932568392,-1.133873192,39,0.6261687779,1.996970697,-0.507704414
17,197,2001,8427,3094,16971,9861,1186,5333,18157,23244,531273,16.2166531,5.9539960473,32.658457311,-246,2.2823010059,10.262657053,34.940758317
17,197,2002,8851,3148,17722,8630,1103,5703,18825,24450,555723,16.28524852,5.7921096306,32.607295703,-78,2.0294462905,10.493138889,34.636741994
17,197,2003,9085,3207,19113,8608,952,5878,20065,24991,580714,15.988567778,5.6439556262,33.636708414,-952,1.6754118354,10.344612152,35.31212025
17,197,2004,9763,3290,21283,8775,878,6473,22161,28053,608767,16.415562754,5.5318243839,35.785355125,-581,1.4762741061,10.88373837,37.261629232
17,197,2005,9662,3386,16132,8965,927,6276,17059,23406,632173,15.572066337,5.4571534482,25.99964543,71,1.4940287202,10.114912889,27.49367415
17,197,2006,9920,3447,16599,8773,922,6473,17521,24017,656190,15.399386664,5.3509763941,25.767582583,23,1.4312736395,10.048410269,27.198856223
17,197,2007,10442,3566,7618,9370,840,6876,8458,14473,670663,15.739497895,5.3751244486,11.482809324,-861,1.2661538241,10.364373446,12.748963148
17,197,2008,11001,3607,2063,9370,845,7394,2908,10434,681097,16.276557969,5.336746168,3.0523169793,132,1.2502219329,10.939811801,4.3025389122
17,199,2001,734,736,496,1776,14,-2,510,471,61737,11.93466826,11.967187792,8.0648439469,-37,0.2276367243,-0.032519532,8.2924806712
17,199,2002,707,710,383,1847,12,-3,395,352,62089,11.419249592,11.467704682,6.1860998498,-40,0.1938203608,-0.04845509,6.3799202106
17,199,2003,785,740,241,1847,5,45,246,233,62322,12.619462909,11.896054207,3.8742554919,-58,0.0803787446,0.7234087018,3.9546342365
17,199,2004,743,733,768,1842,18,10,786,758,63080,11.849890751,11.690403662,12.248608475,-38,0.2870767611,0.1594870895,12.535685236
17,199,2005,762,815,519,1911,15,-53,534,438,63518,12.038104867,12.875400875,8.1991816616,-43,0.2369705683,-0.837296008,8.4361522299
17,199,2006,740,708,-20,1549,16,32,-4,-6,63512,11.650791152,11.146973156,-0.314886247,-34,0.2519089979,0.5038179957,-0.062977249
17,199,2007,815,739,554,1549,12,76,566,657,64169,12.766190741,11.575723874,8.6778768963,15,0.1879684526,1.1904668666,8.865845349
17,199,2008,838,719,312,1549,14,119,326,459,64628,13.012725452,11.164856324,4.8448333424,14,0.2173963679,1.8478691274,5.0622297103
17,201,2001,3886,2493,-971,5153,855,1393,-116,1796,280744,13.886208843,8.9084710877,-3.469765514,519,3.0552518171,4.9777377558,-0.414513697
17,201,2002,3987,2498,-903,5130,794,1489,-109,1774,282518,14.156822225,8.8697622066,-3.206323168,394,2.8192919103,5.2870600183,-0.387031257
17,201,2003,3985,2538,224,5097,703,1447,927,2612,285130,14.040391228,8.9421613394,0.7892214894,238,2.476887085,5.0982298889,3.2661085743
17,201,2004,3985,2494,-767,5028,649,1491,-118,1890,287020,13.929913484,8.7179935332,-2.681115092,517,2.2686358472,5.2119199511,-0.412479245
17,201,2005,3952,2574,107,5112,692,1378,799,2618,289638,13.706564376,8.9273017976,0.3711038432,441,2.4000360699,4.7792625785,2.7711399131
17,201,2006,3997,2493,1272,5079,689,1504,1961,3465,293103,13.717929578,8.5561166968,4.3655757875,0,2.3646868849,5.1618128809,6.7302626724
17,201,2007,4173,2497,2542,5152,618,1676,3160,4907,298010,14.119127815,8.4484692436,8.6007243962,71,2.0909707619,5.6706585712,10.691695158
17,201,2008,4353,2570,-290,5152,621,1783,331,2242,300252,14.552152736,8.5915535334,-0.969474912,128,2.0760135192,5.9605992024,1.1065386068
17,203,2001,451,349,-23,1113,8,102,-15,76,35560,12.696357187,9.8248972468,-0.647486065,-11,0.2252125443,2.8714599403,-0.422273521
17,203,2002,438,372,82,1133,8,66,90,143,35703,12.292494001,10.440200384,2.3013344934,-13,0.2245204384,1.8522936166,2.5258549317
17,203,2003,410,319,247,1132,2,91,249,324,36027,11.431757981,8.8944653562,6.8869371253,-16,0.0557646731,2.5372926251,6.9427017984
17,203,2004,412,364,428,1101,6,48,434,482,36509,11.359876475,10.036395721,11.801036727,0,0.1654350943,1.3234807544,11.966471821
17,203,2005,451,369,432,1126,6,82,438,520,37029,12.265767358,10.035627839,11.749027714,0,0.1631809405,2.2301395197,11.912208654
17,203,2006,442,359,248,1131,6,83,254,336,37365,11.882678711,9.6513159663,6.6672043444,-1,0.1613033309,2.2313627443,6.8285076754
17,203,2007,456,333,447,1185,3,123,450,579,37944,12.110106362,8.8435645142,11.871091105,6,0.0796717524,3.2665418476,11.950762857
17,203,2008,519,342,374,1185,5,177,379,559,38503,13.578034455,8.9473753058,9.7845566209,3,0.1308095805,4.6306591495,9.9153662014
18,0,2001,87746,55459,-6499,180346,10473,32287,3974,32550,6123942,14.36653308,9.0802265415,-1.064072419,-3711,1.714730027,5.286306539,0.6506576079
18,0,2002,85017,55486,-13033,180813,9762,29531,-3271,23032,6146974,13.856667261,9.0434976492,-2.124209798,-3228,1.5910792642,4.8131696118,-0.533130534
18,0,2003,85312,54891,-2231,181447,8288,30421,6057,31854,6178828,13.842831485,8.9066820966,-0.362004842,-4624,1.3448212133,4.9361493881,0.9828163717
18,0,2004,87814,56055,-4363,182408,8063,31759,3700,31973,6210801,14.175404284,9.0486970998,-0.704298732,-3486,1.3015724684,5.1267071839,0.597273736
18,0,2005,86772,55678,3423,183769,8225,31094,11648,37768,6248569,13.928794153,8.9375305493,0.5494659842,-4974,1.3202914754,4.9912636032,1.8697574596
18,0,2006,88476,55065,6530,186978,8435,33411,14965,45555,6294124,14.107975058,8.7804110329,1.0412436946,-2821,1.345006212,5.3275640247,2.3862499066
18,0,2007,89085,55796,628,188776,7608,33289,8236,41738,6335862,14.106903998,8.8354808944,0.0994458743,213,1.2047519293,5.2714231037,1.3041978035
18,0,2008,89921,55600,-1979,188776,7562,34321,5583,40930,6376792,14.14669195,8.7471900045,-0.311343328,1026,1.18968077,5.3995019451,0.8783374424
18,1,2001,599,346,-295,429,10,253,-285,-58,33554,17.836405324,10.30283179,-8.784206295,-26,0.2977697049,7.5335735342,-8.48643659
18,1,2002,592,288,-348,445,9,304,-339,-57,33497,17.658200474,8.5904759064,-10.38015839,-22,0.2684523721,9.0677245679,-10.11170601
18,1,2003,638,295,-132,452,9,343,-123,178,33675,18.996010242,8.7834216638,-3.930209016,-42,0.2679687965,10.212588579,-3.662240219
18,1,2004,602,310,-215,499,11,292,-204,59,33734,17.861116468,9.1975848922,-6.378970167,-29,0.3263659155,8.6635315759,-6.052604252
18,1,2005,641,315,-286,499,9,326,-277,20,33754,18.995969654,9.3349928876,-8.475580844,-29,0.2667140825,9.6609767662,-8.208866761
18,1,2006,660,297,-380,545,10,363,-370,-22,33732,19.559612364,8.8018255638,-11.261595,-15,0.2963577631,10.7577868,-10.96523723
18,1,2007,643,276,-339,545,9,367,-330,30,33762,19.0535455,8.178504756,-10.04533736,-7,0.2666903725,10.875040744,-9.778646991
18,1,2008,659,301,-134,545,8,358,-126,223,33985,19.454736003,8.8860023322,-3.955894726,-9,0.2361728195,10.568733671,-3.719721907
18,3,2001,5319,2564,-1136,5628,818,2755,-318,2128,334823,15.936648899,7.6821898436,-3.403653534,-309,2.4508702387,8.2544590558,-0.952783296
18,3,2002,5310,2670,-1072,5639,763,2640,-309,2033,336856,15.811124064,7.9502262241,-3.192000941,-298,2.2719185802,7.8608978396,-0.920082361
18,3,2003,5190,2593,-672,5649,657,2597,-15,2117,338973,15.358914755,7.6735387206,-1.988668731,-465,1.9442788043,7.6853760345,-0.044389927
18,3,2004,5264,2609,-1700,5530,632,2655,-1068,1318,340291,15.499128468,7.6818438781,-5.005417628,-269,1.8608376125,7.8172845904,-3.144580016
18,3,2005,5342,2580,-999,5454,645,2762,-354,2096,342387,15.650130808,7.5584682676,-2.926709225,-312,1.8896170669,8.0916625408,-1.037092158
18,3,2006,5432,2671,-109,5586,663,2761,554,3142,345529,15.792625844,7.765482995,-0.316899156,-173,1.9275609231,8.0271428488,1.6106617668
18,3,2007,5384,2653,-113,5588,610,2731,497,3232,348761,15.509369284,7.6423396563,-0.325512394,4,1.7571907992,7.8670296274,1.4316784053
18,3,2008,5433,2713,-1695,5588,611,2720,-1084,1762,350523,15.538751065,7.7593652936,-4.847815766,126,1.7475017303,7.7793857717,-3.100314035
18,5,2001,1006,612,-319,880,237,394,-82,250,71973,14.001781539,8.5179824073,-4.439928738,-62,3.298630442,5.4837991315,-1.141298296
18,5,2002,991,636,-854,888,223,355,-631,-320,71653,13.799729854,8.8563352039,-11.89199727,-44,3.1052873435,4.94339465,-8.786709927
18,5,2003,992,603,-215,887,188,389,-27,273,71926,13.818176753,8.3995570383,-2.994866937,-89,2.6187673685,5.4186197146,-0.376099569
18,5,2004,1043,691,6,947,187,352,193,494,72420,14.451387638,9.5742175052,0.0831335818,-51,2.5909966331,4.8771701329,2.6741302149
18,5,2005,1077,731,172,947,191,346,363,649,73069,14.805243008,10.048869674,2.3644399233,-60,2.6256280544,4.7563733341,4.9900679776
18,5,2006,1092,641,215,1007,194,451,409,820,73889,14.861388968,8.7235808871,2.9260060698,-40,2.6402101281,6.1378080812,5.5662161978
18,5,2007,1053,653,120,1007,177,400,297,689,74578,14.184970397,8.7965675874,1.616520843,-8,2.3843682434,5.3884028101,4.0008890865
18,5,2008,1079,683,191,1007,177,396,368,782,75360,14.392615614,9.110432312,2.5477197242,18,2.36097587,5.2821833024,4.9086955942
18,7,2001,131,97,-134,203,1,34,-133,-106,9290,14.021192337,10.382104249,-14.34228834,-7,0.1070320026,3.6390880873,-14.23525634
18,7,2002,86,89,-149,203,0,-3,-149,-158,9132,9.3366626859,9.6623602215,-16.17631093,-6,0,-0.325697536,-16.17631093
18,7,2003,115,81,-54,203,-1,34,-55,-30,9102,12.613798399,8.8845014808,-5.923000987,-9,-0.109685203,3.7292969178,-6.032686191
18,7,2004,133,95,-174,203,2,38,-172,-145,8957,14.729497757,10.521069827,-19.27017,-11,0.2214962069,4.2084279307,-19.04867379
18,7,2005,129,92,-146,203,0,37,-146,-116,8841,14.496010788,10.338240252,-16.40633779,-7,0,4.157770536,-16.40633779
18,7,2006,113,90,-30,203,2,23,-28,-10,8831,12.788592123,10.185604346,-3.395201449,-5,0.2263467632,2.6029877773,-3.168854685
18,7,2007,114,81,-95,203,1,33,-94,-57,8774,12.950866231,9.2019312695,-10.79238853,4,0.1136040897,3.7489349617,-10.67878444
18,7,2008,122,91,-42,203,0,31,-42,-5,8769,13.908681525,10.374508351,-4.788234623,6,0,3.5341731745,-4.788234623
18,9,2001,164,149,-236,178,1,15,-235,-231,13775,11.806630431,10.726755696,-16.99002916,-11,0.071991649,1.0798747345,-16.91803751
18,9,2002,168,139,-30,177,1,29,-29,-14,13761,12.202208019,10.095874492,-2.178965718,-14,0.0726321906,2.106333527,-2.106333527
18,9,2003,155,137,-37,180,1,18,-36,-36,13725,11.278469039,9.968711344,-2.692279706,-18,0.0727643164,1.3097576948,-2.61951539
18,9,2004,158,154,-114,172,0,4,-114,-122,13603,11.56323185,11.270491803,-8.343091335,-12,0,0.2927400468,-8.343091335
18,9,2005,154,180,-48,172,1,-26,-47,-85,13518,11.356513403,13.273846835,-3.539692489,-12,0.0737435935,-1.917333432,-3.465948896
18,9,2006,138,139,-244,163,0,-1,-244,-251,13267,10.304274781,10.378943438,-18.21915251,-6,0,-0.074668658,-18.21915251
18,9,2007,147,125,-94,163,1,22,-93,-80,13187,11.113631209,9.4503666742,-7.106675739,-9,0.0756029334,1.6632645347,-7.031072806
18,9,2008,140,150,-75,163,0,-10,-75,-94,13093,10.654490107,11.415525114,-5.707762557,-9,0,-0.761035008,-5.707762557
18,11,2001,657,421,497,895,18,236,515,707,47086,14.058738565,9.0087198417,10.634997058,-44,0.3851709196,5.0500187236,11.020167977
18,11,2002,626,424,869,893,15,202,884,1068,48154,13.145737085,8.9038219236,18.248635027,-18,0.3149937001,4.2419151617,18.563628727
18,11,2003,671,441,768,890,10,230,778,985,49139,13.793386986,9.0654003885,15.787363942,-23,0.2055646347,4.7279865972,15.992928577
18,11,2004,670,412,927,887,17,258,944,1142,50281,13.478173406,8.2880708107,18.648159324,-60,0.3419835043,5.1901025951,18.990142828
18,11,2005,718,378,808,887,15,340,823,1118,51399,14.122738002,7.4350904799,15.89299764,-45,0.295043273,6.6876475216,16.188040913
18,11,2006,709,444,1253,945,16,265,1269,1503,52902,13.595267543,8.513820577,24.026615277,-31,0.3068043451,5.081446966,24.333419622
18,11,2007,671,458,856,945,14,213,870,1077,53979,12.556020247,8.5702790954,16.017814205,-6,0.2619735968,3.9857411514,16.279787801
18,11,2008,772,449,706,945,14,323,720,1048,55027,14.164357925,8.2380786379,12.953415408,5,0.2568665945,5.9262792874,13.210282003
18,13,2001,158,108,83,138,8,50,91,128,15114,10.49833887,7.1760797342,5.5149501661,-13,0.5315614618,3.3222591362,6.0465116279
18,13,2002,151,155,76,137,7,-4,83,67,15181,9.96864169,10.232711669,5.0173295923,-12,0.4621224625,-0.264069979,5.4794520548
18,13,2003,146,122,-49,140,2,24,-47,-46,15135,9.6318775564,8.0485552184,-3.23261644,-23,0.1319435282,1.583322338,-3.100672912
18,13,2004,142,141,-54,145,6,1,-48,-56,15079,9.399616072,9.3334215926,-3.574501887,-9,0.3971668763,0.0661944794,-3.17733501
18,13,2005,91,117,-149,145,4,-26,-145,-181,14898,6.0713213464,7.8059845882,-9.940954732,-10,0.266871268,-1.734663242,-9.674083464
18,13,2006,99,135,-49,150,6,-36,-43,-85,14813,6.664198445,9.0875433341,-3.298441655,-6,0.4038908148,-2.423344889,-2.89455084
18,13,2007,103,137,-134,150,5,-34,-129,-172,14641,6.9939566782,9.3026414069,-9.098933931,-9,0.3395124601,-2.308684729,-8.759421471
18,13,2008,104,129,-48,150,4,-25,-44,-91,14550,7.125483882,8.8383405844,-3.288684869,-22,0.2740570724,-1.712856702,-3.014627796
18,15,2001,232,150,28,212,23,82,51,114,20261,11.482874678,7.4242724213,1.3858641853,-19,1.1383884379,4.058602257,2.5242526232
18,15,2002,219,162,-125,212,22,57,-103,-68,20193,10.827112276,8.0090967519,-6.179858605,-22,1.0876551145,2.8180155238,-5.09220349
18,15,2003,227,169,55,212,18,58,73,108,20301,11.211537512,8.3469155924,2.71645182,-23,0.8890205956,2.8646219193,3.6054724157
18,15,2004,249,179,-389,212,19,70,-370,-322,19979,12.363455809,8.8877855015,-19.31479643,-22,0.9433962264,3.4756703078,-18.3714002
18,15,2005,228,163,10,212,18,65,28,75,20054,11.390602753,8.1432817925,0.49958784,-18,0.8992581121,3.2473209602,1.3988459521
18,15,2006,214,190,-111,212,19,24,-92,-77,19977,10.691713922,9.4926432015,-5.545702081,-9,0.9492643202,1.1990707202,-4.596437761
18,15,2007,219,172,-117,212,14,47,-103,-56,19921,10.977993884,8.6219860645,-5.864955637,0,0.7017895634,2.3560078199,-5.163166073
18,15,2008,224,178,-115,212,13,46,-102,-57,19864,11.260525324,8.9480960161,-5.781073269,-1,0.6535126304,2.3124293075,-5.127560638
18,17,2001,585,434,-261,1113,98,151,-163,-52,40907,14.291647326,10.602692204,-6.376273422,-40,2.3941563042,3.6889551218,-3.982117118
18,17,2002,575,450,-743,1055,95,125,-648,-547,40360,14.150885353,11.074605929,-18.2854049,-24,2.3379723627,3.0762794246,-15.94743254
18,17,2003,529,425,-361,1035,82,104,-279,-209,40151,13.14106147,10.557563563,-8.967718697,-34,2.0369887345,2.5834979071,-6.930729962
18,17,2004,584,414,-431,1012,75,170,-356,-224,39927,14.585778866,10.339918579,-10.76450461,-38,1.8731736557,4.2458602862,-8.891330952
18,17,2005,545,375,-499,1017,77,170,-422,-284,39643,13.698630137,9.4256629383,-12.54241548,-32,1.93540279,4.2729671987,-10.60701269
18,17,2006,585,403,-588,1017,76,182,-512,-347,39296,14.821571087,10.210415637,-14.89757914,-17,1.9255374403,4.6111554491,-12.9720417
18,17,2007,546,400,-483,1058,71,146,-412,-256,39040,13.93995098,10.212418301,-12.3314951,10,1.8127042484,3.7275326797,-10.51879085
18,17,2008,534,391,-135,1058,70,143,-65,83,39123,13.66375395,10.004733698,-3.454319819,5,1.791128795,3.6590202525,-1.663191024
18,19,2001,1297,928,58,1495,95,369,153,426,97174,13.376512206,9.5708583864,0.5981786491,-96,0.9797753736,3.8056538196,1.5779540228
18,19,2002,1292,997,374,1540,89,295,463,654,97828,13.251146142,10.225536148,3.8358580938,-104,0.9128111507,3.0256099937,4.7486692444
18,19,2003,1316,1012,997,1561,75,304,1072,1286,99114,13.36434077,10.277137431,10.124808319,-90,0.7616455606,3.0872033391,10.88645388
18,19,2004,1320,977,707,1629,82,343,789,1049,100163,13.247891126,9.8054466898,7.0956507776,-83,0.8229750548,3.4424444366,7.9186258324
18,19,2005,1345,967,876,1636,79,378,955,1243,101406,13.345306074,9.5947293483,8.6918127291,-90,0.7838506913,3.7505767256,9.4756634205
18,19,2006,1428,953,1719,1716,86,475,1805,2223,103629,13.929329139,9.2959738581,16.7678689,-57,0.8388811666,4.6333552808,17.606750067
18,19,2007,1504,997,825,1763,78,507,903,1421,105050,14.414483489,9.5553457703,7.9068809032,11,0.747559649,4.8591377187,8.6544405522
18,19,2008,1452,1031,1093,1763,78,421,1171,1623,106673,13.71603463,9.7391402918,10.324811192,31,0.7368117777,3.9768943384,11.06162297
18,21,2001,338,313,-15,313,11,25,-4,-6,26559,12.724945411,11.783751224,-0.564716512,-27,0.4141254424,0.9411941872,-0.15059107
18,21,2002,356,305,-203,318,9,51,-194,-161,26398,13.444870367,11.518779387,-7.666597428,-18,0.3398984081,1.9260909795,-7.32669902
18,21,2003,360,304,199,312,4,56,203,235,26633,13.576964417,11.464992174,7.5050442194,-24,0.1508551602,2.1119722427,7.6558993796
18,21,2004,344,316,160,315,12,28,172,176,26809,12.873769694,11.825904719,5.9877998578,-24,0.4490849893,1.0478649751,6.4368848471
18,21,2005,345,301,-3,315,9,44,6,24,26833,12.863055069,11.222549495,-0.111852653,-26,0.3355579583,1.640505574,0.2237053055
18,21,2006,360,301,-146,318,13,59,-133,-86,26747,13.437849944,11.235535648,-5.4497947,-12,0.4852556924,2.2023142964,-4.964539007
18,21,2007,332,297,-163,318,8,35,-155,-115,26632,12.439348808,11.127971674,-6.10727065,5,0.2997433448,1.3113771333,-5.807527305
18,21,2008,338,288,8,318,8,50,16,71,26703,12.674603919,10.799662511,0.2999906253,5,0.2999906253,1.8749414081,0.5999812506
18,23,2001,549,369,-353,947,174,180,-179,-27,33934,16.172030341,10.869725311,-10.39840931,-28,5.1255615288,5.3023050298,-5.27284778
18,23,2002,498,310,-430,958,163,188,-267,-98,33836,14.696768482,9.1485908219,-12.68998082,-19,4.8103880773,5.5481776597,-7.87959274
18,23,2003,497,362,-420,950,144,135,-276,-159,33677,14.723090368,10.72386059,-12.4420482,-18,4.2658450965,3.999229778,-8.176203102
18,23,2004,504,363,-201,965,133,141,-68,43,33720,14.956155318,10.771992819,-5.964657181,-30,3.946763209,4.1841624998,-2.017893972
18,23,2005,505,357,-286,965,139,148,-147,-28,33692,14.982495698,10.591586068,-8.485136178,-29,4.1238948555,4.3909096303,-4.361241322
18,23,2006,532,347,-182,981,141,185,-41,128,33820,15.760161157,10.279653987,-5.39163408,-16,4.1770351937,5.4805071691,-1.214598886
18,23,2007,506,352,-356,981,129,154,-227,-58,33762,14.974401468,10.416974934,-10.53534965,15,3.8175845639,4.5574265337,-6.717765085
18,23,2008,514,319,-31,981,128,195,97,307,34069,15.155312468,9.405728944,-0.914036355,15,3.7740855951,5.7495835238,2.86004924
18,25,2001,144,108,98,99,0,36,98,126,10911,13.274336283,9.9557522124,9.0339233038,-8,0,3.3185840708,9.0339233038
18,25,2002,136,119,34,95,-1,17,33,40,10951,12.441679627,10.886469673,3.1104199067,-10,-0.091482938,1.5552099533,3.0189369683
18,25,2003,126,108,16,101,-1,18,15,18,10969,11.496350365,9.8540145985,1.4598540146,-15,-0.091240876,1.6423357664,1.3686131387
18,25,2004,144,126,1,102,0,18,1,12,10981,13.120728929,11.480637813,0.0911161731,-7,0,1.6400911162,0.0911161731
18,25,2005,128,123,-27,102,-1,5,-28,-30,10951,11.672442094,11.216487324,-2.462155754,-7,-0.091190954,0.4559547693,-2.553346708
18,25,2006,114,93,-67,103,0,21,-67,-52,10899,10.434782609,8.5125858124,-6.132723112,-6,0,1.9221967963,-6.132723112
18,25,2007,124,114,-118,103,0,10,-118,-114,10785,11.437004243,10.514665191,-10.88360081,-6,0,0.9223390518,-10.88360081
18,25,2008,115,108,-156,103,-1,7,-157,-161,10624,10.743145406,10.089214816,-14.57331029,-11,-0.093418656,0.6539305899,-14.66672895
18,27,2001,494,362,-361,538,49,132,-312,-202,29627,16.617330463,12.177072121,-12.1434338,-22,1.648277718,4.4402583423,-10.49515608
18,27,2002,452,281,-172,504,47,171,-125,19,29646,15.251463567,9.4815514653,-5.803654278,-27,1.5858822735,5.7699121016,-4.217772004
18,27,2003,491,302,-35,488,42,189,7,152,29798,16.51974968,10.160823632,-1.177578898,-44,1.4130946773,6.358926048,0.2355157796
18,27,2004,491,267,-127,489,39,224,-88,113,29911,16.446431861,8.9433753705,-4.253965064,-23,1.3063357283,7.5030564906,-2.947629336
18,27,2005,510,317,-146,489,41,193,-105,61,29972,17.033214769,10.587311925,-4.876175208,-27,1.3693368736,6.4459028439,-3.506838335
18,27,2006,518,304,-389,488,41,214,-348,-147,29825,17.325283877,10.167734167,-13.01068615,-13,1.3713062528,7.1575497099,-11.6393799
18,27,2007,515,303,-96,488,37,212,-59,149,29974,17.2243683,10.133948728,-3.210756033,-4,1.2374788876,7.0904195722,-1.973277145
18,27,2008,509,302,-62,488,36,207,-26,173,30147,16.932519419,10.046406414,-2.062507277,-8,1.1975848705,6.8861130054,-0.864922406
18,29,2001,607,350,204,513,11,257,215,429,46774,13.037081584,7.5172628572,4.3814903511,-43,0.2362568327,5.5198187266,4.6177471837
18,29,2002,537,344,210,513,9,193,219,372,47146,11.435264055,7.3253833049,4.471890971,-40,0.1916524702,4.1098807496,4.6635434412
18,29,2003,556,376,459,513,3,180,462,601,47747,11.718461847,7.9247152055,9.6740539344,-41,0.0632291107,3.793746641,9.7372830451
18,29,2004,637,362,307,513,11,275,318,552,48299,13.264477438,7.5380546821,6.392770131,-41,0.2290569102,5.7264227558,6.6218270412
18,29,2005,658,383,82,513,8,275,90,319,48618,13.578629136,7.9036701507,1.6921695884,-46,0.1650897159,5.6749589855,1.8572593044
18,29,2006,625,396,262,513,10,229,272,477,49095,12.792565984,8.1053698075,5.3626436605,-24,0.2046810557,4.6871961766,5.5673247163
18,29,2007,621,398,249,513,8,223,257,484,49579,12.586902325,8.0669679956,5.0469221882,4,0.1621501105,4.5199343292,5.2090722987
18,29,2008,681,398,108,513,8,283,116,406,49985,13.679643245,7.994857579,2.1694588405,7,0.1607006549,5.6847856655,2.3301594954
18,31,2001,380,223,-230,282,34,157,-196,-57,24510,15.485869144,9.0877600505,-9.373026061,-18,1.3855777656,6.3981090939,-7.987448296
18,31,2002,365,200,-36,286,32,165,-4,138,24648,14.850075268,8.1370275438,-1.464664958,-23,1.301924407,6.7130477237,-0.162740551
18,31,2003,371,245,-36,298,29,126,-7,85,24733,15.026022154,9.9228448189,-1.458050667,-34,1.1745408153,5.1031773354,-0.283509852
18,31,2004,398,236,24,301,29,162,53,199,24932,16.027383469,9.50367462,0.9664753851,-16,1.1678244236,6.5237088493,2.1342998087
18,31,2005,353,271,7,301,29,82,36,99,25031,14.130456538,10.84802754,0.2802073534,-19,1.1608590357,3.2824289975,1.4410663891
18,31,2006,359,235,-205,314,30,124,-175,-64,24967,14.360574423,9.400376015,-8.200328013,-13,1.2000480019,4.9601984079,-7.000280011
18,31,2007,370,235,-175,314,29,135,-146,-30,24937,14.828470664,9.4180827188,-7.013465854,-19,1.1622314845,5.4103879449,-5.85123437
18,31,2008,374,234,-72,314,28,140,-44,61,24998,14.979473315,9.372183839,-2.883748874,-35,1.1214578953,5.6072894763,-1.762290978
18,33,2001,571,330,-175,446,19,241,-156,49,40451,14.1243986,8.1629624133,-4.328843704,-36,0.469988745,5.9614361867,-3.858854959
18,33,2002,621,324,-107,457,18,297,-89,170,40621,15.319715808,7.9928952043,-2.639628972,-38,0.4440497336,7.3268206039,-2.195579238
18,33,2003,572,341,109,454,15,231,124,297,40918,14.030096028,8.3640957088,2.67356725,-58,0.3679220986,5.6660003189,3.0414893487
18,33,2004,567,340,39,457,17,227,56,257,41175,13.813601647,8.2832884655,0.9501419122,-26,0.4141644233,5.5303131814,1.3643063355
18,33,2005,597,348,-10,457,15,249,5,218,41393,14.460808061,8.4294157543,-0.242224591,-36,0.363336886,6.0313923069,0.1211122953
18,33,2006,508,331,-99,460,16,177,-83,74,41467,12.26164615,7.9893796766,-2.389572773,-20,0.3861935795,4.2722664736,-2.003379194
18,33,2007,586,335,-5,460,16,251,11,266,41733,14.086538462,8.0528846154,-0.120192308,4,0.3846153846,6.0336538462,0.2644230769
18,33,2008,573,350,-108,460,15,223,-93,151,41884,13.705346999,8.3715034024,-2.583206764,21,0.3587787172,5.3338435964,-2.224428047
18,35,2001,1417,1160,952,7664,134,257,1086,1253,119987,11.871599063,9.7184579488,7.9758379028,-90,1.1226494527,2.1531411145,9.0984873555
18,35,2002,1320,1129,-846,7834,123,191,-723,-632,119355,11.030241245,9.4341987616,-7.069381889,-100,1.0278179342,1.5960424831,-6.041563955
18,35,2003,1326,1228,-464,7981,99,98,-365,-403,118952,11.12850231,10.306033814,-3.894136555,-136,0.8308610322,0.8224684965,-3.063275523
18,35,2004,1345,1167,-1418,7339,104,178,-1314,-1254,117698,11.366997676,9.862666385,-11.98394253,-118,0.8789351363,1.5043312909,-11.10500739
18,35,2005,1286,1120,-1267,7311,104,166,-1163,-1098,116600,10.977473133,9.5604742678,-10.81528652,-101,0.8877583249,1.4169988647,-9.927528191
18,35,2006,1282,1223,-1226,7419,109,59,-1117,-1102,115498,11.047057708,10.538651776,-10.56450293,-44,0.9392584167,0.508405932,-9.625244509
18,35,2007,1279,1186,-550,7419,96,93,-454,-331,115167,11.089675503,10.283311296,-4.768820584,30,0.8323759565,0.8063642078,-3.936444627
18,35,2008,1353,1157,-827,7419,96,196,-731,-482,114685,11.772792928,10.067347685,-7.195934775,53,0.835320119,1.705445243,-6.360614656
18,37,2001,531,356,7,772,60,175,67,201,39894,13.343887821,8.9461846784,0.1759081257,-41,1.5077839346,4.3977031425,1.6836920603
18,37,2002,531,352,-160,773,58,179,-102,43,39937,13.303102805,8.8186293545,-4.008467888,-34,1.4530696096,4.4844734502,-2.555398279
18,37,2003,527,367,61,771,44,160,105,206,40143,13.161838162,9.1658341658,1.5234765235,-59,1.0989010989,3.996003996,2.6223776224
18,37,2004,545,350,130,773,44,195,174,340,40483,13.519212165,8.6820628581,3.2247662045,-29,1.0914593307,4.8371493067,4.3162255352
18,37,2005,561,330,-12,773,45,231,33,227,40710,13.818925277,8.1287795746,-0.295591985,-37,1.108469942,5.6901457022,0.8128779575
18,37,2006,524,374,82,774,45,150,127,255,40965,12.83134374,9.1582491582,2.0079583716,-22,1.1019283747,3.6730945822,3.1098867463
18,37,2007,600,376,-55,774,39,224,-16,199,41164,14.611160491,9.1563272413,-1.339356378,-9,0.9497254319,5.4548332501,-0.389630946
18,37,2008,571,361,29,774,38,210,67,285,41449,13.82349025,8.7395446237,0.7020686817,8,0.9199520657,5.083945626,1.6220207473
18,39,2001,3311,1375,-1193,2764,925,1936,-268,1511,185033,17.967467542,7.4615728996,-6.473931978,-157,5.019603587,10.505894643,-1.454328391
18,39,2002,2996,1502,-2285,2742,877,1494,-1408,-20,185013,16.192581463,8.1179096653,-12.34981597,-106,4.7399512493,8.0746717976,-7.60986472
18,39,2003,3088,1361,412,2822,769,1727,1181,2642,187655,16.572391512,7.3040883575,2.2110833235,-266,4.1269977567,9.2683031546,6.3380810802
18,39,2004,3252,1451,-74,2824,693,1801,619,2293,189948,17.224439424,7.6853202967,-0.391946039,-127,3.6705216855,9.5391191278,3.2785756469
18,39,2005,3339,1427,1026,2863,729,1912,1755,3480,193428,17.418930762,7.4443887985,5.3524477276,-187,3.8030549643,9.974541964,9.1555026919
18,39,2006,3542,1409,148,2935,732,2133,880,2913,196341,18.174867678,7.2299233649,0.7594241718,-100,3.7560709035,10.944944313,4.5154950753
18,39,2007,3490,1407,-1475,2958,667,2083,-808,1298,197639,17.716635362,7.1424945429,-7.48768973,23,3.3859586781,10.574140819,-4.101731052
18,39,2008,3411,1372,-1217,2958,667,2039,-550,1498,199137,17.193580257,6.9157408714,-6.134443616,9,3.362098514,10.277839385,-2.772345102
18,41,2001,339,304,-325,516,2,35,-323,-305,25251,13.344617868,11.966854961,-12.7935127,-17,0.078729309,1.3777629067,-12.7147834
18,41,2002,294,316,-151,518,1,-22,-150,-190,25061,11.687072667,12.561615519,-6.002544125,-18,0.0397519478,-0.874542853,-5.962792177
18,41,2003,313,306,-153,503,0,7,-153,-176,24885,12.533536219,12.253233492,-6.126616746,-30,0,0.2803027269,-6.126616746
18,41,2004,326,307,-132,498,3,19,-129,-129,24756,13.134304305,12.368808042,-5.318184565,-19,0.120867831,0.7654962632,-5.197316734
18,41,2005,314,276,-183,498,1,38,-182,-166,24590,12.726462125,11.186317027,-7.41701455,-22,0.0405301342,1.5401450979,-7.376484416
18,41,2006,295,264,-251,492,3,31,-248,-227,24363,12.05237677,10.785855821,-10.25473413,-10,0.1225665434,1.2665209487,-10.13216759
18,41,2007,312,296,-138,492,2,16,-136,-113,24250,12.836072655,12.177812519,-5.677493675,7,0.082282517,0.6582601362,-5.595211158
18,41,2008,314,287,-20,492,1,27,-19,15,24265,12.94445017,11.831392353,-0.824487272,7,0.0412243636,1.1130578172,-0.783262908
18,43,2001,874,683,387,1004,16,191,403,533,71440,12.279851349,9.596268274,5.4374170162,-61,0.2248027707,2.6835830752,5.6622197869
18,43,2002,870,681,-179,1057,14,189,-165,-40,71400,12.181461775,9.5351442173,-2.506300756,-64,0.1960235228,2.6463175581,-2.310277233
18,43,2003,819,691,-297,1065,8,128,-289,-243,71157,11.490140786,9.6943678669,-4.166754351,-82,0.1122358074,1.7957729189,-4.054518543
18,43,2004,845,670,80,1051,13,175,93,224,71381,11.856487393,9.4010018381,1.1225076822,-44,0.1824074984,2.4554855547,1.3049151805
18,43,2005,888,678,247,1050,12,210,259,408,71789,12.404833415,9.4712579451,3.4504435287,-61,0.167632884,2.9335754697,3.6180764127
18,43,2006,923,690,319,1022,13,233,332,527,72316,12.810103744,9.5763505777,4.4273272961,-38,0.1804239964,3.2337531661,4.6077512925
18,43,2007,868,680,433,1022,10,188,443,627,72943,11.951066715,9.3625868277,5.9617648476,-4,0.1376851004,2.5884798876,6.099449948
18,43,2008,934,682,561,1022,10,252,571,837,73780,12.731473593,9.296429326,7.6470628327,14,0.1363112804,3.4350442671,7.7833741131
18,45,2001,208,228,-191,184,10,-20,-181,-214,17703,11.678832117,12.801796743,-10.72431218,-13,0.5614823133,-1.122964627,-10.16282987
18,45,2002,242,182,-20,182,9,60,-11,33,17736,13.657270239,10.27117018,-1.12870002,-16,0.5079150089,3.3861000593,-0.620785011
18,45,2003,212,177,-166,182,7,35,-159,-136,17600,11.999094408,10.018111841,-9.395517319,-12,0.3961965135,1.9809825674,-8.999320806
18,45,2004,210,210,-191,183,8,0,-183,-200,17400,12,12,-10.91428571,-17,0.4571428571,0,-10.45714286
18,45,2005,211,188,-206,183,8,23,-198,-187,17213,12.191951001,10.86297056,-11.90304221,-12,0.4622540664,1.3289804409,-11.44078814
18,45,2006,204,200,3,183,9,4,12,7,17220,11.849098249,11.616762989,0.1742514448,-9,0.5227543345,0.2323352598,0.6970057793
18,45,2007,198,199,-113,183,6,-1,-107,-111,17109,11.535436511,11.593696292,-6.583355181,-3,0.3495586822,-0.05825978,-6.233796499
18,45,2008,210,191,-86,183,5,19,-81,-68,17041,12.298682284,11.185944363,-5.036603221,-6,0.2928257687,1.1127379209,-4.743777452
18,47,2001,255,160,-21,360,2,95,-19,54,22275,11.461704423,7.1916576771,-0.94390507,-22,0.089895721,4.2700467458,-0.854009349
18,47,2002,255,168,78,360,1,87,79,148,22423,11.409906484,7.5171148597,3.490089042,-18,0.0447447313,3.8927916238,3.5348337733
18,47,2003,239,201,175,360,1,38,176,195,22618,10.612553007,8.9252014831,7.7706978087,-19,0.0444039875,1.6873515242,7.8151017961
18,47,2004,311,177,17,360,2,134,19,138,22756,13.708291092,7.8018248336,0.7493278089,-15,0.0881562128,5.9064662582,0.8374840217
18,47,2005,305,162,51,360,1,143,52,175,22931,13.351719307,7.0917328781,2.2325825727,-20,0.0437761289,6.2599864294,2.2763587016
18,47,2006,284,196,8,360,2,88,10,87,23018,12.361531263,8.5311976322,0.3482121483,-11,0.0870530371,3.8303336308,0.4352651853
18,47,2007,312,189,39,360,2,123,41,165,23183,13.506201164,8.18164109,1.6882751456,1,0.0865782126,5.3245600745,1.7748533582
18,47,2008,318,205,35,360,1,113,36,160,23343,13.669776039,8.8122770064,1.5045350987,11,0.0429867171,4.8574990328,1.5475218158
18,49,2001,267,222,-141,153,25,45,-116,-88,20465,13.018674728,10.824516066,-6.875030474,-17,1.2189770345,2.1941586621,-5.65605344
18,49,2002,246,216,-135,153,25,30,-110,-95,20370,12.048487817,10.579160034,-6.611975021,-15,1.2244398188,1.4693277825,-5.387535203
18,49,2003,251,230,-171,153,12,21,-159,-155,20215,12.369101885,11.334236787,-8.426758655,-17,0.5913514845,1.0348650979,-7.83540717
18,49,2004,238,251,43,153,11,-13,54,29,20244,11.764996663,12.407622531,2.1256086408,-12,0.54376035,-0.642625868,2.6693689908
18,49,2005,266,231,-20,153,12,35,-8,9,20253,13.136775564,11.408252463,-0.987727486,-18,0.5926364916,1.7285231005,-0.395090994
18,49,2006,247,217,-44,153,14,30,-30,-9,20244,12.198434452,10.716843223,-2.173000469,-9,0.6914092402,1.481591229,-1.481591229
18,49,2007,264,264,7,153,11,0,18,10,20254,13.037680873,13.037680873,0.3456960838,-8,0.543236703,0,0.8889327868
18,49,2008,260,222,11,153,10,38,21,65,20319,12.816404998,10.943238114,0.5422325192,6,0.4929386538,1.8731668844,1.0351711729
18,51,2001,408,359,56,685,16,49,72,91,32622,12.524365724,11.020213958,1.7190305895,-30,0.491151597,1.5041517658,2.2101821865
18,51,2002,377,323,-72,683,15,54,-57,-38,32584,11.563353066,9.9070637671,-2.208385731,-35,0.4600803607,1.6562892985,-1.748305371
18,51,2003,414,322,90,683,11,92,101,155,32739,12.675474182,9.8587021417,2.7555378657,-38,0.3367879614,2.8167720405,3.092325827
18,51,2004,440,382,150,683,11,58,161,193,32932,13.400130956,11.633750057,4.5682264622,-26,0.3350032739,1.7663808987,4.9032297361
18,51,2005,399,343,-54,683,12,56,-42,-14,32918,12.118451025,10.417615793,-1.640091116,-28,0.3644646925,1.7008352316,-1.275626424
18,51,2006,429,317,-83,683,12,112,-71,25,32943,13.027436571,9.6263342494,-2.520459756,-16,0.3644038202,3.4011023216,-2.156055936
18,51,2007,429,311,-351,683,11,118,-340,-234,32709,13.068908792,9.4741972826,-10.69274356,-12,0.3351002254,3.5947115092,-10.35764333
18,51,2008,415,307,-138,683,10,108,-128,-43,32666,12.695984704,9.3919694073,-4.221797323,-23,0.3059273423,3.3040152964,-3.915869981
18,53,2001,884,814,-584,4699,18,70,-566,-551,72739,12.107184189,11.148470509,-7.998411274,-55,0.2465263749,0.9587136802,-7.7518849
18,53,2002,872,779,-693,4787,17,93,-676,-640,72099,12.041038954,10.756845579,-9.569311921,-57,0.2347450255,1.2841933747,-9.334566895
18,53,2003,787,817,-404,4923,10,-30,-394,-499,71600,10.953451311,11.370990752,-5.62286446,-75,0.1391798134,-0.41753944,-5.483684646
18,53,2004,855,819,-770,5052,14,36,-756,-786,70814,12.007246479,11.501678206,-10.81354361,-66,0.1966098839,0.5055682728,-10.61693373
18,53,2005,732,814,-717,5194,12,-82,-705,-844,69970,10.398908967,11.56381407,-10.18581657,-57,0.1704739175,-1.164905103,-10.01534265
18,53,2006,865,765,-611,5313,13,100,-598,-529,69441,12.409350769,10.974743743,-8.765448924,-31,0.1864989133,1.4346070253,-8.578950011
18,53,2007,824,771,-704,5286,9,53,-695,-654,68787,11.922331221,11.155482247,-10.18606939,-12,0.1302196371,0.7668489742,-10.05584976
18,53,2008,790,782,-183,5286,9,8,-174,-178,68609,11.499606975,11.383155259,-2.663833008,-12,0.1310081807,0.1164517162,-2.532824828
18,55,2001,408,345,-71,546,4,63,-67,-38,33161,12.296564195,10.397830018,-2.139843279,-34,0.1205545509,1.8987341772,-2.019288728
18,55,2002,416,408,-169,546,2,8,-167,-193,32968,12.581469552,12.339518214,-5.111222005,-34,0.0604878344,0.2419513375,-5.050734171
18,55,2003,445,374,125,546,1,71,126,162,33130,13.464855215,11.316530001,3.7822627008,-35,0.0302581016,2.1483252141,3.8125208024
18,55,2004,398,354,18,546,4,44,22,42,33172,12.00567102,10.678410908,0.5429700462,-24,0.1206600103,1.3272601128,0.6636300564
18,55,2005,381,349,-139,546,3,32,-136,-130,33042,11.508140272,10.54157731,-4.198507868,-26,0.0906152777,0.9665629625,-4.107892591
18,55,2006,373,345,-164,546,4,28,-160,-147,32895,11.313829868,10.464534328,-4.974445304,-15,0.1213279342,0.8492955397,-4.85311737
18,55,2007,407,377,-280,546,2,30,-278,-253,32642,12.420464776,11.504951401,-8.544791492,-5,0.0610342249,0.9155133741,-8.483757267
18,55,2008,394,351,-86,546,2,43,-84,-65,32577,12.082368635,10.763734495,-2.637268281,-24,0.0613318205,1.3186341404,-2.57593646
18,57,2001,3292,987,7154,1616,308,2305,7462,10972,196259,17.256110666,5.1736881005,37.500065523,1205,1.6144842299,12.082422565,39.114549753
18,57,2002,3326,991,7687,1610,291,2335,7978,11474,207733,16.465672588,4.9060377433,38.055209014,1161,1.4406225866,11.559634844,39.495831601
18,57,2003,3519,950,7577,1643,241,2569,7818,11898,219631,16.468396964,4.4458587995,35.459233815,1511,1.1278441797,12.022538164,36.587077994
18,57,2004,3733,981,7900,1633,239,2752,8139,11937,231568,16.547022489,4.3484138928,35.017808107,1046,1.0593995111,12.198608596,36.077207618
18,57,2005,3645,1059,7353,1633,241,2586,7594,10228,241796,15.400410678,4.4743579993,31.067001293,48,1.0182438884,10.926052678,32.085245181
18,57,2006,3766,1074,6872,1621,246,2692,7118,9815,251611,15.265288089,4.3534039849,27.855299986,5,0.9971483988,10.911884104,28.852448384
18,57,2007,3835,1146,6249,1621,229,2689,6478,9193,260804,14.968336212,4.4729369749,24.390386698,26,0.8938067777,10.495399237,25.284193476
18,57,2008,4175,1149,5733,1621,229,3026,5962,8981,269785,15.737227873,4.3310358865,21.609946682,-7,0.8631916606,11.406191987,22.473138342
18,59,2001,711,444,704,458,5,267,709,932,56594,12.667474344,7.9104903079,12.542759407,-44,0.0890820981,4.7569840365,12.631841505
18,59,2002,705,421,1122,453,4,284,1126,1384,57978,12.306671787,7.3490905282,19.585937227,-26,0.0698250882,4.9575812589,19.655762315
18,59,2003,816,437,890,446,2,379,892,1242,59220,13.925152306,7.4574651445,15.187972491,-29,0.0341302753,6.4676871619,15.222102766
18,59,2004,817,455,902,457,8,362,910,1207,60427,13.656840539,7.6057067875,15.077686862,-65,0.1337267127,6.0511337518,15.211413575
18,59,2005,869,539,1698,457,5,330,1703,1986,62413,14.148485835,8.775643113,27.645718007,-47,0.0814067079,5.3728427222,27.727124715
18,59,2006,932,472,1641,468,7,460,1648,2072,64485,14.688962789,7.4390455326,25.863291778,-36,0.1103248278,7.2499172564,25.973616605
18,59,2007,917,505,1196,468,5,412,1201,1622,66107,14.04373928,7.7340112717,18.316589071,9,0.076574369,6.3097280078,18.39316344
18,59,2008,1021,513,643,468,5,508,648,1175,67282,15.308608656,7.6917886782,9.640974893,19,0.0749687006,7.6168199777,9.7159435935
18,61,2001,434,296,29,374,17,138,46,149,34664,12.547160265,8.5575102271,0.8384047182,-35,0.4914786279,3.9896500383,1.3298833461
18,61,2002,444,309,258,370,15,135,273,379,35043,12.739036252,8.8656806347,7.4024129571,-29,0.4303728463,3.8733556171,7.8327858034
18,61,2003,426,312,258,376,11,114,269,341,35384,12.09763301,8.8602382609,7.326735485,-42,0.3123801951,3.2373947492,7.6391156801
18,61,2004,475,294,470,376,13,181,483,627,36011,13.306253939,8.2358708593,13.166188108,-37,0.3641711604,5.07038308,13.530359269
18,61,2005,438,302,312,376,14,136,326,433,36444,12.090262922,8.3362086813,8.6122420813,-29,0.3864467601,3.7540542406,8.9986888413
18,61,2006,455,306,24,382,16,149,40,170,36614,12.45585699,8.3769060199,0.6570122369,-19,0.4380081579,4.0789509705,1.0950203948
18,61,2007,444,310,21,382,11,134,32,161,36775,12.09990598,8.4481325539,0.5722928504,-5,0.2997724455,3.6517734265,0.8720652959
18,61,2008,461,332,149,382,11,129,160,292,37067,12.486119011,8.9921724764,4.0356436716,3,0.2979334254,3.4939465345,4.333577097
18,63,2001,1524,706,3668,3599,73,818,3741,4520,109885,14.160278746,6.5598141696,34.081300813,-39,0.6782810685,7.6004645761,34.759581882
18,63,2002,1519,681,3848,3654,67,838,3915,4742,114627,13.531570696,6.066490878,34.278791334,-11,0.596850057,7.4650798176,34.875641391
18,63,2003,1433,763,2935,3709,53,670,2988,3705,118332,12.302594019,6.5505088878,25.197566954,47,0.4550156895,5.7520851309,25.652582643
18,63,2004,1556,695,3690,3757,57,861,3747,4414,122746,12.908685156,5.7657687553,30.612498859,-194,0.4728759986,7.1429164005,31.085374858
18,63,2005,1561,798,2786,3642,56,763,2842,3497,126243,12.538706529,6.4099217234,22.378498649,-108,0.4498190683,6.1287848058,22.828317717
18,63,2006,1659,817,2734,3612,58,842,2792,3563,129806,12.95845717,6.3815910236,21.355287465,-71,0.4530382856,6.5768661467,21.80832575
18,63,2007,1729,856,3448,3915,54,873,3502,4424,134230,13.096698935,6.4839643079,26.117650623,49,0.4090351316,6.6127346271,26.526685755
18,63,2008,1782,824,1941,3915,54,958,1995,3010,137240,13.128522489,6.0706523741,14.299922643,57,0.3978340148,7.0578701146,14.697756658
18,65,2001,604,570,-205,657,4,34,-201,-211,48236,12.494440595,11.791111157,-4.240662785,-44,0.0827446397,0.7033294374,-4.157918145
18,65,2002,524,565,-192,813,2,-41,-190,-274,47962,10.894197385,11.746605959,-3.991766981,-43,0.041580906,-0.852408574,-3.950186075
18,65,2003,573,541,-263,861,-1,32,-264,-288,47674,11.982935296,11.313731231,-5.500020913,-56,-0.020912627,0.6692040654,-5.52093354
18,65,2004,553,585,-52,1037,4,-32,-48,-112,47562,11.613255492,12.285270276,-1.092024025,-32,0.084001848,-0.672014784,-1.008022176
18,65,2005,553,561,-230,1139,2,-8,-228,-279,47283,11.66113132,11.829827613,-4.850018451,-43,0.0421740735,-0.168696294,-4.807844378
18,65,2006,541,577,201,1650,4,-36,205,147,47430,11.423986148,12.184177462,4.2444015077,-22,0.0844657016,-0.760191315,4.3288672094
18,65,2007,499,558,-388,1578,1,-59,-387,-439,46991,10.569682592,11.819404582,-8.218510713,7,0.0211817286,-1.24972199,-8.197328984
18,65,2008,544,548,174,1578,1,-4,175,171,47162,11.555659405,11.640627489,3.6961116481,0,0.021242021,-0.084968084,3.717353669
18,67,2001,1196,863,-336,1136,62,333,-274,-16,84955,14.076715747,10.157362617,-3.954662618,-75,0.7297294116,3.9193531302,-3.224933206
18,67,2002,1181,984,-557,1121,56,197,-501,-368,84587,13.931651154,11.607743214,-6.570643262,-64,0.6606032723,2.3239079402,-5.91003999
18,67,2003,1177,874,-333,1113,46,303,-287,-84,84503,13.921580224,10.337689988,-3.938730853,-100,0.5440889467,3.583890236,-3.394641907
18,67,2004,1177,932,-473,1111,49,245,-424,-250,84253,13.94913366,11.045533196,-5.605726611,-71,0.5807200929,2.9036004646,-5.025006518
18,67,2005,1104,838,-184,1111,50,266,-134,58,84311,13.098882324,9.9428110391,-2.183147054,-74,0.593246482,3.1560712845,-1.589900572
18,67,2006,1126,804,-854,1099,51,322,-803,-516,83795,13.396309471,9.5653932638,-10.16025603,-35,0.6067600205,3.8309162076,-9.553496008
18,67,2007,1097,869,-431,1099,44,228,-387,-147,83648,13.102966383,10.379651583,-5.14802052,12,0.5255519789,2.7233147997,-4.622468542
18,67,2008,1120,869,-600,1099,44,251,-556,-267,83381,13.410844823,10.405378707,-7.184381155,38,0.5268546181,3.0054661167,-6.657526537
18,69,2001,483,401,-182,1433,11,82,-171,-126,37973,12.698496162,10.542643811,-4.784940583,-37,0.2891997055,2.1558523504,-4.495740877
18,69,2002,464,377,116,1422,9,87,125,176,38149,12.190956622,9.9051522556,3.0477391556,-36,0.2364625207,2.2858043667,3.2842016763
18,69,2003,473,390,-123,1420,6,83,-117,-79,38070,12.411603406,10.23366877,-3.227541689,-45,0.157441058,2.1779346357,-3.070100631
18,69,2004,448,365,-83,1498,10,83,-73,-22,38048,11.771197351,9.5903728422,-2.180824509,-32,0.2627499409,2.1808245093,-1.918074568
18,69,2005,503,432,-111,1498,8,71,-103,-69,37979,13.232141213,11.364383706,-2.920015258,-37,0.2104515501,1.8677575072,-2.709563708
18,69,2006,472,395,-190,1576,10,77,-180,-120,37859,12.447585643,10.416941375,-5.010680661,-17,0.2637200348,2.030644268,-4.746960627
18,69,2007,470,376,-233,1576,8,94,-225,-130,37729,12.435836376,9.9486691009,-6.164999735,1,0.2116738107,2.4871672752,-5.953325925
18,69,2008,471,403,-249,1576,8,68,-241,-159,37570,12.510126296,10.703993413,-6.613633647,14,0.2124862216,1.8061328836,-6.401147426
18,71,2001,624,410,-311,556,100,214,-211,-31,41372,15.077016007,9.9063726971,-7.514346119,-34,2.4161884627,5.1706433102,-5.098157656
18,71,2002,623,429,-222,545,94,194,-128,34,41406,15.052308584,10.365072845,-5.36374399,-32,2.2711348426,4.687235739,-3.092609147
18,71,2003,619,410,-160,525,85,209,-75,86,41492,14.934015296,9.8916741055,-3.860165505,-48,2.0507129243,5.0423411904,-1.80945258
18,71,2004,597,395,-181,534,77,202,-104,64,41556,14.377227627,9.5125710433,-4.358924959,-34,1.854349292,4.8646565841,-2.504575667
18,71,2005,572,377,53,534,79,195,132,288,41844,13.717026379,9.0407673861,1.2709832134,-39,1.8944844125,4.6762589928,3.1654676259
18,71,2006,601,387,-201,542,78,214,-123,71,41915,14.350696642,9.2407980038,-4.799484235,-20,1.8624864194,5.1098986378,-2.936997815
18,71,2007,595,423,-125,542,69,172,-56,109,42024,14.176961841,10.078747662,-2.978353328,-7,1.6440510371,4.0982141793,-1.334302291
18,71,2008,589,418,-68,542,68,171,0,169,42193,13.987674698,9.9267368821,-1.614875856,-2,1.6148758564,4.0609378154,0
18,73,2001,361,247,-74,956,14,114,-60,25,30207,11.955819769,8.1802977363,-2.450777459,-29,0.4636606004,3.7755220322,-1.987116859
18,73,2002,382,258,73,955,14,124,87,182,30389,12.608092943,8.5154135587,2.4093999604,-29,0.4620767047,4.0926793848,2.8714766651
18,73,2003,413,242,247,996,12,171,259,394,30783,13.502909828,7.9121166547,8.0755901393,-36,0.392336363,5.5907931733,8.4679265023
18,73,2004,412,264,172,974,10,148,182,305,31088,13.318032681,8.5338850188,5.5599553911,-25,0.3232532204,4.7841476621,5.8832086115
18,73,2005,462,258,-4,988,12,204,8,182,31270,14.817665737,8.2748003464,-0.128291478,-30,0.3848744347,6.5428653902,0.2565829565
18,73,2006,436,288,399,1015,11,148,410,541,31811,13.823496774,9.1311171351,12.650401864,-17,0.3487579461,4.6923796389,12.99915981
18,73,2007,478,280,194,1013,11,198,205,411,32222,14.929801821,8.7454906064,6.0593756344,8,0.3435728453,6.1843112145,6.4029484797
18,73,2008,469,280,110,1013,10,189,120,322,32544,14.482907698,8.6465120588,3.3968440231,13,0.3088040021,5.8363956397,3.7056480252
18,75,2001,300,236,-175,248,27,64,-148,-101,21692,13.797861331,10.854317581,-8.048752443,-17,1.2418075198,2.9435437507,-6.806944924
18,75,2002,297,199,-165,248,26,98,-139,-57,21635,13.709696032,9.1859579477,-7.616497796,-16,1.2001754103,4.5237380848,-6.416322386
18,75,2003,304,241,-152,248,25,63,-127,-86,21549,14.079288625,11.161541312,-7.039644313,-22,1.1578362356,2.9177473138,-5.881808077
18,75,2004,305,223,-154,248,21,82,-133,-70,21479,14.176815097,10.365343497,-7.15812959,-19,0.9761085805,3.8114715999,-6.18202101
18,75,2005,305,204,-203,248,22,101,-181,-99,21380,14.232716582,9.5195874845,-9.47292284,-19,1.0266221797,4.7131290977,-8.44630066
18,75,2006,292,257,-6,269,21,35,15,39,21419,13.645178626,12.009626393,-0.280380383,-11,0.9813313395,1.6355522325,0.7009509568
18,75,2007,315,244,-32,269,19,71,-13,55,21474,14.687711282,11.377147786,-1.492084956,-3,0.8859254424,3.3105634952,-0.606159513
18,75,2008,305,224,-171,269,18,81,-153,-62,21412,14.223756004,10.446299492,-7.974630416,10,0.8394347806,3.7774565126,-7.135195635
18,77,2001,388,313,149,1716,11,75,160,208,31936,12.188992209,9.8328725811,4.6808243277,-27,0.3455642121,2.356119628,5.0263885398
18,77,2002,341,289,-1,1679,8,52,7,27,31963,10.673093476,9.0455249691,-0.031299394,-32,0.2503951549,1.6275685065,0.2190957605
18,77,2003,350,312,-65,1658,4,38,-61,-66,31897,10.961478234,9.7713748826,-2.035703101,-43,0.125274037,1.1901033511,-1.910429064
18,77,2004,370,272,62,1588,8,98,70,148,32045,11.57298802,8.5077101123,1.9392574521,-20,0.250226768,3.0652779081,2.1894842201
18,77,2005,387,331,193,1698,6,56,199,230,32275,12.03358209,10.292288557,6.0012437811,-25,0.1865671642,1.7412935323,6.1878109453
18,77,2006,348,289,226,1767,8,59,234,277,32552,10.736267296,8.9160380706,6.9724034739,-16,0.2468107424,1.8202292255,7.2192142163
18,77,2007,384,328,-13,1827,6,56,-7,39,32591,11.78944783,10.070153355,-0.399121932,-10,0.1842101223,1.7192944752,-0.214911809
18,77,2008,387,326,163,1827,6,61,169,229,32820,11.832872147,9.9677424286,4.9838712143,-1,0.1834553821,1.8651297182,5.1673265964
18,79,2001,405,236,32,530,7,169,39,181,27873,14.577521821,8.4945559255,1.1518041933,-27,0.2519571673,6.0829658958,1.4037613606
18,79,2002,390,254,39,530,6,136,45,155,28028,13.953238761,9.0874939625,1.3953238761,-26,0.2146652117,4.8657447988,1.6099890879
18,79,2003,364,262,-270,530,6,102,-264,-184,27844,13.02978236,9.3785796105,-9.664948454,-22,0.2147766323,3.6512027491,-9.450171821
18,79,2004,412,244,-18,530,6,168,-12,138,27982,14.760147601,8.7414466378,-0.644860818,-18,0.2149536058,6.0187009637,-0.429907212
18,79,2005,414,210,-106,530,6,204,-100,78,28060,14.774633311,7.4943792156,-3.782877128,-26,0.2141251204,7.2802540951,-3.568752007
18,79,2006,361,220,-265,530,7,141,-258,-129,27931,12.894929542,7.8584058152,-9.465807005,-12,0.250040185,5.036523727,-9.21576682
18,79,2007,408,255,-15,530,6,153,-9,146,28077,14.569347236,9.1058420226,-0.535637766,2,0.2142551064,5.4635052135,-0.32138266
18,79,2008,387,243,-201,530,5,144,-196,-37,28040,13.792611864,8.6604772172,-7.163604612,15,0.1781991197,5.1321346473,-6.985405492
18,81,2001,1625,962,1806,3656,93,663,1899,2795,118733,13.849176081,8.1987122397,15.391761232,233,0.7925990003,5.6504638409,16.184360232
18,81,2002,1698,991,2114,3643,84,707,2198,3121,121854,14.115475899,8.238184108,17.573684364,216,0.6982920939,5.8772917905,18.271976458
18,81,2003,1633,972,1222,3704,69,661,1291,2114,123968,13.286036238,7.9081611898,9.9421532654,162,0.5613818129,5.3778750478,10.503535078
18,81,2004,1730,1052,1419,3714,78,678,1497,2392,126360,13.821865712,8.4049726758,11.337125691,217,0.6231823847,5.4168930363,11.960308076
18,81,2005,1729,1135,1980,3763,76,594,2056,2889,129249,13.528475132,8.8807514602,15.492412239,239,0.5946582476,4.6477236717,16.087070487
18,81,2006,1735,1003,2514,3678,79,732,2593,3326,132575,13.253177707,7.661635297,19.203739917,1,0.603458812,5.5915424102,19.807198729
18,81,2007,1899,1078,2555,3835,72,821,2627,3457,136032,14.139616615,8.0265964774,19.024076067,9,0.5360992081,6.1130201372,19.560175275
18,81,2008,1944,1086,2197,3835,72,858,2269,3126,139158,14.128420364,7.8927286602,15.967149969,-1,0.5232748283,6.2356917039,16.490424797
18,83,2001,418,460,-316,2603,36,-42,-280,-353,38841,10.713141539,11.789581598,-8.098929967,-31,0.9226629077,-1.076440059,-7.17626706
18,83,2002,451,428,-101,2643,34,23,-67,-77,38764,11.622962438,11.030217125,-2.602925069,-33,0.8762322015,0.5927453128,-1.726692868
18,83,2003,433,455,-325,2390,29,-22,-296,-350,38414,11.220814222,11.790924875,-8.422089196,-32,0.7515094975,-0.570110653,-7.670579699
18,83,2004,446,471,7,2395,33,-25,40,-11,38403,11.612012966,12.262910554,0.1822513246,-26,0.8591848159,-0.650897588,1.0414361404
18,83,2005,453,464,-232,2360,32,-11,-200,-244,38159,11.833546668,12.120895483,-6.060447742,-33,0.8359238264,-0.287348815,-5.224523915
18,83,2006,507,452,-193,2291,34,55,-159,-121,38038,13.307610536,11.863984146,-5.065816239,-17,0.8924235862,1.4436263895,-4.173392653
18,83,2007,498,469,-119,2334,28,29,-91,-56,37982,13.101815312,12.338858195,-3.130755064,6,0.7366482505,0.7629571165,-2.394106814
18,83,2008,474,451,1,2334,28,23,29,75,38057,12.467286524,11.862333802,0.0263022922,23,0.7364641829,0.6049527216,0.7627664751
18,85,2001,1227,579,-196,1444,131,648,-65,513,74725,16.476765344,7.7750995387,-2.631985336,-70,1.7591330563,8.701665805,-0.87285228
18,85,2002,1054,598,-547,1406,125,456,-422,-24,74701,14.107317334,8.0039618273,-7.321349698,-58,1.6730689438,6.1033555071,-5.648280754
18,85,2003,1068,603,-311,1407,99,465,-212,164,74865,14.281320621,8.0633299012,-4.15869917,-89,1.3238302823,6.2179907198,-2.834868887
18,85,2004,1082,609,-348,1404,99,473,-249,167,75032,14.436579785,8.1255795646,-4.643188323,-57,1.3209070228,6.3110002202,-3.3222813
18,85,2005,1075,644,-105,1404,102,431,-3,358,75390,14.293122017,8.5625772826,-1.396072383,-70,1.3561846007,5.7305447341,-0.039887782
18,85,2006,1098,631,-193,1400,104,467,-89,340,75730,14.531498147,8.3509793542,-2.554261514,-38,1.3763896241,6.180518793,-1.17787189
18,85,2007,1137,593,-272,1429,92,544,-180,343,76073,14.979941108,7.8127573236,-3.583591892,-21,1.2120972576,7.1671837842,-2.371494634
18,85,2008,1102,595,-374,1429,92,507,-282,202,76275,14.466878462,7.8110641426,-4.909811747,-23,1.2077611784,6.6558143198,-3.702050568
18,87,2001,731,193,-133,205,47,538,-86,420,35367,20.792445317,5.489660665,-3.783030406,-32,1.3368603692,15.302784652,-2.446170037
18,87,2002,696,212,-345,205,46,484,-299,156,35523,19.636055861,5.981097475,-9.733389759,-29,1.2977853012,13.654958386,-8.435604458
18,87,2003,706,237,-234,205,37,469,-197,231,35754,19.810036898,6.6501115367,-6.56593291,-41,1.0382030669,13.159925362,-5.527729843
18,87,2004,723,223,-205,205,35,500,-170,301,36055,20.136751661,6.2109206367,-5.70959072,-29,0.9748081717,13.925831024,-4.734782548
18,87,2005,733,224,-261,205,37,509,-224,252,36307,20.259252094,6.1910947735,-7.213730964,-33,1.0226361903,14.06815732,-6.191094773
18,87,2006,764,211,-222,205,40,553,-182,354,36661,20.940686328,5.783357088,-6.084859116,-17,1.096371012,15.15732924,-4.988488104
18,87,2007,691,235,-219,205,26,456,-193,265,36926,18.780491119,6.3869977034,-5.952138285,2,0.7066465544,12.393493416,-5.245491731
18,87,2008,739,238,-280,205,25,501,-255,246,37172,19.946557262,6.4239250722,-7.557558908,0,0.6747820454,13.52263219,-6.882776863
18,89,2001,7073,4714,-2867,5624,647,2359,-2220,-310,484179,14.603558701,9.7329528796,-5.919468796,-449,1.3358550091,4.8706058216,-4.583613787
18,89,2002,6777,4865,-2347,5622,603,1912,-1744,-243,483936,14.000402845,10.050458881,-4.848597532,-411,1.245719775,3.9499439633,-3.602877757
18,89,2003,6903,4810,-1488,5595,511,2093,-977,469,484405,14.25737421,9.9345168696,-3.073297526,-647,1.0554133306,4.3228573405,-2.017884196
18,89,2004,7072,4864,-812,5608,493,2208,-319,1567,485972,14.57577828,10.024969677,-1.673576352,-322,1.0160999282,4.5508086033,-0.657476424
18,89,2005,6873,4691,-527,5608,509,2182,-18,1720,487692,14.117806553,9.6357675749,-1.082508956,-444,1.0455352154,4.4820389785,-0.03697374
18,89,2006,6888,4708,-908,5616,535,2180,-373,1577,489269,14.100869943,9.6380510583,-1.85882548,-230,1.0952330748,4.4628188843,-0.763592405
18,89,2007,7001,4643,-793,5616,477,2358,-316,1969,491238,14.280367198,9.4706106127,-1.617530522,-73,0.9729660268,4.8097565851,-0.644564496
18,89,2008,7118,4710,-318,5616,478,2408,160,2562,493800,14.45223433,9.5630828455,-0.64566037,-6,0.9705209342,4.8891514845,0.3248605638
18,91,2001,1442,1072,-474,6529,95,370,-379,-109,110049,13.096768041,9.7362935783,-4.305040258,-100,0.8628245242,3.3604744627,-3.442215733
18,91,2002,1386,1013,-1004,6266,89,373,-915,-625,109424,12.630255202,9.2312038383,-9.149189194,-83,0.8110337035,3.3990513639,-8.338155491
18,91,2003,1305,1046,-922,6116,79,259,-843,-681,108743,11.963312508,9.5889845852,-8.452240715,-97,0.724215853,2.3743279231,-7.728024862
18,91,2004,1351,1067,-440,6189,77,284,-363,-162,108581,12.433049272,9.8194400987,-4.049253649,-83,0.7086193886,2.6136091734,-3.34063426
18,91,2005,1326,1048,314,6326,79,278,393,564,109145,12.180446984,9.6267786116,2.8843592405,-107,0.7256827389,2.5536683722,3.6100419794
18,91,2006,1382,1076,-316,6161,81,306,-235,22,109167,12.660779068,9.8574517205,-2.894939353,-49,0.7420572392,2.803327348,-2.152882114
18,91,2007,1354,1052,703,6807,72,302,775,1107,110274,12.340446863,9.5879985964,6.4071891761,30,0.6562128317,2.7524482663,7.0634020078
18,91,2008,1366,1052,182,6807,72,314,254,614,110888,12.352935857,9.5133883759,1.6458523616,46,0.6511064288,2.839547481,2.2969587904
18,93,2001,606,491,-73,737,13,115,-60,11,45936,13.193847226,10.690064336,-1.589357834,-44,0.2830363266,2.5037828894,-1.306321507
18,93,2002,552,478,-18,739,11,74,-7,23,45959,12.013711301,10.40317754,-0.391751455,-44,0.2394036672,1.6105337614,-0.152347788
18,93,2003,552,438,6,747,8,114,14,60,46019,12.002870252,9.5240166127,0.130465981,-68,0.1739546413,2.4788536389,0.3044206223
18,93,2004,525,533,-99,739,13,-8,-86,-127,45892,11.424095048,11.598176497,-2.154257923,-33,0.2828823536,-0.174081448,-1.87137557
18,93,2005,553,514,64,739,11,39,75,70,45962,12.040847432,11.191673743,1.3935157968,-44,0.2395105276,0.8491736887,1.6330263244
18,93,2006,543,464,-168,738,13,79,-155,-96,45866,11.826458161,10.105850068,-3.65901468,-20,0.2831380407,1.7206080934,-3.375876639
18,93,2007,530,510,76,738,10,20,86,119,45985,11.540429609,11.104941699,1.6548540571,13,0.2177439549,0.4354879098,1.872598012
18,93,2008,538,481,-160,738,10,57,-150,-72,45913,11.708633485,10.468127707,-3.482121483,21,0.2176325927,1.2405057781,-3.26448889
18,95,2001,1641,1506,-388,5821,91,135,-297,-286,132992,12.325834679,11.311826342,-2.914335073,-124,0.6835167311,1.0140083374,-2.230818342
18,95,2002,1696,1498,-708,5939,86,198,-622,-534,132458,12.778300998,11.286494632,-5.334337917,-110,0.6479563006,1.4918063665,-4.686381616
18,95,2003,1566,1395,-931,6203,68,171,-863,-831,131627,11.859817862,10.564780279,-7.050760172,-139,0.5149857054,1.2950375826,-6.535774467
18,95,2004,1659,1458,-597,6328,69,201,-528,-429,131198,12.624369828,11.094834966,-4.542946828,-102,0.5250642062,1.5295348616,-4.017882622
18,95,2005,1584,1486,-649,5973,70,98,-579,-595,130603,12.100794115,11.352133873,-4.957964255,-114,0.5347573157,0.7486602419,-4.42320694
18,95,2006,1648,1386,135,6263,74,262,209,409,131012,12.598665979,10.595722722,1.0320509145,-62,0.5657167976,2.0029432563,1.5977677121
18,95,2007,1627,1450,-125,6352,63,177,-62,145,131157,12.411841217,11.061567157,-0.953583376,30,0.4806060213,1.3502740599,-0.472977354
18,95,2008,1649,1455,1,6352,63,194,64,344,131501,12.556251856,11.079045755,0.0076144644,86,0.4797112595,1.4772061007,0.4873257239
18,97,2001,14574,7813,-4613,18666,2576,6761,-2037,3947,864855,16.889920574,9.0545457285,-5.346041142,-777,2.9853461918,7.8353748458,-2.360694951
18,97,2002,14470,7570,-9182,18453,2382,6900,-6800,-503,864352,16.73599517,8.7554584269,-10.61989687,-603,2.7550200757,7.9805367431,-7.86487679
18,97,2003,14568,7388,-7625,18436,2047,7180,-5578,819,865171,16.846263392,8.5433960693,-8.817460074,-783,2.3671266586,8.3028673224,-6.450333416
18,97,2004,14978,7655,-7754,19113,1957,7323,-5797,758,865929,17.304604009,8.8440875744,-8.958465715,-768,2.2609901219,8.4605164346,-6.697475594
18,97,2005,14709,7586,-6795,19257,1996,7123,-4799,1547,867476,16.971221382,8.752715032,-7.840060459,-777,2.3029817036,8.2185063502,-5.537078755
18,97,2006,15027,7389,-4675,19590,2035,7638,-2640,4593,872069,17.276931611,8.4953249269,-5.374968742,-405,2.3396922759,8.7816066845,-3.035276466
18,97,2007,15137,7358,-5578,19529,1850,7779,-3728,4075,876144,17.317111816,8.4177385708,-6.381373437,24,2.1164469089,8.8993732457,-4.264926528
18,97,2008,14691,7353,-5040,19529,1855,7338,-3185,4236,880380,16.727354707,8.3722169467,-5.738606475,83,2.1121259943,8.3551377607,-3.626480481
18,99,2001,732,415,-160,690,141,317,-19,256,45500,16.133298069,9.1466102442,-3.52640395,-42,3.1076434806,6.9866878251,-0.418760469
18,99,2002,639,380,-420,690,137,259,-283,-56,45444,14.0526038,8.3567909923,-9.236453202,-32,3.0128430683,5.6958128079,-6.223610134
18,99,2003,673,415,29,690,121,258,150,342,45786,14.753918667,9.0978844678,0.6357557821,-66,2.6526361942,5.6560341993,3.2883919763
18,99,2004,705,433,-33,687,113,272,80,322,46108,15.343765643,9.4239014517,-0.718218817,-30,2.4593553442,5.9198641914,1.7411365269
18,99,2005,637,398,-104,687,118,239,14,209,46317,13.78414931,8.612388423,-2.250473357,-44,2.5534216933,5.1717608872,0.3029483365
18,99,2006,726,421,-146,684,119,305,-27,256,46573,15.631391969,9.0644848746,-3.143503068,-22,2.562170309,6.5669070944,-0.581332759
18,99,2007,640,400,-389,684,110,240,-279,-27,46546,13.745852082,8.5911575511,-8.354900718,12,2.3625683265,5.1546945307,-5.992332392
18,99,2008,687,408,-239,684,109,279,-130,163,46709,14.733794435,8.7502010616,-5.125730524,14,2.337676264,5.983593373,-2.78805426
18,101,2001,133,108,-96,111,0,25,-96,-80,10279,12.888845818,10.466130439,-9.303227057,-9,0,2.4227153794,-9.303227057
18,101,2002,141,108,-24,113,-1,33,-25,-1,10278,13.717954955,10.507369752,-2.334971056,-9,-0.097290461,3.2105852021,-2.432261517
18,101,2003,122,119,-65,109,-2,3,-67,-73,10205,11.912317532,11.619391691,-6.346726554,-9,-0.195283894,0.2929258409,-6.542010448
18,101,2004,118,85,-9,111,1,33,-8,18,10223,11.552770707,8.3219111024,-0.881143528,-7,0.0979048365,3.2308596045,-0.783238692
18,101,2005,131,125,-70,109,-1,6,-71,-74,10149,12.860789319,12.271745533,-6.872177499,-9,-0.098173964,0.5890437856,-6.970351463
18,101,2006,134,108,-36,111,0,26,-36,-14,10135,13.212384145,10.648787221,-3.54959574,-4,0,2.5635969237,-3.54959574
18,101,2007,116,111,-105,111,0,5,-105,-99,10036,11.5016608,11.005899559,-10.41098607,1,0,0.4957612414,-10.41098607
18,101,2008,119,109,-74,111,-1,10,-75,-67,9969,11.897025744,10.897275681,-7.398150462,-2,-0.099975006,0.9997500625,-7.498125469
18,103,2001,498,323,37,1631,4,175,41,178,36338,13.738310022,8.910590637,1.0207178129,-38,0.1103478717,4.8277193854,1.1310656846
18,103,2002,456,328,321,2110,3,128,324,426,36764,12.475718859,8.9737626878,8.7822494597,-26,0.0820770978,3.5019561708,8.8643265574
18,103,2003,422,311,16,2508,-1,111,15,75,36839,11.466923903,8.4507424969,0.4347648873,-51,-0.027172805,3.0161814056,0.4075920818
18,103,2004,460,325,-373,2498,6,135,-367,-266,36573,12.532011115,8.854138288,-10.1618264,-34,0.1634610145,3.6778728273,-9.99836539
18,103,2005,458,335,112,3088,3,123,115,207,36780,12.487560154,9.1339140867,3.0537265006,-31,0.0817962456,3.3536460676,3.1355227462
18,103,2006,472,319,13,3244,5,153,18,152,36932,12.806598654,8.6553071413,0.3527241155,-19,0.1356631213,4.1512915129,0.4883872368
18,103,2007,432,347,-381,3300,3,85,-378,-290,36642,11.743278876,9.4326800228,-10.35691956,3,0.0815505477,2.3105988529,-10.27536902
18,103,2008,432,320,-532,3300,3,112,-529,-423,36219,11.858195743,8.7838486982,-14.60314846,-6,0.0823485815,3.0743470444,-14.52079988
18,105,2001,1259,738,-716,13936,483,521,-233,184,120934,10.418563082,6.107148177,-5.925092269,-104,3.9969547012,4.3114149054,-1.928137568
18,105,2002,1241,758,-522,14037,446,483,-76,303,121237,10.248956316,6.2600393937,-4.311003382,-104,3.6833477171,3.9889169223,-0.627655665
18,105,2003,1206,760,462,13795,399,446,861,1158,122395,9.9001773166,6.238917712,3.7926052407,-149,3.2754317988,3.6612596046,7.0680370395
18,105,2004,1298,734,301,13782,379,564,680,1159,123554,10.555033767,5.9687170918,2.4476619136,-85,3.0819397517,4.5863166754,5.5296016654
18,105,2005,1269,743,191,13733,388,526,579,991,124545,10.229787303,5.9895444964,1.5397079392,-114,3.127783667,4.2402428063,4.6674916062
18,105,2006,1292,747,927,13725,395,545,1322,1803,126348,10.299211218,5.9547297055,7.3896043333,-64,3.1487526555,4.344481512,10.538356989
18,105,2007,1383,784,326,13722,357,599,683,1277,127625,10.890921476,6.1738846255,2.5672020254,-5,2.8113224634,4.7170368504,5.3785244888
18,105,2008,1451,804,326,13722,357,647,683,1367,128992,11.30868181,6.2661476052,2.5407513922,37,2.7823565859,5.0425342047,5.323107978
18,107,2001,477,391,61,1222,54,86,115,164,37764,12.658563771,10.37630699,1.6188100419,-37,1.4330449552,2.2822567804,3.0518549971
18,107,2002,509,364,-203,1245,50,145,-153,-37,37727,13.485051198,9.6435336663,-5.378124545,-29,1.3246612179,3.8415175319,-4.053463327
18,107,2003,445,345,-373,1219,41,100,-332,-260,37467,11.836050749,9.1762640636,-9.921004335,-28,1.0905125409,2.6597866851,-8.830491795
18,107,2004,477,384,-23,1191,41,93,18,84,37551,12.716947932,10.23754299,-0.613186169,-27,1.0930709963,2.4794049428,0.4798848276
18,107,2005,485,362,106,1188,40,123,146,232,37783,12.875992248,9.61053442,2.8141343882,-37,1.061937505,3.2654578278,3.8760718932
18,107,2006,466,348,-302,1176,41,118,-261,-158,37625,12.35943136,9.2297899427,-8.009760238,-15,1.0874177806,3.1296414174,-6.922342457
18,107,2007,457,380,11,1176,37,77,48,126,37751,12.12587561,10.082784971,0.2918700913,1,0.9817448525,2.0430906389,1.2736149437
18,107,2008,493,363,-136,1176,36,130,-100,54,37805,13.049923236,9.6087670073,-3.599978824,24,0.952935571,3.4411562285,-2.647043253
18,109,2001,937,547,-53,741,14,390,-39,285,67171,13.979128281,8.1607077586,-0.79070843,-66,0.2088663777,5.8184205226,-0.581842052
18,109,2002,871,533,316,752,13,338,329,607,67778,12.908580278,7.8992804689,4.6832507095,-60,0.1926653773,5.0092998096,4.8759160868
18,109,2003,890,579,396,736,7,311,403,643,68421,13.069112108,8.502265068,5.8150206683,-71,0.1027907694,4.56684704,5.9178114377
18,109,2004,881,563,33,731,12,318,45,319,68740,12.846217219,8.2093306406,0.4811863431,-44,0.174976852,4.6368865785,0.6561631951
18,109,2005,854,562,198,731,10,292,208,434,69174,12.384529489,8.1500065258,2.8713546123,-66,0.1450179097,4.2345229636,3.016372522
18,109,2006,865,527,36,706,11,338,47,352,69526,12.47296323,7.5991348234,0.5191059841,-33,0.1586157174,4.8738284066,0.6777217015
18,109,2007,874,591,-73,706,9,283,-64,229,69755,12.550168365,8.4864410795,-1.048240607,10,0.1292351433,4.0637272851,-0.919005464
18,109,2008,883,567,579,706,9,316,588,913,70668,12.57628736,8.075600151,8.2465123235,9,0.1281841294,4.5006872094,8.3746964529
18,111,2001,158,148,-237,188,13,10,-224,-223,14319,10.949031565,10.256054884,-16.42354735,-9,0.9008696857,0.6929766813,-15.52267766
18,111,2002,168,131,-113,190,13,37,-100,-74,14245,11.763058395,9.1723848201,-7.912057135,-11,0.9102366615,2.5906735751,-7.001820473
18,111,2003,154,147,33,191,12,7,45,33,14278,10.798303124,10.307471164,2.313922098,-19,0.8414262174,0.4908319602,3.1553483154
18,111,2004,144,154,-106,189,11,-10,-95,-117,14161,10.126938359,10.830197968,-7.454551848,-12,0.7735855691,-0.703259608,-6.680966279
18,111,2005,142,165,59,189,12,-23,71,35,14196,10.015163804,11.637338223,4.1612300314,-13,0.8463518708,-1.622174419,5.0075819022
18,111,2006,120,139,-196,187,12,-19,-184,-208,13988,8.5154697701,9.8637524837,-13.90860062,-5,0.851546977,-1.348282714,-13.05705365
18,111,2007,153,146,-3,187,12,7,9,16,14004,10.93169477,10.431551872,-0.214346956,0,0.8573878251,0.500142898,0.6430408688
18,111,2008,146,143,-84,187,11,3,-73,-71,13933,10.452088628,10.237319684,-6.013530443,-1,0.7874861295,0.2147689444,-5.226044314
18,113,2001,776,384,-7,662,168,392,161,507,46965,16.612611455,8.2206737099,-0.149856031,-46,3.5965447481,8.3919377455,3.4466887169
18,113,2002,650,355,-625,666,161,295,-464,-195,46770,13.868885688,7.5745452606,-13.33546701,-26,3.4352163013,6.2943404278,-9.900250707
18,113,2003,689,383,-382,655,135,306,-247,17,46787,14.728988745,8.1875220454,-8.166144703,-42,2.8859411909,6.5414666994,-5.280203512
18,113,2004,715,424,-254,681,127,291,-127,127,46914,15.261309911,9.0500634999,-5.421500304,-37,2.7107501521,6.2112464115,-2.710750152
18,113,2005,699,399,-90,683,130,300,40,297,47211,14.852589641,8.4780876494,-1.912350598,-43,2.7622841965,6.374501992,0.8499335989
18,113,2006,698,364,-246,690,130,334,-116,197,47408,14.753907778,7.6940149441,-5.199801308,-21,2.7478624801,7.0598928334,-2.451938828
18,113,2007,762,393,-460,699,123,369,-337,43,47451,16.065950516,8.2859823528,-9.698605298,11,2.5933227211,7.7799681633,-7.105282577
18,113,2008,697,391,-296,699,122,306,-174,150,47601,14.665656693,8.2270757059,-6.228169844,18,2.5670159492,6.4385809872,-3.661153895
18,115,2001,67,48,17,46,0,19,17,30,5666,11.856308618,8.4940718457,3.008317112,-6,0,3.3622367723,3.008317112
18,115,2002,59,60,80,46,-1,-1,79,73,5739,10.346339325,10.521701008,14.028934678,-5,-0.175361683,-0.175361683,13.853572994
18,115,2003,68,51,1,46,-1,17,0,11,5750,11.837409696,8.8780572722,0.1740795544,-6,-0.174079554,2.9593524241,0
18,115,2004,66,69,65,46,0,-3,65,56,5806,11.422637591,11.94184839,11.249567324,-6,0,-0.5192108,11.249567324
18,115,2005,64,49,29,46,-1,15,28,40,5846,10.985238586,8.4105732921,4.9776862341,-3,-0.171644353,2.5746652935,4.8060418812
18,115,2006,54,55,-19,46,0,-1,-19,-23,5823,9.2552917988,9.4266860914,-3.256491559,-3,0,-0.171394293,-3.256491559
18,115,2007,68,39,-83,46,0,29,-83,-66,5757,11.744386874,6.7357512953,-14.33506045,-12,0,5.0086355786,-14.33506045
18,115,2008,63,44,12,46,-1,19,11,16,5773,10.928013877,7.63226366,2.0815264527,-14,-0.173460538,3.2957502168,1.908065915
18,117,2001,283,224,-29,314,12,59,-17,24,19344,14.638940617,11.587006,-1.500103455,-18,0.6207324643,3.0519346162,-0.879370991
18,117,2002,258,219,-2,314,12,39,10,31,19375,13.326790465,11.312275627,-0.103308453,-18,0.6198507193,2.0145148377,0.5165422661
18,117,2003,229,215,133,314,12,14,145,135,19510,11.778320689,11.058248682,6.8406840684,-24,0.6172045776,0.7200720072,7.457888646
18,117,2004,249,190,-83,314,9,59,-74,-30,19480,12.772505771,9.7460887407,-4.257501924,-15,0.4616568351,3.02641703,-3.795845088
18,117,2005,241,233,79,314,12,8,91,81,19561,12.345995236,11.936169668,4.0470274839,-18,0.614738352,0.409825568,4.6617658359
18,117,2006,249,203,-138,314,10,46,-128,-91,19470,12.759088929,10.401988163,-7.071302298,-9,0.51241321,2.3571007661,-6.558889088
18,117,2007,243,210,62,314,10,33,72,111,19581,12.445263886,10.755166321,3.1753348186,6,0.5121507772,1.6900975647,3.6874855958
18,117,2008,248,208,-72,314,9,40,-63,-10,19571,12.668573764,10.625255415,-3.677973028,13,0.4597466285,2.043318349,-3.2182264
18,119,2001,254,192,149,287,2,62,151,194,22066,11.561746097,8.7395876007,6.7822841276,-19,0.0910373708,2.8221584961,6.8733214985
18,119,2002,251,207,173,287,1,44,174,201,22267,11.323393409,9.3384160783,7.8045699592,-17,0.0451131212,1.9849773307,7.8496830803
18,119,2003,239,220,302,287,0,19,302,306,22573,10.660124888,9.8126672614,13.470115968,-15,0,0.8474576271,13.470115968
18,119,2004,251,241,-54,287,3,10,-51,-56,22517,11.133288978,10.689731648,-2.395209581,-15,0.1330671989,0.4435573298,-2.262142382
18,119,2005,254,224,-161,287,1,30,-160,-150,22367,11.318064344,9.9812850905,-7.174048659,-20,0.0445593084,1.3367792532,-7.12948935
18,119,2006,239,188,-110,287,2,51,-108,-67,22300,10.701412676,8.417847628,-4.925336378,-10,0.0895515705,2.283565048,-4.835784808
18,119,2007,237,244,53,287,2,-7,55,53,22353,10.615188229,10.928716995,2.3738606589,5,0.0895796475,-0.313528766,2.4634403064
18,119,2008,240,223,-3,287,1,17,-2,22,22375,10.731532821,9.9713825791,-0.13414416,7,0.0447147201,0.7601502415,-0.08942944
18,121,2001,191,177,22,1274,0,14,22,19,17236,11.087568572,10.27486721,1.2771021391,-17,0,0.8127013613,1.2771021391
18,121,2002,157,156,54,1333,-1,1,53,39,17275,9.098548289,9.0405957521,3.1294369911,-15,-0.057952537,0.0579525369,3.0714844542
18,121,2003,182,153,213,1533,-2,29,211,233,17508,10.46488227,8.7974010292,12.247362217,-7,-0.114998706,1.6674812408,12.132363511
18,121,2004,186,169,-130,1537,1,17,-129,-126,17382,10.662080825,9.6875895672,-7.451991975,-14,0.0573230152,0.9744912582,-7.39466896
18,121,2005,171,156,-175,1427,-1,15,-176,-172,17210,9.8866790009,9.019426457,-10.11794635,-11,-0.057816836,0.8672525439,-10.17576318
18,121,2006,199,161,-103,1541,0,38,-103,-73,17137,11.587620462,9.3749090168,-5.997612601,-8,0,2.212711445,-5.997612601
18,121,2007,185,176,19,1556,0,9,19,19,17156,10.789373925,10.264485464,1.1080978625,-9,0,0.5248884612,1.1080978625
18,121,2008,198,150,-32,1556,-1,48,-33,-4,17152,11.542497377,8.7443161945,-1.865454121,-19,-0.058295441,2.7981811822,-1.923749563
18,123,2001,258,181,-98,1113,5,77,-93,-35,18845,13.677932406,9.5957587806,-5.195493704,-19,0.2650762094,4.0821736249,-4.930417495
18,123,2002,204,219,-18,1159,4,-15,-14,-49,18796,10.839244441,11.636247709,-0.956403921,-20,0.2125342047,-0.797003268,-0.743869717
18,123,2003,207,198,-12,1273,3,9,-9,-27,18769,11.020897112,10.541727672,-0.638892586,-27,0.1597231465,0.4791694396,-0.47916944
18,123,2004,223,192,104,1348,4,31,108,125,18894,11.841860712,10.195682766,5.522661498,-14,0.2124100576,1.6461779465,5.7350715556
18,123,2005,221,184,10,1515,4,37,14,35,18929,11.686011157,9.7295296513,0.5287787854,-16,0.2115115142,1.956481506,0.7402902996
18,123,2006,238,189,-169,1511,4,49,-165,-125,18804,12.614952429,10.017756341,-8.957676305,-9,0.2120160072,2.5971960883,-8.745660297
18,123,2007,233,209,112,1559,3,24,115,143,18947,12.344043866,11.072554369,5.9336176525,4,0.1589361871,1.271489497,6.0925538396
18,123,2008,237,196,-60,1559,2,41,-58,-18,18929,12.514521069,10.349561728,-3.168233182,-1,0.1056077727,2.164959341,-3.062625409
18,125,2001,154,134,7,172,2,20,9,16,12832,12.008733624,10.449157829,0.5458515284,-13,0.1559575795,1.5595757954,0.7018091079
18,125,2002,142,153,32,172,2,-11,34,11,12843,11.06134372,11.918208374,2.4926971762,-12,0.1557935735,-0.856864654,2.6484907498
18,125,2003,141,147,-61,172,0,-6,-61,-85,12758,11.015194719,11.483926409,-4.76543885,-18,0,-0.46873169,-4.76543885
18,125,2004,153,145,11,172,1,8,12,12,12770,11.986837982,11.360075212,0.8617988092,-8,0.0783453463,0.6267627703,0.9401441554
18,125,2005,153,142,-237,172,1,11,-236,-232,12538,12.091038407,11.221748064,-18.72925557,-7,0.0790263948,0.869290343,-18.65022918
18,125,2006,164,135,59,172,1,29,60,81,12619,13.038120603,10.732599277,4.6905433875,-8,0.0795007354,2.3055213261,4.7700441229
18,125,2007,155,146,-36,172,1,9,-35,-30,12589,12.297683275,11.583624246,-2.856236116,-4,0.0793398921,0.7140590289,-2.776896223
18,125,2008,153,150,-12,172,0,3,-12,-20,12569,12.163129025,11.924636299,-0.953970904,-11,0,0.238492726,-0.953970904
18,127,2001,1880,1154,463,3501,155,726,618,1207,148362,12.723464302,7.8100413851,3.1334914743,-137,1.0490090249,4.9134229164,4.1825004991
18,127,2002,1837,1104,816,3541,144,733,960,1565,149927,12.316914134,7.4022173127,5.4712041007,-128,0.965506606,4.9146968209,6.4367107067
18,127,2003,1782,1160,1018,3584,116,622,1134,1594,151521,11.822934635,7.6961864069,6.7540670364,-162,0.7696186407,4.1267482286,7.5236856771
18,127,2004,1907,1239,1239,3642,120,668,1359,1898,153419,12.507378501,8.1261887584,8.1261887584,-129,0.7870400735,4.3811897422,8.9132288319
18,127,2005,1765,1176,1701,3642,121,589,1822,2271,155690,11.419919834,7.6089664164,11.005826424,-140,0.7828953541,3.8109534177,11.788721778
18,127,2006,1857,1210,1676,3647,126,647,1802,2369,158059,11.837487928,7.7131719942,10.68369939,-80,0.803189811,4.1243159341,11.486889201
18,127,2007,1883,1189,1376,3647,108,694,1484,2208,160267,11.83063903,7.4703291594,8.645225335,30,0.6785496629,4.360309871,9.323774998
18,127,2008,2000,1193,914,3647,108,807,1022,1914,162181,12.405100978,7.3996427331,5.6691311467,85,0.6698754528,5.0054582444,6.3390065995
18,129,2001,278,255,-129,274,9,23,-120,-126,26938,10.295914966,9.4440946632,-4.77760083,-29,0.3333209881,0.851820303,-4.444279841
18,129,2002,272,234,-40,273,7,38,-33,-20,26918,10.101010101,8.6898395722,-1.485442662,-25,0.2599524658,1.4111705288,-1.225490196
18,129,2003,248,209,-204,273,7,39,-197,-183,26735,9.2445902373,7.7908038693,-7.604421002,-25,0.2609360148,1.453786368,-7.343484987
18,129,2004,292,236,-106,270,8,56,-98,-62,26673,10.934691432,8.8376273217,-3.96944278,-20,0.2995805872,2.0970641102,-3.669862193
18,129,2005,244,236,-170,270,7,8,-163,-177,26496,9.178280577,8.877353345,-6.394703681,-22,0.263311328,0.300927232,-6.131392353
18,129,2006,244,237,-158,267,8,7,-150,-156,26340,9.2361268832,8.97115603,-5.980770687,-13,0.3028238322,0.2649708532,-5.677946854
18,129,2007,243,216,-159,267,8,27,-151,-132,26208,9.2486869148,8.2210550354,-6.051609957,-8,0.3044835198,1.0276318794,-5.747126437
18,129,2008,255,207,-172,267,7,48,-165,-129,26079,9.7538585117,7.9178380859,-6.579073192,-12,0.2677529788,1.8360204257,-6.311320213
18,131,2001,155,140,14,367,3,15,17,19,13758,11.273957159,10.182929047,1.0182929047,-13,0.2182056224,1.0910281122,1.2364985271
18,131,2002,144,125,-32,368,2,19,-30,-25,13733,10.476155833,9.0938852715,-2.32803463,-14,0.1455021643,1.3822705613,-2.182532465
18,131,2003,170,177,40,367,0,-7,40,15,13748,12.372184418,12.881627306,2.9111022161,-18,0,-0.509442888,2.9111022161
18,131,2004,174,174,33,369,3,0,36,26,13774,12.644429911,12.644429911,2.3980815348,-10,0.2180074123,0,2.616088947
18,131,2005,165,156,6,369,1,9,7,5,13779,11.976917214,11.323630821,0.4355242623,-11,0.0725873771,0.6532863935,0.5081116394
18,131,2006,168,164,-12,370,2,4,-10,-13,13766,12.198221093,11.907787257,-0.871301507,-7,0.1452169178,0.2904338355,-0.726084589
18,131,2007,170,170,-9,370,2,0,-7,-7,13759,12.352406903,12.352406903,-0.653950954,0,0.1453224342,0,-0.50862852
18,131,2008,173,155,-74,370,1,18,-73,-47,13712,12.595100288,11.284627425,-5.387499545,8,0.0728040479,1.3104728623,-5.314695497
18,133,2001,399,298,-18,4381,16,101,-2,64,36177,11.038871213,8.24457048,-0.49799419,-35,0.4426615023,2.7943007332,-0.055332688
18,133,2002,395,315,-43,4386,15,80,-28,16,36193,10.916125466,8.7052646124,-1.188337709,-36,0.4145364101,2.2108608539,-0.773801299
18,133,2003,406,315,377,4642,13,91,390,455,36648,11.147567991,8.6489751651,10.351313134,-26,0.3569418322,2.4985928255,10.708254966
18,133,2004,427,333,155,4960,13,94,168,232,36880,11.614623001,9.0577739093,4.2160809488,-30,0.3536067893,2.5568490915,4.569687738
18,133,2005,390,279,22,4902,13,111,35,116,36996,10.558232714,7.5531972494,0.5955926147,-30,0.3519410905,3.0050354648,0.9475337051
18,133,2006,387,309,-219,4836,13,78,-206,-144,36852,10.480987975,8.3685407865,-5.931101722,-16,0.3520745315,2.1124471888,-5.579027191
18,133,2007,397,306,195,4964,11,91,206,287,37139,10.731034856,8.2712762363,5.2709113271,-10,0.2973334595,2.4597586193,5.5682447865
18,133,2008,424,310,-63,4964,10,114,-53,44,37183,11.409811361,8.3420790614,-1.695325745,-17,0.2690993246,3.0677323,-1.42622642
18,135,2001,339,315,-272,319,15,24,-257,-251,27124,12.44059524,11.559845135,-9.981834529,-18,0.5504688159,0.8807501055,-9.431365713
18,135,2002,312,340,-200,314,14,-28,-186,-237,26887,11.553202125,12.590027957,-7.405898798,-23,0.5184129159,-1.036825832,-6.887485883
18,135,2003,338,296,-345,299,14,42,-331,-304,26583,12.642603329,11.071628951,-12.90443239,-15,0.5236581261,1.5709743782,-12.38077427
18,135,2004,304,265,-265,301,15,39,-250,-235,26348,11.486652434,10.013035839,-10.01303584,-24,0.5667756135,1.4736165952,-9.446260226
18,135,2005,313,285,-149,301,15,28,-134,-129,26219,11.908611867,10.843304735,-5.668955809,-23,0.5707002492,1.0653071319,-5.09825556
18,135,2006,288,288,-152,310,15,0,-137,-148,26071,11.015490534,11.015490534,-5.813731115,-11,0.5737234653,0,-5.24000765
18,135,2007,304,290,-303,310,11,14,-292,-277,25794,11.722741733,11.182878627,-11.68418008,1,0.4241781548,0.5398631061,-11.26000193
18,135,2008,299,271,-21,310,10,28,-11,7,25801,11.590270375,10.504893885,-0.814032367,-10,0.3876344607,1.08537649,-0.426397907
18,137,2001,412,207,155,358,6,205,161,342,26987,15.363961814,7.7192720764,5.7801312649,-24,0.2237470167,7.6446897375,6.0038782816
18,137,2002,373,226,23,358,5,147,28,147,27134,13.783928604,8.3516564735,0.8499473402,-28,0.1847711609,5.432272131,1.0347185011
18,137,2003,394,265,-61,358,1,129,-60,33,27167,14.511703284,9.7604095689,-2.246735788,-36,0.0368317342,4.7512937147,-2.209904053
18,137,2004,381,265,-17,358,4,116,-13,87,27254,14.001947778,9.7388875618,-0.624758825,-16,0.1470020764,4.2630602157,-0.477756748
18,137,2005,394,277,-60,358,2,117,-58,32,27286,14.448111478,10.157682435,-2.200220022,-27,0.0733406674,4.2904290429,-2.126879355
18,137,2006,400,277,-13,363,3,123,-10,101,27387,14.632451118,10.1329724,-0.475554661,-12,0.1097433834,4.4994787189,-0.365811278
18,137,2007,393,265,-212,363,3,128,-209,-79,27308,14.370600603,9.6900996435,-7.752079715,2,0.1096992412,4.6805009599,-7.642380474
18,137,2008,388,274,-22,363,2,114,-20,92,27400,14.184397163,10.016816553,-0.804269942,-2,0.0731154493,4.1675806098,-0.731154493
18,139,2001,267,197,-142,290,5,70,-137,-81,18125,14.698191627,10.844733148,-7.817015772,-14,0.2752470342,3.853458479,-7.541768737
18,139,2002,247,182,-203,292,5,65,-198,-145,17980,13.682315469,10.081706135,-11.24497992,-12,0.2769699488,3.6006093339,-10.96800997
18,139,2003,248,163,-57,295,5,85,-52,11,17991,13.788885491,9.0628561897,-3.169219649,-22,0.2780017236,4.7260293014,-2.891217926
18,139,2004,201,202,-238,299,4,-1,-234,-254,17737,11.251679355,11.307657859,-13.32288401,-19,0.223914017,-0.055978504,-13.09897
18,139,2005,211,185,-91,299,5,26,-86,-76,17661,11.92157749,10.452567942,-5.14153342,-16,0.2825018363,1.4690095486,-4.859031584
18,139,2006,209,174,-141,303,4,35,-137,-109,17552,11.870615966,9.8827137705,-8.008405986,-7,0.2271888223,1.9879021952,-7.781217164
18,139,2007,219,166,-98,303,3,53,-95,-40,17512,12.491444216,9.4684006388,-5.58977869,2,0.1711156742,3.0230435775,-5.418663016
18,139,2008,205,174,-254,303,2,31,-252,-215,17297,11.778563015,9.9974144618,-14.59392686,6,0.1149128099,1.7811485535,-14.47901405
18,141,2001,3895,2435,-2238,13344,647,1460,-1591,-357,265477,14.661845887,9.1660063503,-8.42444444,-226,2.4354850549,5.4958395365,-5.988959385
18,141,2002,3742,2433,-2161,13373,608,1309,-1553,-435,265042,14.106940562,9.1721502906,-8.146739325,-191,2.2920950993,4.9347902714,-5.854644226
18,141,2003,3744,2323,-2217,13407,534,1421,-1683,-511,264531,14.139693678,8.7731058796,-8.372783356,-249,2.0167191303,5.3665877981,-6.356064225
18,141,2004,3852,2471,-1862,13482,488,1381,-1374,-216,264315,14.567567874,9.3448754458,-7.041747503,-223,1.8455278096,5.2226924284,-5.196219693
18,141,2005,3793,2546,-1299,13464,518,1247,-781,217,264532,14.344413413,9.6284936853,-4.912573958,-249,1.9589786838,4.7159197273,-2.953595274
18,141,2006,3916,2422,-1214,13637,520,1494,-694,680,265212,14.784499683,9.1440393851,-4.583345918,-120,1.9632124196,5.6404602978,-2.620133498
18,141,2007,3928,2376,-1520,13656,472,1552,-1048,545,265757,14.795590703,8.9496750281,-5.725381331,41,1.7778815712,5.8459156749,-3.94749976
18,141,2008,3863,2337,-1158,13656,472,1526,-686,923,266680,14.510636939,8.7785033722,-4.3498104,83,1.772979714,5.732133567,-2.576830686
18,143,2001,316,232,173,208,2,84,175,236,23270,13.648928818,10.02073255,7.4723565999,-23,0.0863856254,3.6281962681,7.5587422253
18,143,2002,305,246,-49,208,2,59,-47,-11,23259,13.110103376,10.574050592,-2.106213329,-23,0.085967891,2.5360527843,-2.020245438
18,143,2003,327,248,144,208,1,79,145,200,23459,13.998886939,10.616892846,6.1646474592,-24,0.0428100518,3.3819940922,6.207457511
18,143,2004,285,216,-109,208,0,69,-109,-59,23400,12.164152031,9.2191468021,-4.652254636,-19,0,2.9450052285,-4.652254636
18,143,2005,296,262,188,208,1,34,189,203,23603,12.594940748,11.148224581,7.9994893943,-20,0.0425504755,1.4467161671,8.0420398698
18,143,2006,341,246,-56,208,0,95,-56,28,23631,14.438751747,10.4162256,-2.371173307,-11,0,4.0225261464,-2.371173307
18,143,2007,312,269,22,208,1,43,23,63,23694,13.185419968,11.368198627,0.9297411516,-3,0.0422609614,1.8172213418,0.972002113
18,143,2008,293,251,-122,208,0,42,-122,-67,23627,12.383508379,10.608397963,-5.156273113,13,0,1.7751104161,-5.156273113
18,145,2001,644,369,-32,690,72,275,40,271,43826,14.740046463,8.4457719642,-0.732424669,-44,1.6479555052,6.294274499,0.9155308362
18,145,2002,547,401,-370,678,68,146,-302,-187,43639,12.507860287,9.1693820385,-8.460527068,-31,1.5549076774,3.3384782484,-6.905619391
18,145,2003,572,371,-465,683,59,201,-406,-236,43403,13.143080352,8.5246202982,-10.68449714,-31,1.355667379,4.6184600538,-9.32882976
18,145,2004,553,391,-116,716,53,162,-63,66,43469,12.731374896,9.0017497007,-2.670595819,-33,1.2201860208,3.7296251957,-1.450409798
18,145,2005,538,421,-181,716,61,117,-120,-41,43428,12.382475805,9.6896325535,-4.165851525,-38,1.4039610113,2.6928432512,-2.761890514
18,145,2006,534,398,6,748,60,136,66,181,43609,12.270643519,9.1455358066,0.1378723991,-21,1.3787239909,3.1251077128,1.51659639
18,145,2007,536,396,101,748,49,140,150,297,43906,12.249328687,9.0498771639,2.3081757413,7,1.1198080329,3.1994515226,3.4279837742
18,145,2008,565,409,59,748,49,156,108,280,44186,12.827498524,9.2857467193,1.3395086955,16,1.1124733233,3.5417518049,2.4519820188
18,147,2001,273,172,-173,363,17,101,-156,-71,20343,13.396471772,8.4402679294,-8.489339255,-16,0.8342125279,4.9562038423,-7.655126727
18,147,2002,218,198,-175,363,17,20,-158,-152,20191,10.756402033,9.7695761583,-8.634726403,-14,0.8388019934,0.9868258746,-7.795924409
18,147,2003,218,202,-21,363,7,16,-14,-28,20163,10.804381226,10.011399118,-1.040789017,-30,0.3469296724,0.7929821083,-0.693859345
18,147,2004,254,187,-101,363,6,67,-95,-45,20118,12.611404881,9.2847744594,-5.014771232,-17,0.2979072019,3.3266304213,-4.71686403
18,147,2005,229,175,118,363,7,54,125,159,20277,11.338036886,8.6644386682,5.8423072162,-20,0.3465775467,2.6735982176,6.188884763
18,147,2006,216,167,-45,363,6,49,-39,2,20279,10.651938061,8.235526186,-2.219153763,-8,0.2958871684,2.4164118749,-1.923266594
18,147,2007,251,197,-64,363,7,54,-57,2,20281,12.376725838,9.7140039448,-3.15581854,5,0.3451676529,2.6627218935,-2.810650888
18,147,2008,237,196,-230,363,6,41,-224,-170,20111,11.734997029,9.7048920578,-11.38839374,13,0.2970885324,2.0301049713,-11.09130521
18,149,2001,335,285,-359,310,26,50,-333,-297,23227,14.331244251,12.192252572,-15.35796026,-14,1.1122756732,2.1389916793,-14.24568458
18,149,2002,304,265,117,310,25,39,142,153,23380,13.045250713,11.371682365,5.0207050443,-28,1.0728002231,1.6735683481,6.0935052674
18,149,2003,287,228,-80,310,17,59,-63,-36,23344,12.284907114,9.7594384042,-3.424364352,-32,0.7276774249,2.5254687099,-2.696686927
18,149,2004,281,254,-54,310,16,27,-38,-26,23318,12.044061549,10.886802966,-2.314517166,-15,0.685782864,1.157258583,-1.628734302
18,149,2005,292,267,57,310,18,25,75,80,23398,12.501070297,11.430773183,2.440277421,-20,0.7706139224,1.0702971145,3.2108913434
18,149,2006,281,283,68,310,18,-2,86,72,23470,11.991124008,12.076470086,2.9017666638,-12,0.7681147051,-0.085346078,3.669881369
18,149,2007,325,280,-34,310,15,45,-19,23,23493,13.840683091,11.924280817,-1.447948385,-3,0.638800758,1.9164022741,-0.809147627
18,149,2008,341,271,72,310,14,70,86,165,23658,14.46416831,11.4949842,3.0540179424,9,0.5938368221,2.9691841106,3.6478547645
18,151,2001,455,294,4,925,26,161,30,158,33472,13.625610158,8.8042404097,0.1197855838,-33,0.7786062947,4.8213697482,0.8983918785
18,151,2002,435,252,-313,925,24,183,-289,-130,33342,13.021223097,7.5433292424,-9.369293861,-24,0.7184123088,5.4778938546,-8.650881552
18,151,2003,433,256,51,921,20,177,71,200,33542,12.947790204,7.6550445548,1.5250284074,-48,0.5980503558,5.2927456492,2.1230787632
18,151,2004,383,283,-233,922,20,100,-213,-141,33401,11.442570545,8.4549542148,-6.96114605,-28,0.5975232661,2.9876163303,-6.363622784
18,151,2005,453,287,-27,922,19,166,-8,128,33529,13.536530704,8.576124309,-0.806813088,-30,0.5677573584,4.9604063947,-0.23905573
18,151,2006,402,257,-177,922,20,145,-157,-27,33502,11.994450329,7.668093867,-5.281138578,-15,0.5967388223,4.3263564619,-4.684399755
18,151,2007,409,280,-276,922,18,129,-258,-136,33366,12.23305617,8.3747083807,-8.25506969,-7,0.5383741102,3.8583477897,-7.716695579
18,151,2008,416,271,-147,922,17,145,-130,2,33368,12.467407918,8.121796985,-4.405550394,-13,0.5094854197,4.345610933,-3.896064974
18,153,2001,254,265,13,2251,2,-11,15,-17,21725,11.68702694,12.193158028,0.5981549221,-21,0.0920238342,-0.506131088,0.6901787563
18,153,2002,270,287,28,2265,1,-17,29,-8,21717,12.430366926,13.213019658,1.2890750886,-20,0.046038396,-0.782652732,1.3351134846
18,153,2003,248,250,2,2289,-3,-2,-1,-34,21683,11.428571429,11.520737327,0.0921658986,-31,-0.138248848,-0.092165899,-0.046082949
18,153,2004,257,257,-8,2334,1,0,-7,-21,21662,11.85834583,11.85834583,-0.369131388,-14,0.0461414235,0,-0.322989964
18,153,2005,217,217,-117,2328,-1,0,-118,-139,21523,10.049785805,10.049785805,-5.418548107,-21,-0.046312377,0,-5.464860484
18,153,2006,230,246,-141,2303,1,-16,-140,-164,21359,10.727111609,11.47334546,-6.576185812,-8,0.0466396157,-0.746233851,-6.529546197
18,153,2007,220,237,-7,2287,0,-17,-7,-19,21340,10.304690976,11.100962552,-0.327876531,5,0,-0.796271575,-0.327876531
18,153,2008,230,237,-16,2287,-1,-7,-17,-12,21328,10.780913096,11.109027843,-0.749976563,12,-0.046873535,-0.328114746,-0.796850098
18,155,2001,102,86,240,95,1,16,241,255,9349,11.061107195,9.3260315567,26.026134577,-2,0.1084422274,1.7350756385,26.134576804
18,155,2002,110,93,143,90,1,17,144,153,9502,11.67046841,9.866850565,15.171608933,-8,0.1060951674,1.8036178452,15.277704101
18,155,2003,105,99,-85,84,1,6,-84,-86,9416,11.100539169,10.466222645,-8.986150756,-8,0.1057194207,0.6343165239,-8.880431335
18,155,2004,117,91,35,84,0,26,35,53,9469,12.390786338,9.6372782632,3.7066454858,-8,0,2.7535080752,3.7066454858
18,155,2005,112,84,180,84,1,28,181,201,9670,11.703850776,8.7778880819,18.809760176,-8,0.1044986676,2.925962694,18.914258843
18,155,2006,107,83,-80,77,0,24,-80,-60,9610,11.099585062,8.6099585062,-8.298755187,-4,0,2.489626556,-8.298755187
18,155,2007,125,96,32,77,1,29,33,57,9667,12.96882295,9.9600560253,3.3200186751,-5,0.1037505836,3.0087669243,3.4237692587
18,155,2008,114,99,17,77,0,15,17,29,9696,11.77503486,10.225688168,1.7559262511,-3,0,1.5493466921,1.7559262511
18,157,2001,1990,1038,-476,15343,974,952,498,1307,150599,13.271488641,6.9225151805,-3.17448673,-143,6.4956934353,6.3489734604,3.3212067051
18,157,2002,1941,1020,-973,15193,910,921,-63,737,151336,12.857071886,6.756421084,-6.445095799,-121,6.0277874377,6.1006508023,-0.417308361
18,157,2003,1941,931,-610,14405,805,1010,195,1016,152352,12.782856089,6.1312926424,-4.017280894,-189,5.3014936382,6.6515634467,1.2842127447
18,157,2004,2071,1006,-438,14369,747,1065,309,1255,153607,13.537761596,6.5760445027,-2.86312872,-119,4.8830072003,6.9617170928,2.0198784804
18,157,2005,2053,1006,666,14438,775,1047,1441,2348,155955,13.2639019,6.4995057533,4.3028537094,-140,5.0070745117,6.7643961468,9.3099282212
18,157,2006,2189,1068,1707,14979,786,1121,2493,3525,159480,13.87924612,6.7716011223,10.823148985,-89,4.9835940844,7.1076449982,15.806743069
18,157,2007,2202,1065,752,14778,721,1137,1473,2584,162064,13.696414799,6.6242878113,4.6774313935,-26,4.4846117483,7.0721269873,9.1620431418
18,157,2008,2282,1045,195,14778,721,1237,916,2173,164237,13.987085544,6.4051290067,1.1952154606,20,4.4192325491,7.5819565371,5.6144480097
18,159,2001,200,175,-112,201,3,25,-109,-100,16458,12.115338018,10.600920766,-6.78458929,-16,0.1817300703,1.5144172522,-6.60285922
18,159,2002,183,156,-21,201,3,27,-18,-9,16449,11.122253624,9.4812653843,-1.276324186,-18,0.1823320266,1.6409882396,-1.09399216
18,159,2003,245,162,-127,201,3,83,-124,-58,16391,14.920828258,9.8660170524,-7.734470158,-17,0.1827040195,5.0548112058,-7.551766139
18,159,2004,200,168,-48,201,2,32,-46,-24,16367,12.210757678,10.257036449,-2.930581843,-10,0.1221075768,1.9537212284,-2.808474266
18,159,2005,189,164,-140,201,3,25,-137,-128,16239,11.592958351,10.059498252,-8.587376556,-16,0.1840152119,1.5334600994,-8.403361345
18,159,2006,184,158,-142,201,2,26,-140,-121,16118,11.373118645,9.7660475322,-8.777080694,-7,0.1236208548,1.6070711129,-8.653459839
18,159,2007,180,170,-111,201,3,10,-108,-91,16027,11.199253383,10.57707264,-6.906206253,7,0.1866542231,0.6221807435,-6.71955203
18,159,2008,195,155,-146,201,2,40,-144,-104,15923,12.20657277,9.7026604069,-9.139280125,0,0.1251956182,2.5039123631,-9.014084507
18,161,2001,76,63,-78,79,1,13,-77,-71,7269,10.404545143,8.6248203162,-10.67834896,-7,0.1369019098,1.7797248272,-10.54144705
18,161,2002,77,64,-11,79,0,13,-11,-6,7263,10.597302505,8.8081475365,-1.513900358,-8,0,1.7891549683,-1.513900358
18,161,2003,72,61,-135,79,-1,11,-136,-125,7138,9.9993056038,8.4716339143,-18.74869801,0,-0.138879244,1.5276716895,-18.88757725
18,161,2004,94,64,-76,79,2,30,-74,-50,7088,13.215239702,8.9976100098,-10.68466189,-6,0.2811753128,4.2176296921,-10.40348657
18,161,2005,91,78,26,79,0,13,26,34,7122,12.807881773,10.978184377,3.6593947924,-5,0,1.8296973962,3.6593947924
18,161,2006,98,69,12,79,1,29,13,38,7160,13.723568128,9.6625122532,1.6804369136,-4,0.1400364095,4.0610558745,1.8204733231
18,161,2007,90,52,-20,79,1,38,-19,17,7177,12.554927809,7.2539582897,-2.789983958,-2,0.1394991979,5.3009695194,-2.65048476
18,161,2008,99,70,-43,79,0,29,-43,-20,7157,13.813311009,9.766987582,-5.999720943,-6,0,4.0463234268,-5.999720943
18,163,2001,2355,1887,-431,7129,139,468,-292,20,171978,13.694408262,10.972971716,-2.506280238,-156,0.8082899144,2.7214365463,-1.697990324
18,163,2002,2238,1931,-69,7269,132,307,63,195,172173,13.005918914,11.22181833,-0.400986776,-175,0.767105137,1.7841005838,0.3661183608
18,163,2003,2330,1832,307,7437,106,498,413,666,172839,13.506776576,10.619920467,1.7796482441,-245,0.6144713807,2.8868561094,2.3941196248
18,163,2004,2361,1864,109,7582,105,497,214,599,173438,13.636481776,10.765947493,0.6295537965,-112,0.6064509049,2.8705342832,1.2360047014
18,163,2005,2467,1838,-385,7570,110,629,-275,185,173623,14.216521015,10.591797984,-2.218630154,-169,0.6338943298,3.6247230314,-1.584735825
18,163,2006,2446,1865,40,7437,112,581,152,651,174274,14.061633185,10.721564141,0.2299531183,-82,0.6438687313,3.3400690434,0.8738218496
18,163,2007,2475,1811,-318,7526,101,664,-217,495,174769,14.181633782,10.376944961,-1.822125068,48,0.5787252573,3.8046888206,-1.24339981
18,163,2008,2444,1840,-859,7526,101,604,-758,-40,174729,13.985773881,10.529387865,-4.915621835,114,0.5779718339,3.4563860165,-4.337650001
18,165,2001,191,217,-126,306,6,-26,-120,-159,16611,11.443635601,13.001407987,-7.549204637,-13,0.3594859351,-1.557772385,-7.189718702
18,165,2002,190,236,-56,306,5,-46,-51,-112,16499,11.476895198,14.25551193,-3.382663848,-15,0.3020235578,-2.778616732,-3.08064029
18,165,2003,206,242,-43,306,2,-36,-41,-99,16400,12.523176996,14.711693365,-2.614061218,-22,0.1215842427,-2.188516368,-2.492476975
18,165,2004,208,220,12,306,5,-12,17,-5,16395,12.684860497,13.416679372,0.7318188748,-10,0.3049245312,-0.731818875,1.036743406
18,165,2005,200,186,51,306,3,14,54,52,16447,12.179526216,11.326959381,3.1057791852,-16,0.1826928932,0.8525668352,3.2884720784
18,165,2006,196,218,15,306,4,-22,19,-11,16436,11.921053432,13.259130858,0.9123255177,-8,0.2432868047,-1.338077426,1.1556123225
18,165,2007,178,215,-20,306,3,-37,-17,-58,16378,10.849027854,13.104162857,-1.218991894,-4,0.1828487841,-2.255135003,-1.03614311
18,165,2008,211,230,-125,306,2,-19,-123,-144,16234,12.940022078,14.105237336,-7.665889856,-2,0.1226542377,-1.165215258,-7.543235619
18,167,2001,1298,1203,-548,8472,114,95,-434,-434,105302,12.301102171,11.400790379,-5.193377496,-95,1.0803741506,0.9003117922,-4.113003345
18,167,2002,1338,1218,-639,8130,102,120,-537,-498,104804,12.736428279,11.594147716,-6.082643999,-81,0.9709384787,1.1422805631,-5.11170552
18,167,2003,1276,1193,-78,8227,80,83,2,-63,104741,12.178768284,11.386575676,-0.744470162,-148,0.76355914,0.7921926078,0.0190889785
18,167,2004,1307,1208,-949,7808,95,99,-854,-851,103890,12.529298139,11.580254133,-9.097401633,-96,0.9106987936,0.9490440059,-8.186702839
18,167,2005,1272,1087,234,8432,89,185,323,419,104309,12.219078862,10.441932958,2.2478494133,-89,0.8549512726,1.7771459037,3.1028006859
18,167,2006,1362,1070,748,9162,94,292,842,1081,105390,12.99004764,10.205103506,7.1340349739,-53,0.8965231117,2.7849441342,8.0305580856
18,167,2007,1356,1119,79,9569,87,237,166,371,105761,12.84388897,10.599049969,0.7482796672,-32,0.8240548233,2.2448390015,1.5723344905
18,167,2008,1386,1108,-146,9569,87,278,-59,207,105968,13.092207492,10.466209164,-1.379121424,-12,0.8218052322,2.6259983281,-0.557316192
18,169,2001,414,373,-365,1953,0,41,-365,-350,34627,11.895868054,10.717774841,-10.48790299,-26,0,1.178093213,-10.48790299
18,169,2002,384,404,-221,1957,-1,-20,-222,-269,34358,11.132854968,11.712691165,-6.407189969,-27,-0.02899181,-0.579836196,-6.436181779
18,169,2003,404,385,-225,1960,-2,19,-227,-244,34114,11.800443977,11.245472602,-6.572029443,-36,-0.058418039,0.5549713752,-6.630447482
18,169,2004,375,382,-208,1932,1,-7,-207,-244,33870,11.032007531,11.237938338,-6.119086844,-30,0.0294186867,-0.205930807,-6.089668157
18,169,2005,379,386,-346,1960,-1,-7,-347,-384,33486,11.253637389,11.461488212,-10.27376923,-30,-0.029692975,-0.207850822,-10.3034622
18,169,2006,402,387,-254,1952,0,15,-254,-252,33234,12.050359712,11.600719424,-7.613908873,-13,0,0.4496402878,-7.613908873
18,169,2007,371,404,-347,1960,0,-33,-347,-362,32872,11.22439718,12.222793695,-10.49829062,18,0,-0.998396515,-10.49829062
18,169,2008,368,390,-163,1960,-1,-22,-164,-166,32706,11.223276099,11.894232822,-4.971179359,20,-0.030498033,-0.670956723,-5.001677392
18,171,2001,98,98,125,112,0,0,125,117,8559,11.528733604,11.528733604,14.705017352,-8,0,0,14.705017352
18,171,2002,85,104,74,116,0,-19,74,48,8607,9.9032972154,12.116975417,8.6216940464,-7,0,-2.213678201,8.6216940464
18,171,2003,103,89,-19,113,0,14,-19,-18,8589,11.979530123,10.351244475,-2.209816236,-13,0,1.6282856478,-2.209816236
18,171,2004,96,90,19,113,0,6,19,20,8609,11.164088848,10.466333295,2.2095592511,-5,0,0.697755553,2.2095592511
18,171,2005,84,98,36,113,0,-14,36,14,8623,9.7493036212,11.374187558,4.1782729805,-8,0,-1.624883937,4.1782729805
18,171,2006,84,65,-56,109,0,19,-56,-42,8581,9.7651708905,7.5563822367,-6.510113927,-5,0,2.2087886538,-6.510113927
18,171,2007,90,87,-95,109,0,3,-95,-89,8492,10.542962572,10.191530487,-11.12868272,3,0,0.3514320857,-11.12868272
18,171,2008,84,97,63,109,-1,-13,62,55,8547,9.8597335524,11.385644697,7.3948001643,6,-0.11737778,-1.525911145,7.2774223839
18,173,2001,692,443,-32,658,15,249,-17,176,52694,13.154393035,8.421092651,-0.608295632,-56,0.2851385773,4.733300384,-0.323157054
18,173,2002,631,463,320,630,14,168,334,454,53148,11.923433042,8.7488898547,6.0467489276,-48,0.2645452656,3.174543187,6.3112941932
18,173,2003,633,467,864,650,10,166,874,1009,54157,11.798145473,8.7041610363,16.10362984,-31,0.1863846046,3.0939844369,16.290014445
18,173,2004,699,445,430,664,14,254,444,654,54811,12.829454519,8.1675354232,7.8922252404,-44,0.2569561706,4.6619190955,8.1491814111
18,173,2005,657,462,633,664,12,195,645,793,55604,11.90055699,8.3684282027,11.465833447,-47,0.2173617715,3.5321287868,11.683195218
18,173,2006,637,491,335,680,14,146,349,467,56071,11.408103873,8.7933736288,5.9995522722,-28,0.2507275576,2.614730244,6.2502798299
18,173,2007,703,481,702,680,12,222,714,925,56996,12.435104849,8.5082296338,12.417416222,-11,0.2122635252,3.9268752156,12.629679747
18,173,2008,720,493,417,680,12,227,429,660,57656,12.559746014,8.5999372013,7.2741862331,4,0.2093291002,3.9598088128,7.4835153334
18,175,2001,375,269,98,334,5,106,103,184,27446,13.709146743,9.8340279301,3.5826570154,-25,0.1827886232,3.8751188126,3.7654456387
18,175,2002,358,279,79,334,3,79,82,136,27582,13.011557752,10.140292215,2.8712655375,-25,0.1090354002,2.8712655375,2.9803009377
18,175,2003,344,251,-63,334,0,93,-63,-7,27575,12.47348478,9.1012926736,-2.284388201,-37,0,3.3721921062,-2.284388201
18,175,2004,343,276,3,334,5,67,8,57,27632,12.425960476,9.9987320448,0.1086818701,-18,0.1811364501,2.4272284312,0.2898183201
18,175,2005,360,239,-121,334,3,121,-118,-22,27610,13.033561421,8.6528366098,-4.380724811,-25,0.1086130118,4.3807248108,-4.272111799
18,175,2006,332,262,136,334,5,70,141,198,27808,11.981666607,9.4554115991,4.9081525858,-13,0.1804467862,2.5262550074,5.088599372
18,175,2007,350,273,-11,334,3,77,-8,71,27879,12.570258768,9.8048018388,-0.395065276,2,0.1077450752,2.7654569289,-0.2873202
18,175,2008,350,274,-24,334,3,76,-21,70,27949,12.538511141,9.8158630078,-0.859783621,15,0.1074729526,2.7226481336,-0.752310668
18,177,2001,886,827,-550,2260,50,59,-500,-496,70521,12.519606042,11.685907671,-7.771764473,-55,0.706524043,0.8336983708,-7.06524043
18,177,2002,845,777,-418,2220,49,68,-369,-367,70154,12.013506309,11.046738937,-5.942775902,-66,0.6966411942,0.9667673716,-5.246134708
18,177,2003,895,781,-337,2259,38,114,-299,-261,69893,12.781423379,11.153398502,-4.812670032,-76,0.5426749591,1.6280248774,-4.269995073
18,177,2004,901,780,-694,2326,39,121,-655,-600,69293,12.94670441,11.208023795,-9.972267326,-66,0.5604011898,1.7386806144,-9.411866136
18,177,2005,911,797,-561,2326,37,114,-524,-474,68819,13.192191844,11.541357739,-8.12384152,-64,0.5357970343,1.6508341057,-7.588044486
18,177,2006,941,769,-486,2398,39,172,-447,-304,68515,13.703816972,11.198974762,-7.077635545,-29,0.567958408,2.5048422095,-6.509677137
18,177,2007,875,805,-514,2359,37,70,-477,-379,68136,12.806346093,11.781838406,-7.522813591,28,0.5415254919,1.0245076875,-6.981288099
18,177,2008,891,770,-530,2359,36,121,-494,-341,67795,13.109592367,11.329277354,-7.798074023,32,0.5296804997,1.7803150128,-7.268393523
18,179,2001,370,262,-84,457,3,108,-81,3,27604,13.404582918,9.4918938502,-3.043202608,-24,0.1086858074,3.912689068,-2.934516801
18,179,2002,319,235,65,486,1,84,66,118,27722,11.531648773,8.4951017605,2.3497089976,-32,0.0361493692,3.0365470123,2.3858583668
18,179,2003,356,241,-37,466,-1,115,-38,38,27760,12.83299088,8.687502253,-1.333765906,-39,-0.036047727,4.1454886269,-1.369813633
18,179,2004,360,271,-53,466,3,89,-50,18,27778,12.964096655,9.7590838705,-1.908603119,-21,0.1080341388,3.205012784,-1.80056898
18,179,2005,313,236,-71,466,1,77,-70,-16,27762,11.271155924,8.4983795463,-2.55671588,-23,0.0360100828,2.7727763774,-2.520705798
18,179,2006,354,259,4,451,3,95,7,89,27851,12.730836315,9.3143689425,0.1438512578,-13,0.1078884433,3.4164673727,0.2517397011
18,179,2007,380,267,-58,451,1,113,-57,48,27899,13.632286996,9.5784753363,-2.080717489,-8,0.0358744395,4.0538116592,-2.044843049
18,179,2008,358,255,-38,451,1,103,-37,65,27964,12.817070333,9.1294774717,-1.360471153,-1,0.0358018724,3.6875928611,-1.32466928
18,181,2001,383,259,-194,308,63,124,-131,-28,25197,15.191781365,10.273293404,-7.695053746,-21,2.4989092063,4.9184879616,-5.19614454
18,181,2002,375,267,-398,312,60,108,-338,-246,24951,14.955731036,10.648480498,-15.87301587,-16,2.3929169658,4.3072505384,-13.48009891
18,181,2003,338,285,-441,306,46,53,-395,-348,24603,13.64168382,11.502603221,-17.79876498,-6,1.8565605198,2.1390805989,-15.94220446
18,181,2004,333,256,-327,307,43,77,-284,-231,24372,13.598774885,10.454313425,-13.35375191,-24,1.7559979581,3.1444614599,-11.59775396
18,181,2005,315,253,-357,307,47,62,-310,-267,24105,12.995853704,10.437939641,-14.7286342,-19,1.939063886,2.5579140623,-12.78957031
18,181,2006,336,266,-242,307,47,70,-195,-135,23970,13.978159126,11.066042642,-10.0676027,-10,1.9552782111,2.9121164847,-8.112324493
18,181,2007,309,272,-259,307,40,37,-219,-184,23786,12.94078231,11.391238797,-10.84680459,-2,1.6751821761,1.5495435129,-9.171622414
18,181,2008,312,269,-57,307,39,43,-18,14,23800,13.113100492,11.305846257,-2.39566259,-11,1.6391375615,1.8072542344,-0.756525028
18,183,2001,445,262,150,451,13,183,163,315,31042,14.408522074,8.4832197381,4.8568051935,-31,0.4209231168,5.9253023361,5.2777283103
18,183,2002,426,301,115,451,12,125,127,226,31268,13.673567646,9.6613705665,3.6912213128,-26,0.3851709196,4.0121970791,4.0763922324
18,183,2003,408,298,191,451,10,110,201,273,31541,12.991768696,9.489085959,6.0819309335,-38,0.3184257033,3.5026827366,6.4003566368
18,183,2004,436,286,30,451,8,150,38,168,31709,13.786561265,9.0434782609,0.9486166008,-20,0.2529644269,4.743083004,1.2015810277
18,183,2005,394,301,205,451,11,93,216,279,31988,12.371069281,9.4509945523,6.4367238645,-30,0.345385183,2.9200747288,6.7821090475
18,183,2006,384,277,215,451,11,107,226,317,32305,11.945312865,8.616801207,6.6881309007,-16,0.3421834414,3.3285116576,7.0303143422
18,183,2007,407,286,77,451,8,121,85,212,32517,12.557465058,8.8241646355,2.3757366326,6,0.24682978,3.7333004227,2.6225664126
18,183,2008,446,291,-28,451,7,155,-21,150,32667,13.684339715,8.9285714286,-0.859106529,16,0.2147766323,4.7557682867,-0.644329897
19,0,2001,38033,27849,-13271,104454,5486,10184,-7785,1248,2929294,12.986440944,9.5090945719,-4.531408455,-1151,1.8732052433,3.4773463722,-2.658203212
19,0,2002,37383,27962,-13252,104211,5141,9421,-8111,101,2929395,12.761558089,9.545480226,-4.523878977,-1209,1.7550001374,3.2160778632,-2.76887884
19,0,2003,38020,27859,-8497,104556,4286,10161,-4211,4012,2933407,12.969907563,9.503646891,-2.898614007,-1938,1.4620995217,3.4662606719,-1.436514486
19,0,2004,38287,27657,-3840,105115,4203,10630,363,9332,2942739,13.031330399,9.4133127393,-1.306979098,-1661,1.4305294661,3.6180176599,0.1235503679
19,0,2005,38669,27742,-5533,104017,4274,10927,-1259,9036,2951775,13.120335281,9.4128201239,-1.877338827,-632,1.4501619642,3.7075151573,-0.427176863
19,0,2006,39987,27378,-598,105057,4360,12609,3762,15495,2967270,13.511301232,9.2508166436,-0.202059623,-876,1.4732106277,4.2604845883,1.2711510049
19,0,2007,41292,26561,-2491,105683,3884,14731,1393,16090,2983360,13.87819441,8.9271220022,-0.837222277,-34,1.3054079988,4.9510724075,0.4681857215
19,0,2008,41247,26712,411,105683,3810,14535,4221,19195,3002555,13.781351723,8.9249513232,0.1373223643,439,1.2729883401,4.8564003999,1.4103107044
19,1,2001,72,121,-78,187,2,-49,-76,-131,8077,8.8424930918,14.86030089,-9.579367516,-6,0.2456248081,-6.017807799,-9.333742708
19,1,2002,63,106,-63,185,2,-43,-61,-112,7965,7.8543822466,13.215309812,-7.854382247,-8,0.2493454681,-5.360927565,-7.605036778
19,1,2003,74,114,3,196,0,-40,3,-48,7917,9.3187256013,14.355874575,0.377786173,-11,0,-5.037148974,0.377786173
19,1,2004,72,126,-11,190,1,-54,-10,-69,7848,9.1341579448,15.984776403,-1.395496353,-5,0.1268633048,-6.850618459,-1.268633048
19,1,2005,70,117,-74,179,1,-47,-73,-127,7721,8.9922281457,15.029867043,-9.506069754,-7,0.1284604021,-6.037638898,-9.377609352
19,1,2006,102,103,-39,180,1,-1,-38,-42,7679,13.246753247,13.376623377,-5.064935065,-3,0.1298701299,-0.12987013,-4.935064935
19,1,2007,88,116,-35,181,1,-28,-34,-58,7621,11.503267974,15.163398693,-4.575163399,4,0.1307189542,-3.660130719,-4.444444444
19,1,2008,84,95,-103,181,0,-11,-103,-115,7506,11.105969459,12.560322602,-13.61803398,-1,0,-1.454353143,-13.61803398
19,3,2001,35,36,-74,123,0,-1,-74,-78,4397,7.8899909829,8.1154192967,-16.68169522,-3,0,-0.225428314,-16.68169522
19,3,2002,42,66,-17,124,0,-24,-17,-45,4352,9.6010972683,15.087438564,-3.886158418,-4,0,-5.486341296,-3.886158418
19,3,2003,40,56,-6,133,-1,-16,-7,-30,4322,9.2229651833,12.912151257,-1.383444777,-7,-0.23057413,-3.689186073,-1.614018907
19,3,2004,49,55,-55,121,0,-6,-55,-65,4257,11.423242802,12.822007227,-12.82200723,-4,0,-1.398764425,-12.82200723
19,3,2005,34,66,-61,114,0,-32,-61,-96,4161,8.077928249,15.680684248,-14.49275362,-3,0,-7.602755999,-14.49275362
19,3,2006,50,44,-28,109,0,6,-28,-24,4137,12.05109665,10.604965052,-6.748614124,-2,0,1.446131598,-6.748614124
19,3,2007,54,28,-72,113,0,26,-72,-52,4085,13.135490148,6.8109948918,-17.51398686,-6,0,6.3244952566,-17.51398686
19,3,2008,40,46,-33,113,-1,-6,-34,-45,4040,9.8461538462,11.323076923,-8.123076923,-5,-0.246153846,-1.476923077,-8.369230769
19,5,2001,148,177,-391,398,106,-29,-285,-322,14346,10.201971462,12.201006411,-26.95250569,-8,7.3068173985,-1.999034949,-19.64568829
19,5,2002,182,163,-119,383,103,19,-16,-10,14336,12.69088627,11.366013528,-8.297887177,-13,7.1822048672,1.3248727425,-1.115682309
19,5,2003,190,159,-24,394,74,31,50,64,14400,13.223830735,11.066258352,-1.670378619,-17,5.1503340757,2.1575723831,3.4799554566
19,5,2004,187,157,-79,401,73,30,-6,12,14412,12.980702485,10.898236846,-5.483826184,-12,5.0673330557,2.0824656393,-0.416493128
19,5,2005,200,169,-29,402,74,31,45,62,14474,13.8475386,11.701170117,-2.007893097,-14,5.123589282,2.146368483,3.115696185
19,5,2006,203,154,-101,409,73,49,-28,15,14489,14.017884888,10.634257501,-6.974415634,-6,5.0409142699,3.3836273867,-1.933501364
19,5,2007,211,175,-91,383,53,36,-38,5,14494,14.560259462,12.076044578,-6.27954318,7,3.6573163579,2.4842148846,-2.622226823
19,5,2008,211,154,-74,383,52,57,-22,44,14538,14.535684762,10.608983191,-5.097823092,9,3.5822540645,3.9267015707,-1.515569027
19,7,2001,138,155,-120,219,6,-17,-114,-140,13560,10.124724872,11.371973588,-8.804108584,-9,0.4402054292,-1.247248716,-8.363903155
19,7,2002,148,158,-165,214,5,-10,-160,-180,13380,10.987379362,11.729769859,-12.24944321,-10,0.3711952487,-0.742390497,-11.87824796
19,7,2003,161,185,108,234,3,-24,111,77,13457,11.998360472,13.786935947,8.0485896337,-10,0.2235719343,-1.788575474,8.272161568
19,7,2004,167,203,-52,211,4,-36,-48,-93,13364,12.452928675,15.137392342,-3.877558629,-9,0.2982737407,-2.684463667,-3.579284889
19,7,2005,182,196,-13,198,3,-14,-10,-37,13327,13.63755573,14.686598479,-0.974111124,-13,0.2247948747,-1.049042748,-0.749316249
19,7,2006,157,165,-136,198,4,-8,-132,-145,13182,11.845033762,12.448602361,-10.26066619,-5,0.3017842997,-0.603568599,-9.958881889
19,7,2007,157,190,-176,184,3,-33,-173,-196,12986,11.999388566,14.521553042,-13.45154387,10,0.2292876796,-2.522164476,-13.22225619
19,7,2008,164,184,-128,184,2,-20,-126,-136,12850,12.695463694,14.243690974,-9.90865459,10,0.154822728,-1.54822728,-9.753831863
19,9,2001,36,105,-80,187,1,-69,-79,-153,6654,5.34878538,15.600624025,-11.88618973,-5,0.1485773717,-10.25183864,-11.73761236
19,9,2002,65,113,-56,184,1,-48,-55,-107,6547,9.8477388077,17.119915158,-8.484205742,-4,0.151503674,-7.27217635,-8.332702068
19,9,2003,56,83,-83,184,1,-27,-82,-113,6434,8.6279947616,12.787920807,-12.78792081,-4,0.154071335,-4.159926046,-12.63384947
19,9,2004,60,86,-30,187,0,-26,-30,-60,6374,9.3691442848,13.429106808,-4.684572142,-4,0,-4.059962523,-4.684572142
19,9,2005,61,105,-79,177,1,-44,-78,-126,6248,9.6656631279,16.637616859,-12.51782602,-4,0.1584534939,-6.971953732,-12.35937252
19,9,2006,55,74,-79,173,0,-19,-79,-101,6147,8.874546188,11.940298507,-12.74707543,-3,0,-3.065752319,-12.74707543
19,9,2007,59,76,-68,177,1,-17,-67,-89,6058,9.6681687833,12.453912331,-11.14297419,-5,0.1638672675,-2.785743548,-10.97910692
19,9,2008,59,84,5,177,0,-25,5,-25,6033,9.7593251179,13.894632371,0.8270614507,-5,0,-4.135307253,0.8270614507
19,11,2001,314,247,203,305,4,67,207,280,25618,12.32435827,9.6946385117,7.9676583719,6,0.1569981945,2.6297197582,8.1246565664
19,11,2002,319,227,268,308,3,92,271,370,25988,12.362903538,8.7974266558,10.38638918,7,0.1162655505,3.5654768825,10.50265473
19,11,2003,310,252,132,365,3,58,135,186,26174,11.886047314,9.6622062037,5.0611556305,-7,0.1150262643,2.2238411104,5.1761818949
19,11,2004,319,228,219,349,4,91,223,320,26494,12.113617377,8.658008658,8.3162451584,6,0.1518948887,3.4556087188,8.4681400471
19,11,2005,316,235,70,355,3,81,73,153,26647,11.89288873,8.8443950998,2.634500668,-1,0.1129071715,3.0484936302,2.7474078395
19,11,2006,289,240,-135,343,4,49,-131,-83,26564,10.862415666,9.0206912105,-5.074138806,-1,0.1503448535,1.8417244555,-4.923793952
19,11,2007,310,216,-141,333,3,94,-138,-63,26501,11.683784038,8.140959201,-5.314237256,-19,0.1130688778,3.5428248375,-5.201168378
19,11,2008,308,219,-43,333,2,89,-41,31,26532,11.615409273,8.2590085419,-1.621631814,-17,0.0754247355,3.3564007316,-1.546207079
19,13,2001,1535,1194,-1030,6453,414,341,-616,-373,127624,12.009967882,9.3419554731,-8.05880581,-98,3.2391704907,2.668012409,-4.819635319
19,13,2002,1604,1142,-1784,5960,386,462,-1398,-1002,126622,12.617700967,8.9834255013,-14.03365245,-66,3.036429285,3.6342754655,-10.99722316
19,13,2003,1574,1067,-1275,5666,341,507,-934,-532,126090,12.456867897,8.4443952009,-10.09053785,-105,2.6987242395,4.0124726962,-7.391813606
19,13,2004,1683,1167,-582,5574,316,516,-266,153,126243,13.33951564,9.2496819679,-4.612951933,-97,2.5046268225,4.0898336722,-2.10832511
19,13,2005,1689,1150,-450,5700,333,539,-117,306,126549,13.362764644,9.0983891895,-3.560239248,-116,2.6345770436,4.2643754549,-0.925662205
19,13,2006,1705,1083,-439,5814,335,622,-104,456,127005,13.448811693,8.5425589815,-3.462773216,-62,2.642435142,4.9062527115,-0.820338074
19,13,2007,1784,1043,-825,5911,296,741,-529,199,127204,14.035695038,8.2058463705,-6.490722201,-13,2.3287924503,5.8298486678,-4.161929751
19,13,2008,1781,1051,118,5911,296,730,414,1143,128347,13.938509339,8.2253640174,0.9234947232,-1,2.3165630344,5.7131453213,3.2400577576
19,15,2001,293,304,-5,911,9,-11,4,-35,26220,11.167222487,11.586469747,-0.190566937,-28,0.3430204859,-0.419247261,0.1524535493
19,15,2002,271,274,-157,914,5,-3,-152,-176,26044,10.370427063,10.485228838,-6.00795959,-21,0.1913362927,-0.114801776,-5.816623297
19,15,2003,330,271,68,872,-2,59,66,93,26137,12.648281942,10.386922443,2.6063126425,-32,-0.076656254,2.2613594987,2.5296563883
19,15,2004,302,260,74,858,9,42,83,106,26243,11.531118748,9.9274532264,2.8255059183,-19,0.3436426117,1.6036655212,3.16914853
19,15,2005,291,249,70,855,4,42,74,91,26334,11.06947905,9.4718222797,2.6627612835,-25,0.1521577876,1.5976567701,2.8149190711
19,15,2006,345,301,-59,846,8,44,-51,-20,26314,13.105910956,11.434432457,-2.241300714,-13,0.3039051816,1.6714784987,-1.937395533
19,15,2007,307,286,13,862,5,21,18,41,26355,11.657711367,10.860278342,0.4936490155,2,0.189865006,0.7974330251,0.6835140215
19,15,2008,324,277,-73,862,5,47,-68,-6,26349,12.295081967,10.511536126,-2.770188221,15,0.1897389192,1.7835458409,-2.580449302
19,17,2001,264,221,91,1447,7,43,98,121,23403,11.309842562,9.4677091143,3.8984684588,-20,0.2998821891,1.8421334476,4.198350648
19,17,2002,241,237,-188,1468,6,4,-182,-197,23206,10.341350383,10.169709713,-8.067111502,-19,0.2574610054,0.1716406703,-7.809650497
19,17,2003,239,205,65,1460,6,34,71,77,23283,10.282002194,8.8192905849,2.7963604293,-28,0.2581255781,1.4627116092,3.0544860074
19,17,2004,232,219,102,1567,7,13,109,105,23388,9.9419339633,9.384842836,4.3710226908,-17,0.2999721454,0.5570911273,4.6709948362
19,17,2005,270,221,0,1556,6,49,6,32,23420,11.536489489,9.4428302854,0,-23,0.2563664331,2.0936592036,0.2563664331
19,17,2006,279,203,91,1540,7,76,98,163,23583,11.871582665,8.6377465268,3.8720932706,-11,0.2978533285,3.2338361381,4.1699465992
19,17,2007,294,220,63,1570,6,74,69,140,23723,12.429712933,9.301145732,2.6635099142,-3,0.2536676109,3.1285672008,2.917177525
19,17,2008,287,214,-120,1570,5,73,-115,-33,23690,12.106384325,9.027060089,-5.061902854,9,0.2109126189,3.079324236,-4.850990235
19,19,2001,289,174,-235,393,1,115,-234,-136,20942,13.755354593,8.2817705854,-11.18514993,-17,0.0475963827,5.4735840076,-11.13755355
19,19,2002,306,205,-275,374,1,101,-274,-184,20758,14.676258993,9.8321342926,-13.18944844,-11,0.0479616307,4.8441247002,-13.14148681
19,19,2003,309,218,-48,405,0,91,-48,16,20774,14.880092459,10.497929308,-2.311470673,-27,0,4.3821631513,-2.311470673
19,19,2004,301,197,-16,409,1,104,-15,75,20849,14.463157389,9.4659202845,-0.768805708,-14,0.0480503568,4.9972371045,-0.720755352
19,19,2005,275,199,-153,406,1,76,-152,-92,20757,13.219247224,9.5659279912,-7.354708456,-16,0.0480699899,3.6533192328,-7.306638466
19,19,2006,330,170,-64,413,1,160,-63,87,20844,15.865003245,8.1728804596,-3.076849114,-10,0.0480757674,7.6921227855,-3.028773347
19,19,2007,328,204,-59,405,1,124,-58,59,20903,15.713703979,9.7731573526,-2.826550411,-7,0.0479076341,5.9405466261,-2.778642777
19,19,2008,322,198,14,405,0,124,14,129,21032,15.357100274,9.4431858829,0.6677000119,-9,0,5.9139143913,0.6677000119
19,21,2001,242,198,-340,1432,156,44,-184,-155,20193,11.938531363,9.7678892973,-16.77314324,-15,7.6959127797,2.1706420661,-9.077230458
19,21,2002,244,198,-226,1384,147,46,-79,-49,20144,12.098073729,9.8172893373,-11.20559288,-16,7.2885935989,2.2807843915,-3.916999281
19,21,2003,258,194,-330,1380,122,64,-208,-155,19989,12.857249645,9.6678543842,-16.44531931,-11,6.0797847158,3.1893952608,-10.3655346
19,21,2004,242,170,-347,1365,113,72,-234,-185,19804,12.162943231,8.5442163195,-17.44025331,-23,5.6793908476,3.6187269118,-11.76086246
19,21,2005,287,182,-291,1277,118,105,-173,-84,19720,14.522821577,9.2095941706,-14.72523024,-16,5.9710555612,5.3132274061,-8.754174679
19,21,2006,282,175,-282,1212,118,107,-164,-65,19655,14.323809524,8.8888888889,-14.32380952,-8,5.9936507937,5.4349206349,-8.33015873
19,21,2007,273,180,-282,1098,108,93,-174,-70,19585,13.914373089,9.1743119266,-14.37308869,11,5.504587156,4.7400611621,-8.868501529
19,21,2008,282,183,-99,1098,107,99,8,117,19702,14.355893807,9.3160587472,-5.03983506,10,5.4470944587,5.0398350599,0.4072593988
19,23,2001,146,200,-221,269,0,-54,-221,-283,15007,9.6379179457,13.202627323,-14.58890319,-8,0,-3.564709377,-14.58890319
19,23,2002,151,204,-116,263,-1,-53,-117,-180,14827,10.122678823,13.675672052,-7.776362539,-10,-0.067037608,-3.552993229,-7.843400147
19,23,2003,135,198,44,264,-1,-63,43,-42,14785,9.1179251655,13.372956909,2.9717682021,-22,-0.067540186,-4.255031744,2.9042280157
19,23,2004,190,197,19,262,0,-7,19,1,14786,12.850427784,13.323864597,1.2850427784,-11,0,-0.473436813,1.2850427784
19,23,2005,174,188,-40,248,0,-14,-40,-68,14718,11.795010846,12.744034707,-2.711496746,-14,0,-0.949023861,-2.711496746
19,23,2006,168,197,-21,244,0,-29,-21,-56,14662,11.436351259,13.410483322,-1.429543907,-6,0,-1.974132063,-1.429543907
19,23,2007,187,163,-35,244,0,24,-35,-8,14654,12.757538546,11.120207395,-2.387774594,3,0,1.6373311502,-2.387774594
19,23,2008,193,185,-29,244,-1,8,-30,-10,14644,13.174960748,12.628848386,-1.979657314,12,-0.068264045,0.5461123626,-2.04792136
19,25,2001,103,151,-88,722,2,-48,-86,-143,10946,9.3487633311,13.705468573,-7.987292943,-9,0.1815293851,-4.356705242,-7.805763558
19,25,2002,102,163,-159,732,2,-61,-157,-227,10719,9.4161089315,15.047311332,-14.67805216,-9,0.1846295869,-5.6312024,-14.49342257
19,25,2003,80,148,-118,737,2,-68,-116,-195,10524,7.5318928588,13.934001789,-11.10954197,-11,0.1882973215,-6.40210893,-10.92124465
19,25,2004,102,122,-104,726,1,-20,-103,-132,10392,9.7532989099,11.665710461,-9.944540065,-9,0.0956205775,-1.912411551,-9.848919487
19,25,2005,94,150,-77,768,2,-56,-75,-140,10252,9.1067622554,14.532067429,-7.459794613,-9,0.1937608991,-5.425305173,-7.266033714
19,25,2006,119,145,-100,751,1,-26,-99,-131,10121,11.682128307,14.234526088,-9.816914544,-6,0.0981691454,-2.552397781,-9.718745398
19,25,2007,105,125,-135,749,2,-20,-133,-159,9962,10.456605089,12.448339392,-13.44420654,-6,0.1991734303,-1.991734303,-13.24503311
19,25,2008,103,131,-37,749,1,-28,-36,-75,9887,10.378356592,13.199657413,-3.728147514,-11,0.1007607436,-2.821300821,-3.62738677
19,27,2001,229,229,-150,539,7,0,-143,-161,21210,10.755970973,10.755970973,-7.045395834,-18,0.3287851389,0,-6.716610695
19,27,2002,251,202,-113,537,6,49,-107,-75,21135,11.85500059,9.540677766,-5.33711182,-17,0.2833864683,2.3143228244,-5.053725351
19,27,2003,243,256,-125,581,5,-13,-120,-152,20983,11.53900945,12.156322712,-5.935704449,-19,0.237428178,-0.617313263,-5.698276271
19,27,2004,247,192,-135,590,6,55,-129,-93,20890,11.797578392,9.1705872519,-6.448069162,-19,0.2865808516,2.6269911399,-6.16148831
19,27,2005,282,233,-12,590,6,49,-6,28,20918,13.490241102,11.146192116,-0.574052813,-15,0.2870264064,2.3440489858,-0.287026406
19,27,2006,297,244,-128,596,6,53,-122,-80,20838,14.225500527,11.686943194,-6.130855446,-11,0.287383849,2.5385573331,-5.843471597
19,27,2007,276,240,64,605,6,36,70,88,20926,13.217124796,11.493151997,3.0648405325,-18,0.2873287999,1.7239727995,3.3521693324
19,27,2008,283,242,-26,605,5,41,-21,0,20926,13.523845933,11.564560833,-1.242473478,-20,0.2389372073,1.9592850999,-1.003536271
19,29,2001,167,202,-154,454,1,-35,-153,-198,14473,11.460334889,13.862201482,-10.56821301,-10,0.0686247598,-2.401866593,-10.49958825
19,29,2002,136,206,-185,445,0,-70,-185,-262,14211,9.4826384047,14.363408172,-12.89917724,-7,0,-4.880769767,-12.89917724
19,29,2003,165,180,52,441,-1,-15,51,14,14225,11.605007737,12.66000844,3.6573357716,-22,-0.07033338,-1.055000703,3.5870023913
19,29,2004,151,184,-106,452,3,-33,-103,-150,14075,10.671378092,13.003533569,-7.491166078,-14,0.2120141343,-2.332155477,-7.279151943
19,29,2005,143,176,-114,441,1,-33,-113,-159,13916,10.217569933,12.575470687,-8.145475331,-13,0.071451538,-2.357900754,-8.074023793
19,29,2006,167,191,6,447,3,-24,9,-21,13895,12.009636475,13.735572256,0.4314839452,-6,0.2157419726,-1.725935781,0.6472259178
19,29,2007,174,155,-61,438,1,19,-60,-40,13855,12.540540541,11.171171171,-4.396396396,1,0.0720720721,1.3693693694,-4.324324324
19,29,2008,171,175,-23,438,1,-4,-22,-15,13840,12.348799422,12.637660227,-1.66094963,11,0.0722152013,-0.288860805,-1.588734429
19,31,2001,179,179,-108,281,2,0,-106,-124,18076,9.8687837689,9.8687837689,-5.954349983,-18,0.1102657404,0,-5.844084243
19,31,2002,199,193,-13,283,1,6,-12,-24,18052,11.016386182,10.684233835,-0.719663419,-18,0.0553587245,0.3321523472,-0.664304694
19,31,2003,201,174,9,284,-1,27,8,11,18063,11.131108957,9.6358853662,0.4984078638,-24,-0.055378652,1.4952235913,0.4430292122
19,31,2004,183,173,-27,287,2,10,-25,-26,18037,10.138504155,9.5844875346,-1.495844875,-11,0.1108033241,0.5540166205,-1.385041551
19,31,2005,216,172,-122,271,0,44,-122,-93,17944,12.006336678,9.5606014285,-6.781356827,-15,0,2.4457352492,-6.781356827
19,31,2006,187,130,-12,259,1,57,-11,37,17981,10.410577592,7.2372999304,-0.668058455,-9,0.0556715379,3.1732776618,-0.612386917
19,31,2007,220,180,-61,251,1,40,-60,-18,17963,12.241264189,10.015579791,-3.394168707,2,0.0556421099,2.225684398,-3.338526597
19,31,2008,219,173,69,251,0,46,69,116,18079,12.152488763,9.5999112147,3.8288663226,1,0,2.5525775484,3.8288663226
19,33,2001,504,543,-561,1371,24,-39,-537,-610,45741,10.945576163,11.792555271,-12.18346871,-34,0.5212179125,-0.846979108,-11.66225079
19,33,2002,488,516,-442,1299,25,-28,-417,-477,45264,10.724685457,11.340036262,-9.713751992,-32,0.5494203615,-0.615350805,-9.16433163
19,33,2003,502,515,-66,1315,20,-13,-46,-118,45146,11.104966265,11.392545072,-1.460015485,-59,0.4424289349,-0.287578808,-1.01758655
19,33,2004,501,523,-437,1261,17,-22,-420,-482,44664,11.156886761,11.646809932,-9.731655718,-40,0.3785769959,-0.489923171,-9.353078722
19,33,2005,463,542,-222,1214,20,-79,-202,-323,44341,10.403909893,12.179091062,-4.988483793,-42,0.4494129543,-1.77518117,-4.539070839
19,33,2006,515,518,-208,1213,19,-3,-189,-213,44128,11.642496242,11.710316608,-4.702212074,-21,0.4295289876,-0.067820366,-4.272683087
19,33,2007,520,477,-190,1209,19,43,-171,-124,44004,11.800481097,10.824672083,-4.311714247,4,0.4311714247,0.9758090138,-3.880542822
19,33,2008,519,484,-296,1209,18,35,-278,-218,43786,11.823670122,11.026312792,-6.743364848,25,0.410069484,0.79735733,-6.333295364
19,35,2001,131,159,-131,386,0,-28,-131,-167,12839,10.137357322,12.30412072,-10.13735732,-8,0,-2.166763397,-10.13735732
19,35,2002,105,164,-237,352,-1,-59,-238,-305,12534,8.2765144051,12.927127261,-18.68127537,-8,-0.078823947,-4.650612856,-18.76009932
19,35,2003,119,146,-144,327,-1,-27,-145,-182,12352,9.5636100619,11.733504782,-11.57277184,-10,-0.080366471,-2.16989472,-11.65313831
19,35,2004,119,158,-86,328,0,-39,-86,-134,12218,9.6866096866,12.861212861,-7.000407,-9,0,-3.174603175,-7.000407
19,35,2005,113,151,-138,331,-1,-38,-139,-188,12030,9.320356318,12.454635434,-11.38238205,-11,-0.082481029,-3.134279116,-11.46486308
19,35,2006,114,161,-155,321,0,-47,-155,-207,11823,9.5585460948,13.499350187,-12.99626881,-5,0,-3.940804092,-12.99626881
19,35,2007,127,125,-140,328,0,2,-140,-144,11679,10.807590843,10.637392562,-11.91387967,-6,0,0.170198281,-11.91387967
19,35,2008,123,144,-106,328,-1,-21,-107,-127,11552,10.589298782,12.397227842,-9.125737162,1,-0.08609186,-1.80792906,-9.211829022
19,37,2001,166,134,-43,214,11,32,-32,-12,13052,12.712513402,10.261908409,-3.293000459,-12,0.8423954664,2.4506049931,-2.450604993
19,37,2002,138,151,-273,212,10,-13,-263,-280,12772,10.687732342,11.694547708,-21.14312268,-4,0.7744733581,-1.006815366,-20.36864932
19,37,2003,138,154,-195,204,4,-16,-191,-212,12560,10.895310279,12.15853466,-15.39554713,-5,0.3158060951,-1.26322438,-15.07974104
19,37,2004,152,154,-104,176,5,-2,-99,-112,12448,12.156110045,12.316058861,-8.317338452,-11,0.3998720409,-0.159948816,-7.917466411
19,37,2005,141,145,-159,169,4,-4,-155,-168,12280,11.404076351,11.727596247,-12.85991588,-9,0.3235198965,-0.323519896,-12.53639599
19,37,2006,171,135,-35,181,5,36,-30,1,12281,13.924514474,10.993037743,-2.850046822,-5,0.407149546,2.9314767314,-2.442897276
19,37,2007,159,116,-135,166,4,43,-131,-97,12184,12.998160638,9.4829348048,-11.03617413,-9,0.3269977519,3.5152258328,-10.70917637
19,37,2008,162,129,-97,166,3,33,-94,-63,12121,13.330590413,10.615099774,-7.981896729,-2,0.2468627854,2.7154906398,-7.735033944
19,39,2001,134,106,-35,149,8,28,-27,-6,9181,14.590592334,11.541811847,-3.81097561,-7,0.8710801394,3.0487804878,-2.93989547
19,39,2002,116,94,-31,156,7,22,-24,-9,9172,12.640985125,10.243556912,-3.378194301,-7,0.7628180679,2.3974282134,-2.615376233
19,39,2003,125,97,24,153,5,28,29,45,9217,13.595084018,10.549785198,2.6102561314,-12,0.5438033607,3.0452988199,3.1540594921
19,39,2004,114,92,-10,156,6,22,-4,11,9228,12.361073462,9.9756031445,-1.08430469,-7,0.6505828138,2.3854703172,-0.433721876
19,39,2005,123,106,-160,160,6,17,-154,-144,9084,13.433813893,11.577107907,-17.47487986,-7,0.6553079948,1.8567059851,-16.81957187
19,39,2006,139,118,-47,160,6,21,-41,-23,9061,15.321025076,13.006337834,-5.180490493,-3,0.6613392119,2.3146872417,-4.519151281
19,39,2007,140,109,-122,160,6,31,-116,-82,8979,15.521064302,12.084257206,-13.52549889,3,0.6651884701,3.4368070953,-12.86031042
19,39,2008,137,95,8,160,5,42,13,53,9032,15.212925434,10.549108878,0.8883460108,-2,0.5552162567,4.6638165565,1.4435622675
19,41,2001,198,164,-158,266,16,34,-142,-121,17249,11.43880528,9.4745659898,-9.127935527,-13,0.9243479014,1.9642392906,-8.203587625
19,41,2002,192,181,-203,274,15,11,-188,-187,17062,11.191746087,10.550552301,-11.83293987,-10,0.8743551631,0.6411937862,-10.95858471
19,41,2003,209,208,-105,227,11,1,-94,-113,16949,12.290141425,12.23133692,-6.174472965,-20,0.6468495487,0.0588045044,-5.527623416
19,41,2004,213,159,-95,246,14,54,-81,-41,16908,12.582331571,9.3924446939,-5.611838025,-14,0.8270077089,3.1898868772,-4.784830316
19,41,2005,217,186,-157,237,12,31,-145,-131,16777,12.88407303,11.043491168,-9.321656524,-17,0.7124833012,1.8405818614,-8.609173223
19,41,2006,205,160,-95,247,13,45,-82,-44,16733,12.235153685,9.5493882423,-5.669949269,-7,0.7758877947,2.6857654432,-4.894061474
19,41,2007,202,187,-77,246,12,15,-65,-47,16686,12.088931446,11.191238517,-4.608157036,3,0.7181543433,0.8976929292,-3.890002693
19,41,2008,215,190,-38,246,11,25,-27,5,16691,12.883123109,11.385085538,-2.277017108,7,0.6591365311,1.4980375708,-1.617880576
19,43,2001,198,226,-123,481,12,-28,-111,-153,18454,10.685086749,12.196109117,-6.637705405,-14,0.6475810151,-1.511022369,-5.99012439
19,43,2002,195,225,-206,473,12,-30,-194,-236,18218,10.634816754,12.270942408,-11.23472949,-12,0.6544502618,-1.636125654,-10.58027923
19,43,2003,199,218,-63,440,7,-19,-56,-99,18119,10.953023089,11.998789113,-3.467539973,-24,0.3852822192,-1.045766024,-3.082257754
19,43,2004,200,199,-68,445,6,1,-62,-76,18043,11.061335103,11.006028428,-3.760853935,-15,0.3318400531,0.0553066755,-3.429013882
19,43,2005,201,207,-153,447,7,-6,-146,-167,17876,11.191848325,11.52593335,-8.519168128,-15,0.3897658621,-0.334085025,-8.129402266
19,43,2006,223,198,-123,444,6,25,-117,-101,17775,12.510168018,11.107682814,-6.900227203,-9,0.3365964489,1.4024852038,-6.563630754
19,43,2007,202,186,-125,454,5,16,-120,-103,17672,11.397297374,10.494541146,-7.052783028,1,0.2821113211,0.9027562276,-6.770671707
19,43,2008,207,199,-116,454,4,8,-112,-106,17566,11.748680402,11.294625121,-6.583801578,-2,0.2270276406,0.4540552812,-6.356773937
19,45,2001,601,492,-307,1006,34,109,-273,-207,49841,12.033357026,9.8509345373,-6.146822974,-43,0.6807556388,2.182422489,-5.466067335
19,45,2002,603,533,-304,946,32,70,-272,-241,49600,12.127794371,10.719924377,-6.114178256,-39,0.6435977112,1.4078699933,-5.470580545
19,45,2003,566,551,-111,1032,29,15,-82,-129,49471,11.426148923,11.123335789,-2.240817192,-62,0.5854387258,0.302813134,-1.655378466
19,45,2004,565,551,-122,1019,29,14,-93,-113,49358,11.433890862,11.150573212,-2.468910947,-34,0.5868722743,0.2833176497,-1.882038673
19,45,2005,614,545,-144,1007,29,69,-115,-90,49268,12.451077809,11.051852453,-2.920122483,-44,0.5880802223,1.3992253564,-2.332042261
19,45,2006,630,524,-199,1018,30,106,-169,-85,49183,12.798244812,10.644889336,-4.042620187,-22,0.6094402291,2.1533554763,-3.433179958
19,45,2007,654,500,-316,1045,28,154,-288,-127,49056,13.314467778,10.179256711,-6.433290241,7,0.5700383758,3.1352110669,-5.863251865
19,45,2008,614,505,-248,1045,27,109,-221,-114,48942,12.530867977,10.306332782,-5.061327782,-2,0.5510316537,2.2245351946,-4.510296128
19,47,2001,206,167,-153,640,82,39,-71,-47,16878,12.188267314,9.8807798124,-9.052450966,-15,4.8516403869,2.3074875011,-4.200810579
19,47,2002,220,162,-174,639,78,58,-96,-52,16826,13.054830287,9.6131023024,-10.32518395,-14,4.6285307382,3.4417279848,-5.696653216
19,47,2003,230,165,-222,639,68,65,-154,-102,16724,13.710879285,9.8360655738,-13.23397914,-13,4.0536512668,3.8748137109,-9.180327869
19,47,2004,238,175,-192,628,61,63,-131,-82,16642,14.266019301,10.489720074,-11.50872145,-14,3.6564167116,3.7762992268,-7.852304741
19,47,2005,217,169,-189,619,65,48,-124,-88,16554,13.073864321,10.181949632,-11.38691409,-12,3.916134474,2.8919146885,-7.470779612
19,47,2006,239,166,-203,612,66,73,-137,-72,16482,14.469064051,10.049642814,-12.28962344,-8,3.9956411188,4.4194212374,-8.293982322
19,47,2007,261,158,-123,614,59,103,-64,34,16516,15.819140554,9.5763379599,-7.454997273,-5,3.5759743015,6.2428025941,-3.879022971
19,47,2008,260,163,-249,614,58,97,-191,-101,16415,15.790592451,9.8994868057,-15.12252892,-7,3.5225167775,5.8911056451,-11.60001215
19,49,2001,552,298,1232,467,84,254,1316,1652,42721,13.175796634,7.1130206469,29.406850459,82,2.0050125313,6.0627759876,31.411862991
19,49,2002,547,307,1214,438,78,240,1292,1610,44331,12.567201213,7.0532555254,27.89137527,78,1.7920323485,5.5139456876,29.683407618
19,49,2003,594,304,1488,400,56,290,1544,1986,46317,13.105639396,6.7072632601,32.830288589,152,1.2355484953,6.3983761363,34.065837084
19,49,2004,627,339,2735,436,66,288,2801,3083,49400,13.101121013,7.0833812175,57.147633127,-6,1.3790653698,6.0177397954,58.526698497
19,49,2005,720,314,1920,412,63,406,1983,2396,51796,14.229811455,6.2057788845,37.94616388,7,1.2451085023,8.0240325705,39.191272382
19,49,2006,868,322,2196,426,69,546,2265,2816,54612,16.314562815,6.0521765281,41.275092098,5,1.2968949703,10.262386287,42.571987069
19,49,2007,934,340,1899,421,56,594,1955,2589,57201,16.706465259,6.0815826424,33.967427759,40,1.0016724352,10.624882617,34.969100194
19,49,2008,945,327,2039,421,56,618,2095,2729,59930,16.135779597,5.5834919876,34.815719152,16,0.9561943465,10.55228761,35.771913499
19,51,2001,143,102,-4,174,1,41,-3,29,8571,16.712440834,11.920761994,-0.467480863,-9,0.1168702156,4.7916788406,-0.350610647
19,51,2002,114,86,-25,193,0,28,-25,-5,8566,13.30454572,10.036762561,-2.917663535,-8,0,3.2677831592,-2.917663535
19,51,2003,111,100,-73,189,0,11,-73,-68,8498,13.009845288,11.720581341,-8.556024379,-6,0,1.2892639475,-8.556024379
19,51,2004,132,106,44,183,1,26,45,63,8561,15.475701975,12.427457647,5.1585673252,-8,0.1172401665,3.0482443285,5.2758074916
19,51,2005,132,93,-81,175,1,39,-80,-47,8514,15.461200586,10.893118594,-9.487554905,-6,0.1171303075,4.5680819912,-9.370424597
19,51,2006,135,79,-36,180,1,56,-35,17,8531,15.840422411,9.2695805221,-4.224112643,-4,0.1173364623,6.5708418891,-4.106776181
19,51,2007,140,79,-24,179,1,61,-23,29,8560,16.38289158,9.2446316775,-2.808495699,-9,0.1170206541,7.1382599029,-2.691475045
19,51,2008,138,88,-36,179,0,50,-36,9,8569,16.113024695,10.274972269,-4.203397747,-5,0,5.8380524257,-4.203397747
19,53,2001,99,94,-9,796,9,5,0,-3,8656,11.435171816,10.857637886,-1.039561074,-8,1.0395610742,0.5775339301,0
19,53,2002,74,93,-89,738,8,-19,-81,-106,8550,8.601650587,10.810182494,-10.34522841,-6,0.9299081716,-2.208531907,-9.415320237
19,53,2003,102,102,-70,699,5,0,-65,-72,8478,11.980267794,11.980267794,-8.221752408,-7,0.5872680291,0,-7.634484379
19,53,2004,90,90,-15,788,6,0,-9,-13,8465,10.62385646,10.62385646,-1.770642743,-4,0.7082570973,0,-1.062385646
19,53,2005,109,80,-21,799,6,29,-15,7,8472,12.871228671,9.4467733365,-2.479778001,-7,0.7085080002,3.4244553345,-1.771270001
19,53,2006,95,89,-79,754,6,6,-73,-70,8402,11.259926514,10.548773261,-9.363517838,-3,0.7111532535,0.7111532535,-8.652364585
19,53,2007,109,99,22,795,4,10,26,30,8432,12.949982179,11.761910419,2.613757871,-6,0.4752287038,1.1880717595,3.0889865748
19,53,2008,110,95,-39,795,3,15,-36,-23,8409,13.063357283,11.281990381,-4.631553946,-2,0.3562733804,1.7813669022,-4.275280565
19,55,2001,207,163,-207,267,1,44,-206,-176,18212,11.31147541,8.9071038251,-11.31147541,-14,0.0546448087,2.4043715847,-11.2568306
19,55,2002,187,160,-99,264,1,27,-98,-89,18123,10.293105821,8.8069354617,-5.449291317,-18,0.0550433466,1.4861703592,-5.39424797
19,55,2003,224,168,-188,304,1,56,-187,-145,17978,12.409628542,9.3072214066,-10.41522396,-14,0.0554001274,3.1024071355,-10.35982383
19,55,2004,205,139,-229,307,0,66,-229,-180,17798,11.46019678,7.7705724508,-12.80187835,-17,0,3.6896243292,-12.80187835
19,55,2005,194,167,-195,296,1,27,-194,-176,17622,10.954263128,9.429700734,-11.0107284,-9,0.0564652739,1.5245623941,-10.95426313
19,55,2006,238,156,-184,303,0,82,-184,-111,17511,13.548515641,8.8805396636,-10.47448268,-9,0,4.667975977,-10.47448268
19,55,2007,203,156,-86,304,1,47,-85,-61,17450,11.612940133,8.9242298561,-4.919767741,-23,0.0572066016,2.6887102772,-4.86256114
19,55,2008,226,148,-194,304,0,78,-194,-149,17301,13.006819948,8.5177404967,-11.16514633,-33,0,4.489079451,-11.16514633
19,57,2001,531,414,-474,842,27,117,-447,-369,41916,12.612676809,9.8336124274,-11.25877365,-39,0.6413225496,2.7790643817,-10.6174511
19,57,2002,496,429,-683,784,25,67,-658,-611,41305,11.920068252,10.309897742,-16.41412624,-20,0.6008098917,1.6101705098,-15.81331635
19,57,2003,502,422,-236,920,21,80,-215,-173,41132,12.178997295,10.238121232,-5.725584386,-38,0.5094799665,1.9408760629,-5.216104419
19,57,2004,519,438,-470,913,24,81,-446,-407,40725,12.680650403,10.701589357,-11.48344063,-42,0.5863884579,1.9790610455,-10.89705218
19,57,2005,472,446,-194,903,22,26,-172,-185,40540,11.616316988,10.97643512,-4.774503169,-39,0.5414385037,0.639881868,-4.233064665
19,57,2006,546,453,-182,882,25,93,-157,-81,40459,13.481647922,11.185323276,-4.493882641,-17,0.6172915715,2.296324646,-3.876591069
19,57,2007,575,406,-60,872,25,169,-35,128,40587,14.189472645,10.019001555,-1.480640624,-6,0.6169335933,4.1704710905,-0.863707031
19,57,2008,547,395,-144,872,24,152,-120,42,40629,13.470252167,9.7271473601,-3.546099291,10,0.5910165485,3.7431048069,-2.955082742
19,59,2001,174,197,48,282,5,-23,53,15,16476,10.565625285,11.962230926,2.9146552509,-15,0.303609922,-1.396605641,3.2182651729
19,59,2002,150,179,-91,281,5,-29,-86,-128,16348,9.1396539118,10.906653668,-5.544723373,-13,0.3046551304,-1.766999756,-5.240068243
19,59,2003,155,186,29,280,-1,-31,28,-26,16322,9.4888276706,11.386593205,1.7753290481,-23,-0.061218243,-1.897765534,1.714110805
19,59,2004,180,180,176,279,0,0,176,158,16480,10.974940552,10.974940552,10.731052985,-18,0,0,10.731052985
19,59,2005,176,146,116,291,0,30,116,130,16610,10.637654881,8.8244182532,7.0111816259,-16,0,1.8132366274,7.0111816259
19,59,2006,153,161,73,282,0,-8,73,58,16668,9.1952641385,9.6760622634,4.3872828896,-7,0,-0.480798125,4.3872828896
19,59,2007,183,187,3,274,0,-4,3,1,16669,10.978792333,11.218765936,0.1799802022,2,0,-0.239973603,0.1799802022
19,59,2008,183,181,98,274,-1,2,97,106,16775,10.943667025,10.824064107,5.8605429972,7,-0.059801459,0.1196029183,5.8007415381
19,61,2001,1195,846,-711,4523,113,349,-598,-243,88988,13.410466897,9.4939372345,-7.97894725,6,1.2681027275,3.9165296629,-6.710844523
19,61,2002,1131,829,-181,4533,106,302,-75,217,89205,12.69410134,9.3045181348,-2.031505166,-10,1.1897212573,3.3895832047,-0.841783908
19,61,2003,1240,794,405,4910,85,446,490,904,90109,13.830487302,8.8559733205,4.5172156106,-32,0.9480575973,4.9745139811,5.4652732079
19,61,2004,1177,795,20,5003,91,382,111,524,90633,13.024089586,8.7970698565,0.2213099335,31,1.0069601974,4.2270197298,1.2282701309
19,61,2005,1207,854,-100,4891,89,353,-11,342,90975,13.292365975,9.4048720321,-1.101273072,0,0.9801330338,3.887493943,-0.121140038
19,61,2006,1133,879,77,4812,93,254,170,423,91398,12.425084854,9.639584807,0.8444232425,-1,1.0198878123,2.7855000466,1.8643110548
19,61,2007,1253,843,383,4819,86,410,469,898,92296,13.642252877,9.1783074025,4.1699783335,19,0.9363397825,4.4639454745,5.106318116
19,61,2008,1256,799,-174,4819,86,457,-88,428,92724,13.576910604,8.6369041185,-1.880877743,59,0.9296292293,4.9400064858,-0.951248514
19,63,2001,118,130,-109,527,12,-12,-97,-117,10875,10.792518407,11.890062651,-9.969360223,-8,1.0975442448,-1.097544245,-8.871815978
19,63,2002,130,131,-79,564,12,-1,-67,-76,10799,11.995939836,12.088216296,-7.289840362,-8,1.1073175233,-0.09227646,-6.182522838
19,63,2003,143,139,-113,524,9,4,-104,-112,10687,13.310993205,12.938657731,-10.51847715,-12,0.8377548171,0.3723354743,-9.680722331
19,63,2004,135,139,-167,520,8,-4,-159,-174,10513,12.735849057,13.113207547,-15.75471698,-11,0.7547169811,-0.377358491,-15
19,63,2005,147,108,-74,549,9,39,-65,-37,10476,14.007337177,10.291104864,-7.051312592,-11,0.857592072,3.7162323122,-6.19372052
19,63,2006,147,133,-77,550,8,14,-69,-59,10417,14.071698655,12.731536878,-7.370889772,-4,0.7658067295,1.3401617767,-6.605083042
19,63,2007,136,119,-49,552,7,17,-42,-20,10397,13.068127222,11.434611319,-4.708369367,5,0.6726241953,1.6335159028,-4.035745172
19,63,2008,141,143,53,552,6,-2,59,60,10457,13.522585595,13.71439532,5.082957706,3,0.5754291743,-0.191809725,5.6583868802
19,65,2001,207,276,-241,812,9,-69,-232,-317,21675,9.4808436577,12.641124877,-11.03808368,-16,0.4122105938,-3.160281219,-10.62587308
19,65,2002,210,265,-186,770,9,-55,-177,-246,21429,9.7438752784,12.295842613,-8.630289532,-14,0.4175946548,-2.551967335,-8.212694878
19,65,2003,214,248,-70,840,5,-34,-65,-124,21305,10.015444377,11.606683203,-3.276079936,-25,0.2340057097,-1.591238826,-3.042074227
19,65,2004,226,248,-233,853,4,-22,-229,-271,21034,10.675736319,11.714967288,-11.00640072,-20,0.1889510853,-1.039230969,-10.81744963
19,65,2005,241,248,-59,830,5,-7,-54,-80,20954,11.479470325,11.812898924,-2.81032676,-19,0.2381632847,-0.333428599,-2.572163475
19,65,2006,229,234,-243,842,4,-5,-239,-253,20701,10.995078622,11.235145841,-11.66726683,-9,0.1920537751,-0.240067219,-11.47521306
19,65,2007,237,253,-296,841,3,-16,-293,-304,20397,11.533407952,12.312034649,-14.4045939,5,0.1459925057,-0.778626697,-14.25860139
19,65,2008,234,251,-117,841,2,-17,-115,-124,20273,11.507253504,12.343250553,-5.753626752,8,0.098352594,-0.835997049,-5.655274158
19,67,2001,198,193,-241,479,12,5,-229,-236,16618,11.830783939,11.532026769,-14.4000956,-12,0.7170172084,0.2987571702,-13.68307839
19,67,2002,177,209,6,470,11,-32,17,-31,16587,10.661045023,12.588465593,0.3613913567,-16,0.6625508207,-1.927420569,1.0239421774
19,67,2003,192,192,-63,432,11,0,-52,-75,16512,11.601558959,11.601558959,-3.806761534,-23,0.6646726487,0,-3.142088885
19,67,2004,193,218,-66,430,12,-25,-54,-92,16420,11.721122313,13.239402405,-4.008259444,-13,0.7287744443,-1.518280092,-3.279484999
19,67,2005,187,193,-99,420,11,-6,-88,-109,16311,11.426476429,11.793101341,-6.049311051,-15,0.6721456723,-0.366624912,-5.377165378
19,67,2006,211,195,7,420,12,16,19,28,16339,12.924961715,11.944869832,0.4287901991,-7,0.7350689127,0.9800918836,1.1638591118
19,67,2007,236,189,-129,400,10,47,-119,-70,16269,14.474975466,11.592247301,-7.912168793,2,0.6133464181,2.8827281649,-7.298822375
19,67,2008,211,175,-139,400,9,36,-130,-86,16183,13.003821028,10.78515962,-8.566498213,8,0.5546653519,2.2186614076,-8.011832861
19,69,2001,127,130,-121,200,50,-3,-71,-82,10603,11.93160466,12.213453589,-11.3679068,-8,4.6974821496,-0.281848929,-6.670424652
19,69,2002,115,131,8,193,50,-16,58,30,10633,10.830664909,12.337540026,0.7534375589,-12,4.7089847429,-1.506875118,5.4624223018
19,69,2003,110,141,-58,195,35,-31,-23,-65,10568,10.376869016,13.301259375,-5.471440026,-11,3.3017310504,-2.924390359,-2.169708976
19,69,2004,137,137,11,241,34,0,45,39,10607,12.939787485,12.939787485,1.038961039,-6,3.2113341204,0,4.2502951594
19,69,2005,131,109,-45,238,35,22,-10,3,10610,12.348588396,10.274779658,-4.24188151,-9,3.2992411745,2.0738087383,-0.942640336
19,69,2006,124,116,-149,231,34,8,-115,-113,10497,11.749656512,10.991614156,-14.11853887,-6,3.2216800114,0.7580423556,-10.89685886
19,69,2007,153,113,-23,232,32,40,9,51,10548,14.540270848,10.738892849,-2.18579235,2,3.0411023996,3.8013779995,0.8553100499
19,69,2008,154,122,-139,232,31,32,-108,-71,10477,14.649227111,11.605231867,-13.22235434,5,2.9488703924,3.0439952438,-10.27348395
19,71,2001,87,90,-126,174,6,-3,-120,-127,7869,10.967538607,11.345729593,-15.88402143,-4,0.7563819729,-0.378190986,-15.12763946
19,71,2002,86,104,-78,176,5,-18,-73,-97,7772,10.996739339,13.298382456,-9.973786842,-6,0.6393453104,-2.301643117,-9.334441532
19,71,2003,73,94,-28,170,2,-21,-26,-58,7714,9.4278703345,12.139997417,-3.616169443,-11,0.2582978174,-2.712127083,-3.357871626
19,71,2004,88,106,-77,158,5,-18,-72,-96,7618,11.479259066,13.82728933,-10.04435168,-6,0.6522306288,-2.348030264,-9.392121054
19,71,2005,71,92,-25,152,3,-21,-22,-48,7570,9.3494864367,12.114827495,-3.292072689,-5,0.3950487227,-2.765341059,-2.897023966
19,71,2006,99,93,-11,146,4,6,-7,-5,7565,13.082259663,12.289395441,-1.453584407,-4,0.528576148,0.792864222,-0.925008259
19,71,2007,92,58,-36,135,3,34,-33,-12,7553,12.17092208,7.6729726154,-4.762534727,-13,0.3968778939,4.4979494642,-4.365656833
19,71,2008,103,79,-128,135,2,24,-126,-107,7446,13.73424895,10.534035602,-17.06780452,-5,0.2666844456,3.2002133476,-16.80112007
19,73,2001,99,138,-154,234,5,-39,-149,-193,10145,9.6665527511,13.474588683,-15.03685983,-5,0.4882097349,-3.808035932,-14.5486501
19,73,2002,92,137,5,234,4,-45,9,-45,10100,9.0886638676,13.534205977,0.4939491232,-9,0.3951592986,-4.445542109,0.8891084218
19,73,2003,119,142,-63,291,2,-23,-61,-91,10009,11.835496544,14.123029489,-6.265851111,-7,0.1989159083,-2.287532945,-6.066935203
19,73,2004,96,133,-27,291,3,-37,-24,-68,9941,9.6240601504,13.333333333,-2.706766917,-7,0.3007518797,-3.709273183,-2.406015038
19,73,2005,95,122,-117,277,3,-27,-114,-146,9795,9.627077422,12.363194163,-11.85650588,-5,0.3040129712,-2.736116741,-11.55249291
19,73,2006,103,99,-228,261,3,4,-225,-226,9569,10.638297872,10.225160091,-23.54885354,-5,0.3098533361,0.4131377815,-23.23900021
19,73,2007,119,99,-98,263,3,20,-95,-90,9479,12.494750105,10.394792104,-10.2897942,-15,0.3149937001,2.0999580008,-9.974800504
19,73,2008,99,109,-163,263,2,-10,-161,-186,9293,10.547624121,11.613040699,-17.36629022,-15,0.2130833156,-1.065416578,-17.1532069
19,75,2001,130,128,-67,173,1,2,-66,-75,12287,10.548095257,10.385816869,-5.436326017,-11,0.0811391943,0.1622783886,-5.355186823
19,75,2002,125,129,34,160,0,-4,34,18,12305,10.165907612,10.491216656,2.7651268705,-12,0,-0.325309044,2.7651268705
19,75,2003,119,158,-4,150,-2,-39,-6,-62,12243,9.6952908587,12.872739123,-0.32589213,-17,-0.162946065,-3.177448265,-0.488838195
19,75,2004,122,151,42,147,1,-29,43,6,12249,9.962436714,12.330556917,3.4296913278,-8,0.0816593173,-2.368120203,3.5113506451
19,75,2005,124,128,6,145,-1,-4,5,-11,12238,10.127822926,10.454526892,0.4900559481,-12,-0.081675991,-0.326703965,0.4083799567
19,75,2006,114,136,28,143,0,-22,28,-1,12237,9.315628192,11.113381001,2.2880490296,-7,0,-1.797752809,2.2880490296
19,75,2007,146,136,-106,146,0,10,-106,-90,12147,11.975065617,11.154855643,-8.694225722,6,0,0.8202099738,-8.694225722
19,75,2008,136,135,29,146,-1,1,28,36,12183,11.179613646,11.097410604,2.3838882039,7,-0.082203042,0.0822030415,2.3016851624
19,77,2001,120,139,-92,235,4,-19,-88,-120,11222,10.636411984,12.320510548,-8.154582521,-13,0.3545470661,-1.684098564,-7.800035455
19,77,2002,137,137,6,239,3,0,9,-1,11221,12.208706501,12.208706501,0.534687876,-10,0.267343938,0,0.8020318139
19,77,2003,146,147,104,247,1,-1,105,98,11319,12.954747116,13.043478261,9.2280390417,-6,0.0887311446,-0.088731145,9.3167701863
19,77,2004,133,167,86,217,2,-34,88,42,11361,11.728395062,14.726631393,7.5837742504,-12,0.176366843,-2.998236332,7.7601410935
19,77,2005,115,144,-114,193,2,-29,-112,-147,11214,10.188261351,12.757475083,-10.09966777,-6,0.1771871539,-2.569213732,-9.92248062
19,77,2006,130,128,-146,178,2,2,-144,-148,11066,11.669658887,11.490125673,-13.1059246,-6,0.1795332136,0.1795332136,-12.92639138
19,77,2007,116,122,-35,169,2,-6,-33,-51,11015,10.506770527,11.050224175,-3.17014628,-12,0.181151216,-0.543453648,-2.988995064
19,77,2008,125,137,-35,169,1,-12,-34,-59,10956,11.378635474,12.47098448,-3.186017933,-13,0.0910290838,-1.092349006,-3.094988849
19,79,2001,182,191,-242,208,16,-9,-226,-245,16168,11.172155551,11.724624781,-14.85528375,-10,0.9821675209,-0.552469231,-13.87311623
19,79,2002,181,173,34,216,16,8,50,44,16212,11.179740581,10.6856084,2.1000617665,-14,0.9882643607,0.4941321804,3.0883261272
19,79,2003,182,159,-61,197,12,23,-49,-51,16161,11.243937849,9.8230006487,-3.768572576,-25,0.7413585395,1.4209372008,-3.027214036
19,79,2004,191,178,-150,202,11,13,-139,-138,16023,11.869251802,11.061396967,-9.321401939,-12,0.6835694755,0.8078548347,-8.637832463
19,79,2005,182,197,-71,197,12,-15,-59,-86,15937,11.389236546,12.327909887,-4.443053817,-12,0.7509386733,-0.938673342,-3.692115144
19,79,2006,188,168,-199,188,12,20,-187,-175,15762,11.86157292,10.599703461,-12.55560112,-8,0.7571216758,1.2618694596,-11.79847945
19,79,2007,194,149,-241,180,10,45,-231,-204,15558,12.388250319,9.5146871009,-15.38952746,-18,0.6385696041,2.8735632184,-14.75095785
19,79,2008,185,150,-221,180,9,35,-212,-201,15357,11.968300178,9.7040271713,-14.2972667,-24,0.5822416303,2.2642730066,-13.71502507
19,81,2001,126,136,-187,194,11,-10,-176,-192,11904,10.5,11.333333333,-15.58333333,-6,0.9166666667,-0.833333333,-14.66666667
19,81,2002,115,110,-152,194,10,5,-142,-143,11761,9.7189942954,9.296429326,-12.84597507,-6,0.8451299387,0.4225649694,-12.00084513
19,81,2003,110,124,30,191,9,-14,39,11,11772,9.3485743424,10.538392895,2.5496111843,-14,0.7648833553,-1.189818553,3.3144945396
19,81,2004,117,117,-99,194,9,0,-90,-101,11671,9.9816576377,9.9816576377,-8.446018001,-11,0.7678198183,0,-7.678198183
19,81,2005,142,128,-60,186,9,14,-51,-47,11624,12.191457394,10.989482722,-5.151320026,-10,0.7726980039,1.2019746727,-4.378622022
19,81,2006,136,152,-68,173,10,-16,-58,-78,11546,11.739318084,13.120414329,-5.869659042,-4,0.8631851532,-1.381096245,-5.006473889
19,81,2007,134,118,-209,177,8,16,-201,-178,11368,11.695906433,10.299380292,-18.24212272,7,0.6982630706,1.3965261412,-17.54385965
19,81,2008,131,115,-38,177,7,16,-31,-14,11354,11.530675117,10.122348385,-3.344775988,1,0.6161429452,1.4083267318,-2.728633043
19,83,2001,215,266,-117,875,17,-51,-100,-166,18650,11.477072546,14.199540917,-6.245662734,-15,0.9074894571,-2.722468371,-5.338173277
19,83,2002,208,235,-203,866,16,-27,-187,-226,18424,11.22080164,12.677348007,-10.95107083,-12,0.8631385877,-1.456546367,-10.08793224
19,83,2003,220,224,-196,877,9,-4,-187,-207,18217,12.008405884,12.226740537,-10.69839797,-16,0.491252968,-0.218334652,-10.207145
19,83,2004,177,259,-122,868,10,-82,-112,-209,18008,9.7722567288,14.299516908,-6.735679779,-15,0.5521048999,-4.527260179,-6.183574879
19,83,2005,218,278,-165,855,9,-60,-156,-233,17775,12.184556913,15.538104687,-9.222256379,-17,0.5030321661,-3.353547774,-8.719224213
19,83,2006,209,226,-144,875,10,-17,-134,-159,17616,11.810912379,12.771608601,-8.137662117,-8,0.5651154248,-0.960696222,-7.572546693
19,83,2007,191,269,-80,832,10,-78,-70,-143,17473,10.886602639,15.332440366,-4.559833566,5,0.5699791958,-4.445837727,-3.98985437
19,83,2008,212,233,-100,832,9,-21,-91,-102,17371,12.168522558,13.373895075,-5.739869131,10,0.5165882218,-1.205372518,-5.223280909
19,85,2001,187,173,-57,328,6,14,-51,-52,15639,11.937440153,11.043728056,-3.638684966,-15,0.3830194702,0.893712097,-3.255665496
19,85,2002,152,230,-53,317,5,-78,-48,-140,15499,9.7629905582,14.772946239,-3.404200655,-14,0.3211510052,-5.009955681,-3.08304965
19,85,2003,188,191,70,310,2,-3,72,50,15549,12.110280855,12.303530018,4.509147127,-19,0.1288327751,-0.193249163,4.6379799021
19,85,2004,145,168,31,305,4,-23,35,0,15549,9.325358544,10.804553347,1.9936973439,-12,0.2572512702,-1.479194804,2.2509486141
19,85,2005,165,195,23,302,3,-30,26,-19,15530,10.618102256,12.548666302,1.4800991023,-15,0.1930564046,-1.930564046,1.6731555069
19,85,2006,178,199,1,307,4,-21,5,-23,15507,11.470180752,12.823404324,0.0644392177,-7,0.2577568708,-1.353223572,0.3221960885
19,85,2007,192,190,-114,294,2,2,-112,-104,15403,12.423164025,12.293756066,-7.37625364,6,0.1294079586,0.1294079586,-7.246845681
19,85,2008,191,185,-200,294,1,6,-199,-181,15222,12.473469388,12.081632653,-13.06122449,12,0.0653061224,0.3918367347,-12.99591837
19,87,2001,245,196,11,1556,6,49,17,45,20337,12.060350981,9.6482807847,0.5414851461,-21,0.2953555342,2.4120701962,0.8368406803
19,87,2002,218,225,-357,1477,5,-7,-352,-368,19969,10.817248052,11.16459088,-17.7144842,-9,0.2481020196,-0.347342827,-17.46638218
19,87,2003,223,201,139,1690,2,22,141,137,20106,11.129132876,10.031191516,6.9369931379,-26,0.0998128509,1.09794136,7.0368059888
19,87,2004,229,199,-54,1673,7,30,-47,-32,20074,11.398705824,9.9054255849,-2.68790443,-15,0.3484320557,1.4932802389,-2.339472374
19,87,2005,250,202,58,1719,5,48,63,93,20167,12.42513854,10.039511941,2.8826321413,-18,0.2485027708,2.3856265997,3.1311349122
19,87,2006,234,211,-86,1706,7,23,-79,-66,20101,11.622131717,10.479785438,-4.271381742,-10,0.3476706069,1.1423462799,-3.923711135
19,87,2007,236,210,52,1772,4,26,56,72,20173,11.719719919,10.428564334,2.5823111685,-10,0.1986393207,1.2911555842,2.7809504891
19,87,2008,244,194,-14,1772,4,50,-10,40,20213,12.083395236,9.6072896548,-0.693309563,0,0.1980884465,2.4761055811,-0.495221116
19,89,2001,106,117,-28,272,2,-11,-26,-46,9868,10.716813265,11.828935396,-2.830856334,-9,0.2022040239,-1.112122131,-2.62865231
19,89,2002,118,127,-58,262,2,-9,-56,-72,9796,12.001627339,12.917005696,-5.899104963,-7,0.2034174125,-0.915378356,-5.695687551
19,89,2003,105,113,-64,248,1,-8,-63,-81,9715,10.763159244,11.583209472,-6.560401825,-10,0.1025062785,-0.820050228,-6.457895546
19,89,2004,101,116,-12,264,0,-15,-12,-33,9682,10.413981544,11.960612466,-1.237304738,-6,0,-1.546630922,-1.237304738
19,89,2005,138,129,-60,264,1,9,-59,-58,9624,14.296073759,13.363721123,-6.215684243,-8,0.1035947374,0.9323526365,-6.112089506
19,89,2006,121,112,-88,273,0,9,-88,-84,9540,12.627843874,11.688582759,-9.183886454,-5,0,0.9392611146,-9.183886454
19,89,2007,133,106,-56,257,1,27,-55,-24,9516,13.958858102,11.125104954,-5.877413938,4,0.1049538203,2.8337531486,-5.772460118
19,89,2008,127,102,-62,257,0,25,-62,-32,9484,13.368421053,10.736842105,-6.526315789,5,0,2.6315789474,-6.526315789
19,91,2001,89,107,-71,160,13,-18,-58,-87,10282,8.6194373154,10.362694301,-6.87618033,-11,1.2590189337,-1.743256985,-5.617161397
19,91,2002,130,132,-210,155,13,-2,-197,-204,10078,12.770137525,12.966601179,-20.62868369,-5,1.2770137525,-0.196463654,-19.35166994
19,91,2003,101,130,-28,181,10,-29,-18,-58,10020,10.050751319,12.936610608,-2.7863469,-11,0.9951238929,-2.885859289,-1.791223007
19,91,2004,122,130,-68,179,9,-8,-59,-76,9944,12.221999599,13.023442196,-6.812262072,-9,0.9016229213,-0.801442597,-5.91063915
19,91,2005,133,118,-153,173,10,15,-143,-134,9810,13.465627215,11.946947454,-15.49053356,-6,1.012453174,1.5186797611,-14.47808039
19,91,2006,116,124,-75,168,9,-8,-66,-78,9732,11.871865725,12.690615085,-7.675775253,-4,0.9210930304,-0.81874936,-6.754682223
19,91,2007,120,108,-169,167,9,12,-160,-154,9578,12.428793371,11.185914034,-17.503884,-6,0.9321595028,1.2428793371,-16.5717245
19,91,2008,115,123,-56,167,8,-8,-48,-64,9514,12.046930652,12.884978001,-5.866331448,-8,0.8380473497,-0.83804735,-5.028284098
19,93,2001,69,80,-121,160,0,-11,-121,-137,7659,8.9291491427,10.352636687,-15.65836299,-5,0,-1.423487544,-15.65836299
19,93,2002,89,119,-74,152,0,-30,-74,-112,7547,11.705905564,15.651716428,-9.733000132,-8,0,-3.945810864,-9.733000132
19,93,2003,85,110,-69,153,-1,-25,-70,-103,7444,11.340137416,14.67547195,-9.205523314,-8,-0.133413381,-3.335334534,-9.338936695
19,93,2004,77,89,-129,151,0,-12,-129,-149,7295,10.448470045,12.07680304,-17.50457969,-8,0,-1.628332994,-17.50457969
19,93,2005,75,111,-86,143,0,-36,-86,-126,7169,10.370575221,15.348451327,-11.89159292,-4,0,-4.977876106,-11.89159292
19,93,2006,81,110,-148,134,0,-29,-148,-180,6989,11.442294109,15.538917926,-20.90690776,-3,0,-4.096623817,-20.90690776
19,93,2007,99,96,-51,130,0,3,-51,-59,6930,14.225159853,13.794094403,-7.328112652,-11,0,0.4310654501,-7.328112652
19,93,2008,88,88,-54,130,-1,0,-55,-68,6862,12.761020882,12.761020882,-7.83062645,-13,-0.145011601,0,-7.975638051
19,95,2001,184,170,72,288,4,14,76,76,15784,11.68550743,10.796392735,4.5725898641,-14,0.2540327702,0.8891146958,4.8266226343
19,95,2002,174,149,-36,305,4,25,-32,-22,15762,11.031509542,9.4465225385,-2.282381284,-15,0.2535979205,1.5849870031,-2.028783364
19,95,2003,192,152,49,302,2,40,51,74,15836,12.15266789,9.6208620799,3.1014621179,-17,0.1265902905,2.5318058105,3.2280524084
19,95,2004,181,186,-10,294,1,-5,-9,-24,15812,11.438321537,11.75429727,-0.631951466,-10,0.0631951466,-0.315975733,-0.56875632
19,95,2005,200,165,92,293,2,35,94,113,15925,12.60358572,10.397958219,5.7976494313,-16,0.1260358572,2.205627501,5.9236852885
19,95,2006,196,169,12,282,1,27,13,32,15957,12.295339063,10.601593376,0.752775861,-8,0.0627313217,1.6937456872,0.8155071827
19,95,2007,199,145,-159,280,2,54,-157,-97,15860,12.50903605,9.1146242575,-9.994656944,6,0.1257189553,3.3944117924,-9.868937989
19,95,2008,188,170,-13,280,1,18,-12,17,15877,11.847370577,10.713047862,-0.819233072,11,0.0630179286,1.1343227148,-0.756215143
19,97,2001,261,222,-68,293,2,39,-66,-47,20255,12.870774466,10.947555293,-3.353305225,-20,0.0986266243,1.923219173,-3.2546786
19,97,2002,210,190,-139,289,1,20,-138,-133,20122,10.401961513,9.4112985115,-6.885107858,-15,0.0495331501,0.9906630012,-6.835574708
19,97,2003,216,204,4,285,-1,12,3,-15,20107,10.738521962,10.141937408,0.1988615178,-30,-0.049715379,0.5965845534,0.1491461384
19,97,2004,210,205,-10,287,2,5,-8,-17,20090,10.448540936,10.199766152,-0.497549568,-14,0.0995099137,0.2487747842,-0.398039655
19,97,2005,192,204,-8,279,0,-12,-8,-39,20051,9.566278867,10.164171296,-0.398594953,-19,0,-0.597892429,-0.398594953
19,97,2006,207,231,41,278,1,-24,42,7,20058,10.321872896,11.518611783,2.0444289312,-11,0.0498641203,-1.196738887,2.0942930514
19,97,2007,234,197,-85,279,0,37,-85,-40,20018,11.677812157,9.8313204911,-4.241940313,8,0,1.8464916658,-4.241940313
19,97,2008,220,205,-84,279,-1,15,-85,-53,19965,11.004676988,10.254358102,-4.201785759,17,-0.050021259,0.7503188855,-4.251807018
19,99,2001,483,375,-42,1659,26,108,-16,54,37269,12.969228291,10.069276623,-1.127758982,-38,0.6981365125,2.8999516675,-0.429622469
19,99,2002,451,337,-1,1717,24,114,23,100,37369,12.084996918,9.0302526863,-0.026796002,-37,0.6431040489,3.0547442322,0.6163080468
19,99,2003,463,342,-49,1720,17,121,-32,37,37406,12.383818121,9.147442327,-1.310598462,-52,0.4546974256,3.236375794,-0.855901036
19,99,2004,422,343,-210,1721,20,79,-190,-140,37266,11.302764088,9.1868437969,-5.624598243,-29,0.5356760231,2.1159202914,-5.08892222
19,99,2005,439,353,-313,1723,19,86,-294,-238,37028,11.817912617,9.5027862277,-8.425983256,-30,0.5114814117,2.3151263897,-7.914501844
19,99,2006,450,384,-283,1729,21,66,-262,-212,36816,12.187855479,10.400303342,-7.66480689,-16,0.568766589,1.7875521369,-7.096040301
19,99,2007,414,345,-244,1680,17,69,-227,-169,36647,11.270979949,9.3924832909,-6.642799777,-11,0.4628180172,1.8784966582,-6.17998176
19,99,2008,429,328,-163,1680,17,101,-146,-64,36583,11.716509627,8.9580772907,-4.451727434,-19,0.4642905913,2.7584323365,-3.987436843
19,101,2001,145,149,-124,638,18,-4,-106,-122,16034,9.009009009,9.2575333955,-7.70425598,-12,1.118359739,-0.248524386,-6.585896241
19,101,2002,156,129,-267,626,18,27,-249,-230,15804,9.7996105283,8.1035240907,-16.77241033,-8,1.1307242917,1.6960864376,-15.64168604
19,101,2003,147,172,-53,640,15,-25,-38,-81,15723,9.3253401846,10.911282393,-3.362197482,-18,0.951565325,-1.585942208,-2.410632157
19,101,2004,138,142,-33,654,12,-4,-21,-35,15688,8.7867307631,9.0414186113,-2.101174748,-10,0.7640635446,-0.254687848,-1.337111203
19,101,2005,164,151,-141,651,14,13,-127,-128,15560,10.496671787,9.6646185356,-9.024577573,-14,0.8960573477,0.8320532514,-8.128520225
19,101,2006,175,154,-87,647,13,21,-74,-59,15501,11.26814977,9.9159717974,-5.601880171,-6,0.8370625543,1.3521779724,-4.764817617
19,101,2007,136,136,37,625,13,0,50,50,15551,8.7595001932,8.7595001932,2.3830993173,0,0.8373051655,0,3.2204044828
19,101,2008,165,149,-118,625,12,16,-106,-88,15463,10.640355968,9.6085638744,-7.609466692,2,0.7738440704,1.0317920939,-6.835622622
19,103,2001,1362,487,729,8284,550,875,1279,2388,113849,12.09000932,4.3229328481,6.4710842839,234,4.8821623541,7.7670764724,11.353246638
19,103,2002,1407,536,121,8259,521,871,642,1685,115534,12.267692026,4.6734064861,1.0550040762,172,4.5426208568,7.5942855399,5.597624933
19,103,2003,1491,543,372,8113,454,948,826,1926,117460,12.79861284,4.6610642334,3.1932152759,152,3.8970960626,8.1375486064,7.0903113385
19,103,2004,1597,508,785,8148,411,1089,1196,2304,119764,13.464067717,4.2828718848,6.618217381,19,3.4650794186,9.1811958318,10.0832968
19,103,2005,1454,539,132,8021,433,915,565,1472,121236,12.066390041,4.4730290456,1.0954356846,-8,3.5933609959,7.5933609959,4.6887966805
19,103,2006,1510,542,484,8215,437,968,921,1890,123126,12.358713712,4.4360416104,3.9613360506,1,3.5766608556,7.9226721012,7.5379969062
19,103,2007,1688,514,735,8307,399,1174,1134,2328,125454,13.58114088,4.1354895808,5.9135891866,20,3.2102341299,9.4456512994,9.1238233164
19,103,2008,1705,527,1035,8307,399,1178,1434,2640,128094,13.449129948,4.157003802,8.1641346017,28,3.1473330494,9.2921261457,11.311467651
19,105,2001,213,201,-41,1657,1,12,-40,-50,20159,10.552913199,9.9583828775,-2.03131193,-22,0.0495441934,0.594530321,-1.981767737
19,105,2002,186,208,34,1622,0,-22,34,-7,20152,9.2282503535,10.319763836,1.6868844732,-19,0,-1.091513483,1.6868844732
19,105,2003,227,176,44,1663,0,51,44,65,20217,11.246253313,8.7195620402,2.17989051,-30,0,2.526691273,2.17989051
19,105,2004,217,208,165,1652,1,9,166,156,20373,10.692288741,10.248829761,8.1300813008,-19,0.04927322,0.44345898,8.1793545208
19,105,2005,230,190,-84,1692,0,40,-84,-60,20313,11.306100379,9.3398220518,-4.129184486,-16,0,1.9662783267,-4.129184486
19,105,2006,215,182,-6,1722,1,33,-5,18,20331,10.579667356,8.9558114359,-0.295246531,-10,0.0492077551,1.6238559197,-0.246038776
19,105,2007,229,179,-9,1684,1,50,-8,19,20350,11.258326983,8.8001769868,-0.442466999,-23,0.0491629999,2.4581499963,-0.393303999
19,105,2008,248,184,-54,1684,0,64,-54,-4,20346,12.187930018,9.0426577551,-2.653823472,-14,0,3.1452722626,-2.653823472
19,107,2001,137,138,-33,164,2,-1,-31,-44,11374,12.021762022,12.10951211,-2.895752896,-12,0.1755001755,-0.087750088,-2.72025272
19,107,2002,131,118,-33,152,1,13,-32,-30,11344,11.532705344,10.388238401,-2.905185316,-11,0.0880359187,1.1444669425,-2.817149397
19,107,2003,141,137,-143,145,0,4,-143,-146,11198,12.509981368,12.15508828,-12.68742791,-7,0,0.3548930885,-12.68742791
19,107,2004,129,128,-110,157,1,1,-109,-119,11079,11.581451722,11.491673026,-9.875656507,-11,0.0897786955,0.0897786955,-9.785877811
19,107,2005,130,141,-160,146,0,-11,-160,-180,10899,11.83001183,12.831012831,-14.56001456,-9,0,-1.001001001,-14.56001456
19,107,2006,123,137,-107,133,1,-14,-106,-125,10774,11.350528307,12.642458358,-9.87403682,-5,0.0922807179,-1.291930051,-9.781756102
19,107,2007,139,108,-58,136,1,31,-57,-24,10750,12.915814904,10.035309422,-5.389332838,2,0.0929195317,2.8805054823,-5.296413306
19,107,2008,123,115,-65,136,0,8,-65,-53,10697,11.470135683,10.724110598,-6.061453816,4,0,0.7460250851,-6.061453816
19,109,2001,165,199,-303,304,3,-34,-300,-345,16779,9.7336518892,11.739374097,-17.87452438,-11,0.1769754889,-2.005722207,-17.69754889
19,109,2002,160,191,-240,260,2,-31,-238,-283,16496,9.6168294515,11.480090158,-14.42524418,-14,0.1202103681,-1.863260706,-14.30503381
19,109,2003,172,183,-179,256,-1,-11,-180,-206,16290,10.492283292,11.163301409,-10.91929482,-15,-0.061001647,-0.671018117,-10.98029647
19,109,2004,153,184,-98,260,2,-31,-96,-139,16151,9.4325082457,11.343670047,-6.041737308,-12,0.1233007614,-1.911161801,-5.918436546
19,109,2005,185,161,-214,262,0,24,-214,-202,15949,11.526479751,10.031152648,-13.33333333,-12,0,1.4953271028,-13.33333333
19,109,2006,186,178,-242,279,1,8,-241,-239,15710,11.75021321,11.244827695,-15.28791181,-6,0.0631731893,0.5053855144,-15.22473862
19,109,2007,170,186,-104,265,1,-16,-103,-120,15590,10.862619808,11.884984026,-6.645367412,-1,0.0638977636,-1.022364217,-6.581469649
19,109,2008,186,192,-127,265,0,-6,-127,-127,15463,11.979518887,12.36595498,-8.179563971,6,0,-0.386436093,-8.179563971
19,111,2001,399,432,-495,1579,16,-33,-479,-537,37381,10.597750302,11.474255966,-13.14758496,-25,0.4249724432,-0.876505664,-12.72261252
19,111,2002,399,417,-503,1566,15,-18,-488,-526,36855,10.74950159,11.234441511,-13.55137669,-20,0.4041166011,-0.484939921,-13.14726009
19,111,2003,428,414,-383,1608,13,14,-370,-382,36473,11.67357626,11.291730308,-10.44621427,-26,0.3545712415,0.3818459524,-10.09164303
19,111,2004,381,447,-7,1714,17,-66,10,-79,36394,10.457408704,12.268928321,-0.192130869,-23,0.466603538,-1.811519618,0.2744726694
19,111,2005,409,452,-209,1649,16,-43,-193,-269,36125,11.279802535,12.465698644,-5.764006674,-33,0.4412636688,-1.18589611,-5.322743005
19,111,2006,416,414,-251,1685,18,2,-233,-248,35877,11.555234577,11.499680564,-6.972028555,-17,0.4999861115,0.0555540124,-6.472042443
19,111,2007,445,425,-209,1801,14,20,-195,-171,35706,12.433119595,11.874327704,-5.839375271,4,0.3911543244,0.5587918919,-5.448220946
19,111,2008,411,386,-335,1801,14,25,-321,-298,35408,11.558905419,10.855808983,-9.421492252,-2,0.3937340046,0.7030964367,-9.027758247
19,113,2001,2770,1503,451,5091,283,1267,734,2007,194295,14.330687071,7.7758204577,2.3332634906,6,1.4641099065,6.5548666134,3.7973733972
19,113,2002,2792,1372,-58,5237,266,1420,208,1598,195893,14.311050058,7.0325074067,-0.297292587,-30,1.3634453135,7.2785426512,1.0661527264
19,113,2003,2747,1514,-569,5285,234,1233,-335,814,196707,13.993886908,7.7126846663,-2.898624554,-84,1.1920529801,6.2812022415,-1.706571574
19,113,2004,2787,1504,-155,5284,220,1283,65,1432,198139,14.116896208,7.6181599915,-0.785116223,84,1.1143585094,6.4987362161,0.3292422869
19,113,2005,2703,1512,636,5339,225,1191,861,2052,200191,13.571661688,7.591695328,3.1933321618,0,1.1297165667,5.9799663596,4.3230487284
19,113,2006,2881,1586,774,5261,226,1295,1000,2297,202488,14.309164372,7.8772421706,3.8442531148,2,1.1224821756,6.4319222011,4.9667352904
19,113,2007,2897,1551,1549,5318,203,1346,1752,3133,205621,14.197187516,7.6009105411,7.591109238,35,0.9948322629,6.596276975,8.5859415009
19,113,2008,2957,1507,1252,5318,203,1450,1455,2953,208574,14.278298869,7.2767657746,6.0454616787,48,0.9802146332,7.0015330943,7.0256763119
19,115,2001,175,118,-82,175,35,57,-47,-1,12167,14.382576536,9.6979658927,-6.739264434,-11,2.8765153072,4.6846106431,-3.862749127
19,115,2002,164,102,-57,173,35,62,-22,28,12195,13.463590838,8.3736967408,-4.679418767,-12,2.873327313,5.0898940974,-1.806091454
19,115,2003,169,104,-98,165,27,65,-71,-19,12176,13.868942596,8.5347339051,-8.042345411,-13,2.2157482253,5.3342086907,-5.826597185
19,115,2004,139,117,-160,173,24,22,-136,-127,12049,11.475748194,9.6594427245,-13.20949432,-13,1.9814241486,1.8163054696,-11.22807018
19,115,2005,156,121,-328,167,25,35,-303,-274,11775,13.096037609,10.157824043,-27.53525856,-6,2.0987239758,2.9382135662,-25.43653459
19,115,2006,143,103,-67,174,24,40,-43,-9,11766,12.149016609,8.750690285,-5.692196593,-6,2.0389957946,3.3983263243,-3.653200799
19,115,2007,150,121,-40,162,20,29,-20,2,11768,12.747514235,10.282994816,-3.399337129,-7,1.6996685646,2.4645194187,-1.699668565
19,115,2008,156,113,-92,162,19,43,-73,-43,11725,13.280551654,9.6198867748,-7.832120206,-13,1.617503086,3.6606648789,-6.21461712
19,117,2001,117,124,53,202,1,-7,54,38,9443,12.415110357,13.157894737,5.6239388795,-9,0.1061120543,-0.74278438,5.7300509338
19,117,2002,114,106,-5,211,1,8,-4,-4,9439,12.074992056,11.227624192,-0.529604915,-8,0.1059209829,0.8473678636,-0.423683932
19,117,2003,98,109,55,197,1,-11,56,35,9474,10.363242214,11.526463279,5.8161053244,-10,0.1057473695,-1.163221065,5.9218526939
19,117,2004,106,95,149,198,0,11,149,149,9623,11.101220087,9.9492066817,15.604545217,-11,0,1.1520134052,15.604545217
19,117,2005,91,124,11,200,1,-33,12,-31,9592,9.4717668488,12.906583398,1.1449388499,-10,0.10408535,-3.43481655,1.2490241998
19,117,2006,121,110,-138,141,0,11,-138,-132,9460,12.702078522,11.547344111,-14.48666807,-5,0,1.1547344111,-14.48666807
19,117,2007,135,98,-64,147,1,37,-63,-27,9433,14.291007251,10.374212671,-6.77499603,-1,0.105859313,3.91679458,-6.669136717
19,117,2008,119,98,-160,147,0,21,-160,-143,9290,12.711638092,10.468407841,-17.09127811,-4,0,2.2432302516,-17.09127811
19,119,2001,135,130,-105,196,6,5,-99,-104,11637,11.549319873,11.121567285,-8.982804346,-10,0.5133031055,0.4277525879,-8.46950124
19,119,2002,159,105,-101,202,6,54,-95,-48,11589,13.69155257,9.0415913201,-8.697149746,-7,0.5166623611,4.6499612503,-8.180487385
19,119,2003,162,138,-31,194,4,24,-27,-20,11569,13.990845496,11.918127645,-2.677260558,-17,0.3454529752,2.0727178513,-2.331807583
19,119,2004,146,113,-70,202,3,33,-67,-43,11526,12.643429314,9.7856678935,-6.061918164,-9,0.2597964927,2.8577614202,-5.802121671
19,119,2005,164,112,-106,199,4,52,-102,-59,11467,14.265211151,9.7420954203,-9.220197451,-9,0.3479319793,4.5231157309,-8.872265472
19,119,2006,169,141,-128,191,3,28,-125,-101,11366,14.803135812,12.350545263,-11.21184251,-4,0.2627775588,2.4525905488,-10.94906495
19,119,2007,170,112,-181,194,3,58,-178,-119,11247,15.035598992,9.9058063946,-16.00849069,1,0.2653340999,5.1297925972,-15.74315659
19,119,2008,164,111,-66,194,2,53,-64,-13,11234,14.590098305,9.8750055603,-5.871624928,-2,0.1779280281,4.715092745,-5.6936969
19,121,2001,172,133,66,310,-1,39,65,92,14150,12.195121951,9.4299489507,4.6795235394,-12,-0.070901872,2.7651730006,4.6086216676
19,121,2002,203,160,137,221,-2,43,135,167,14317,14.262128078,11.24108617,9.625180033,-11,-0.140513577,3.0210419082,9.4846664559
19,121,2003,196,138,102,206,-4,58,98,140,14457,13.623410023,9.5919927713,7.0897337874,-16,-0.278028776,4.0314172517,6.8117050115
19,121,2004,212,136,173,204,2,76,175,236,14693,14.545454545,9.3310463122,11.869639794,-15,0.1372212693,5.2144082333,12.006861063
19,121,2005,172,118,137,212,-1,54,136,177,14870,11.63616683,7.9829516626,9.2683421845,-13,-0.067652133,3.6532151676,9.2006900518
19,121,2006,211,154,275,195,1,57,276,324,15194,14.03672166,10.24481107,18.294305482,-9,0.0665247472,3.7919105907,18.360830229
19,121,2007,190,128,124,190,-1,62,123,183,15377,12.430080796,8.3739491675,8.112263256,-2,-0.065421478,4.056131628,8.0468417782
19,121,2008,208,146,73,190,-1,62,72,130,15507,13.469757803,9.4547338428,4.7273669214,-4,-0.064758451,4.0150239606,4.6626084704
19,123,2001,294,220,-2,768,24,74,22,73,22377,13.159956133,9.8475862223,-0.089523511,-23,1.0742821333,3.3123699111,0.9847586222
19,123,2002,276,201,-148,805,23,75,-125,-66,22311,12.352309345,8.9957035446,-6.623702112,-16,1.0293591121,3.3566058002,-5.594343
19,123,2003,246,216,-319,696,20,30,-299,-285,22026,11.096826578,9.7435550443,-14.38978731,-16,0.9021810226,1.3532715339,-13.48760629
19,123,2004,298,215,-43,608,17,83,-26,43,22069,13.516271686,9.7516725252,-1.950334505,-14,0.7710624787,3.7645991609,-1.179272026
19,123,2005,284,194,76,583,19,90,95,164,22233,12.821091599,8.7580696131,3.4309963433,-21,0.8577490858,4.0630219855,4.2887454291
19,123,2006,309,219,-177,548,17,90,-160,-80,22153,13.923309152,9.867976389,-7.975487766,-10,0.7660072996,4.0553327626,-7.209480467
19,123,2007,313,215,-18,553,18,98,0,100,22253,14.097194073,9.6833761203,-0.810701257,2,0.8107012566,4.4138179525,0
19,123,2008,298,204,-53,553,17,94,-36,68,22321,13.371023467,9.1533180778,-2.378067932,10,0.7627765065,4.2177053888,-1.615291425
19,125,2001,373,331,377,2048,8,42,385,404,32506,11.546557702,10.246409113,11.670381377,-23,0.2476473502,1.3001485884,11.918028727
19,125,2002,399,358,-110,2070,7,41,-103,-95,32411,12.292619807,11.029468398,-3.388942804,-33,0.2156599966,1.2631514087,-3.173282807
19,125,2003,437,324,-219,2106,5,113,-214,-132,32279,13.510588963,10.017004174,-6.770752821,-31,0.1545833977,3.493584789,-6.616169423
19,125,2004,369,341,-30,2108,8,28,-22,-16,32263,11.4344148,10.566762728,-0.929627219,-22,0.2479005919,0.8676520715,-0.681726628
19,125,2005,399,364,43,1997,6,35,49,58,32321,12.356001486,11.272141707,1.3315991577,-26,0.1858045336,1.0838597795,1.5174036913
19,125,2006,434,303,286,2230,7,131,293,407,32728,13.343786991,9.3160540516,8.793371151,-17,0.2152223708,4.0277329398,9.0085935218
19,125,2007,447,302,-367,1967,7,145,-360,-239,32489,13.708082248,9.2613889017,-11.2547342,-24,0.2146679547,4.4466933468,-11.04006624
19,125,2008,448,320,-36,1967,6,128,-30,82,32571,13.771902859,9.8370734706,-1.106670765,-16,0.1844451276,3.9348293883,-0.922225638
19,127,2001,556,517,-194,1315,142,39,-52,-50,39263,14.151903889,13.159234372,-4.937894523,-37,3.614335166,0.9926695174,-1.323559357
19,127,2002,520,511,-356,1217,137,9,-219,-237,39026,13.284113988,13.05419663,-9.094508807,-27,3.4998531084,0.2299173575,-5.594655699
19,127,2003,562,494,-137,1331,122,68,-15,14,39040,14.398073425,12.655957779,-3.509850639,-39,3.1255604232,1.7421156457,-0.384290216
19,127,2004,624,456,-38,1340,111,168,73,211,39251,15.940529563,11.648848527,-0.970737377,-30,2.8355749703,4.2916810361,1.8648375931
19,127,2005,610,463,-422,1309,117,147,-305,-185,39066,15.577716205,11.823741972,-10.77671514,-27,2.9878570425,3.7539742329,-7.788858102
19,127,2006,619,479,-372,1307,118,140,-254,-132,38934,15.871794872,12.282051282,-9.538461538,-18,3.0256410256,3.5897435897,-6.512820513
19,127,2007,627,421,-7,1327,103,206,96,280,39214,16.046475917,10.774428008,-0.179147259,-22,2.6360239545,5.2720479091,2.4568766955
19,127,2008,627,425,20,1327,102,202,122,309,39523,15.92643865,10.795432897,0.5080203716,-15,2.5909038952,5.1310057533,3.0989242669
19,129,2001,168,144,-87,688,4,24,-83,-73,14482,11.571443331,9.9183799979,-5.992354582,-14,0.2755105555,1.653063333,-5.716844027
19,129,2002,174,128,18,692,3,46,21,53,14535,11.992969638,8.8224144467,1.2406520316,-14,0.2067753386,3.1705551918,1.4474273702
19,129,2003,170,125,37,675,-1,45,36,65,14600,11.66981294,8.5807448086,2.5399004634,-16,-0.068645958,3.0890681311,2.4712545049
19,129,2004,163,141,88,678,4,22,92,101,14701,11.12590014,9.6242449063,6.0066209344,-13,0.2730282243,1.5016552336,6.2796491587
19,129,2005,199,135,101,642,1,64,102,152,14853,13.466874196,9.1358191785,6.8349462002,-14,0.0676727347,4.3310550179,6.9026189348
19,129,2006,192,134,210,629,3,58,213,264,15117,12.812812813,8.9422756089,14.014014014,-7,0.2002002002,3.8705372039,14.214214214
19,129,2007,182,146,-28,613,1,36,-27,6,15123,12.037037037,9.6560846561,-1.851851852,-3,0.0661375661,2.380952381,-1.785714286
19,129,2008,197,134,-67,613,1,63,-66,-10,15113,13.030824183,8.8636062971,-4.431803149,-7,0.0661463157,4.167217886,-4.365656833
19,131,2001,148,131,-132,191,0,17,-132,-128,10739,13.699898176,12.126261224,-12.2188281,-13,0,1.5736369527,-12.2188281
19,131,2002,132,134,111,294,-1,-2,110,89,10828,12.240923633,12.426392173,10.293503964,-19,-0.09273427,-0.18546854,10.200769694
19,131,2003,127,136,27,307,-1,-9,26,3,10831,11.727226557,12.558289856,2.493189898,-14,-0.092340367,-0.831063299,2.4008495314
19,131,2004,113,124,86,293,0,-11,86,65,10896,10.401804207,11.414369218,7.9164173609,-10,0,-1.012565011,7.9164173609
19,131,2005,127,142,-80,285,0,-15,-80,-105,10791,11.712085581,13.095402776,-7.377691705,-10,0,-1.383317195,-7.377691705
19,131,2006,135,146,6,252,0,-11,6,-10,10781,12.516224736,13.53606527,0.5562766549,-5,0,-1.019840534,0.5562766549
19,131,2007,114,100,-56,266,0,14,-56,-36,10745,10.591842423,9.2910898448,-5.203010313,6,0,1.3007525783,-5.203010313
19,131,2008,125,130,-36,266,-1,-5,-37,-35,10710,11.652295502,12.118387322,-3.355861105,7,-0.093218364,-0.46609182,-3.449079469
19,133,2001,86,163,-100,290,0,-77,-100,-184,9819,8.6772273232,16.446372717,-10.08979921,-7,0,-7.769145394,-10.08979921
19,133,2002,105,182,-23,280,-1,-77,-24,-113,9706,10.755441741,18.642765685,-2.355953905,-12,-0.102432778,-7.887323944,-2.458386684
19,133,2003,109,156,39,272,-2,-47,37,-21,9685,11.242328915,16.089938631,4.0224846578,-11,-0.206281265,-4.847609716,3.8162033933
19,133,2004,101,175,-89,283,1,-74,-88,-171,9514,10.521381322,18.230116152,-9.271316214,-9,0.1041720923,-7.70873483,-9.167144122
19,133,2005,92,190,-57,262,-1,-98,-58,-166,9348,9.7550630898,20.146325946,-6.043897784,-10,-0.106033294,-10.39126286,-6.149931078
19,133,2006,111,137,-138,265,0,-26,-138,-167,9181,11.98121863,14.787630201,-14.89556911,-3,0,-2.806411571,-14.89556911
19,133,2007,105,139,-63,220,0,-34,-63,-110,9071,11.505588429,15.231207539,-6.903353057,-13,0,-3.72561911,-6.903353057
19,133,2008,97,149,-57,220,-1,-52,-58,-105,8966,10.755668903,16.5215945,-6.32034152,5,-0.110883185,-5.765925597,-6.431224705
19,135,2001,100,108,-52,173,0,-8,-52,-66,7934,12.551776076,13.555918162,-6.52692356,-6,0,-1.004142086,-6.52692356
19,135,2002,73,117,-97,168,-1,-44,-98,-146,7788,9.2863503371,14.883602595,-12.33939702,-4,-0.127210279,-5.597252258,-12.4666073
19,135,2003,89,97,37,165,-1,-8,36,17,7805,11.415378696,12.441480151,4.745719233,-11,-0.128262682,-1.026101456,4.617456551
19,135,2004,82,98,-5,164,0,-16,-5,-27,7778,10.52428929,12.577809151,-0.641724957,-6,0,-2.053519861,-0.641724957
19,135,2005,86,103,-33,164,0,-17,-33,-56,7722,11.096774194,13.290322581,-4.258064516,-6,0,-2.193548387,-4.258064516
19,135,2006,87,86,-76,170,0,1,-76,-78,7644,11.323701679,11.193544188,-9.891969283,-3,0,0.1301574906,-9.891969283
19,135,2007,93,94,-62,167,0,-1,-62,-61,7583,12.215144152,12.346489788,-8.143429435,2,0,-0.131345636,-8.143429435
19,135,2008,88,96,-3,167,-1,-8,-4,-6,7577,11.609498681,12.664907652,-0.395778364,6,-0.131926121,-1.055408971,-0.527704485
19,137,2001,138,166,-261,259,8,-28,-253,-284,11508,11.845493562,14.248927039,-22.40343348,-3,0.686695279,-2.403433476,-21.7167382
19,137,2002,136,158,-187,247,7,-22,-180,-206,11302,11.924594476,13.853572994,-16.3963174,-4,0.6137658922,-1.928978518,-15.78255151
19,137,2003,126,168,-63,248,3,-42,-60,-112,11190,11.203983639,14.938644852,-5.601991819,-10,0.2667615152,-3.734661213,-5.335230304
19,137,2004,119,155,10,245,7,-36,17,-27,11163,10.647340402,13.868384557,0.8947344875,-8,0.6263141413,-3.221044155,1.5210486288
19,137,2005,141,141,19,243,5,0,24,16,11179,12.621967595,12.621967595,1.7008325128,-8,0.4475875034,0,2.1484200161
19,137,2006,129,147,-25,249,7,-18,-18,-42,11137,11.561211687,13.174404015,-2.240544901,-6,0.6273525721,-1.613192328,-1.613192328
19,137,2007,142,148,-161,230,5,-6,-156,-159,10978,12.841962469,13.384580601,-14.56025322,3,0.4521817771,-0.542618132,-14.10807144
19,137,2008,130,137,-101,230,5,-7,-96,-108,10870,11.900402783,12.541193702,-9.245697547,-5,0.4577077993,-0.640790919,-8.787989747
19,139,2001,640,349,-349,683,80,291,-269,-10,41786,15.314302122,8.3510803762,-8.351080376,-32,1.9142877653,6.9632217463,-6.436792611
19,139,2002,615,418,-229,679,77,197,-152,10,41796,14.716087196,10.002153574,-5.479648728,-35,1.8425019741,4.7139336221,-3.637146754
19,139,2003,642,398,-404,702,67,244,-337,-122,41674,15.382772254,9.536360369,-9.680124596,-29,1.6053671978,5.8464118845,-8.074757398
19,139,2004,587,385,-104,678,66,202,-38,136,41810,14.062574865,9.2233242298,-2.491495376,-28,1.5811412965,4.8392506349,-0.91035408
19,139,2005,617,430,-60,585,66,187,6,158,41968,14.729403901,10.265224761,-1.432356943,-35,1.5755926377,4.4641791401,0.1432356943
19,139,2006,588,336,-75,560,67,252,-8,222,42190,13.973716105,7.9849806317,-1.782361748,-22,1.5922431617,5.9887354738,-0.190118586
19,139,2007,641,332,-212,548,58,309,-154,145,42335,15.167110322,7.8556640047,-5.016267377,-10,1.372375037,7.3114463177,-3.64389234
19,139,2008,626,341,-169,548,57,285,-112,169,42504,14.757363948,8.0387557609,-3.984016785,-4,1.3437216375,6.7186081873,-2.640295147
19,141,2001,175,192,-168,574,11,-17,-157,-185,14881,11.687314255,12.822653354,-11.21982168,-11,0.7346311818,-1.135339099,-10.4851905
19,141,2002,163,196,-167,579,10,-33,-157,-198,14683,11.026924638,13.259369503,-11.29752402,-8,0.6764984441,-2.232444865,-10.62102557
19,141,2003,154,180,-61,631,4,-26,-57,-96,14587,10.522719508,12.299282542,-4.168090195,-13,0.2733173898,-1.776563034,-3.894772805
19,141,2004,158,187,-207,654,7,-29,-200,-247,14340,10.924050195,12.929097383,-14.31188855,-18,0.4839769074,-2.005047188,-13.82791164
19,141,2005,189,182,-93,639,5,7,-88,-91,14249,13.221868551,12.732169716,-6.505998811,-10,0.3497848823,0.4896988352,-6.156213928
19,141,2006,169,192,-41,631,6,-23,-35,-65,14184,11.8875954,13.505433827,-2.883972848,-7,0.4220448071,-1.617838427,-2.461928041
19,141,2007,179,191,-115,656,6,-12,-109,-124,14060,12.675258462,13.524996459,-8.143322476,-3,0.4248689987,-0.849737997,-7.718453477
19,141,2008,184,200,-102,656,5,-16,-97,-108,13952,13.137226903,14.27959446,-7.282593174,5,0.3569898615,-1.142367557,-6.925603313
19,143,2001,82,97,-27,121,6,-15,-21,-43,6939,11.780762876,13.935780476,-3.879031679,-7,0.8620070397,-2.155017599,-3.017024639
19,143,2002,72,85,-75,121,6,-13,-69,-86,6853,10.440835267,12.325986079,-10.87587007,-4,0.8700696056,-1.885150812,-10.00580046
19,143,2003,82,71,-42,118,5,11,-37,-35,6818,11.996196328,10.386950479,-6.144393241,-9,0.7314753859,1.6092458489,-5.412917855
19,143,2004,70,84,-30,105,4,-14,-26,-45,6773,10.300934442,12.36112133,-4.414686189,-5,0.5886248253,-2.060186888,-3.826061364
19,143,2005,81,89,-132,117,5,-8,-127,-140,6633,12.084141429,13.277636879,-19.69267492,-5,0.7459346561,-1.19349545,-18.94674027
19,143,2006,73,85,-40,118,4,-12,-36,-52,6581,11.048887544,12.86514303,-6.054184955,-4,0.6054184955,-1.816255487,-5.44876646
19,143,2007,66,67,-126,120,4,-1,-122,-130,6451,10.128913444,10.282381829,-19.33701657,-7,0.6138735421,-0.153468386,-18.72314303
19,143,2008,72,65,-6,120,3,7,-3,-7,6444,11.167119038,10.08142691,-0.930593253,-11,0.4652966266,1.0856921287,-0.465296627
19,145,2001,172,228,22,1529,6,-56,28,-48,16869,10.181732078,13.496714616,1.3023145682,-20,0.3551767004,-3.314982537,1.6574912686
19,145,2002,151,227,-363,1441,5,-76,-358,-444,16425,9.07070343,13.636090587,-21.80573076,-10,0.3003544182,-4.565387157,-21.50537634
19,145,2003,176,219,-205,1406,4,-43,-201,-259,16166,10.800527753,13.439293056,-12.58016017,-15,0.2454665398,-2.638765303,-12.33469363
19,145,2004,173,219,-112,1454,7,-46,-105,-164,16002,10.756030838,13.616015916,-6.96344193,-13,0.4352151206,-2.859985078,-6.528226809
19,145,2005,155,209,70,1507,5,-54,75,5,16007,9.6847761567,13.058827205,4.3737698772,-16,0.3124121341,-3.374051048,4.6861820113
19,145,2006,194,206,53,1589,6,-12,59,39,16046,12.104951175,12.853711041,3.3070227436,-8,0.3743799332,-0.748759866,3.6814026768
19,145,2007,165,191,-133,1630,6,-26,-127,-150,15896,10.331225346,11.959176007,-8.327593764,3,0.3756809217,-1.627950661,-7.951912842
19,145,2008,178,205,-207,1630,5,-27,-202,-232,15664,11.280101394,12.99112801,-13.11787072,-3,0.3168567807,-1.711026616,-12.80101394
19,147,2001,119,126,-98,419,6,-7,-92,-107,10029,11.802628316,12.49690057,-9.719811555,-8,0.5950905033,-0.694272254,-9.124721051
19,147,2002,102,148,-139,425,6,-46,-133,-184,9845,10.264667405,14.893831136,-13.98812519,-5,0.603803965,-4.629163732,-13.38432122
19,147,2003,104,118,-162,421,5,-14,-157,-175,9670,10.658467845,12.093261594,-16.60261337,-4,0.5124263387,-1.434793748,-16.09018704
19,147,2004,111,125,5,431,6,-14,11,-10,9660,11.484738748,12.933264356,0.5173305742,-7,0.6207966891,-1.448525608,1.1381272633
19,147,2005,124,125,-73,431,6,-1,-67,-74,9586,12.885794451,12.989712148,-7.585991894,-6,0.6235061831,-0.103917697,-6.962485711
19,147,2006,105,136,-102,450,6,-31,-96,-131,9455,11.028832519,14.284964025,-10.71372302,-4,0.6302190011,-3.256131506,-10.08350402
19,147,2007,134,115,-46,439,6,19,-40,-28,9427,14.193411715,12.180913039,-4.872365216,-7,0.6355258977,2.012498676,-4.236839318
19,147,2008,123,129,-74,439,5,-6,-69,-82,9345,13.104623908,13.743873855,-7.884082676,-7,0.5327082889,-0.639249947,-7.351374387
19,149,2001,299,238,-159,375,16,61,-143,-102,24749,12.056451613,9.5967741935,-6.411290323,-20,0.6451612903,2.4596774194,-5.766129032
19,149,2002,308,252,-238,344,15,56,-223,-187,24562,12.492141713,10.22084322,-9.653018596,-20,0.608383525,2.2712984932,-9.044635071
19,149,2003,324,231,-35,353,11,93,-24,35,24597,13.181716471,9.3980756321,-1.423950853,-34,0.4475274111,3.7836408389,-0.976423442
19,149,2004,300,235,50,355,14,65,64,112,24709,12.168904393,9.5323084412,2.0281507322,-17,0.567882205,2.6365959518,2.5960329372
19,149,2005,317,261,-182,326,14,56,-168,-132,24577,12.863693544,10.591242949,-7.385464432,-20,0.5681126486,2.2724505945,-6.817351783
19,149,2006,316,245,-169,350,16,71,-153,-92,24485,12.88165994,9.9873629285,-6.889242183,-10,0.6522359464,2.8942970119,-6.237006237
19,149,2007,323,254,-231,336,11,69,-220,-147,24338,13.231468775,10.404932102,-9.462753211,4,0.4506072957,2.8265366733,-9.012145915
19,149,2008,336,231,-131,336,11,105,-120,-15,24323,13.809827172,9.4942561805,-5.38418857,0,0.4521074372,4.3155709911,-4.932081133
19,151,2001,71,114,-97,167,6,-43,-91,-139,8461,8.3230760213,13.363812203,-11.37096302,-5,0.703358537,-5.040736182,-10.66760448
19,151,2002,76,107,-89,158,5,-31,-84,-120,8341,9.0465420783,12.736578979,-10.59397691,-5,0.595167242,-3.6900369,-9.998809666
19,151,2003,68,109,-151,162,3,-41,-148,-191,8150,8.2469225638,13.219331757,-18.31301922,-2,0.363834819,-4.972409193,-17.9491844
19,151,2004,71,116,-122,165,4,-45,-118,-172,7978,8.8045634921,14.384920635,-15.12896825,-9,0.496031746,-5.580357143,-14.63293651
19,151,2005,74,123,-121,165,3,-49,-118,-174,7804,9.3777721455,15.587378026,-15.33392472,-7,0.3801799518,-6.20960588,-14.95374477
19,151,2006,76,102,-93,153,4,-26,-89,-119,7685,9.8134159726,13.170637226,-12.00852218,-4,0.5164955775,-3.357221254,-11.4920266
19,151,2007,75,117,19,156,2,-42,21,-19,7666,9.7713504006,15.243306625,2.4754087682,2,0.260569344,-5.471956224,2.7359781122
19,151,2008,82,113,-79,156,1,-31,-78,-106,7560,10.771049521,14.843031656,-10.37698673,3,0.1313542624,-4.071982136,-10.24563247
19,153,2001,6247,2761,-52,9008,1435,3486,1383,5137,381062,16.504906953,7.2947091562,-0.137386772,268,3.7913464828,9.2101977973,3.6539597113
19,153,2002,6093,2859,73,8944,1340,3234,1413,4817,385879,15.889097075,7.4555930639,0.1903666645,170,3.4944017858,8.4335040114,3.6847684502
19,153,2003,6265,2795,-228,9149,1169,3470,941,4429,390308,16.143017082,7.2018727446,-0.587487294,18,3.0121607293,8.9411443376,2.4246734357
19,153,2004,6309,2867,-205,9195,1089,3442,884,4044,394352,16.080850305,7.3076236841,-0.522519308,-282,2.7757245176,8.7732266204,2.2532052099
19,153,2005,6561,2813,2544,8957,1129,3748,3673,8410,402762,16.461886255,7.0579615965,6.3830267691,989,2.8327190339,9.4039246582,9.215745803
19,153,2006,6681,2831,2339,8963,1136,3850,3475,7327,410089,16.438437057,6.9656062427,5.755052279,2,2.795100209,9.472830814,8.550152488
19,153,2007,7014,2806,2326,9224,1023,4208,3349,7579,417668,16.947002562,6.7797674922,5.6200068378,22,2.4717398947,10.16723507,8.0917467324
19,153,2008,6945,2904,1871,9224,1025,4041,2896,7110,424778,16.487703663,6.8942104301,4.4418277255,173,2.4333903894,9.5934932328,6.8752181149
19,155,2001,1191,846,-623,1629,54,345,-569,-303,87662,13.562834872,9.6340539894,-7.094581129,-79,0.6149396163,3.9287808822,-6.479641513
19,155,2002,1202,856,-37,1654,48,346,11,271,87933,13.690594835,9.7497081352,-0.4214243,-86,0.5467126057,3.9408866995,0.1252883055
19,155,2003,1223,868,-151,1693,31,355,-120,111,88044,13.89954369,9.86492553,-1.716133358,-124,0.3523187689,4.0346181603,-1.363814589
19,155,2004,1237,864,392,1893,48,373,440,740,88784,13.990996901,9.7722080214,4.4336869727,-73,0.5429004456,4.2187888796,4.9765874183
19,155,2005,1178,824,-122,1899,42,354,-80,197,88981,13.253452592,9.2706663291,-1.372598656,-77,0.4725339634,3.9827862628,-0.900064692
19,155,2006,1299,877,-121,1842,46,422,-75,303,89284,14.573808656,9.8392842117,-1.357529521,-44,0.5160856029,4.7345244439,-0.841443918
19,155,2007,1220,786,-378,1931,40,434,-338,71,89355,13.658831498,8.7998701291,-4.231998612,-25,0.4478305409,4.858961369,-3.784168071
19,155,2008,1263,821,-161,1931,40,442,-121,292,89647,14.111574172,9.173081865,-1.798862583,-29,0.4469223808,4.9384923073,-1.351940202
19,157,2001,219,198,-3,1469,18,21,15,16,18850,11.622969961,10.508438595,-0.159218767,-20,0.9553125995,1.1145313661,0.7960938329
19,157,2002,187,234,-46,1454,17,-47,-29,-94,18756,9.9452215072,12.444822635,-2.446418125,-18,0.9041110461,-2.499601127,-1.542307079
19,157,2003,192,228,100,1550,15,-36,115,53,18809,10.222281379,12.138959137,5.3241048849,-26,0.7986157327,-1.916677759,6.1227206176
19,157,2004,200,228,22,1586,13,-28,35,-4,18805,10.634338278,12.123145637,1.1697772106,-11,0.6912319881,-1.488807359,1.8610091987
19,157,2005,173,202,-132,1584,15,-29,-117,-162,18643,9.2394787439,10.7882931,-7.049775689,-16,0.8011108737,-1.548814356,-6.248664815
19,157,2006,191,224,56,1553,14,-33,70,27,18670,10.237718758,12.006539276,3.001634819,-10,0.7504087047,-1.768820518,3.7520435237
19,157,2007,210,217,39,1601,13,-7,52,43,18713,11.235053367,11.609555145,2.0865099109,-2,0.6955033036,-0.374501779,2.7820132146
19,157,2008,204,203,-141,1601,12,1,-129,-123,18590,10.937458113,10.883843123,-7.559713696,5,0.643379889,0.0536149908,-6.916333807
19,159,2001,64,89,-42,145,0,-25,-42,-71,5390,11.79614782,16.404018063,-7.741222007,-4,0,-4.607870242,-7.741222007
19,159,2002,68,91,-70,148,0,-23,-70,-96,5294,12.729314863,17.03481842,-13.10370648,-3,0,-4.305503557,-13.10370648
19,159,2003,61,87,2,135,-1,-26,1,-30,5264,11.555218791,16.480394014,0.3788596325,-5,-0.189429816,-4.925175223,0.1894298163
19,159,2004,46,75,17,139,0,-29,17,-16,5248,8.7519025875,14.269406393,3.2343987823,-4,0,-5.517503805,3.2343987823
19,159,2005,77,65,-63,137,0,12,-63,-55,5193,14.749545063,12.450914663,-12.0678096,-4,0,2.2986303994,-12.0678096
19,159,2006,61,83,-27,122,0,-22,-27,-51,5142,11.804547654,16.061925496,-5.224963716,-2,0,-4.257377842,-5.224963716
19,159,2007,64,82,24,125,0,-18,24,-1,5141,12.447729262,15.948653117,4.6678984732,-7,0,-3.500923855,4.6678984732
19,159,2008,62,78,40,125,-1,-16,39,15,5156,12.04234243,15.150043702,7.7692531805,-8,-0.19423133,-3.107701272,7.575021851
19,161,2001,124,146,-91,280,7,-22,-84,-115,11359,10.86147243,12.788507861,-7.970919283,-9,0.6131476372,-1.927035431,-7.357771646
19,161,2002,93,160,-249,269,6,-67,-243,-317,11042,8.30320075,14.285076559,-22.2311504,-7,0.535690371,-5.981875809,-21.69546002
19,161,2003,99,151,-136,270,5,-52,-131,-190,10852,9.0435735818,13.793733443,-12.42349502,-7,0.4567461405,-4.750159861,-11.96674888
19,161,2004,115,156,-84,267,6,-41,-78,-127,10725,10.65949854,14.459841498,-7.786068499,-8,0.5561477499,-3.800342958,-7.229920749
19,161,2005,125,141,-166,264,5,-16,-161,-185,10540,11.756407242,13.261227369,-15.61250882,-8,0.4702562897,-1.504820127,-15.14225253
19,161,2006,115,141,14,265,6,-26,20,-12,10528,10.917030568,13.385228783,1.3290298082,-6,0.5695842035,-2.468198215,1.8986140118
19,161,2007,121,142,-155,261,6,-21,-149,-168,10360,11.585599387,13.596323248,-14.84105707,2,0.5744925316,-2.010723861,-14.26656453
19,161,2008,116,148,-21,261,5,-32,-16,-49,10311,11.223453147,14.319578153,-2.031832035,-1,0.4837695322,-3.096125006,-1.548062503
19,163,2001,2258,1295,-1229,3288,236,963,-993,-162,158501,14.238690394,8.1661222585,-7.749933788,-132,1.4881890757,6.0725681351,-6.261744713
19,163,2002,2279,1281,-977,3134,220,998,-757,121,158622,14.372972001,8.0788842184,-6.161647058,-120,1.3874742608,6.294087783,-4.774172797
19,163,2003,2259,1349,-805,3187,188,910,-617,136,158758,14.235301531,8.5008507152,-5.072783414,-157,1.184699729,5.7344508161,-3.888083685
19,163,2004,2239,1327,-588,3249,194,912,-394,549,159307,14.078883247,8.3442063729,-3.697357458,31,1.2198764404,5.7346768742,-2.477481018
19,163,2005,2294,1292,-383,3315,194,1002,-189,794,160101,14.364073536,8.0899664379,-2.398186645,-19,1.2147472825,6.2741070981,-1.183439363
19,163,2006,2262,1311,225,3386,200,951,425,1375,161476,14.068170298,8.1535681967,1.3993538095,-1,1.2438700529,5.9146021015,2.6432238624
19,163,2007,2374,1246,-350,3339,176,1128,-174,969,162445,14.657894981,7.6932338441,-2.161020743,15,1.0866847163,6.9646611365,-1.074336026
19,163,2008,2373,1251,871,3339,176,1122,1047,2245,164690,14.507772021,7.6482186253,5.3250187232,76,1.0760083757,6.8595533954,6.4010270989
19,165,2001,123,142,-47,277,4,-19,-43,-75,12995,9.4379436025,10.89583733,-3.606368694,-13,0.3069249952,-1.457893727,-3.299443698
19,165,2002,137,167,-116,291,4,-30,-112,-151,12844,10.604125547,12.926196834,-8.978675645,-9,0.309609505,-2.322071288,-8.66906614
19,165,2003,146,159,-60,287,1,-13,-59,-90,12754,11.407141183,12.422845535,-4.68786624,-18,0.078131104,-1.015704352,-4.609735136
19,165,2004,118,158,-49,287,0,-40,-49,-97,12657,9.2873165165,12.435559403,-3.856597536,-8,0,-3.148242887,-3.856597536
19,165,2005,108,134,-206,280,1,-26,-205,-238,12419,8.6138140054,10.68750997,-16.43005264,-7,0.0797575371,-2.073695964,-16.3502951
19,165,2006,113,142,-79,278,0,-29,-79,-114,12305,9.1409157094,11.486814431,-6.390551691,-6,0,-2.345898722,-6.390551691
19,165,2007,122,133,22,277,1,-11,23,5,12310,9.9126548852,10.80641885,1.7875279301,-7,0.0812512696,-0.893763965,1.8687791997
19,165,2008,127,136,-162,277,0,-9,-162,-179,12131,10.392373471,11.128840882,-13.2564134,-8,0,-0.736467411,-13.2564134
19,167,2001,478,234,-48,2726,36,244,-12,181,31738,15.103878663,7.3939489691,-1.516707481,-51,1.1375306106,7.7099296943,-0.37917687
19,167,2002,459,267,-130,2823,35,192,-95,54,31792,14.449866205,8.4054777271,-4.092554699,-43,1.1018416496,6.0443884779,-2.990713049
19,167,2003,450,287,-151,2953,24,163,-127,-12,31780,14.157176115,9.0291323224,-4.750519096,-48,0.7550493928,5.1280437929,-3.995469704
19,167,2004,457,253,-108,3012,24,204,-84,87,31867,14.360456895,7.950099769,-3.393718478,-33,0.7541596619,6.410357126,-2.639558817
19,167,2005,497,253,-226,3017,24,244,-202,42,31909,15.585800301,7.9340190667,-7.087305569,0,0.7526342198,7.6517812343,-6.33467135
19,167,2006,496,214,-98,3065,25,282,-73,209,32118,15.493463695,6.6846799007,-3.061208553,0,0.7809205491,8.8087837943,-2.280288003
19,167,2007,509,241,-368,2789,23,268,-345,-74,32044,15.866088962,7.512234656,-11.47096412,3,0.7169352576,8.3538543063,-10.75402886
19,167,2008,514,268,-123,2789,22,246,-101,156,32200,16.001494303,8.3431915821,-3.82915136,11,0.6848888612,7.6583027209,-3.144262499
19,169,2001,984,473,-1044,9305,519,511,-525,-69,80052,12.286714989,5.9061140142,-13.03590493,-55,6.480492967,6.3806009752,-6.555411961
19,169,2002,898,438,667,10436,486,460,1153,1555,81607,11.109805207,5.4188136757,8.2519377208,-58,6.0126562703,5.6909915316,14.264593991
19,169,2003,953,484,-982,9648,436,469,-546,-126,81481,11.686942019,5.9354458942,-12.04257824,-49,5.346806632,5.7514961248,-6.695771608
19,169,2004,900,450,-325,9542,413,450,88,476,81957,11.013350628,5.5066753142,-3.977043282,-62,5.0539042328,5.5066753142,1.0768609503
19,169,2005,881,493,-846,9313,426,388,-420,-105,81852,10.756429744,6.019205294,-10.3291028,-73,5.2011794224,4.7372244504,-5.127923374
19,169,2006,1013,455,700,10012,438,558,1138,1653,83505,12.252278404,5.5032444952,8.4665299927,-43,5.2976287668,6.7490339085,13.76415876
19,169,2007,1027,485,848,10894,397,542,1245,1801,85306,12.167453543,5.7460710499,10.04673866,14,4.7034849625,6.4213824928,14.750223623
19,169,2008,1061,484,450,10894,397,577,847,1448,86754,12.332907125,5.625944438,5.2307334651,24,4.6146693014,6.7069626874,9.8454027665
19,171,2001,245,229,-67,476,12,16,-55,-59,18013,13.579049467,12.692254399,-3.713454344,-20,0.6650963004,0.8867950672,-3.048358044
19,171,2002,228,211,-125,477,12,17,-113,-110,17903,12.696291346,11.749638044,-6.960686045,-14,0.6682258603,0.9466533021,-6.292460185
19,171,2003,221,191,-68,458,10,30,-58,-53,17850,12.362598943,10.684418091,-3.803876598,-25,0.5593936173,1.678180852,-3.24448298
19,171,2004,266,189,14,462,9,77,23,88,17938,14.865317984,10.56219962,0.782385157,-12,0.5029618867,4.3031183637,1.2853470437
19,171,2005,221,192,-49,456,10,29,-39,-28,17910,12.32983709,10.711894666,-2.733764785,-18,0.5579111805,1.6179424236,-2.175853604
19,171,2006,240,202,-121,465,9,38,-112,-82,17828,13.431081762,11.304493816,-6.771503722,-8,0.5036655661,2.1265879456,-6.267838155
19,171,2007,231,207,-90,427,7,24,-83,-61,17767,12.979351032,11.630847029,-5.056890013,-2,0.3933136676,1.3485040034,-4.663576345
19,171,2008,239,193,-136,427,6,46,-130,-77,17690,13.481117974,10.886425812,-7.671263784,7,0.3384381081,2.5946921623,-7.332825676
19,173,2001,90,107,-64,173,8,-17,-56,-80,6898,12.972038051,15.422311905,-9.224560392,-7,1.153070049,-2.450273854,-8.071490343
19,173,2002,63,89,-53,173,8,-26,-45,-76,6822,9.1836734694,12.973760933,-7.725947522,-5,1.166180758,-3.790087464,-6.559766764
19,173,2003,80,102,-44,168,1,-22,-43,-72,6750,11.788977306,15.030946065,-6.483937518,-7,0.1473622163,-3.241968759,-6.336575302
19,173,2004,65,68,-52,171,2,-3,-50,-58,6692,9.6711798839,10.117542032,-7.736943907,-5,0.2975747657,-0.446362148,-7.439369141
19,173,2005,71,108,-115,159,2,-37,-113,-155,6537,10.733993499,16.327764759,-17.38604581,-5,0.3023660141,-5.59377126,-17.08367979
19,173,2006,86,62,-47,158,2,24,-45,-25,6512,13.181086673,9.5026438808,-7.203617135,-4,0.3065368994,3.6784427926,-6.897080236
19,173,2007,64,84,-103,163,1,-20,-102,-121,6391,9.920173603,13.020227854,-15.96527939,1,0.1550027125,-3.100054251,-15.81027668
19,173,2008,69,81,-74,163,0,-12,-74,-93,6298,10.87556151,12.766963512,-11.66364568,-7,0,-1.891402002,-11.66364568
19,175,2001,122,141,-47,301,6,-19,-41,-70,12202,9.969763831,11.522431969,-3.840810656,-10,0.490316254,-1.552668138,-3.350494402
19,175,2002,132,168,-78,289,6,-36,-72,-118,12084,10.870460348,13.835131351,-6.423453842,-10,0.494111834,-2.964671004,-5.929342008
19,175,2003,147,151,-198,299,6,-4,-192,-199,11885,12.265843381,12.599607827,-16.52134006,-3,0.5006466686,-0.333764446,-16.0206934
19,175,2004,133,143,53,285,5,-10,58,40,11925,11.171776564,12.011759765,4.4519109618,-8,0.4199916002,-0.8399832,4.8719025619
19,175,2005,156,163,38,296,6,-7,44,26,11951,13.067515497,13.653878372,3.1831127492,-11,0.5025967499,-0.586362875,3.6857094991
19,175,2006,159,148,98,334,5,11,103,108,12059,13.244481466,12.328196585,8.1632653061,-6,0.4164931279,0.9162848813,8.579758434
19,175,2007,170,149,76,335,6,21,82,97,12156,14.04088375,12.306421639,6.2771009705,-6,0.4955606029,1.7344621103,6.7726615734
19,175,2008,164,135,72,335,5,29,77,105,12261,13.43326371,11.057869517,5.8975304091,-1,0.4095507229,2.3753941926,6.307081132
19,177,2001,86,110,-52,127,0,-24,-52,-81,7736,11.058959686,14.145180994,-6.686812834,-5,0,-3.086221308,-6.686812834
19,177,2002,93,93,10,132,-1,0,9,1,7737,12.020939701,12.020939701,1.2925741614,-8,-0.129257416,0,1.1633167453
19,177,2003,78,104,-26,118,-1,-26,-27,-64,7673,10.123296561,13.497728748,-3.374432187,-11,-0.129785853,-3.374432187,-3.50421804
19,177,2004,94,91,-4,128,0,3,-4,-7,7666,12.256340048,11.865180259,-0.521546385,-6,0,0.3911597888,-0.521546385
19,177,2005,96,103,-25,126,0,-7,-25,-38,7628,12.553942723,13.469334379,-3.269255917,-6,0,-0.915391657,-3.269255917
19,177,2006,82,93,49,126,0,-11,49,35,7663,10.725263227,12.16401805,6.4089987574,-3,0,-1.438754823,6.4089987574
19,177,2007,106,77,-11,121,0,29,-11,9,7672,13.824584284,10.042386697,-1.434626671,-9,0,3.7821975872,-1.434626671
19,177,2008,101,85,-6,121,-1,16,-7,4,7676,13.161323951,11.076361741,-0.781860829,-5,-0.130310138,2.0849622101,-0.912170967
19,179,2001,465,440,-74,1058,34,25,-40,-54,35952,12.924205787,12.229356013,-2.056755329,-39,0.9449956919,0.6948497735,-1.111759638
19,179,2002,455,398,-206,1064,32,57,-174,-150,35802,12.682219807,11.093458204,-5.741840176,-33,0.891936338,1.5887616021,-4.849903838
19,179,2003,457,402,-120,1009,29,55,-91,-82,35720,12.779284696,11.241296384,-3.355610861,-46,0.8109392914,1.5379883113,-2.54467157
19,179,2004,500,410,-156,971,33,90,-123,-60,35660,14.009526478,11.487811712,-4.370972261,-27,0.9246287475,2.521714766,-3.446343514
19,179,2005,501,419,43,1015,31,82,74,125,35785,14.024774302,11.72930226,1.2037231437,-31,0.8678004059,2.2954720414,2.0715235496
19,179,2006,489,419,-153,985,33,70,-120,-67,35718,13.677747787,11.719787981,-4.279540719,-17,0.9230381942,1.9579598059,-3.356502524
19,179,2007,508,379,-437,949,28,129,-409,-259,35459,14.274273993,10.649507566,-12.27924751,21,0.7867710075,3.6247664274,-11.4924765
19,179,2008,500,378,-111,949,28,122,-83,54,35513,14.090063687,10.652088147,-3.127994139,15,0.7890435665,3.4379755396,-2.338950572
19,181,2001,510,309,65,1699,13,201,78,238,41017,12.470047435,7.5553816813,1.5893197711,-41,0.3178639542,4.9146657538,1.9071837254
19,181,2002,481,355,180,1633,12,126,192,279,41296,11.687096813,8.6256119932,4.3735497431,-39,0.2915699829,3.0614848201,4.6651197259
19,181,2003,493,340,535,1702,5,153,540,667,41963,11.842563567,8.1672852184,12.851463505,-26,0.1201071356,3.6752783483,12.971570641
19,181,2004,491,350,211,1710,11,141,222,331,42294,11.654817997,8.3079150694,5.0084859418,-32,0.2611059022,3.3469029279,5.269591844
19,181,2005,529,330,496,1803,8,199,504,668,42962,12.409683776,7.7413906353,11.635544712,-35,0.187670076,4.6682931407,11.823214788
19,181,2006,541,325,533,1839,10,216,543,736,43698,12.485575814,7.5005769675,12.300946227,-23,0.2307869836,4.9849988461,12.53173321
19,181,2007,532,349,526,1836,8,183,534,710,44408,12.076362563,7.9222754409,11.940162985,-7,0.181599437,4.1540871223,12.121762423
19,181,2008,578,363,435,1836,8,215,443,651,45059,12.920965272,8.1147238647,9.7242558709,-7,0.1788368896,4.8062414074,9.9030927605
19,183,2001,310,217,212,513,17,93,229,304,21005,14.865966528,10.406176569,10.166402916,-18,0.8152304225,4.4597899583,10.981633338
19,183,2002,331,251,-90,490,16,80,-74,-12,20993,15.762655365,11.95295014,-4.285918377,-18,0.7619410448,3.8097052241,-3.523977332
19,183,2003,297,235,-26,456,10,62,-16,15,21008,14.142520416,11.190209757,-1.23806576,-31,0.4761791386,2.9523106593,-0.761886622
19,183,2004,309,228,-55,444,11,81,-44,21,21029,14.701334539,10.84758665,-2.616742394,-16,0.5233484787,3.8537478888,-2.093393915
19,183,2005,279,242,0,440,10,37,10,28,21057,13.258565794,11.50026137,0,-19,0.475217412,1.7583044243,0.475217412
19,183,2006,292,224,37,425,11,68,48,105,21162,13.832634596,10.611336128,1.7527653426,-11,0.5210923992,3.2212984675,2.2738577418
19,183,2007,288,209,-4,371,5,79,1,74,21236,13.585546488,9.8589556111,-0.188688146,-6,0.2358601821,3.7265908769,0.0471720364
19,183,2008,283,213,26,371,4,70,30,107,21343,13.292937833,10.004932009,1.2212593062,7,0.1878860471,3.2880058245,1.4091453533
19,185,2001,81,110,-49,116,2,-29,-47,-83,6642,12.119398519,16.458442433,-7.331487993,-7,0.2992444079,-4.339043914,-7.032243585
19,185,2002,91,92,3,110,2,-1,5,-2,6640,13.702755609,13.853335341,0.4517391959,-6,0.3011594639,-0.150579732,0.7528986598
19,185,2003,69,99,-26,103,-1,-30,-27,-67,6573,10.444259441,14.985241807,-3.93551805,-10,-0.151366079,-4.540982366,-4.086884129
19,185,2004,73,90,-43,102,0,-17,-43,-65,6508,11.161226206,13.76041587,-6.574420916,-5,0,-2.599189664,-6.574420916
19,185,2005,81,115,-41,94,0,-34,-41,-80,6428,12.523191095,17.779839208,-6.338899196,-5,0,-5.256648114,-6.338899196
19,185,2006,80,93,-37,105,0,-13,-37,-54,6374,12.49804718,14.528979847,-5.780346821,-4,0,-2.030932667,-5.780346821
19,185,2007,92,96,-95,100,0,-4,-95,-105,6269,14.55350787,15.186269082,-15.02807878,-6,0,-0.632761212,-15.02807878
19,185,2008,88,88,-6,100,-1,0,-7,-16,6253,14.055262738,14.055262738,-0.958313368,-9,-0.159718895,0,-1.118032263
19,187,2001,518,460,-211,2657,27,58,-184,-160,40036,12.912553595,11.466746435,-5.259746734,-34,0.6730481603,1.4458071592,-4.586698574
19,187,2002,483,450,-394,2696,25,33,-369,-369,39667,12.119995483,11.291921258,-9.88670439,-33,0.6273289588,0.8280742256,-9.259375431
19,187,2003,461,476,-263,2784,22,-15,-241,-299,39368,11.66571772,12.045296388,-6.655279307,-43,0.5567153793,-0.379578668,-6.098563927
19,187,2004,521,455,-489,2753,24,66,-465,-436,38932,13.307790549,11.621966794,-12.49042146,-37,0.6130268199,1.6858237548,-11.87739464
19,187,2005,454,440,-354,2696,23,14,-331,-353,38579,11.714466334,11.353227284,-9.134187406,-36,0.5934641535,0.3612390499,-8.540723252
19,187,2006,478,515,86,2710,25,-37,111,56,38635,12.381174398,13.339549823,2.2275753102,-18,0.6475509623,-0.958375424,2.8751262724
19,187,2007,509,444,-126,2769,21,65,-105,-29,38606,13.179529007,11.496485027,-3.262516021,11,0.5437526702,1.6830439792,-2.718763351
19,187,2008,499,437,-200,2769,21,62,-179,-89,38517,12.940367984,11.332546711,-5.186520234,28,0.5445846246,1.6078212725,-4.641935609
19,189,2001,128,144,-208,532,24,-16,-184,-208,11535,10.997508377,12.372196924,-17.87095111,-8,2.0620328207,-1.374688547,-15.80891829
19,189,2002,136,139,-215,430,24,-3,-191,-199,11336,11.892789996,12.155130952,-18.80110183,-5,2.0987276464,-0.262340956,-16.70237419
19,189,2003,115,135,-3,443,19,-20,16,-19,11317,10.153180594,11.918951132,-0.264865581,-15,1.6774820112,-1.765770538,1.4126164305
19,189,2004,89,125,-77,449,17,-36,-60,-106,11211,7.9012784091,11.097301136,-6.8359375,-10,1.5092329545,-3.196022727,-5.326704545
19,189,2005,107,107,-18,465,18,0,0,-8,11203,9.547604176,9.547604176,-1.60613902,-8,1.6061390203,0,0
19,189,2006,127,133,-198,436,17,-6,-181,-192,11011,11.434230665,11.974430539,-17.82659584,-5,1.5305663095,-0.540199874,-16.29602953
19,189,2007,134,120,-122,432,17,14,-105,-84,10927,12.216245784,10.939921597,-11.12225362,7,1.5498222263,1.2763241863,-9.572431398
19,189,2008,105,121,-35,432,16,-16,-19,-26,10901,9.6206706982,11.086677662,-3.206890233,9,1.4660069635,-1.466006964,-1.740883269
19,191,2001,187,205,-16,2297,8,-18,-8,-47,21238,8.7952402229,9.6418408861,-0.752533923,-21,0.3762669614,-0.846600663,-0.376266961
19,191,2002,223,192,-131,2254,8,31,-123,-111,21127,10.527558126,9.06408592,-6.184350289,-19,0.3776702467,1.4634722058,-5.806680042
19,191,2003,161,173,-203,2262,7,-12,-196,-224,20903,7.661194385,8.2322150845,-9.659766833,-16,0.333095408,-0.5710207,-9.326671425
19,191,2004,203,180,-12,2287,6,23,-6,3,20906,9.7108278122,8.6105862374,-0.574039082,-14,0.2870195412,1.1002415748,-0.287019541
19,191,2005,190,167,-30,2291,7,23,-23,-20,20886,9.0926493109,7.9919601838,-1.43568147,-20,0.334992343,1.1006891271,-1.100689127
19,191,2006,198,164,-69,2276,6,34,-63,-39,20847,9.4888936813,7.8594876956,-3.306735677,-10,0.2875422328,1.6294059857,-3.019193444
19,191,2007,215,165,-19,2268,6,50,-13,41,20888,10.303102911,7.9070324668,-0.910506769,4,0.2875284533,2.3960704445,-0.622978316
19,191,2008,221,175,-35,2268,5,46,-30,25,20913,10.573909715,8.3730054305,-1.674601086,9,0.2392287266,2.2009042846,-1.43537236
19,193,2001,1694,881,-1657,2742,408,813,-1249,-503,103313,16.356956293,8.5067759705,-15.99969101,-67,3.9395738887,7.8501803224,-12.06011713
19,193,2002,1631,974,-1266,2764,383,657,-883,-294,103019,15.809472113,9.4410949344,-12.27148479,-68,3.7124634085,6.3683771785,-8.559021383
19,193,2003,1579,977,-1357,2783,314,602,-1043,-502,102517,15.364704967,9.5068503814,-13.20449946,-61,3.0554258135,5.8578545851,-10.14907364
19,193,2004,1689,903,-1066,2876,317,786,-749,-61,102456,16.480219346,8.8109165597,-10.40136994,-98,3.0930903095,7.6693027862,-7.308279627
19,193,2005,1567,906,-1960,2819,317,661,-1643,-1068,101388,15.37450207,8.8891505269,-19.23039187,-86,3.110221542,6.4853515433,-16.12017033
19,193,2006,1632,866,-637,2948,324,766,-313,408,101796,16.064257028,8.5242932514,-6.270178754,-45,3.1892274982,7.5399637767,-3.080951256
19,193,2007,1694,913,-994,2887,288,781,-706,114,101910,16.631812514,8.9638989524,-9.759162715,39,2.8276044888,7.6679135617,-6.931558226
19,193,2008,1626,881,-436,2887,289,745,-147,649,102559,15.904611457,8.617443231,-4.264705163,51,2.8268343857,7.287168226,-1.437870777
19,195,2001,74,106,-64,127,4,-32,-60,-99,7802,9.4249506464,13.50060498,-8.151308667,-7,0.5094567917,-4.075654334,-7.641851875
19,195,2002,79,96,15,127,4,-17,19,-5,7797,10.128854414,12.308481313,1.9232002051,-7,0.512853388,-2.179626899,2.4360535932
19,195,2003,83,107,-41,119,2,-24,-39,-75,7722,10.6965655,13.789548296,-5.283845609,-12,0.2577485663,-3.092982795,-5.026097042
19,195,2004,82,113,26,111,1,-31,27,-9,7713,10.625202462,14.642047295,3.3689666343,-5,0.1295756398,-4.016844833,3.4985422741
19,195,2005,75,91,29,114,2,-16,31,8,7721,9.7188026435,11.792147207,3.7579370222,-7,0.2591680705,-2.073344564,4.0171050927
19,195,2006,77,93,-49,104,1,-16,-48,-68,7653,10.016911669,12.09834786,-6.374398335,-4,0.1300897619,-2.081436191,-6.244308573
19,195,2007,83,78,-1,95,2,5,1,4,7657,10.842586545,10.189418681,-0.130633573,-2,0.2612671457,0.6531678641,0.1306335728
19,195,2008,78,93,14,95,1,-15,15,4,7661,10.184097141,12.14257736,1.8279148714,4,0.130565348,-1.958480219,1.9584802193
19,197,2001,162,213,-232,298,36,-51,-196,-256,14056,11.421319797,15.016920474,-16.35645798,-9,2.538071066,-3.595600677,-13.81838691
19,197,2002,170,199,-228,274,35,-29,-193,-230,13826,12.194247185,14.274442293,-16.3546374,-8,2.5105803027,-2.080195108,-13.8440571
19,197,2003,155,188,-180,277,22,-33,-158,-199,13627,11.292026372,13.696135213,-13.11332095,-8,1.602739227,-2.404108841,-11.51058172
19,197,2004,186,173,-113,277,23,13,-90,-90,13537,13.694595789,12.737446621,-8.319835076,-13,1.6934177588,0.957149168,-6.626417317
19,197,2005,167,187,-155,258,22,-20,-133,-164,13373,12.411742847,13.898179116,-11.51988109,-11,1.6350798959,-1.486436269,-9.884801189
19,197,2006,176,151,-271,263,23,25,-248,-228,13145,13.274002564,11.388490836,-20.43894713,-5,1.7346707897,1.8855117279,-18.70427634
19,197,2007,180,176,-153,256,18,4,-135,-124,13021,13.758312314,13.45257204,-11.69456547,7,1.3758312314,0.3057402736,-10.31873424
19,197,2008,172,172,-145,256,17,0,-128,-118,12903,13.269557167,13.269557167,-11.18654529,10,1.3115259991,0,-9.875019287
20,0,2001,39193,24910,-13837,82033,7196,14283,-6641,8665,2701346,14.531999933,9.2361421254,-5.130489706,1023,2.6681364405,5.2958578072,-2.462353266
20,0,2002,38956,24847,-9577,82118,6011,14109,-3566,11215,2712561,14.391085772,9.178953388,-3.537925568,672,2.2205774868,5.2121323842,-1.317348082
20,0,2003,39545,24365,-9750,81859,3406,15180,-6344,9509,2722070,14.55296597,8.9665701314,-3.588100094,673,1.253442966,5.5863958381,-2.334657128
20,0,2004,39431,24535,-11929,82011,6421,14896,-5508,8999,2731069,14.461762299,8.9984869265,-4.375094785,-389,2.3549738967,5.4632753722,-2.020120888
20,0,2005,39361,24527,-10937,82149,5490,14834,-5447,11135,2742204,14.382984368,8.9624617665,-3.996511776,1748,2.0061122476,5.4205226014,-1.990399529
20,0,2006,39840,24504,-6743,82098,6122,15336,-621,14063,2756267,14.491301309,8.913023275,-2.452681846,-652,2.2268008688,5.578278034,-0.225880977
20,0,2007,42061,23246,-3280,82152,4917,18815,1637,21115,2777382,15.201903843,8.4016893735,-1.185474539,663,1.7771275337,6.8002144697,0.5916529943
20,0,2008,42579,23321,284,82152,5225,19258,5509,24752,2802134,15.262614177,8.3595064518,0.1018009447,-15,1.8729223108,6.9031077248,1.9747232556
20,1,2001,181,193,-221,357,5,-12,-216,-237,14149,12.686174873,13.52724724,-15.48974943,-9,0.3504468197,-0.841072367,-15.13930261
20,1,2002,168,174,-63,357,5,-6,-58,-80,14069,11.907293217,12.332553689,-4.465234956,-16,0.3543837267,-0.425260472,-4.11085123
20,1,2003,163,189,-163,357,3,-26,-160,-193,13876,11.665772052,13.526570048,-11.66577205,-7,0.2147074611,-1.860797996,-11.45106459
20,1,2004,172,211,8,357,7,-39,15,-32,13844,12.40981241,15.223665224,0.5772005772,-8,0.5050505051,-2.813852814,1.0822510823
20,1,2005,165,170,-193,357,5,-5,-188,-206,13638,12.00785969,12.371734226,-14.04555709,-13,0.3638745361,-0.363874536,-13.68168256
20,1,2006,175,163,-120,357,6,12,-114,-107,13531,12.882329125,11.998969414,-8.833597114,-5,0.4416798557,0.8833597114,-8.391917259
20,1,2007,187,177,-118,357,5,10,-113,-99,13432,13.870860067,13.129102845,-8.75273523,4,0.3708786114,0.7417572229,-8.381856618
20,1,2008,178,171,-133,357,7,7,-126,-113,13319,13.307913723,12.784568801,-9.943553512,6,0.5233449217,0.5233449217,-9.42020859
20,3,2001,101,105,87,127,3,-4,90,78,8168,12.424652479,12.916717923,10.702423422,-8,0.3690490835,-0.492065445,11.071472506
20,3,2002,107,102,-79,127,3,5,-76,-76,8092,13.161131611,12.546125461,-9.717097171,-5,0.36900369,0.6150061501,-9.348093481
20,3,2003,109,102,17,127,3,7,20,17,8109,13.455959509,12.59181532,2.0986358867,-10,0.3703475094,0.8641441886,2.4689833961
20,3,2004,88,102,-95,127,2,-14,-93,-114,7995,10.928961749,12.667660209,-11.79831098,-7,0.2483854943,-1.73869846,-11.54992548
20,3,2005,101,117,-24,127,3,-16,-21,-42,7953,12.666165036,14.67268623,-3.009781791,-5,0.3762227239,-2.006521194,-2.633559067
20,3,2006,105,89,-78,127,2,16,-76,-64,7889,13.255902033,11.235955056,-9.84724151,-4,0.252493372,2.0199469764,-9.594748138
20,3,2007,112,85,-10,127,3,27,-7,9,7898,14.188889593,10.768353709,-1.266865142,-11,0.3800595427,3.420535884,-0.8868056
20,3,2008,114,79,65,127,2,35,67,86,7984,14.355874575,9.948369223,8.1853670822,-16,0.2518574487,4.407505352,8.4372245309
20,5,2001,229,184,-3,1053,5,45,2,29,16794,13.647605709,10.965761793,-0.178789594,-18,0.2979826574,2.6818439167,0.119193063
20,5,2002,201,195,-88,1053,5,6,-83,-91,16703,12.001074723,11.642833687,-5.254201869,-14,0.2985341971,0.3582410365,-4.955667672
20,5,2003,207,190,-4,1053,5,17,1,-6,16697,12.395209581,11.377245509,-0.239520958,-24,0.2994011976,1.0179640719,0.0598802395
20,5,2004,233,167,-41,1053,4,66,-37,18,16715,13.94708488,9.996408476,-2.454208069,-11,0.2394349336,3.9506764037,-2.214773135
20,5,2005,222,192,-148,1053,5,30,-143,-127,16588,13.33213224,11.530492748,-8.88808816,-14,0.3002732487,1.8016394919,-8.587814912
20,5,2006,212,183,-1,1053,6,29,5,26,16614,12.770315041,11.023432323,-0.060237335,-8,0.3614240106,1.7468827179,0.3011866755
20,5,2007,223,186,-128,1053,6,37,-122,-85,16529,13.456838548,11.224089551,-7.724104637,0,0.3620674049,2.2327489968,-7.362037233
20,5,2008,232,170,-113,1053,5,62,-108,-48,16481,14.056346562,10.299909118,-6.846410179,-2,0.3029385035,3.7564374432,-6.543471675
20,7,2001,38,66,-135,65,2,-28,-133,-164,5123,7.3006724304,12.680115274,-25.93659942,-3,0.3842459174,-5.379442843,-25.55235351
20,7,2002,35,65,-67,65,2,-30,-65,-98,5025,6.8979109184,12.810405991,-13.20457233,-3,0.3941663382,-5.912495073,-12.81040599
20,7,2003,42,71,-39,65,2,-29,-37,-69,4956,8.4159903817,14.22703136,-7.814848212,-3,0.4007614467,-5.811040978,-7.414086765
20,7,2004,47,61,-55,65,1,-14,-54,-72,4884,9.5528455285,12.398373984,-11.17886179,-4,0.2032520325,-2.845528455,-10.97560976
20,7,2005,45,81,-9,65,2,-36,-7,-48,4836,9.2592592593,16.666666667,-1.851851852,-5,0.4115226337,-7.407407407,-1.440329218
20,7,2006,60,52,2,65,1,8,3,8,4844,12.396694215,10.743801653,0.4132231405,-3,0.2066115702,1.652892562,0.6198347107
20,7,2007,55,71,-50,65,1,-16,-49,-65,4779,11.43094669,14.756313,-10.39176972,0,0.2078353944,-3.32536631,-10.18393432
20,7,2008,55,68,-89,65,0,-13,-89,-105,4674,11.636517508,14.3869671,-18.83000106,-3,0,-2.750449593,-18.83000106
20,9,2001,312,337,-418,868,78,-25,-340,-203,27923,11.133115667,12.025192243,-14.91552035,162,2.7832789167,-0.892076576,-12.13224143
20,9,2002,362,306,-281,878,72,56,-209,-29,27894,12.970958669,10.964401526,-10.06861709,124,2.5798591827,2.0065571421,-7.488757905
20,9,2003,370,293,-333,874,62,77,-271,-67,27827,13.280450817,10.516681323,-11.95240574,127,2.2253728397,2.7637694944,-9.727032896
20,9,2004,330,324,-353,843,62,6,-291,-102,27725,11.880760369,11.664746544,-12.70881336,183,2.2321428571,0.2160138249,-10.47667051
20,9,2005,356,289,-46,853,63,67,17,140,27865,12.808059003,10.397553517,-1.654973916,56,2.2665947113,2.4105054866,0.6116207951
20,9,2006,365,283,-243,853,65,82,-178,-96,27769,13.121472481,10.173634828,-8.735665241,0,2.3367005788,2.9478376532,-6.398964662
20,9,2007,403,303,-171,853,56,100,-115,-4,27765,14.513631289,10.912233947,-6.158389455,11,2.0167825116,3.6013973422,-4.141606943
20,9,2008,398,284,-245,853,58,114,-187,-62,27703,14.350616572,10.240138458,-8.833922261,11,2.0912958823,4.1104781135,-6.742626379
20,11,2001,210,225,0,324,3,-15,3,-26,15356,13.663868827,14.639859457,0,-14,0.1951981261,-0.97599063,0.1951981261
20,11,2002,207,211,-191,324,3,-4,-188,-202,15154,13.569321534,13.831530646,-12.52048509,-10,0.1966568338,-0.262209112,-12.32382825
20,11,2003,203,186,-51,324,0,17,-51,-52,15102,13.418826018,12.295081967,-3.371232152,-18,0,1.1237440508,-3.371232152
20,11,2004,218,190,-126,324,4,28,-122,-107,14995,14.48649367,12.625843107,-8.372927534,-13,0.2658072233,1.8606505632,-8.107120311
20,11,2005,211,193,-149,324,2,18,-147,-143,14852,14.138774416,12.932623044,-9.984253024,-14,0.1340168191,1.206151372,-9.850236205
20,11,2006,213,203,-56,324,4,10,-52,-48,14804,14.364715403,13.690315619,-3.776638791,-6,0.2697599137,0.6743997842,-3.506878878
20,11,2007,235,179,-81,324,2,56,-79,-20,14784,15.88481817,12.099499797,-5.475192646,3,0.1351899419,3.7853183723,-5.340002704
20,11,2008,243,170,-12,324,4,73,-8,67,14851,16.399527586,11.472920533,-0.809853214,2,0.2699510714,4.9266070525,-0.539902143
20,13,2001,127,123,-151,202,11,4,-140,-142,10569,11.936090226,11.560150376,-14.19172932,-6,1.0338345865,0.3759398496,-13.15789474
20,13,2002,155,134,-207,202,11,21,-196,-178,10391,14.790076336,12.786259542,-19.7519084,-3,1.0496183206,2.0038167939,-18.70229008
20,13,2003,118,132,-95,202,9,-14,-86,-108,10283,11.415304247,12.769662378,-9.190287317,-8,0.8706587985,-1.354358131,-8.319628519
20,13,2004,147,145,-18,202,8,2,-10,-17,10266,14.30726556,14.112608886,-1.751910069,-9,0.7786266972,0.1946566743,-0.973283371
20,13,2005,119,154,-137,202,9,-35,-128,-171,10095,11.68901331,15.126958401,-13.45709936,-8,0.8840430234,-3.437945091,-12.57305633
20,13,2006,161,161,4,202,8,0,12,7,10102,15.942961826,15.942961826,0.3960984305,-5,0.7921968609,0,1.1882952914
20,13,2007,131,134,-64,202,6,-3,-58,-58,10044,13.00506304,13.302888911,-6.353618584,3,0.5956517423,-0.297825871,-5.757966842
20,13,2008,144,140,-51,202,5,4,-46,-35,10009,14.361940857,13.962998055,-5.08652072,7,0.498678502,0.3989428016,-4.587842218
20,15,2001,754,558,-130,2010,44,196,-86,53,59731,12.628863821,9.3460291938,-2.177390314,-57,0.7369628755,3.2828346272,-1.440427438
20,15,2002,747,515,186,2010,37,232,223,401,60132,12.464229996,8.5931438392,3.1035432118,-54,0.6173714991,3.8710861567,3.720914711
20,15,2003,710,510,233,2010,15,200,248,378,60510,11.770361897,8.4547669966,3.8626680592,-70,0.2486696175,3.3155949006,4.1113376768
20,15,2004,749,544,410,2010,39,205,449,602,61112,12.31685057,8.9457499466,6.7422012465,-52,0.6413313381,3.3711006232,7.3835325846
20,15,2005,780,579,321,2010,31,201,352,494,61606,12.712071579,9.4362685181,5.2315063805,-59,0.5052233576,3.2758030607,5.7367297381
20,15,2006,794,519,489,2010,36,275,525,770,62376,12.808310884,8.3721830588,7.8882418416,-30,0.5807294607,4.436127825,8.4689713023
20,15,2007,824,555,194,2010,27,269,221,503,62879,13.157159395,8.8619216798,3.0976807313,13,0.4311205142,4.2952377151,3.5288012455
20,15,2008,862,545,315,2010,30,317,345,683,63562,13.63481782,8.6206214756,4.9825610364,21,0.4745296225,5.0141963445,5.4570906589
20,17,2001,58,43,-68,113,6,15,-62,-49,2980,19.304376768,14.311865535,-22.63271759,-2,1.9970044933,4.9925112332,-20.6357131
20,17,2002,90,34,-11,113,6,56,-5,47,3027,29.965040786,11.320126519,-3.662393874,-4,1.9976693857,18.644914267,-1.664724488
20,17,2003,36,48,-57,113,3,-12,-54,-66,2961,12.024048096,16.032064128,-19.03807615,0,1.002004008,-4.008016032,-18.03607214
20,17,2004,32,31,57,113,2,1,59,56,3017,10.705921713,10.371361659,19.069923051,-4,0.6691201071,0.3345600535,19.739043158
20,17,2005,39,25,-48,113,3,14,-45,-32,2985,12.995668111,8.3305564812,-15.99466844,-1,0.9996667777,4.6651116295,-14.99500167
20,17,2006,34,36,-18,113,2,-2,-16,-20,2965,11.428571429,12.100840336,-6.050420168,-2,0.6722689076,-0.672268908,-5.378151261
20,17,2007,27,31,-107,113,1,-4,-106,-115,2850,9.2863284609,10.662080825,-36.80137575,-5,0.3439380911,-1.375752365,-36.45743766
20,17,2008,29,25,-41,113,0,4,-41,-46,2804,10.258224266,8.843296781,-14.50300672,-9,0,1.414927485,-14.50300672
20,19,2001,28,79,-47,154,3,-51,-44,-99,4248,6.5154159395,18.382780686,-10.93659104,-4,0.6980802792,-11.86736475,-10.23851076
20,19,2002,41,78,-15,154,3,-37,-12,-53,4195,9.712187611,18.476844723,-3.55323937,-4,0.710647874,-8.764657112,-2.842591496
20,19,2003,34,76,6,154,1,-42,7,-41,4154,8.1446879866,18.205773146,1.43729788,-6,0.2395496467,-10.06108516,1.6768475266
20,19,2004,45,73,30,154,0,-28,30,0,4154,10.832932114,17.573423207,7.2219547424,-2,0,-6.740491093,7.2219547424
20,19,2005,38,63,-124,154,1,-25,-123,-151,4003,9.3171509133,15.446855462,-30.40333456,-3,0.2451881819,-6.129704548,-30.15814638
20,19,2006,36,67,-109,154,0,-31,-109,-141,3862,9.1544818818,17.037507947,-27.71773681,-1,0,-7.883026065,-27.71773681
20,19,2007,38,53,-49,154,1,-15,-48,-65,3797,9.9229664447,13.839926883,-12.7954041,-2,0.2611306959,-3.916960439,-12.5342734
20,19,2008,41,67,-7,154,0,-26,-7,-29,3768,10.839391937,17.713152677,-1.850627892,4,0,-6.87376074,-1.850627892
20,21,2001,270,289,-254,335,6,-19,-248,-284,22265,12.049805864,12.897755166,-11.33574329,-17,0.2677734636,-0.847949302,-11.06796983
20,21,2002,290,246,-258,335,6,44,-252,-223,22042,13.090482317,11.104340172,-11.6460153,-15,0.2708375652,1.9861421446,-11.37517774
20,21,2003,282,248,-147,335,6,34,-141,-128,21914,12.831012831,11.284011284,-6.688506689,-21,0.273000273,1.547001547,-6.415506416
20,21,2004,267,266,-70,335,5,1,-65,-79,21835,12.20599328,12.160277949,-3.200073145,-15,0.2285766532,0.0457153306,-2.971496491
20,21,2005,208,299,-336,335,6,-91,-330,-438,21397,9.6225018505,13.83234641,-15.54404145,-17,0.2775721688,-4.20984456,-15.26646928
20,21,2006,228,273,24,335,5,-45,29,-26,21371,10.662177329,12.766554433,1.1223344557,-10,0.2338196783,-2.104377104,1.3561541339
20,21,2007,265,275,-46,335,6,-10,-40,-59,21312,12.417121571,12.885692196,-2.155424876,-9,0.2811423752,-0.468570625,-1.874282501
20,21,2008,270,262,-232,335,5,8,-227,-230,21082,12.737651554,12.360239657,-10.94494504,-11,0.2358824362,0.3774118979,-10.7090626
20,23,2001,30,48,-66,54,11,-18,-55,-76,3080,9.6215522771,15.394483643,-21.16741501,-3,3.5279025016,-5.772931366,-17.63951251
20,23,2002,27,44,-45,54,11,-17,-34,-53,3027,8.8423121009,14.409693794,-14.73718683,-2,3.6024234485,-5.567381693,-11.13476339
20,23,2003,20,38,-74,54,5,-18,-69,-85,2942,6.7012899983,12.732450997,-24.79477299,2,1.6753224996,-6.031160998,-23.11945049
20,23,2004,23,36,-27,54,4,-13,-23,-38,2904,7.8686281218,12.316113582,-9.237085186,-2,1.3684570647,-4.44748546,-7.868628122
20,23,2005,19,43,-27,54,5,-24,-22,-49,2855,6.5983677722,14.933148116,-9.376627887,-3,1.7364125716,-8.334780344,-7.640215315
20,23,2006,26,42,-13,54,4,-16,-9,-28,2827,9.1517071454,14.783526927,-4.575853573,-3,1.4079549454,-5.631819782,-3.167898627
20,23,2007,16,43,-33,54,3,-27,-30,-54,2773,5.7142857143,15.357142857,-11.78571429,3,1.0714285714,-9.642857143,-10.71428571
20,23,2008,23,42,-15,54,2,-19,-13,-31,2742,8.3408884859,15.23118767,-5.439709882,1,0.725294651,-6.890299184,-4.714415231
20,25,2001,27,28,-26,46,7,-1,-19,-22,2365,11.363636364,11.784511785,-10.94276094,-2,2.9461279461,-0.420875421,-7.996632997
20,25,2002,18,30,-28,46,7,-12,-21,-34,2331,7.6660988075,12.776831346,-11.92504259,-1,2.9812606474,-5.110732538,-8.943781942
20,25,2003,26,25,-32,46,1,1,-31,-31,2300,11.228676312,10.796804146,-13.81990931,-1,0.4318721658,0.4318721658,-13.38803714
20,25,2004,19,30,-10,46,0,-11,-10,-23,2277,8.3023814726,13.109023378,-4.369674459,-2,0,-4.806641905,-4.369674459
20,25,2005,33,34,-77,46,1,-1,-76,-79,2198,14.748603352,15.195530726,-34.41340782,-2,0.4469273743,-0.446927374,-33.96648045
20,25,2006,22,31,-45,46,0,-9,-45,-56,2142,10.138248848,14.285714286,-20.73732719,-2,0,-4.147465438,-20.73732719
20,25,2007,24,27,-54,46,1,-3,-53,-55,2087,11.350200993,12.768976117,-25.53795223,1,0.4729250414,-1.418775124,-25.06502719
20,25,2008,26,23,20,46,0,3,20,21,2108,12.395709178,10.965435042,9.5351609058,-2,0,1.4302741359,9.5351609058
20,27,2001,103,102,-64,165,-1,1,-65,-71,8741,11.735885604,11.621944967,-7.292200763,-7,-0.113940637,0.1139406369,-7.4061414
20,27,2002,86,113,-58,165,-4,-27,-62,-96,8645,9.8930173703,12.998964684,-6.672034971,-7,-0.460140343,-3.105947314,-7.132175313
20,27,2003,87,110,-44,165,-11,-23,-55,-86,8559,10.113926994,12.787723785,-5.115089514,-8,-1.278772379,-2.673796791,-6.393861893
20,27,2004,87,96,-17,165,4,-9,-13,-28,8531,10.181392627,11.23464014,-1.989467525,-6,0.4681100059,-1.053247513,-1.521357519
20,27,2005,97,122,53,165,-1,-25,52,19,8550,11.35764885,14.284877935,6.2057256601,-8,-0.117089163,-2.927229085,6.0886364967
20,27,2006,110,111,39,165,2,-1,41,36,8586,12.838468721,12.955182073,4.5518207283,-4,0.233426704,-0.116713352,4.7852474323
20,27,2007,126,106,85,165,-1,20,84,105,8691,14.585865602,12.270648839,9.8396712392,1,-0.115760838,2.3152167622,9.7239104011
20,27,2008,115,99,148,165,1,16,149,168,8859,13.105413105,11.282051282,16.866096866,3,0.113960114,1.8233618234,16.98005698
20,29,2001,91,153,-110,662,6,-62,-104,-172,10054,8.9743589744,15.088757396,-10.84812623,-6,0.5917159763,-6.114398422,-10.25641026
20,29,2002,112,164,-117,662,5,-52,-112,-170,9884,11.234827967,16.450998094,-11.73638279,-6,0.5015548199,-5.216170127,-11.23482797
20,29,2003,108,152,-44,662,5,-44,-39,-94,9790,10.978956999,15.451865406,-4.472908407,-11,0.5082850463,-4.472908407,-3.964623361
20,29,2004,112,168,-110,662,6,-56,-104,-171,9619,11.541037663,17.311556494,-11.3349477,-11,0.6182698748,-5.770518831,-10.71667783
20,29,2005,88,134,20,662,6,-46,26,-30,9589,9.162848813,13.952519783,2.0824656393,-10,0.6247396918,-4.78967097,2.7072053311
20,29,2006,121,149,-134,662,6,-28,-128,-158,9431,12.723449001,15.667718191,-14.09043113,-2,0.6309148265,-2.94426919,-13.4595163
20,29,2007,115,154,-7,662,6,-39,-1,-43,9388,12.221690844,16.366438174,-0.743929008,-3,0.6376534354,-4.14474733,-0.106275573
20,29,2008,118,151,94,662,7,-33,101,65,9453,12.525874423,16.028873202,9.978238947,-3,0.7430603471,-3.502998779,10.721299294
20,31,2001,103,125,-90,170,4,-22,-86,-114,8776,11.660817389,14.151477414,-10.18906374,-6,0.4528472773,-2.490660025,-9.736216461
20,31,2002,103,115,-38,170,4,-12,-34,-54,8722,11.772774031,13.144359355,-4.343353526,-8,0.457195108,-1.371585324,-3.886158418
20,31,2003,113,107,-4,170,4,6,0,-8,8714,12.961688461,12.273457215,-0.45882083,-14,0.4588208305,0.6882312457,0
20,31,2004,99,119,-89,170,3,-20,-86,-113,8601,11.435171816,13.745307537,-10.28010396,-7,0.3465203581,-2.31013572,-9.933583598
20,31,2005,100,104,-82,170,4,-4,-78,-90,8511,11.687704535,12.155212716,-9.583917719,-8,0.4675081814,-0.467508181,-9.116409537
20,31,2006,96,115,48,170,3,-19,51,27,8538,11.261657575,13.490527304,5.6308287876,-5,0.3519267992,-2.228869728,5.9827555868
20,31,2007,90,104,-120,170,3,-14,-117,-124,8414,10.61821614,12.26993865,-14.15762152,7,0.353940538,-1.651722511,-13.80368098
20,31,2008,98,97,-9,170,2,1,-7,-5,8409,11.650716281,11.531831421,-1.06996374,1,0.23776972,0.11888486,-0.83219402
20,33,2001,22,28,33,70,1,-6,34,27,1983,11.170347804,14.216806296,16.755521706,-1,0.507743082,-3.046458492,17.263264788
20,33,2002,17,42,-2,70,1,-25,-1,-28,1955,8.6338242763,21.330624683,-1.015744033,-2,0.5078720163,-12.69680041,-0.507872016
20,33,2003,13,34,-30,70,1,-21,-29,-50,1905,6.7357512953,17.616580311,-15.54404145,0,0.518134715,-10.88082902,-15.02590674
20,33,2004,23,34,8,70,0,-11,8,-5,1900,12.08935611,17.871222076,4.2049934297,-2,0,-5.781865966,4.2049934297
20,33,2005,11,26,39,70,1,-15,40,24,1924,5.7531380753,13.59832636,20.39748954,-1,0.5230125523,-7.845188285,20.920502092
20,33,2006,14,41,-41,70,0,-27,-41,-69,1855,7.4093675576,21.698862133,-21.69886213,-1,0,-14.28949458,-21.69886213
20,33,2007,15,36,46,70,1,-21,47,22,1877,8.038585209,19.292604502,24.651661308,-4,0.5359056806,-11.25401929,25.187566988
20,33,2008,16,30,90,70,0,-14,90,73,1950,8.361640972,15.678076823,47.034230468,-3,0,-7.316435851,47.034230468
20,35,2001,470,434,-538,1808,28,36,-510,-497,35757,13.053561261,12.053714016,-14.94216161,-23,0.7776589688,0.9998472456,-14.16450265
20,35,2002,504,442,243,1808,27,62,270,304,36061,14.035478571,12.308891921,6.7671057395,-28,0.7519006377,1.7265866496,7.5190063772
20,35,2003,454,455,-678,1808,20,-1,-658,-665,35396,12.706942637,12.734931497,-18.97644737,-6,0.5597772087,-0.02798886,-18.41667017
20,35,2004,466,438,-278,1808,23,28,-255,-256,35140,13.213111035,12.419190201,-7.882499716,-29,0.6521492571,0.7939208348,-7.230350459
20,35,2005,434,410,-682,1808,21,24,-661,-656,34484,12.466965414,11.777547972,-19.59094565,-19,0.603240262,0.6894174423,-18.98770539
20,35,2006,448,437,-341,1808,22,11,-319,-324,34160,13.052852398,12.732358254,-9.935318455,-16,0.6409882874,0.3204941437,-9.294330167
20,35,2007,457,372,-20,1808,19,85,-1,48,34208,13.368827522,10.88228411,-0.585069038,-36,0.5558155862,2.4865434121,-0.029253452
20,35,2008,476,382,-212,1808,21,94,-191,-143,34065,13.944018865,11.190368081,-6.210361343,-46,0.6151773029,2.7536507844,-5.595184041
20,37,2001,548,453,3,1814,97,95,100,158,38393,14.302865793,11.823354387,0.0783003602,-37,2.5317116459,2.4795114058,2.6100120061
20,37,2002,495,439,-234,1814,93,56,-141,-119,38274,12.912987335,11.452124121,-6.104321286,-34,2.4260764084,1.4608632136,-3.678244877
20,37,2003,520,450,167,1814,70,70,237,264,38538,13.539551112,11.716919231,4.3482789148,-43,1.8226318804,1.8226318804,6.1709107952
20,37,2004,538,460,-113,1814,72,78,-41,5,38543,13.959341472,11.935496426,-2.931980644,-32,1.868164658,2.0238450461,-1.063815986
20,37,2005,478,481,-76,1814,73,-3,-3,-37,38506,12.407688614,12.485561136,-1.972770575,-31,1.8948980519,-0.077872523,-0.077872523
20,37,2006,521,418,-38,1814,74,103,36,121,38627,13.509133574,10.838421947,-0.985311086,-18,1.9187636939,2.670711628,0.9334526078
20,37,2007,542,447,-56,1814,67,95,11,105,38732,14.012590649,11.556509262,-1.447795344,-1,1.7321837149,2.4560813868,0.2843883711
20,37,2008,588,430,-101,1814,69,158,-32,136,38868,15.154639175,11.082474227,-2.603092784,10,1.7783505155,4.0721649485,-0.824742268
20,39,2001,37,56,-9,121,6,-19,-3,-24,3434,10.737086477,16.250725479,-2.611723738,-2,1.7411491584,-5.513639002,-0.870574579
20,39,2002,32,67,-52,121,6,-35,-46,-83,3351,9.4325718497,19.74944731,-15.32792926,-2,1.7686072218,-10.31687546,-13.55932203
20,39,2003,22,46,-72,121,5,-24,-67,-90,3261,6.6545674531,13.914095584,-21.77858439,1,1.5124016939,-7.259528131,-20.2661827
20,39,2004,24,43,-56,121,4,-19,-52,-74,3187,7.4441687345,13.337468983,-17.36972705,-3,1.2406947891,-5.893300248,-16.12903226
20,39,2005,19,56,-88,121,5,-37,-83,-121,3066,6.0770830002,17.911402527,-28.14648968,-1,1.5992323685,-11.83431953,-26.54725732
20,39,2006,17,53,-10,121,4,-36,-6,-44,3022,5.5847568988,17.41130092,-3.285151117,-2,1.3140604468,-11.82654402,-1.97109067
20,39,2007,24,47,-57,121,5,-23,-52,-77,2945,8.0442433384,15.753309871,-19.10507793,-2,1.6758840288,-7.709066533,-17.4291939
20,39,2008,25,46,-15,121,4,-21,-11,-33,2912,8.5367935803,15.707700188,-5.122076148,-1,1.3658869729,-7.170906607,-3.756189175
20,41,2001,223,228,-283,338,10,-5,-273,-289,19058,11.613071215,11.873453977,-14.73766437,-11,0.5207655253,-0.260382763,-14.21689884
20,41,2002,196,270,0,338,2,-74,2,-90,18968,10.308736128,14.200809972,0,-18,0.105191185,-3.892073844,0.105191185
20,41,2003,210,238,105,338,-16,-28,89,42,19010,11.059034178,12.533572068,5.5295170888,-19,-0.84259308,-1.47453789,4.6869240086
20,41,2004,210,236,-115,338,16,-26,-99,-141,18869,11.087937908,12.46073022,-6.071965997,-16,0.8447952691,-1.372792312,-5.227170728
20,41,2005,197,225,49,338,5,-28,54,9,18878,10.437915596,11.921477203,2.5962328132,-17,0.2649217156,-1.483561608,2.8611545288
20,41,2006,229,223,80,338,12,6,92,87,18965,12.102634569,11.785534973,4.2279946093,-11,0.6341991914,0.3170995957,4.8621938007
20,41,2007,240,217,-24,338,4,23,-20,3,18968,12.653889753,11.441225318,-1.265388975,0,0.2108981625,1.2126644347,-1.054490813
20,41,2008,246,233,332,338,8,13,340,360,19328,12.847294757,12.168372676,17.338625444,7,0.4177982035,0.6789220806,17.756423647
20,43,2001,84,93,-31,391,0,-9,-31,-49,8186,10.230802022,11.326959381,-3.775653127,-9,0,-1.096157359,-3.775653127
20,43,2002,82,86,-52,391,0,-4,-52,-64,8122,10.05641403,10.546970812,-6.377238165,-8,0,-0.490556782,-6.377238165
20,43,2003,77,82,-57,391,-3,-5,-60,-72,8050,9.5226317091,10.140984418,-7.049220876,-7,-0.371011625,-0.618352708,-7.420232501
20,43,2004,80,79,-153,391,1,1,-152,-159,7891,10.03701148,9.9115488363,-19.19578446,-8,0.1254626435,0.1254626435,-19.07032181
20,43,2005,69,85,-151,391,-1,-16,-152,-174,7717,8.8416196822,10.891850333,-19.34905177,-6,-0.128139416,-2.050230651,-19.47719118
20,43,2006,69,74,23,391,1,-5,24,16,7733,8.932038835,9.5792880259,2.9773462783,-3,0.1294498382,-0.647249191,3.1067961165
20,43,2007,95,67,13,391,-1,28,12,34,7767,12.258064516,8.6451612903,1.6774193548,-6,-0.129032258,3.6129032258,1.5483870968
20,43,2008,88,75,-25,391,1,13,-24,-14,7753,11.340206186,9.6649484536,-3.221649485,-3,0.1288659794,1.675257732,-3.092783505
20,45,2001,1166,531,218,8714,353,635,571,2044,102325,11.510024382,5.2417006407,2.1519599617,838,3.4845957178,6.2683237416,5.6365556795
20,45,2002,1221,570,480,8714,329,651,809,2147,104472,11.808681944,5.5126525046,4.6422336881,687,3.1818643404,6.2960294395,7.8240980285
20,45,2003,1245,524,203,8714,270,721,473,1855,106327,11.812200248,4.9715605862,1.9260053416,661,2.5616819814,6.8406396615,4.487687323
20,45,2004,1231,537,433,8714,275,694,708,2182,108509,11.459904299,4.9991621516,4.0309817721,780,2.5600923495,6.4607421475,6.5910741217
20,45,2005,1229,573,52,8714,278,656,330,3010,111519,11.17130547,5.2084280183,0.4726671151,2024,2.5269511153,5.962877452,2.9996182304
20,45,2006,1274,610,542,8714,286,664,828,1040,112559,11.371040441,5.4445327074,4.8376011924,-452,2.552682548,5.9265077339,7.3902837405
20,45,2007,1285,557,-110,8714,259,728,149,841,113400,11.373744794,4.9300979381,-0.973627959,-36,2.2924512854,6.4436468563,1.3188233264
20,45,2008,1361,557,304,8714,263,804,567,1348,114748,11.930851903,4.8827953784,2.6649367954,-23,2.3055209776,7.0480565247,4.970457773
20,47,2001,43,40,-64,61,18,3,-46,-46,3379,12.639623751,11.757789536,-18.81246326,-3,5.291005291,0.8818342152,-13.52145797
20,47,2002,41,48,-61,61,18,-7,-43,-51,3328,12.226032503,14.313403906,-18.1899508,-1,5.3675264649,-2.087371403,-12.82242433
20,47,2003,37,50,-75,61,7,-13,-68,-81,3247,11.254752852,15.209125475,-22.81368821,0,2.1292775665,-3.954372624,-20.68441065
20,47,2004,40,50,24,61,6,-10,30,18,3265,12.285012285,15.356265356,7.371007371,-2,1.8427518428,-3.071253071,9.2137592138
20,47,2005,36,37,-35,61,7,-1,-28,-30,3235,11.076923077,11.384615385,-10.76923077,-1,2.1538461538,-0.307692308,-8.615384615
20,47,2006,48,41,-114,61,6,7,-108,-103,3132,15.077744621,12.878906864,-35.80964347,-2,1.8847180776,2.1988377572,-33.9249254
20,47,2007,46,26,-49,61,4,20,-45,-34,3098,14.767255217,8.3467094703,-15.73033708,-9,1.2841091493,6.4205457464,-14.44622793
20,47,2008,43,31,-22,61,3,12,-19,-16,3082,13.915857605,10.03236246,-7.1197411,-9,0.9708737864,3.8834951456,-6.148867314
20,49,2001,32,70,-21,86,2,-38,-19,-61,3158,10.036067116,21.953896817,-6.586169045,-4,0.6272541948,-11.9178297,-5.95891485
20,49,2002,39,48,18,86,2,-9,20,8,3166,12.333965844,15.180265655,5.6925996205,-3,0.6325110689,-2.84629981,6.3251106894
20,49,2003,26,60,-17,86,1,-34,-16,-54,3112,8.282892641,19.114367633,-5.415737496,-4,0.3185727939,-10.83147499,-5.097164702
20,49,2004,30,44,9,86,0,-14,9,-8,3104,9.6525096525,14.157014157,2.8957528958,-3,0,-4.504504505,2.8957528958
20,49,2005,43,55,-13,86,1,-12,-12,-27,3077,13.913606213,17.796473063,-4.206439088,-3,0.3235722375,-3.88286685,-3.88286685
20,49,2006,37,47,-34,86,0,-10,-34,-45,3032,12.113275495,15.387133737,-11.13111802,-1,0,-3.273858242,-11.13111802
20,49,2007,34,35,-9,86,1,-1,-8,-10,3022,11.232243145,11.562603238,-2.973240833,-1,0.3303600925,-0.330360093,-2.64288074
20,49,2008,32,40,31,86,0,-8,31,25,3047,10.545394628,13.181743286,10.215851046,2,0,-2.636348657,10.215851046
20,51,2001,345,232,-47,1259,33,113,-14,74,27532,12.547735952,8.4378977996,-1.709401709,-25,1.2002182215,4.1098381524,-0.509183488
20,51,2002,341,259,-219,1259,32,82,-187,-126,27406,12.413993957,9.4288106593,-7.972623685,-21,1.1649495795,2.9851832975,-6.807674105
20,51,2003,367,233,-231,1259,24,134,-207,-96,27310,13.414723298,8.5167044375,-8.443599678,-23,0.8772571094,4.898018861,-7.566342569
20,51,2004,373,278,-210,1259,28,95,-182,-111,27199,13.685813352,10.200150434,-7.705149608,-24,1.0273532811,3.4856629181,-6.677796327
20,51,2005,323,240,-182,1259,25,83,-157,-94,27105,11.895992929,8.8391278727,-6.703005303,-20,0.9207424867,3.056865056,-5.782262817
20,51,2006,350,230,77,1259,27,120,104,209,27314,12.863154413,8.4529300428,2.8298939709,-15,0.9923004833,4.4102243702,3.8221944541
20,51,2007,381,226,-67,1259,25,155,-42,107,27421,13.921622362,8.2579702202,-2.448159313,-6,0.913492281,5.6636521421,-1.534667032
20,51,2008,394,251,222,1259,27,143,249,380,27801,14.269675129,9.0905798414,8.0402738039,-12,0.9778711383,5.1790952881,9.0181449422
20,53,2001,55,106,-24,826,-1,-51,-25,-82,6443,8.4824182603,16.347933374,-3.701418877,-6,-0.154225787,-7.865515114,-3.855644664
20,53,2002,41,96,-24,826,-1,-55,-25,-86,6357,6.40625,15,-3.75,-6,-0.15625,-8.59375,-3.90625
20,53,2003,52,83,37,826,-3,-31,34,-6,6351,8.183821215,13.062637709,5.8231035568,-9,-0.472143532,-4.878816494,5.3509600252
20,53,2004,35,58,-7,826,1,-23,-6,-34,6317,5.5257341332,9.1569308494,-1.105146827,-5,0.1578781181,-3.631196716,-0.947268709
20,53,2005,44,98,-3,826,-1,-54,-4,-61,6256,6.9991251094,15.588960471,-0.477213076,-3,-0.159071025,-8.589835361,-0.636284101
20,53,2006,56,83,55,826,0,-27,55,25,6281,8.9335566723,13.240807211,8.7740288745,-3,0,-4.307250538,8.7740288745
20,53,2007,56,65,25,826,-1,-9,24,17,6298,8.9037284363,10.334684792,3.9748787662,2,-0.158995151,-1.430956356,3.8158836155
20,53,2008,59,72,-36,826,1,-13,-35,-48,6250,9.403889066,11.47593242,-5.73796621,0,0.1593879503,-2.072043354,-5.578578259
20,55,2001,901,237,-1540,572,443,664,-1097,54,40638,22.186107212,5.83585728,-37.92076039,487,10.908374578,16.350249932,-27.01238581
20,55,2002,795,211,-1922,572,418,584,-1504,-516,40122,19.687964339,5.2253590887,-47.5978207,404,10.351659237,14.46260525,-37.24616147
20,55,2003,780,190,-1483,572,356,590,-1127,-105,40017,19.466177517,4.7417611899,-37.01069392,432,8.8845630717,14.724416327,-28.12613085
20,55,2004,787,187,-785,572,325,600,-460,499,40516,19.544782884,4.6440589572,-19.4951138,359,8.0712254604,14.900723927,-11.42388834
20,55,2005,821,207,-1337,572,348,614,-989,-14,40502,20.267101138,5.109975561,-33.00501123,361,8.5906835518,15.157125577,-24.41432768
20,55,2006,743,172,-1106,572,349,571,-757,174,40676,18.305452216,4.2376013206,-27.24876198,360,8.598388726,14.067850896,-18.65037325
20,55,2007,761,183,-1136,572,312,578,-824,106,40782,18.684475435,4.4931130153,-27.89167424,352,7.6603894031,14.19136242,-20.23128483
20,55,2008,769,165,-667,572,314,604,-353,216,40998,18.80655417,4.0352164343,-16.31205674,-35,7.6791391538,14.771337735,-8.632917584
20,57,2001,632,289,-1068,782,447,343,-621,-284,32281,19.492335688,8.9134256546,-32.93957993,-6,13.786509577,10.578910033,-19.15307035
20,57,2002,648,278,-900,782,415,370,-485,-117,32164,20.110171464,8.6275118318,-27.9307937,-2,12.879199317,11.482659632,-15.05159438
20,57,2003,666,264,-348,782,368,402,20,394,32558,20.580328173,8.1579679244,-10.75368499,-28,11.371712864,12.422360248,0.6180278731
20,57,2004,667,258,-604,782,333,409,-271,96,32654,20.456357726,7.9126541127,-18.524198,-42,10.212844262,12.543703613,-8.311353739
20,57,2005,650,247,-510,782,353,403,-157,222,32876,19.838242027,7.5385319701,-15.5653899,-24,10.773691439,12.299710056,-4.791698459
20,57,2006,642,213,-892,782,351,429,-541,-125,32751,19.565118015,6.4912307434,-27.18393344,-13,10.696816859,13.073887272,-16.48711658
20,57,2007,659,208,-455,782,323,451,-132,326,33077,20.02187519,6.3194993012,-13.82390472,7,9.8134532418,13.702375889,-4.01045148
20,57,2008,661,214,-561,782,324,447,-237,216,33293,19.918637939,6.4486967003,-16.90522827,6,9.7634473407,13.469941239,-7.141780925
20,59,2001,352,263,78,592,18,89,96,294,25145,14.08112649,10.520841667,3.12024962,109,0.7200576046,3.5602848228,3.8403072246
20,59,2002,375,231,99,592,17,144,116,348,25493,14.811011493,9.1235830799,3.9101070342,88,0.671432521,5.6874284134,4.5815395553
20,59,2003,378,238,-18,592,13,140,-5,211,25704,14.766490224,9.2974197707,-0.703166201,76,0.5078422564,5.4690704533,-0.195323945
20,59,2004,363,241,115,592,16,122,131,258,25962,14.051794217,9.3291526342,4.4516703441,5,0.6193628305,4.7226415825,5.0710331746
20,59,2005,362,224,-116,592,14,138,-102,36,25998,13.933795227,8.6220169361,-4.464973056,0,0.5388760585,5.311778291,-3.926096998
20,59,2006,376,230,135,592,15,146,150,296,26294,14.380784824,8.7967566741,5.1633137,0,0.5737015222,5.5840281496,5.7370152222
20,59,2007,400,237,-59,592,13,163,-46,117,26411,15.178825538,8.9934541315,-2.238876767,0,0.49331183,6.1853714069,-1.745564937
20,59,2008,388,230,-21,592,15,158,-6,151,26562,14.648972118,8.6836690389,-0.792856738,-1,0.5663262417,5.9653030789,-0.226530497
20,61,2001,555,204,-811,624,30,351,-781,303,27986,19.939283982,7.3290341123,-29.13650326,733,1.0777991342,12.61024987,-28.05870413
20,61,2002,592,209,-691,610,-115,383,-806,160,28146,21.093137604,7.4467327015,-24.6205373,583,-4.097484501,13.646404903,-28.71802181
20,61,2003,589,201,-86,598,-408,388,-494,460,28606,20.756977728,7.0834508035,-3.030730195,566,-14.3783479,13.673526924,-17.40907809
20,61,2004,538,198,-1518,589,234,340,-1284,-476,28130,18.965031021,6.9796954315,-53.51099831,468,8.2487309645,11.985335589,-45.26226734
20,61,2005,535,176,-777,598,10,359,-767,137,28267,18.972640389,6.2414667447,-27.55465716,545,0.3546287923,12.731173644,-27.20002837
20,61,2006,542,197,-356,587,141,345,-215,744,29011,18.925241803,6.8787317993,-12.43060163,614,4.9233562624,12.046510004,-7.507245365
20,61,2007,731,167,-659,621,7,564,-652,528,29539,24.970111016,5.7045260461,-22.51067464,616,0.2391118702,19.26558497,-22.27156277
20,61,2008,685,160,1041,621,61,525,1102,1632,31171,22.566298798,5.2709603031,34.294185472,5,2.0095536155,17.295338494,36.303739087
20,63,2001,33,40,-55,53,1,-7,-54,-62,3005,10.869565217,13.175230567,-18.11594203,-1,0.3293807642,-2.305665349,-17.78656126
20,63,2002,29,36,-39,53,1,-7,-38,-47,2958,9.7266476606,12.074459165,-13.0806641,-2,0.3354016435,-2.347811504,-12.74526245
20,63,2003,27,41,-79,53,1,-14,-78,-90,2868,9.2687950566,14.074836938,-27.11980776,2,0.3432887058,-4.806041881,-26.77651905
20,63,2004,31,49,-48,53,0,-18,-48,-68,2800,10.938602682,17.2900494,-16.93719125,-2,0,-6.351446718,-16.93719125
20,63,2005,27,32,-70,53,1,-5,-69,-75,2725,9.7737556561,11.583710407,-25.33936652,-1,0.3619909502,-1.809954751,-24.97737557
20,63,2006,41,35,-23,53,0,6,-23,-19,2706,15.098508562,12.888970724,-8.469895047,-2,0,2.2095378383,-8.469895047
20,63,2007,24,29,-71,53,1,-5,-70,-77,2629,8.9971883786,10.871602624,-26.61668229,-2,0.3748828491,-1.874414246,-26.24179944
20,63,2008,35,34,-80,53,0,1,-80,-81,2548,13.521344408,13.135020282,-30.90593008,-2,0,0.3863241259,-30.90593008
20,65,2001,14,40,-22,69,1,-26,-21,-50,2871,4.8342541436,13.812154696,-7.596685083,-3,0.3453038674,-8.977900552,-7.251381215
20,65,2002,20,38,-9,69,1,-18,-8,-29,2842,7.0015753545,13.302993173,-3.15070891,-3,0.3500787677,-6.301417819,-2.800630142
20,65,2003,25,40,-50,69,1,-15,-49,-65,2777,8.8983804947,14.237408792,-17.79676099,-1,0.3559352198,-5.339028297,-17.44082577
20,65,2004,29,34,-62,69,0,-5,-62,-71,2706,10.578150647,12.401969725,-22.61535656,-4,0,-1.823819077,-22.61535656
20,65,2005,22,45,-19,69,1,-23,-18,-44,2662,8.1967213115,16.766020864,-7.078986587,-3,0.3725782414,-8.569299553,-6.706408346
20,65,2006,19,35,-4,69,0,-16,-4,-21,2641,7.1657552329,13.200075429,-1.508580049,-1,0,-6.034320196,-1.508580049
20,65,2007,28,26,-37,69,1,2,-36,-36,2605,10.674799848,9.9123141441,-14.10598551,-2,0.3812428517,0.7624857034,-13.72474266
20,65,2008,25,32,-3,69,0,-7,-3,-13,2592,9.6209351549,12.314796998,-1.154512219,-3,0,-2.693861843,-1.154512219
20,67,2001,141,64,-255,71,45,77,-210,-136,7741,18.056089128,8.1956716609,-32.65462927,-3,5.7625816366,9.860417467,-26.89204764
20,67,2002,158,51,-84,71,44,107,-40,62,7803,20.329387545,6.5620174987,-10.80802882,-5,5.6613484303,13.767370046,-5.146680391
20,67,2003,151,52,-330,71,39,99,-291,-178,7625,19.574799067,6.7409904071,-42.7793622,14,5.0557428053,12.83380866,-37.72361939
20,67,2004,135,58,-192,71,36,77,-156,-90,7535,17.810026385,7.6517150396,-25.3298153,-11,4.7493403694,10.158311346,-20.58047493
20,67,2005,131,51,-192,71,39,80,-153,-78,7457,17.475987193,6.8036286019,-25.61366062,-5,5.2027748132,10.672358591,-20.41088581
20,67,2006,131,58,-100,71,38,73,-62,7,7464,17.559144829,7.7742778634,-13.40392735,-4,5.0934923933,9.784866966,-8.310434957
20,67,2007,133,41,-111,71,35,92,-76,17,7481,17.798594848,5.4867848779,-14.85446638,1,4.6838407494,12.31180997,-10.17062563
20,67,2008,134,55,-196,71,34,79,-162,-86,7395,18.01559559,7.3944608766,-26.35116967,-3,4.5711212692,10.621134714,-21.7800484
20,69,2001,110,52,-97,141,46,58,-51,3,5906,18.629858582,8.806842239,-16.42814802,-4,7.7906681345,9.8230163435,-8.637479888
20,69,2002,85,67,-8,141,45,18,37,49,5955,14.332686957,11.297529719,-1.348958772,-6,7.587893095,3.035157238,6.2389343226
20,69,2003,106,66,-76,141,34,40,-42,-5,5950,17.807643847,11.087778244,-12.76774465,-3,5.7118857623,6.7198656027,-7.055858883
20,69,2004,91,41,-112,141,33,50,-79,-35,5915,15.339233038,6.9110830173,-18.87905605,-6,5.5625790139,8.4281500211,-13.31647703
20,69,2005,99,62,-148,141,34,37,-114,-82,5833,16.853932584,10.554988083,-25.195778,-5,5.7882192714,6.2989445012,-19.40755873
20,69,2006,88,51,-167,141,33,37,-134,-98,5735,15.214384509,8.8174273859,-28.87275242,-1,5.7053941909,6.3969571231,-23.16735823
20,69,2007,93,44,-179,141,28,49,-151,-102,5633,16.361717101,7.7410274455,-31.49190711,0,4.9261083744,8.6206896552,-26.56579873
20,69,2008,88,53,-7,141,27,35,20,55,5688,15.54632983,9.3631304655,-1.236639873,0,4.7698966522,6.183199364,3.5332567794
20,71,2001,20,14,-16,27,9,6,-7,-2,1538,12.995451592,9.0968161144,-10.39636127,-1,5.8479532164,3.8986354776,-4.548408057
20,71,2002,21,20,-111,27,9,1,-102,-99,1439,14.10816258,13.436345314,-74.57171649,2,6.0463553913,0.6718172657,-68.5253611
20,71,2003,14,23,-41,27,7,-9,-34,-43,1396,9.8765432099,16.225749559,-28.92416226,0,4.9382716049,-6.349206349,-23.98589065
20,71,2004,11,25,2,27,6,-14,8,-7,1389,7.8994614004,17.953321364,1.4362657092,-1,4.3087971275,-10.05385996,5.7450628366
20,71,2005,19,22,-71,27,7,-3,-64,-67,1322,14.016967909,16.230173368,-52.37919587,0,5.1641460716,-2.213205459,-47.2150498
20,71,2006,9,9,-48,27,6,0,-42,-43,1279,6.9204152249,6.9204152249,-36.9088812,-1,4.6136101499,0,-32.29527105
20,71,2007,14,9,3,27,3,5,6,10,1289,10.903426791,7.0093457944,2.3364485981,-1,2.3364485981,3.8940809969,4.6728971963
20,71,2008,13,9,-27,27,2,4,-25,-23,1266,10.176125245,7.0450097847,-21.13502935,-2,1.5655577299,3.1311154599,-19.56947162
20,73,2001,92,133,49,191,6,-41,55,7,7667,12.00495857,17.354994454,6.3939453252,-7,0.7829320806,-5.350035884,7.1768774059
20,73,2002,79,133,-33,191,6,-54,-27,-87,7580,10.362694301,17.446054962,-4.328720404,-6,0.7870400735,-7.083360661,-3.541680331
20,73,2003,85,110,-50,191,4,-25,-46,-78,7502,11.271714627,14.586924811,-6.630420369,-7,0.5304336295,-3.315210184,-6.099986739
20,73,2004,71,124,-21,191,3,-53,-18,-76,7426,9.5123258307,16.613076099,-2.813504823,-5,0.4019292605,-7.100750268,-2.411575563
20,73,2005,75,129,-139,191,4,-54,-135,-196,7230,10.234716157,17.60371179,-18.96834061,-7,0.5458515284,-7.368995633,-18.42248908
20,73,2006,80,112,-219,191,3,-32,-216,-249,6981,11.258883963,15.762437548,-30.82119485,-1,0.4222081486,-4.503553585,-30.3989867
20,73,2007,73,98,54,191,4,-25,58,26,7007,10.437517872,14.012010295,7.7209036317,-7,0.5719187875,-3.574492422,8.2928224192
20,73,2008,84,111,-114,191,3,-27,-111,-146,6861,12.114219787,16.008076147,-16.44072685,-8,0.4326507067,-3.89385636,-16.00807615
20,75,2001,39,31,-16,43,31,8,15,19,2679,14.60947743,11.612661547,-5.993631766,-4,11.612661547,2.9968158831,5.6190297809
20,75,2002,55,35,-49,43,31,20,-18,1,2680,20.526217578,13.062138459,-18.28699384,-1,11.569322635,7.4640791192,-6.717671207
20,75,2003,42,27,-25,43,17,15,-8,5,2685,15.657036347,10.065237651,-9.319664492,-2,6.3373718546,5.5917986952,-2.982292637
20,75,2004,38,26,-84,43,16,12,-68,-60,2625,14.312617702,9.7928436911,-31.63841808,-4,6.0263653484,4.5197740113,-25.61205273
20,75,2005,36,26,-84,43,17,10,-67,-59,2566,13.870159892,10.0173377,-32.36370641,-2,6.5497977268,3.8528221923,-25.81390869
20,75,2006,36,33,-12,43,16,3,4,7,2573,14.010507881,12.842965558,-4.670169294,0,6.2268923915,1.1675423234,1.5567230979
20,75,2007,45,22,3,43,15,23,18,40,2613,17.354415735,8.4843810258,1.156961049,-1,5.7848052449,8.8700347088,6.9417662939
20,75,2008,43,14,-22,43,14,29,-8,18,2631,16.399694889,5.3394355454,-8.390541571,-3,5.3394355454,11.060259344,-3.051106026
20,77,2001,67,106,-71,168,2,-39,-69,-112,6390,10.394042817,16.444306547,-11.01458269,-4,0.3102699348,-6.050263729,-10.70431275
20,77,2002,65,106,-123,168,2,-41,-121,-166,6224,10.306009196,16.806722689,-19.50214048,-4,0.3171079753,-6.500713493,-19.1850325
20,77,2003,71,107,3,168,2,-36,5,-38,6186,11.442385173,17.244157937,0.4834810637,-7,0.3223207091,-5.801772764,0.8058017728
20,77,2004,66,101,-42,168,1,-35,-41,-82,6104,10.740439382,16.436126932,-6.834825061,-6,0.16273393,-5.695687551,-6.672091131
20,77,2005,61,108,-80,168,2,-47,-78,-129,5975,10.100173855,17.882275023,-13.24612965,-4,0.3311532412,-7.782101167,-12.91497641
20,77,2006,73,116,-68,168,1,-43,-67,-113,5862,12.334206302,19.5995607,-11.48939765,-3,0.1689617302,-7.265354397,-11.32043592
20,77,2007,79,93,-23,168,2,-14,-21,-35,5827,13.516981778,15.91239627,-3.935323809,0,0.3422020703,-2.395414492,-3.593121738
20,77,2008,72,93,51,168,1,-21,52,30,5857,12.324546388,15.919205751,8.729887025,-1,0.1711742554,-3.594659363,8.9010612804
20,79,2001,427,324,-93,1440,57,103,-36,36,32909,12.982274786,9.8507190417,-2.827521206,-31,1.7329968684,3.1315557447,-1.094524338
20,79,2002,435,342,139,1440,55,93,194,256,33165,13.16705512,10.352029543,4.20740382,-31,1.6648000726,2.8150255774,5.8722038926
20,79,2003,444,358,27,1440,43,86,70,108,33273,13.365844848,10.77696499,0.8127878624,-48,1.294439929,2.5888798579,2.1072277913
20,79,2004,412,386,45,1440,44,26,89,94,33367,12.364945978,11.584633854,1.3505402161,-21,1.3205282113,0.7803121248,2.6710684274
20,79,2005,410,348,-101,1440,44,62,-57,-28,33339,12.292747279,10.433844032,-3.028213354,-33,1.3192216592,1.8589032471,-1.708991695
20,79,2006,436,332,-167,1440,45,104,-122,-32,33307,13.084056057,9.9630885575,-5.011553582,-14,1.3504186298,3.1209674999,-3.661134952
20,79,2007,467,369,25,1440,37,98,62,164,33471,13.986642307,11.051543922,0.7487495882,4,1.1081493905,2.9350983857,1.8568989787
20,79,2008,454,350,38,1440,39,104,77,204,33675,13.522771275,10.425043934,1.1318619128,23,1.1616477527,3.0977273404,2.2935096655
20,81,2001,66,39,-132,35,35,27,-97,-72,4233,15.460295151,9.1356289529,-30.9205903,-2,8.198641368,6.3246661982,-22.72194893
20,81,2002,68,29,-139,35,35,39,-104,-66,4167,16.19047619,6.9047619048,-33.0952381,-1,8.3333333333,9.2857142857,-24.76190476
20,81,2003,71,26,-67,35,13,45,-54,-12,4155,17.06320596,6.2484979572,-16.10189858,-3,3.1242489786,10.814708003,-12.9776496
20,81,2004,69,28,-61,35,14,41,-47,-9,4146,16.624503072,6.7461751596,-14.69702445,-3,3.3730875798,9.8783279123,-11.32393688
20,81,2005,87,31,-90,35,14,56,-76,-23,4123,21.042447696,7.4978836619,-21.76804934,-3,3.3861410086,13.544564034,-18.38190833
20,81,2006,60,33,-152,35,14,27,-138,-112,4011,14.752889107,8.1140890091,-37.37398574,-1,3.4423407917,6.6388000984,-33.93164495
20,81,2007,67,24,-76,35,11,43,-65,-30,3981,16.766766767,6.006006006,-19.01901902,-8,2.7527527528,10.760760761,-16.26626627
20,81,2008,64,16,-108,35,11,48,-97,-62,3919,16.202531646,4.0506329114,-27.34177215,-13,2.7848101266,12.151898734,-24.55696203
20,83,2001,16,28,55,35,2,-12,57,42,2126,7.6009501188,13.301662708,26.128266033,-3,0.9501187648,-5.700712589,27.078384798
20,83,2002,20,20,16,35,2,0,18,17,2143,9.3698758491,9.3698758491,7.4959006793,-1,0.9369875849,0,8.4328882642
20,83,2003,22,25,-20,35,1,-3,-19,-24,2119,10.323791647,11.731581417,-9.385265134,-2,0.4692632567,-1.40778977,-8.916001877
20,83,2004,27,28,-34,35,0,-1,-34,-38,2081,12.857142857,13.333333333,-16.19047619,-3,0,-0.476190476,-16.19047619
20,83,2005,23,26,-52,35,1,-3,-51,-55,2026,11.200389579,12.661309959,-25.32261992,-1,0.4869734599,-1.46092038,-24.83564646
20,83,2006,24,22,-13,35,0,2,-13,-12,2014,11.881188119,10.891089109,-6.435643564,-1,0,0.9900990099,-6.435643564
20,83,2007,13,22,-62,35,1,-9,-61,-68,1946,6.5656565657,11.111111111,-31.31313131,2,0.5050505051,-4.545454545,-30.80808081
20,83,2008,21,14,-7,35,0,7,-7,2,1948,10.785824345,7.1905495634,-3.595274782,2,0,3.5952747817,-3.595274782
20,85,2001,159,125,0,231,1,34,1,23,12687,12.54388387,9.8615439233,0,-12,0.0788923514,2.6823399471,0.0788923514
20,85,2002,166,151,150,231,0,15,150,153,12840,13.005836957,11.830610726,11.75226231,-12,0,1.175226231,11.75226231
20,85,2003,185,120,103,231,-3,65,100,151,12991,14.323874414,9.2911617824,7.9749138632,-14,-0.232279045,5.0327126321,7.7426348186
20,85,2004,189,109,11,231,2,80,13,85,13076,14.501093336,8.3630644109,0.8439789773,-8,0.1534507231,6.1380289255,0.9974297004
20,85,2005,190,111,219,231,0,79,219,285,13361,14.373794303,8.3973219352,16.567689223,-13,0,5.9764723683,16.567689223
20,85,2006,171,153,-28,231,2,18,-26,-14,13347,12.805152014,11.457241276,-2.096750037,-6,0.1497678598,1.3479107384,-1.946982178
20,85,2007,180,118,-61,231,-1,62,-62,1,13348,13.485671474,8.8406068552,-4.570144222,1,-0.074920397,4.6450646188,-4.645064619
20,85,2008,189,114,-192,231,1,75,-191,-108,13240,14.216939973,8.5752971265,-14.44260569,8,0.0752219046,5.6416428464,-14.36738378
20,87,2001,199,162,-3,259,5,37,2,20,18463,10.784154338,8.7790603154,-0.162575191,-19,0.2709586517,2.0050940227,0.1083834607
20,87,2002,200,160,1,259,4,40,5,27,18490,10.824560929,8.659648743,0.0541228046,-18,0.2164912186,2.1649121857,0.2706140232
20,87,2003,216,147,-30,259,-2,69,-32,10,18500,11.678832117,7.9480940795,-1.622060016,-27,-0.108137334,3.7307380373,-1.730197351
20,87,2004,222,160,67,259,5,62,72,119,18619,11.961529136,8.6209218998,3.6100110456,-15,0.2694038094,3.3406072362,3.8794148549
20,87,2005,197,163,8,259,2,34,10,28,18647,10.57263994,8.7479203564,0.4293457844,-16,0.1073364461,1.8247195835,0.5366822305
20,87,2006,207,188,-233,259,4,19,-229,-218,18429,11.166253102,10.141331319,-12.56877765,-8,0.2157730068,1.0249217823,-12.35300464
20,87,2007,225,185,-30,259,2,40,-28,7,18436,12.206700122,10.0366201,-1.627560016,-5,0.1085040011,2.1700800217,-1.519056015
20,87,2008,223,167,-67,259,4,56,-63,-15,18421,12.100822096,9.0620506281,-3.635673006,-8,0.2170551049,3.0387714681,-3.418617902
20,89,2001,16,68,-94,45,1,-52,-93,-147,3612,4.3413376747,18.450685117,-25.50535884,-2,0.2713336047,-14.10934744,-25.23402523
20,89,2002,20,54,-82,45,1,-34,-81,-116,3496,5.6274620146,15.19414744,-23.07259426,-1,0.2813731007,-9.566685425,-22.79122116
20,89,2003,21,47,-47,45,-1,-26,-48,-74,3422,6.0711188205,13.587742122,-13.58774212,0,-0.289100896,-7.516623302,-13.87684302
20,89,2004,23,56,-39,45,0,-33,-39,-77,3345,6.7976946948,16.550908822,-11.52652579,-5,0,-9.753214127,-11.52652579
20,89,2005,25,49,-57,45,0,-24,-57,-83,3262,7.5677311942,14.832753141,-17.25442712,-2,0,-7.265021946,-17.25442712
20,89,2006,21,48,14,45,0,-27,14,-15,3247,6.4526040866,14.748809341,4.3017360578,-2,0,-8.296205254,4.3017360578
20,89,2007,31,38,-46,45,0,-7,-46,-51,3196,9.6228465001,11.795747323,-14.27906255,2,0,-2.172900823,-14.27906255
20,89,2008,28,47,-36,45,0,-19,-36,-54,3142,8.8355948249,14.831177027,-11.36005049,1,0,-5.995582203,-11.36005049
20,91,2001,7011,2801,4088,4978,1369,4210,5457,9273,463878,15.266477442,6.0991874645,8.901634543,-394,2.9810023702,9.1672899771,11.882636913
20,91,2002,7078,2857,6664,4978,1277,4221,7941,11877,475755,15.065456407,6.08109762,14.184261302,-285,2.7180824854,8.9843587869,16.902343787
20,91,2003,7432,2817,5054,4978,1114,4615,6168,10405,486160,15.452508798,5.8570663728,10.508204987,-378,2.316212971,9.5954424247,12.824417958
20,91,2004,7535,2874,4758,4978,1015,4661,5773,9992,496152,15.341357939,5.851501356,9.687349844,-442,2.0665531929,9.4898565832,11.753903037
20,91,2005,7474,3079,4154,4978,1069,4395,5223,9177,505329,14.92589475,6.1488934887,8.2957140475,-441,2.1348383045,8.7770012611,10.430552352
20,91,2006,7505,3075,4724,4978,1066,4430,5790,9946,515275,14.706977437,6.0258435201,9.257263346,-274,2.088959087,8.6811339168,11.346222433
20,91,2007,7905,3002,3662,4978,962,4903,4624,9526,524801,15.200812248,5.7726550752,7.0417930997,-1,1.8498648176,9.4281571731,8.8916579173
20,91,2008,8122,3041,3111,4978,966,5081,4077,9292,534093,15.340534558,5.743728834,5.8759422567,134,1.824545233,9.5968057237,7.7004874898
20,93,2001,77,32,-54,45,29,45,-25,17,4530,17.029746765,7.0772973571,-11.94293929,-3,6.4138007298,9.9524494084,-5.52913856
20,93,2002,75,38,-156,45,29,37,-127,-90,4440,16.722408027,8.4726867336,-34.7826087,0,6.4659977703,8.2497212932,-28.31661093
20,93,2003,69,50,-147,45,16,19,-131,-106,4334,15.728288124,11.397310235,-33.50809209,6,3.6471392751,4.3309778892,-29.86095282
20,93,2004,60,28,-39,45,15,32,-24,2,4336,13.84083045,6.4590542099,-8.996539792,-6,3.4602076125,7.3817762399,-5.53633218
20,93,2005,72,25,-127,45,16,47,-111,-65,4271,16.730568142,5.8092250494,-29.51086325,-1,3.7179040316,10.921343093,-25.79295922
20,93,2006,62,39,-93,45,15,23,-78,-57,4214,14.61402475,9.1926929876,-21.92103712,-2,3.5356511491,5.4213317619,-18.38538598
20,93,2007,62,27,-139,45,12,35,-127,-93,4121,14.877024595,6.4787042591,-33.35332933,-1,2.8794241152,8.3983203359,-30.47390522
20,93,2008,53,28,12,45,11,25,23,38,4159,12.801932367,6.7632850242,2.8985507246,-10,2.6570048309,6.038647343,5.5555555556
20,95,2001,99,102,-112,198,-1,-3,-113,-122,8555,11.490250696,11.838440111,-12.99907149,-6,-0.116063138,-0.348189415,-13.11513463
20,95,2002,84,124,-114,198,-1,-40,-115,-161,8394,9.9120892088,14.632131689,-13.45212107,-6,-0.118001062,-4.72004248,-13.57012213
20,95,2003,81,106,69,198,-3,-25,66,34,8428,9.6302461063,12.602544287,8.2035429794,-7,-0.356675782,-2.972298181,7.8468671977
20,95,2004,81,114,-100,198,1,-33,-99,-139,8289,9.6907339834,13.638810791,-11.96386912,-7,0.1196386912,-3.948076808,-11.84423042
20,95,2005,75,119,-170,198,-1,-44,-171,-221,8068,9.1703857676,14.550345418,-20.78620774,-6,-0.12227181,-5.37995965,-20.90847955
20,95,2006,78,103,-116,198,0,-25,-116,-145,7923,9.7554874617,12.882246264,-14.50816084,-4,0,-3.126758802,-14.50816084
20,95,2007,90,109,-76,198,-1,-19,-77,-92,7831,11.425669671,13.837755491,-9.648343278,4,-0.126951885,-2.412085819,-9.775295163
20,95,2008,84,106,-93,198,1,-22,-92,-112,7719,10.803858521,13.633440514,-11.96141479,2,0.1286173633,-2.829581994,-11.83279743
20,97,2001,42,51,-116,108,4,-9,-112,-121,3133,13.15171442,15.969938938,-36.32378268,0,1.2525442305,-2.818224519,-35.07123845
20,97,2002,34,33,-34,108,4,1,-30,-32,3101,10.907924286,10.587102984,-10.90792429,-3,1.2832852101,0.3208213025,-9.624639076
20,97,2003,42,35,-1,108,3,7,2,6,3107,13.530927835,11.275773196,-0.322164948,-3,0.9664948454,2.2551546392,0.6443298969
20,97,2004,33,29,-64,108,2,4,-62,-62,3045,10.728218466,9.4278283485,-20.80624187,-4,0.6501950585,1.300390117,-20.15604681
20,97,2005,39,35,-69,108,3,4,-66,-64,2981,12.943909725,11.61632924,-22.90076336,-2,0.9956853634,1.3275804846,-21.905078
20,97,2006,29,27,-39,108,2,2,-37,-36,2945,9.7873776578,9.1123860952,-13.16233547,-1,0.6749915626,0.6749915626,-12.48734391
20,97,2007,30,22,-24,108,3,8,-21,-12,2933,10.20755359,7.4855392991,-8.166042872,1,1.020755359,2.7220142906,-7.145287513
20,97,2008,28,22,-408,108,2,6,-406,-392,2541,10.230179028,8.0379978078,-149.068323,8,0.7307270734,2.1921812203,-148.3375959
20,99,2001,281,297,-248,857,2,-16,-246,-279,22458,12.435003872,13.143046797,-10.97466534,-17,0.0885053656,-0.708042925,-10.88615997
20,99,2002,274,315,-155,857,2,-41,-153,-210,22248,12.257862479,14.092068179,-6.934192278,-16,0.0894734488,-1.834205699,-6.84471883
20,99,2003,265,284,-73,857,0,-19,-73,-119,22129,11.94312369,12.799423125,-3.289992564,-27,0,-0.856299434,-3.289992564
20,99,2004,267,325,-114,857,4,-58,-110,-185,21944,12.116261657,14.748258571,-5.173235314,-17,0.1815170286,-2.631996914,-4.991718286
20,99,2005,267,294,41,857,2,-27,43,-5,21939,12.168721373,13.399266231,1.8686051546,-21,0.091151471,-1.230544858,1.9597566256
20,99,2006,279,272,19,857,3,7,22,18,21957,12.711864407,12.392928741,0.8656825223,-11,0.1366867141,0.3189356661,1.0023692364
20,99,2007,333,269,-43,857,2,64,-41,27,21984,15.156687376,12.243690403,-1.957169841,4,0.0910311554,2.9129969732,-1.866138686
20,99,2008,309,256,-186,857,4,53,-182,-113,21871,14.091893741,11.674837533,-8.482499145,16,0.1824193364,2.417056208,-8.300079808
20,101,2001,19,23,-41,23,1,-4,-40,-46,2099,8.9538171536,10.838831291,-19.32139491,-2,0.4712535344,-1.885014138,-18.85014138
20,101,2002,11,31,-108,23,1,-20,-107,-127,1972,5.4040776222,15.229673299,-53.05821665,0,0.4912797838,-9.825595677,-52.56693687
20,101,2003,17,27,-18,23,1,-10,-17,-28,1944,8.682328907,13.789581205,-9.193054137,-1,0.5107252298,-5.107252298,-8.682328907
20,101,2004,22,37,-27,23,0,-15,-27,-44,1900,11.44640999,19.250780437,-14.04786681,-2,0,-7.804370447,-14.04786681
20,101,2005,11,28,-57,23,1,-17,-56,-73,1827,5.9028709418,15.02548967,-30.58760397,0,0.5366246311,-9.122618728,-30.05097934
20,101,2006,23,21,-71,23,0,2,-71,-69,1758,12.831241283,11.715481172,-39.60948396,0,0,1.1157601116,-39.60948396
20,101,2007,21,23,-6,23,1,-2,-5,-12,1746,11.98630137,13.127853881,-3.424657534,-5,0.5707762557,-1.141552511,-2.853881279
20,101,2008,17,21,6,23,0,-4,6,-3,1743,9.7449125824,12.03783319,3.4393809114,-5,0,-2.292920608,3.4393809114
20,103,2001,906,494,496,6478,28,412,524,876,69798,13.062283737,7.122260669,7.1510957324,-60,0.4036908881,5.9400230681,7.5547866205
20,103,2002,935,542,712,6478,-105,393,607,951,70749,13.305157705,7.7127224345,10.131842017,-49,-1.494162095,5.5924352708,8.637679922
20,103,2003,967,532,460,6478,-372,435,88,446,71195,13.625091585,7.4959138815,6.4814292961,-77,-5.241503692,6.1291777039,1.2399256045
20,103,2004,908,532,-325,6619,216,376,-109,206,71401,12.735280092,7.4616398777,-4.558332632,-61,3.0295379955,5.2736402143,-1.528794637
20,103,2005,880,552,83,6587,10,328,93,355,71756,12.294194486,7.7118129047,1.1595660708,-66,0.1397067555,4.5823815811,1.2992728263
20,103,2006,946,549,293,6600,119,397,412,774,72530,13.112845321,7.609885921,4.0613780963,-35,1.6495016842,5.5029594001,5.7108797804
20,103,2007,955,465,496,6593,-2,490,494,977,73507,13.078877271,6.3682491423,6.7927990852,-7,-0.027390319,6.7106281285,6.7654087663
20,103,2008,989,503,234,6593,48,486,282,769,74276,13.38448942,6.807278239,3.1668053836,1,0.6496011043,6.5772111813,3.8164064879
20,105,2001,42,69,-2,76,1,-27,-1,-31,3543,11.802725868,19.390192497,-0.562034565,-3,0.2810172826,-7.587466629,-0.281017283
20,105,2002,38,65,-32,76,1,-27,-31,-61,3482,10.818505338,18.505338078,-9.110320285,-3,0.2846975089,-7.68683274,-8.825622776
20,105,2003,35,54,28,76,1,-19,29,8,3490,10.040160643,15.490533563,8.0321285141,-2,0.2868617326,-5.45037292,8.3189902467
20,105,2004,26,53,-100,76,0,-27,-100,-133,3357,7.5945669636,15.481232657,-29.20987294,-6,0,-7.886665693,-29.20987294
20,105,2005,38,45,19,76,1,-7,20,9,3366,11.304477168,13.386880857,5.652238584,-4,0.2974862413,-2.082403689,5.9497248252
20,105,2006,31,47,-73,76,0,-16,-73,-90,3276,9.3345377898,14.152363746,-21.98133092,-1,0,-4.817825956,-21.98133092
20,105,2007,43,45,17,76,1,-2,18,15,3291,13.09578194,13.704888077,5.1774021623,-1,0.3045530684,-0.609106137,5.4819552307
20,105,2008,35,54,-15,76,0,-19,-15,-30,3261,10.683760684,16.483516484,-4.578754579,4,0,-5.7997558,-4.578754579
20,107,2001,116,118,123,131,0,-2,123,113,9718,12.006417223,12.213424416,12.7309424,-8,0,-0.207007193,12.7309424
20,107,2002,123,118,-41,131,-1,5,-42,-46,9672,12.686952037,12.17122228,-4.228984012,-9,-0.103145952,0.5157297576,-4.332129964
20,107,2003,94,95,19,131,-1,-1,18,5,9677,9.7162644064,9.8196289214,1.9639257843,-12,-0.103364515,-0.103364515,1.8605612693
20,107,2004,122,101,-1,131,0,21,-1,12,9689,12.599401012,10.430651658,-0.103273779,-8,0,2.1687493545,-0.103273779
20,107,2005,102,82,143,131,0,20,143,155,9844,10.44386423,8.3960477141,14.641888087,-8,0,2.0478165156,14.641888087
20,107,2006,106,109,24,131,0,-3,24,16,9860,10.759236703,11.063743402,2.4360535932,-5,0,-0.304506699,2.4360535932
20,107,2007,123,106,-159,131,0,17,-159,-134,9726,12.559991831,10.824058001,-16.236087,8,0,1.7359338303,-16.236087
20,107,2008,120,95,-141,131,0,25,-141,-110,9616,12.408230793,9.8231827112,-14.57967118,6,0,2.5850480819,-14.57967118
20,109,2001,35,49,-77,57,1,-14,-76,-90,2958,11.655011655,16.317016317,-25.64102564,0,0.333000333,-4.662004662,-25.30802531
20,109,2002,30,36,-23,57,1,-6,-22,-32,2926,10.197144799,12.236573759,-7.817811013,-4,0.3399048266,-2.03942896,-7.477906186
20,109,2003,30,34,-79,57,1,-4,-78,-84,2842,10.40221914,11.789181692,-27.3925104,-2,0.346740638,-1.386962552,-27.04576976
20,109,2004,31,31,-39,57,0,0,-39,-41,2801,10.987063619,10.987063619,-13.82243488,-2,0,0,-13.82243488
20,109,2005,29,33,-45,57,1,-4,-44,-49,2752,10.44480461,11.885467315,-16.20745543,-1,0.3601656762,-1.440662705,-15.84728975
20,109,2006,31,35,-84,57,0,-4,-84,-89,2663,11.449676824,12.927054478,-31.02493075,-1,0,-1.477377655,-31.02493075
20,109,2007,27,27,-29,57,1,0,-28,-34,2629,10.204081633,10.204081633,-10.95993953,-6,0.3779289494,0,-10.58201058
20,109,2008,26,30,-23,57,0,-4,-23,-36,2593,9.9578705477,11.489850632,-8.808885484,-9,0,-1.531980084,-8.808885484
20,111,2001,547,296,-368,1613,192,251,-176,43,36001,15.203101766,8.2269069887,-10.22804653,-32,5.3363721008,6.9761947776,-4.891674426
20,111,2002,523,302,-641,1613,183,221,-458,-251,35750,14.578194032,8.4180011428,-17.8673468,-14,5.1009742025,6.1601928893,-12.76637259
20,111,2003,552,294,-390,1613,165,258,-225,6,35756,15.439263838,8.2230861746,-10.90817554,-27,4.6149973429,7.2161776634,-6.293178195
20,111,2004,521,281,-213,1613,149,240,-64,145,35901,14.541496295,7.8429183471,-5.944987929,-31,4.1587004759,6.6985779477,-1.786287453
20,111,2005,548,301,-505,1613,153,247,-352,-128,35773,15.291458548,8.3991405531,-14.09158133,-23,4.2693305801,6.8923179954,-9.822250746
20,111,2006,567,309,-555,1613,154,258,-401,-158,35615,15.885022693,8.6569171289,-15.54883174,-15,4.3144506079,7.228105564,-11.23438113
20,111,2007,536,292,-137,1613,143,244,6,231,35846,15.00118946,8.1722897804,-3.834259246,-19,4.0021830089,6.8288996795,0.1679237626
20,111,2008,568,273,-713,1613,145,295,-568,-284,35562,15.908581672,7.6462021062,-19.96975129,-11,4.0611696168,8.2623795653,-15.90858167
20,113,2001,372,370,-64,1637,4,2,-60,-88,29483,12.598638534,12.530903918,-2.167507705,-30,0.1354692316,0.0677346158,-2.032038473
20,113,2002,348,378,-220,1637,3,-30,-217,-268,29215,11.857303486,12.879484821,-7.495996456,-21,0.1022181335,-1.022181335,-7.393778323
20,113,2003,330,333,10,1637,0,-3,10,-35,29180,11.302337529,11.405086052,0.3424950766,-42,0,-0.102748523,0.3424950766
20,113,2004,357,355,20,1637,7,2,27,8,29188,12.232730263,12.164199561,0.6853070175,-21,0.2398574561,0.0685307018,0.9251644737
20,113,2005,350,317,46,1637,4,33,50,60,29248,11.978917106,10.84947635,1.5743719625,-23,0.1369019098,1.1294407557,1.7112738723
20,113,2006,347,369,-186,1637,6,-22,-180,-216,29032,11.908030199,12.663006177,-6.382978723,-14,0.2059025395,-0.754975978,-6.177076184
20,113,2007,353,369,151,1637,3,-16,154,118,29150,12.13433708,12.684335361,5.1906087793,-20,0.1031246777,-0.549998281,5.2937334571
20,113,2008,351,334,-114,1637,5,17,-109,-106,29044,12.063099289,11.478846616,-3.917929683,-14,0.1718390212,0.5842526721,-3.746090662
20,115,2001,128,178,-24,765,3,-50,-21,-84,13293,9.59880015,13.348331459,-1.799775028,-13,0.2249718785,-3.749531309,-1.57480315
20,115,2002,129,179,-104,765,3,-50,-101,-163,13130,9.7642205654,13.54880218,-7.871929758,-12,0.2270748969,-3.784581615,-7.644854861
20,115,2003,130,179,-66,765,3,-49,-63,-128,13002,9.9494872187,13.699678555,-5.051278126,-16,0.2296035512,-3.750191336,-4.821674575
20,115,2004,137,177,-190,765,2,-40,-188,-243,12759,10.636233065,13.741702574,-14.75098016,-15,0.1552734754,-3.105469508,-14.59570669
20,115,2005,129,190,-62,765,3,-61,-59,-131,12628,10.162681687,14.968290858,-4.884389648,-11,0.2363414346,-4.80560917,-4.648048214
20,115,2006,115,169,-193,765,2,-54,-191,-250,12378,9.1977925298,13.516755979,-15.43629529,-5,0.1599616092,-4.318963449,-15.27633368
20,115,2007,115,172,-106,765,3,-57,-103,-158,12220,9.3503536873,13.984876819,-8.618586877,2,0.2439222701,-4.634523132,-8.374664607
20,115,2008,116,177,-60,765,2,-61,-58,-120,12100,9.5394736842,14.555921053,-4.934210526,-1,0.1644736842,-5.016447368,-4.769736842
20,117,2001,104,153,-86,244,3,-49,-83,-140,10794,9.5729013255,14.083210604,-7.916053019,-8,0.2761413844,-4.510309278,-7.639911635
20,117,2002,123,134,-192,244,3,-11,-189,-205,10589,11.504466165,12.533320862,-17.95819109,-5,0.2805967357,-1.028854698,-17.67759435
20,117,2003,115,155,-92,244,1,-40,-91,-141,10448,10.93311784,14.735941437,-8.746494272,-10,0.0950705899,-3.802823597,-8.651423682
20,117,2004,129,134,-128,244,5,-5,-123,-138,10310,12.428943058,12.910685037,-12.33259466,-10,0.481741979,-0.481741979,-11.85085268
20,117,2005,108,145,0,244,3,-37,3,-43,10267,10.49715702,14.093405258,0,-9,0.291587695,-3.596248238,0.291587695
20,117,2006,114,146,-63,244,5,-32,-58,-95,10172,11.155144577,14.28641323,-6.164685161,-5,0.489260727,-3.131268653,-5.675424434
20,117,2007,134,135,-5,244,3,-1,-2,-3,10169,13.17536011,13.273683693,-0.491617915,0,0.2949707487,-0.098323583,-0.196647166
20,117,2008,137,131,-2,244,5,6,3,9,10178,13.466358677,12.876591144,-0.196589178,0,0.4914729444,0.5897675333,0.2948837666
20,119,2001,76,31,-33,114,21,45,-12,28,4650,16.393442623,6.6867989646,-7.118205349,-5,4.5297670406,9.7066436583,-2.588438309
20,119,2002,66,52,-52,114,20,14,-32,-20,4630,14.224137931,11.206896552,-11.20689655,-2,4.3103448276,3.0172413793,-6.896551724
20,119,2003,59,55,-110,114,13,4,-97,-92,4538,12.870855148,11.998254799,-23.9965096,1,2.8359511344,0.872600349,-21.16055846
20,119,2004,63,54,-64,114,14,9,-50,-45,4493,13.951943306,11.958808548,-14.17340272,-4,3.1004318459,1.9931347581,-11.07297088
20,119,2005,57,40,-34,114,14,17,-20,-7,4486,12.696291346,8.9096781379,-7.573226417,-4,3.1183873483,3.7866132086,-4.454839069
20,119,2006,47,46,-86,114,14,1,-72,-73,4413,10.562984605,10.338240252,-19.32801438,-2,3.1464209462,0.2247443533,-16.18159344
20,119,2007,60,40,-84,114,9,20,-75,-58,4355,13.686131387,9.1240875912,-19.16058394,-3,2.052919708,4.5620437956,-17.10766423
20,119,2008,59,42,-22,114,10,17,-12,4,4359,13.541427588,9.6396603167,-5.04934588,-1,2.2951572183,3.9017672711,-2.754188662
20,121,2001,403,270,-30,746,7,133,-23,82,28592,14.115092291,9.4567615845,-1.050751287,-28,0.2451753003,4.6583307065,-0.805575987
20,121,2002,345,261,83,746,7,84,90,150,28742,12.034743782,9.104545296,2.8953151708,-24,0.2441832072,2.9301984861,3.1394983779
20,121,2003,403,242,67,746,2,161,69,192,28934,13.974616825,8.3917053887,2.3233233927,-38,0.0693529371,5.5829114363,2.3926763298
20,121,2004,453,253,378,746,6,200,384,555,29489,15.507591188,8.6609725622,12.940109204,-29,0.2053985588,6.8466186262,13.145507762
20,121,2005,392,242,297,746,4,150,301,423,29912,13.198431003,8.1480109762,9.9998316527,-28,0.1346778674,5.0504200266,10.13450952
20,121,2006,386,243,198,746,6,143,204,332,30244,12.833300086,8.078994614,6.5828845003,-15,0.1994813485,4.7543054724,6.7823658488
20,121,2007,409,227,464,746,3,182,467,653,30897,13.378911042,7.4254591845,15.178031108,4,0.0981338218,5.9534518572,15.27616493
20,121,2008,451,247,-130,746,5,204,-125,92,30989,14.575186633,7.9824192871,-4.201273309,13,0.161587435,6.5927673464,-4.039685874
20,123,2001,57,98,-105,345,2,-41,-103,-148,6763,8.3369899079,14.333772122,-15.35761299,-4,0.2925259617,-5.996782214,-15.06508703
20,123,2002,70,83,-62,345,2,-13,-60,-78,6685,10.410469958,12.343842951,-9.220701963,-5,0.2974419988,-1.933372992,-8.923259964
20,123,2003,64,98,7,345,2,-34,9,-34,6651,9.5980803839,14.697060588,1.049790042,-9,0.299940012,-5.098980204,1.349730054
20,123,2004,56,101,-104,345,1,-45,-103,-156,6495,8.5197018104,15.365890765,-15.82230336,-8,0.1521375323,-6.846188955,-15.67016583
20,123,2005,66,91,-79,345,2,-25,-77,-108,6387,10.246856078,14.128240956,-12.26517621,-6,0.3105107902,-3.881384878,-11.95466542
20,123,2006,61,116,-14,345,1,-55,-13,-71,6316,9.604030544,18.263402346,-2.204203731,-3,0.1574431237,-8.659371802,-2.046760608
20,123,2007,56,71,-8,345,2,-15,-6,-22,6294,8.8818398097,11.260904044,-1.268834259,-1,0.3172085646,-2.379064235,-0.951625694
20,123,2008,62,80,9,345,1,-18,10,-2,6292,9.8522167488,12.71253774,1.4301604958,6,0.1589067218,-2.860320992,1.5890672175
20,125,2001,455,463,-443,900,24,-8,-419,-451,35755,12.645738664,12.868081322,-12.31222468,-24,0.6670279735,-0.222342658,-11.6451967
20,125,2002,488,502,-580,900,23,-14,-557,-590,35165,13.761985336,14.15679639,-16.35645798,-19,0.6486181613,-0.394811055,-15.70783982
20,125,2003,454,477,-474,900,15,-23,-459,-499,34666,13.002821097,13.661554324,-13.5756326,-17,0.4296086265,-0.658733227,-13.14602397
20,125,2004,453,499,-95,900,21,-46,-74,-146,34520,13.095134854,14.424883647,-2.746220334,-26,0.6070592316,-1.329748793,-2.139161102
20,125,2005,468,471,-255,900,18,-3,-237,-270,34250,13.610586011,13.697833358,-7.416024429,-30,0.5234840774,-0.087247346,-6.892540352
20,125,2006,480,488,68,900,20,-8,88,64,34314,14.001516831,14.234875445,1.9835482177,-16,0.5833965346,-0.233358614,2.5669447523
20,125,2007,512,446,55,900,16,66,71,146,34460,14.889347719,12.970017739,1.5994416495,9,0.4652921162,1.9193299794,2.0647337657
20,125,2008,531,421,-220,900,18,110,-202,-65,34395,15.423716506,12.228596326,-6.39024036,27,0.5228378477,3.1951201801,-5.867402513
20,127,2001,61,90,-26,75,4,-29,-22,-55,6058,10.02382713,14.789253143,-4.272450908,-4,0.6573001397,-4.765426013,-3.615150768
20,127,2002,56,71,-62,75,4,-15,-58,-78,5980,9.3038710749,11.795979399,-10.3007144,-5,0.6645622196,-2.492108324,-9.636152185
20,127,2003,50,81,-21,75,2,-31,-19,-59,5921,8.4026552391,13.612301487,-3.5291152,-9,0.3361062096,-5.209646248,-3.193008991
20,127,2004,54,76,6,75,6,-22,12,-14,5907,9.1308758877,12.850862361,1.0145417653,-4,1.0145417653,-3.719986473,2.0290835306
20,127,2005,63,74,54,75,4,-11,58,42,5949,10.627530364,12.483130904,9.1093117409,-5,0.6747638327,-1.85560054,9.7840755735
20,127,2006,48,59,-33,75,6,-11,-27,-42,5907,8.0971659919,9.9527665317,-5.566801619,-4,1.012145749,-1.85560054,-4.55465587
20,127,2007,58,73,56,75,4,-15,60,42,5949,9.7840755735,12.314439946,9.4466936572,-3,0.6747638327,-2.530364372,10.12145749
20,127,2008,66,79,102,75,6,-13,108,88,6037,11.012848323,13.18204572,17.019856499,-7,1.0011680294,-2.169197397,18.021024529
20,129,2001,71,38,-168,57,28,33,-140,-109,3372,20.720852182,11.090033562,-49.02962206,-2,8.1716036772,9.6308186196,-40.85801839
20,129,2002,65,24,-93,57,28,41,-65,-27,3345,19.353878219,7.1460473426,-27.69093345,-3,8.337055233,12.207830877,-19.35387822
20,129,2003,41,36,-35,57,13,5,-22,-19,3326,12.292010193,10.79298456,-10.49317943,-2,3.8974666467,1.4990256333,-6.595712787
20,129,2004,35,28,-120,57,11,7,-109,-107,3219,10.695187166,8.5561497326,-36.66921314,-5,3.3613445378,2.1390374332,-33.3078686
20,129,2005,56,43,-84,57,13,13,-71,-59,3160,17.557610911,13.481736949,-26.33641637,-1,4.0758739614,4.0758739614,-22.2605424
20,129,2006,51,41,-79,57,12,10,-67,-60,3100,16.293929712,13.099041534,-25.23961661,-3,3.8338658147,3.1948881789,-21.4057508
20,129,2007,51,24,-102,57,8,27,-94,-76,3024,16.655780536,7.8380143697,-33.31156107,-9,2.6126714566,8.8177661659,-30.69888961
20,129,2008,52,27,-63,57,7,25,-56,-46,2978,17.327557481,8.9970009997,-20.99300233,-15,2.3325558147,8.3305564812,-18.66044652
20,131,2001,126,181,-159,498,2,-55,-157,-219,10465,11.915456996,17.116648541,-15.03617192,-7,0.189134238,-5.201191546,-14.84703768
20,131,2002,144,143,-9,498,2,1,-7,-15,10450,13.770021516,13.674396366,-0.860626345,-9,0.1912502988,0.0956251494,-0.669376046
20,131,2003,124,138,-14,498,2,-14,-12,-39,10411,11.888212454,13.230429989,-1.342217535,-13,0.1917453622,-1.342217535,-1.150472173
20,131,2004,117,149,-74,498,1,-32,-73,-114,10297,11.299980684,14.390573691,-7.14699633,-9,0.0965810315,-3.090593008,-7.050415298
20,131,2005,131,162,-19,498,2,-31,-17,-56,10241,12.756840978,15.775635408,-1.850228844,-8,0.194760931,-3.01879443,-1.655467913
20,131,2006,124,133,-42,498,1,-9,-41,-55,10186,12.140794047,13.021980712,-4.112204435,-5,0.0979096294,-0.881186665,-4.014294806
20,131,2007,135,147,1,498,2,-12,3,-9,10177,13.259342926,14.437951186,0.098217355,0,0.19643471,-1.17860826,0.294652065
20,131,2008,136,128,-79,498,1,8,-78,-65,10112,13.406279265,12.617674602,-7.787471043,5,0.0985755828,0.7886046626,-7.688895461
20,133,2001,214,198,-113,478,4,16,-109,-106,16838,12.669468948,11.722218933,-6.68995323,-13,0.2368125037,0.9472500148,-6.453140726
20,133,2002,196,193,-221,478,4,3,-217,-225,16613,11.718633225,11.53926639,-13.21335685,-11,0.2391557801,0.1793668351,-12.97420107
20,133,2003,195,204,-150,478,2,-9,-148,-173,16440,11.799231537,12.343811454,-9.076331952,-16,0.1210177594,-0.544579917,-8.955314192
20,133,2004,243,226,-19,478,3,17,-16,-11,16429,14.785968542,13.75155922,-1.156104536,-12,0.1825428215,1.0344093219,-0.973561715
20,133,2005,201,195,-130,478,3,6,-127,-134,16295,12.28456179,11.917858453,-7.945238968,-13,0.1833516685,0.366703337,-7.7618873
20,133,2006,214,201,-164,478,3,13,-161,-154,16141,13.195215193,12.3936367,-10.11222099,-6,0.1849796522,0.801578493,-9.927241337
20,133,2007,233,188,37,478,3,45,40,79,16220,14.400049442,11.618924013,2.2867031303,-6,0.1854083619,2.7811254288,2.4721114922
20,133,2008,237,202,-27,478,3,35,-24,3,16223,14.610239497,12.452609192,-1.664457664,-8,0.1849397405,2.1576303055,-1.479517924
20,135,2001,34,51,-80,79,1,-17,-79,-78,3362,9.9970596883,14.995589532,-23.52249338,18,0.2940311673,-4.998529844,-23.22846222
20,135,2002,24,46,-53,79,0,-22,-53,-61,3301,7.2039621792,13.807594177,-15.90874981,14,0,-6.603631998,-15.90874981
20,135,2003,35,53,-105,79,-1,-18,-106,-106,3195,10.775862069,16.31773399,-32.32758621,18,-0.307881773,-5.541871921,-32.63546798
20,135,2004,35,46,-77,79,0,-11,-77,-78,3117,11.089987326,14.575411914,-24.39797212,10,0,-3.485424588,-24.39797212
20,135,2005,26,50,-51,79,0,-24,-51,-63,3054,8.4265111003,16.204829039,-16.52892562,12,0,-7.778317939,-16.52892562
20,135,2006,27,53,-44,79,0,-26,-44,-59,2995,8.9270953877,17.523557613,-14.54785915,11,0,-8.596462225,-14.54785915
20,135,2007,25,48,20,79,0,-23,20,-4,2991,8.3528232543,16.037420648,6.6822586034,-1,0,-7.684597394,6.6822586034
20,135,2008,29,46,-30,79,1,-17,-29,-46,2945,9.7708894879,15.498652291,-10.10781671,0,0.3369272237,-5.727762803,-9.770889488
20,137,2001,54,67,-118,790,2,-13,-116,-134,5814,9.1821118857,11.392620303,-20.06461486,-5,0.340078218,-2.210508417,-19.72453664
20,137,2002,49,71,-27,790,2,-22,-25,-53,5761,8.4665226782,12.267818575,-4.665226782,-6,0.3455723542,-3.801295896,-4.319654428
20,137,2003,63,64,-26,790,2,-1,-24,-32,5729,10.966057441,11.140121845,-4.5256745,-7,0.3481288077,-0.174064404,-4.177545692
20,137,2004,39,82,-49,790,1,-43,-48,-97,5632,6.8655928175,14.435349001,-8.626001232,-6,0.1760408415,-7.569756183,-8.449960391
20,137,2005,63,72,-49,790,2,-9,-47,-58,5574,11.243976441,12.85025879,-8.74531501,-2,0.3569516331,-1.606282349,-8.388363377
20,137,2006,54,65,-51,790,1,-11,-50,-64,5510,9.7437748105,11.728617827,-9.202453988,-3,0.1804402743,-1.984843017,-9.022013713
20,137,2007,45,57,-83,790,2,-12,-81,-101,5409,8.2425130506,10.440516531,-15.2028574,-8,0.3663339134,-2.19800348,-14.83652349
20,137,2008,47,72,-8,790,1,-25,-7,-39,5370,8.7206605436,13.359309769,-1.484367752,-7,0.185545969,-4.638649225,-1.298821783
20,139,2001,174,193,-87,233,3,-19,-84,-117,16641,10.419473637,11.557232252,-5.209736818,-14,0.1796460972,-1.137758616,-5.030090721
20,139,2002,158,181,51,233,1,-23,52,14,16655,9.490629505,10.872176838,3.0634310428,-15,0.0600672753,-1.381547333,3.1234983181
20,139,2003,225,177,-9,233,-5,48,-14,9,16664,13.505807497,10.624568564,-0.5402323,-25,-0.300129055,2.8812389327,-0.840361355
20,139,2004,170,187,125,233,6,-17,131,99,16763,10.171418315,11.188560146,7.4789840548,-15,0.3589912346,-1.017141831,7.8379752894
20,139,2005,189,193,16,233,2,-4,18,2,16765,11.274158912,11.51276545,0.9544261513,-12,0.1193032689,-0.238606538,1.0737294202
20,139,2006,199,183,-171,233,4,16,-167,-160,16605,11.926880432,10.967935271,-10.2487264,-9,0.2397362901,0.9589451603,-10.00899011
20,139,2007,187,178,-185,233,0,9,-185,-186,16419,11.325096899,10.78003876,-11.20397287,-10,0,0.5450581395,-11.20397287
20,139,2008,192,171,-93,233,2,21,-91,-92,16327,11.726623099,10.444023698,-5.680083064,-22,0.1221523239,1.2825994015,-5.55793074
20,141,2001,36,76,-61,119,1,-40,-60,-102,4333,8.2116788321,17.335766423,-13.91423358,-2,0.2281021898,-9.124087591,-13.68613139
20,141,2002,38,68,-40,119,1,-30,-39,-72,4261,8.8433791017,15.824994182,-9.308820107,-3,0.2327205027,-6.98161508,-9.076099604
20,141,2003,35,67,-116,119,1,-32,-115,-146,4115,8.3572110793,15.99808978,-27.69818529,1,0.2387774594,-7.640878701,-27.45940783
20,141,2004,37,81,-15,119,0,-44,-15,-63,4052,9.060854659,19.835925064,-3.673319456,-4,0,-10.77507041,-3.673319456
20,141,2005,29,65,-31,119,1,-36,-30,-69,3983,7.2184194151,16.17921593,-7.716241444,-3,0.2489110143,-8.960796515,-7.467330429
20,141,2006,38,58,-19,119,0,-20,-19,-40,3943,9.5886954328,14.635377239,-4.794347716,-1,0,-5.046681807,-4.794347716
20,141,2007,37,61,-59,119,1,-24,-58,-80,3863,9.4798872662,15.629003331,-15.11657699,2,0.2562131694,-6.149116065,-14.86036382
20,141,2008,39,65,-38,119,0,-26,-38,-59,3804,10.173470719,16.955784531,-9.912612495,5,0,-6.782313812,-9.912612495
20,143,2001,64,85,-44,191,2,-21,-42,-68,6122,10.396361274,13.807667316,-7.147498376,-5,0.3248862898,-3.411306043,-6.822612086
20,143,2002,70,84,48,191,1,-14,49,30,6152,11.40622454,13.687469448,7.8214111129,-5,0.1629460649,-2.281244908,7.9843571778
20,143,2003,74,77,-46,191,-1,-3,-47,-55,6097,12.082618989,12.572454894,-7.51081721,-5,-0.163278635,-0.489835905,-7.674095845
20,143,2004,73,78,-47,191,0,-5,-47,-58,6039,12.030323006,12.854317732,-7.745550428,-6,0,-0.823994726,-7.745550428
20,143,2005,63,70,-23,191,0,-7,-23,-35,6004,10.462509342,11.625010379,-3.819646268,-5,0,-1.162501038,-3.819646268
20,143,2006,53,66,-11,191,0,-13,-11,-26,5978,8.8466032382,11.016524787,-1.836087465,-2,0,-2.169921549,-1.836087465
20,143,2007,76,72,20,191,0,4,20,25,6003,12.686754027,12.019030131,3.3386194808,1,0,0.6677238962,3.3386194808
20,143,2008,74,66,13,191,1,8,14,23,6026,12.303599634,10.973480755,2.161443179,1,0.1662648599,1.3301188794,2.3277080389
20,145,2001,58,87,-180,904,3,-29,-177,-209,7009,8.1535109299,12.230266395,-25.30399944,-3,0.421733324,-4.076755465,-24.88226611
20,145,2002,59,103,-90,904,3,-44,-87,-137,6872,8.5008284706,14.840429364,-12.96736546,-6,0.4322455155,-6.339600893,-12.53511995
20,145,2003,67,79,-95,904,3,-12,-92,-108,6764,9.8269287181,11.586975653,-13.9337049,-4,0.4400117336,-1.760046935,-13.49369317
20,145,2004,64,88,-37,904,2,-24,-35,-63,6701,9.5061269959,13.070924619,-5.49572967,-4,0.2970664686,-3.564797623,-5.198663201
20,145,2005,69,76,-33,904,3,-7,-30,-38,6663,10.326249626,11.373840168,-4.938641125,-1,0.448967375,-1.047590542,-4.48967375
20,145,2006,52,77,-168,904,2,-25,-166,-194,6469,7.9195857447,11.727078891,-25.58635394,-3,0.3045994517,-3.807493147,-25.28175449
20,145,2007,64,64,-47,904,3,0,-44,-63,6406,9.9417475728,9.9417475728,-7.300970874,-19,0.4660194175,0,-6.834951456
20,145,2008,73,67,-99,904,2,6,-97,-115,6291,11.498779239,10.553674096,-15.59423486,-24,0.3150350476,0.9451051429,-15.27919981
20,147,2001,63,86,-107,143,0,-23,-107,-134,5860,10.629323435,14.509870086,-18.0529779,-4,0,-3.880546651,-18.0529779
20,147,2002,58,108,-54,143,-1,-50,-55,-109,5751,9.9905262251,18.603048833,-9.301524417,-4,-0.172250452,-8.612522608,-9.473774869
20,147,2003,70,108,-84,143,-1,-38,-85,-125,5626,12.305528698,18.985672849,-14.76663444,-2,-0.175793267,-6.68014415,-14.94242771
20,147,2004,51,74,-14,143,0,-23,-14,-41,5585,9.098207118,13.201320132,-2.497547052,-4,0,-4.103113014,-2.497547052
20,147,2005,57,70,-127,143,0,-13,-127,-143,5442,10.338260633,12.696109549,-23.03437018,-3,0,-2.357848916,-23.03437018
20,147,2006,52,76,-52,143,0,-24,-52,-79,5363,9.6251735308,14.067561314,-9.625173531,-3,0,-4.442387783,-9.625173531
20,147,2007,59,72,6,143,0,-13,6,-4,5359,11.005409439,13.430330162,1.1191941802,3,0,-2.424920724,1.1191941802
20,147,2008,59,79,-4,143,1,-20,-3,-20,5339,11.030099084,14.769115723,-0.747803328,3,0.1869508319,-3.739016639,-0.560852496
20,149,2001,253,162,-77,282,0,91,-77,-4,18273,13.844049248,8.8645690834,-4.213406293,-18,0,4.9794801642,-4.213406293
20,149,2002,277,164,-42,282,-3,113,-45,52,18325,15.137439204,8.9622383737,-2.295207388,-16,-0.163943385,6.1752008306,-2.459150773
20,149,2003,274,159,131,282,-10,115,121,218,18543,14.863838559,8.6253661712,7.1064337637,-18,-0.54247586,6.238472388,6.5639579039
20,149,2004,312,178,14,282,4,134,18,139,18682,16.76292814,9.563465413,0.7521826729,-13,0.2149093351,7.1994627267,0.9670920081
20,149,2005,271,172,34,282,-1,99,33,113,18795,14.462203485,9.1789630974,1.8144461937,-19,-0.053366065,5.2832403874,1.7610801291
20,149,2006,284,172,-13,282,2,112,-11,92,18887,15.073509899,9.1290271217,-0.689984608,-9,0.1061514782,5.9444827769,-0.58383313
20,149,2007,369,177,331,282,-1,192,330,529,19416,19.267420307,9.2420959194,17.283241522,7,-0.052215231,10.025324387,17.23102629
20,149,2008,351,164,88,282,1,187,89,279,19695,17.948914628,8.3863874613,4.5000127841,3,0.0511365089,9.5625271663,4.551149293
20,151,2001,117,125,-98,325,7,-8,-91,-106,9524,12.216769343,13.052103999,-10.23284954,-7,0.730917824,-0.835334656,-9.501931711
20,151,2002,110,127,72,325,7,-17,79,56,9580,11.515912898,13.295644891,7.5376884422,-6,0.7328308208,-1.779731993,8.270519263
20,151,2003,110,126,-120,325,5,-16,-115,-137,9443,11.564947695,13.247121905,-12.61630658,-6,0.5256794407,-1.68217421,-12.09062714
20,151,2004,121,105,-130,325,4,16,-126,-120,9323,12.895662368,11.190450815,-13.85484387,-10,0.4263028882,1.7052115528,-13.42854098
20,151,2005,116,130,100,325,4,-14,104,84,9407,12.386545649,13.881473572,10.678056594,-6,0.4271222637,-1.494927923,11.105178857
20,151,2006,130,94,-16,325,4,36,-12,19,9426,13.805554081,9.982477566,-1.699145118,-5,0.4247862794,3.8230765146,-1.274358838
20,151,2007,112,141,10,325,3,-29,13,-22,9404,11.895910781,14.976101965,1.0621348911,-6,0.3186404673,-3.080191184,1.3807753585
20,151,2008,129,128,6,325,3,1,9,7,9411,13.71246346,13.606165294,0.6377889981,-3,0.3188944991,0.1062981664,0.9566834972
20,153,2001,24,45,-63,56,1,-21,-62,-85,2875,8.2262210797,15.424164524,-21.59383033,-2,0.3427592117,-7.197943445,-21.25107112
20,153,2002,26,36,-18,56,1,-10,-17,-29,2846,9.0893200489,12.585212375,-6.292606188,-2,0.3495892327,-3.495892327,-5.943016955
20,153,2003,17,38,-61,56,1,-21,-60,-81,2765,6.0595259312,13.54482267,-21.74300481,0,0.3564427018,-7.485296739,-21.38656211
20,153,2004,15,47,-38,56,0,-32,-38,-73,2692,5.4975261132,17.225581822,-13.92706615,-3,0,-11.72805571,-13.92706615
20,153,2005,17,39,-66,56,1,-22,-65,-89,2603,6.4211520302,14.730878187,-24.92917847,-2,0.3777148253,-8.309726157,-24.55146364
20,153,2006,25,51,-5,56,0,-26,-5,-32,2571,9.663703131,19.713954387,-1.932740626,-1,0,-10.05025126,-1.932740626
20,153,2007,23,31,-3,56,1,-8,-2,-10,2561,8.9633671083,12.081060016,-1.16913484,0,0.3897116134,-3.117692907,-0.779423227
20,153,2008,19,30,-51,56,0,-11,-51,-58,2503,7.5039494471,11.848341232,-20.14218009,4,0,-4.344391785,-20.14218009
20,155,2001,887,686,-424,3253,55,201,-369,-219,64469,13.735221475,10.622730475,-6.565652655,-51,0.8516766416,3.1124909993,-5.713976014
20,155,2002,832,711,-637,3253,52,121,-585,-504,63965,12.956070822,11.071834561,-9.919491723,-40,0.8097544264,1.8842362614,-9.109737297
20,155,2003,817,650,-432,3253,33,167,-399,-300,63665,12.80263261,10.185693019,-6.769568283,-68,0.5171197994,2.616939591,-6.252448484
20,155,2004,833,626,-492,3253,41,207,-451,-299,63366,13.114908959,9.855861955,-7.746140706,-55,0.6455117255,3.2590470043,-7.10062898
20,155,2005,842,666,-257,3253,37,176,-220,-105,63261,13.298901498,10.519083608,-4.059165897,-61,0.5843935338,2.7798178903,-3.474772363
20,155,2006,835,737,-84,3253,39,98,-45,23,63284,13.196886483,11.648030345,-1.327590976,-30,0.6163815244,1.5488561381,-0.711209451
20,155,2007,873,666,-463,3253,33,207,-430,-194,63090,13.816133065,10.540142751,-7.327456597,29,0.5222593255,3.2759903145,-6.805197272
20,155,2008,852,659,62,3253,35,193,97,337,63427,13.468545729,10.417572342,0.9801054404,47,0.5532853292,3.050973387,1.5333907696
20,157,2001,48,122,-74,140,1,-74,-73,-151,5650,8.3835472884,21.308182691,-12.9246354,-4,0.1746572352,-12.9246354,-12.74997817
20,157,2002,42,98,-173,140,1,-56,-172,-229,5421,7.5873904796,17.703911119,-31.25282269,-1,0.1806521543,-10.11652064,-31.07217054
20,157,2003,52,95,-79,140,1,-43,-78,-124,5297,9.703302855,17.727187908,-14.74155626,-3,0.186601978,-8.023885053,-14.55495428
20,157,2004,47,88,-90,140,0,-41,-90,-136,5161,8.9883342895,16.829221648,-17.21170396,-5,0,-7.840887359,-17.21170396
20,157,2005,38,84,-28,140,1,-46,-27,-77,5084,7.4182528062,16.398243045,-5.466081015,-4,0.1952171791,-8.979990239,-5.270863836
20,157,2006,52,76,-92,140,0,-24,-92,-117,4967,10.347229131,15.122873346,-18.30663616,-1,0,-4.775644215,-18.30663616
20,157,2007,43,63,-40,140,1,-20,-39,-68,4899,8.7168051895,12.771133185,-8.10865599,-9,0.2027163998,-4.054327995,-7.905939591
20,157,2008,47,71,-53,140,0,-24,-53,-87,4812,9.6797446195,14.622592936,-10.9154567,-10,0,-4.942848316,-10.9154567
20,159,2001,140,133,-145,879,24,7,-121,-120,10611,13.119670134,12.463686627,-13.58822978,-6,2.2490863087,0.6559835067,-11.33914347
20,159,2002,124,134,-87,879,24,-10,-63,-85,10526,11.732980082,12.679188153,-8.232010219,-12,2.2708993708,-0.946208071,-5.961110848
20,159,2003,123,120,-82,879,17,3,-65,-73,10453,11.726011726,11.44001144,-7.817341151,-11,1.6206682873,0.286000286,-6.196672863
20,159,2004,133,149,30,879,18,-16,48,25,10478,12.708422913,14.237255745,2.8665615594,-7,1.7199369356,-1.528832832,4.5864984951
20,159,2005,128,128,-123,879,18,0,-105,-110,10368,12.280533436,12.280533436,-11.8008251,-5,1.7269500144,0,-10.07387508
20,159,2006,113,144,-161,879,18,-31,-143,-179,10189,10.993822056,14.009826337,-15.66376417,-5,1.7512282921,-3.016004281,-13.91253588
20,159,2007,124,107,-165,879,15,17,-150,-146,10043,12.257809411,10.577303282,-16.31079478,-13,1.4827995255,1.6805061289,-14.82799526
20,159,2008,134,103,-3,879,15,31,12,17,10060,13.331343581,10.247226782,-0.298462916,-26,1.4923145799,3.0841167985,1.1938516639
20,161,2001,959,321,-1267,9458,206,638,-1061,250,63327,15.173570457,5.0789531977,-20.04683396,673,3.2593905256,10.094617259,-16.78744344
20,161,2002,894,334,-621,9574,-102,560,-723,362,63689,14.076966681,5.2591799458,-9.778295648,525,-1.60609687,8.8177867355,-11.38439252
20,161,2003,931,293,866,9437,-734,638,132,1686,65375,14.42695097,4.5403830658,13.419698754,916,-11.37420195,9.8865679043,2.0454968078
20,161,2004,856,312,-486,9505,579,544,93,642,66017,13.029712616,4.7491475889,-7.397710667,5,8.8133219679,8.2805650268,1.4156113005
20,161,2005,864,291,-159,9743,121,573,-38,1331,67348,12.956922731,4.3639635587,-2.384433697,796,1.8145690399,8.5929591722,-0.569864657
20,161,2006,1012,297,615,9743,370,715,985,1700,69048,14.839144843,4.3549664213,9.0178597613,0,5.4253790434,10.484178422,14.443238805
20,161,2007,1098,280,-692,9743,101,818,-591,230,69278,15.87554039,4.0484073855,-10.00534968,3,1.4603183783,11.827133005,-8.545031303
20,161,2008,1053,292,816,9743,212,761,1028,1791,71069,15.005664531,4.1611149508,11.628321232,2,3.0210834574,10.844549581,14.64940469
20,163,2001,53,70,-95,197,1,-17,-94,-115,5548,9.454999554,12.48773526,-16.94764071,-4,0.178396218,-3.032735706,-16.76924449
20,163,2002,68,84,-77,197,1,-16,-76,-96,5452,12.363636364,15.272727273,-14,-4,0.1818181818,-2.909090909,-13.81818182
20,163,2003,49,62,-57,197,1,-13,-56,-74,5378,9.0489381348,11.449676824,-10.52631579,-5,0.1846722068,-2.400738689,-10.34164358
20,163,2004,59,76,-30,197,0,-17,-30,-51,5327,11.022886502,14.198972443,-5.604857543,-4,0,-3.176085941,-5.604857543
20,163,2005,57,70,-59,197,1,-13,-58,-74,5253,10.775047259,13.232514178,-11.15311909,-3,0.1890359168,-2.457466919,-10.96408318
20,163,2006,53,70,-23,197,0,-17,-23,-43,5210,10.13093759,13.380483609,-4.396444614,-3,0,-3.249546019,-4.396444614
20,163,2007,69,56,-62,197,1,13,-61,-54,5156,13.312753232,10.804553347,-11.96218406,-6,0.1929384526,2.5081998842,-11.76924561
20,163,2008,69,57,-25,197,0,12,-25,-20,5136,13.4084726,11.076564322,-4.858142246,-7,0,2.3319082783,-4.858142246
20,165,2001,37,60,-14,88,1,-23,-13,-39,3495,10.527813345,17.072129748,-3.983496941,-3,0.2845354958,-6.544316403,-3.698961445
20,165,2002,38,63,-46,88,1,-25,-45,-72,3423,10.985834056,18.213356461,-13.29864123,-2,0.2891008962,-7.227522405,-13.00954033
20,165,2003,35,54,-11,88,1,-19,-10,-33,3390,10.274475268,15.852047556,-3.229120798,-4,0.2935564362,-5.577572288,-2.935564362
20,165,2004,36,47,3,88,0,-11,3,-11,3379,10.636726252,13.886837051,0.8863938543,-3,0,-3.250110799,0.8863938543
20,165,2005,36,49,-58,88,1,-13,-57,-73,3306,10.770381451,14.659685864,-17.35228123,-3,0.2991772625,-3.889304413,-17.05310396
20,165,2006,34,62,-50,88,0,-28,-50,-80,3226,10.410287814,18.983466013,-15.30924679,-2,0,-8.5731782,-15.30924679
20,165,2007,36,38,-23,88,1,-2,-22,-23,3203,11.199253383,11.821434127,-7.15507855,1,0.3110903718,-0.622180744,-6.843988179
20,165,2008,39,50,39,88,0,-11,39,29,3232,12.121212121,15.54001554,12.121212121,1,0,-3.418803419,12.121212121
20,167,2001,76,110,-166,209,1,-34,-165,-202,7151,10.479867623,15.168229454,-22.89023718,-3,0.137892995,-4.688361831,-22.75234418
20,167,2002,58,103,-94,209,1,-45,-93,-143,7008,8.1926689738,14.549050074,-13.27777385,-5,0.1412529133,-6.3563811,-13.13652094
20,167,2003,72,93,-44,209,1,-21,-43,-71,6937,10.326281821,13.338114019,-6.310505558,-7,0.1434205809,-3.011832198,-6.167084977
20,167,2004,83,109,52,209,0,-26,52,18,6955,11.949323352,15.692484883,7.4863230636,-8,0,-3.743161532,7.4863230636
20,167,2005,63,117,-126,209,1,-54,-125,-183,6772,9.1789903111,17.046696292,-18.35798062,-4,0.1456982589,-7.867705981,-18.21228236
20,167,2006,68,124,0,209,0,-56,0,-60,6712,10.086027885,18.392168496,0,-4,0,-8.306140611,0
20,167,2007,81,88,21,209,1,-7,22,11,6723,12.058057313,13.100111649,3.1261630071,-4,0.1488649051,-1.042054336,3.2750279122
20,167,2008,92,105,-72,209,0,-13,-72,-82,6641,13.768332834,15.713858126,-10.775217,3,0,-1.945525292,-10.775217
20,169,2001,749,491,-81,1443,98,258,17,223,53868,13.933198776,9.1337791709,-1.506794527,-52,1.8230353539,4.7994196051,0.3162408267
20,169,2002,760,498,-184,1443,89,262,-95,121,53989,14.092733898,9.2344493172,-3.411925049,-46,1.6503333117,4.8582845805,-1.761591737
20,169,2003,758,489,-538,1443,73,269,-465,-239,53750,14.071042055,9.0774928299,-9.987098451,-43,1.3551267415,4.9935492254,-8.631971709
20,169,2004,761,532,-181,1443,77,229,-104,85,53835,14.146953572,9.8898545336,-3.364781336,-40,1.4314263141,4.257099038,-1.933355022
20,169,2005,801,446,-286,1443,77,355,-209,97,53932,14.865404066,8.2771163714,-5.30774727,-49,1.4290088803,6.5882876947,-3.878738389
20,169,2006,804,523,-154,1443,81,281,-73,181,54113,14.882687769,9.6811513721,-2.850664075,-27,1.4993752603,5.2015363969,-1.351288815
20,169,2007,816,542,29,1443,65,274,94,349,54462,15.031084504,9.9838821091,0.5341929542,-19,1.1973290352,5.0472023947,1.7315219894
20,169,2008,825,519,-175,1443,67,306,-108,195,54657,15.121106315,9.5125505182,-3.2075074,-3,1.2280171189,5.6085557969,-1.979490281
20,171,2001,59,57,-19,86,5,2,-14,-19,5077,11.599331564,11.206133884,-3.735377961,-7,0.9829942003,0.3931976801,-2.752383761
20,171,2002,62,54,-187,86,5,8,-182,-176,4901,12.427340148,10.823812387,-37.48246142,-2,1.0022048507,1.6035277611,-36.48025656
20,171,2003,65,59,-136,86,4,6,-132,-125,4776,13.43391547,12.193861734,-28.10788468,1,0.8267024904,1.2400537357,-27.28118218
20,171,2004,68,42,-194,86,3,26,-191,-172,4604,14.498933902,8.9552238806,-41.36460554,-7,0.6396588486,5.5437100213,-40.7249467
20,171,2005,61,45,12,86,4,16,16,30,4634,13.206321715,9.742368478,2.5979649275,-2,0.8659883092,3.4639532366,3.4639532366
20,171,2006,72,53,-66,86,3,19,-63,-47,4587,15.616527492,11.495499404,-14.3151502,-3,0.6506886455,4.1210280881,-13.66446156
20,171,2007,73,61,-24,86,4,12,-20,-14,4573,15.938864629,13.318777293,-5.240174672,-6,0.8733624454,2.6200873362,-4.366812227
20,171,2008,69,49,-11,86,3,20,-8,4,4577,15.081967213,10.710382514,-2.404371585,-8,0.6557377049,4.3715846995,-1.74863388
20,173,2001,7694,3700,-2305,6304,1412,3994,-893,2704,456222,16.914722888,8.1341921868,-5.067381889,-397,3.1041836129,8.7805307011,-1.963198276
20,173,2002,7468,3696,-809,6277,1170,3772,361,3703,459925,16.303060535,8.068574148,-1.766092123,-430,2.5541752579,8.234486387,0.7880831351
20,173,2003,7601,3857,-2916,6180,719,3744,-2197,1041,460966,16.507925477,8.3766699859,-6.332997065,-506,1.5615311693,8.1312554906,-4.771465896
20,173,2004,7626,3793,-3749,6159,1257,3833,-2492,929,461895,16.526865909,8.2200894826,-8.124733844,-412,2.7241372211,8.3067764268,-5.400596623
20,173,2005,7739,3835,-2059,6068,1092,3904,-967,2529,464424,16.709146633,8.2800849383,-4.445552774,-408,2.3577191011,8.4290616947,-2.087833673
20,173,2006,7765,3864,-1070,6028,1210,3901,140,3811,468235,16.65131629,8.2859866253,-2.29451493,-230,2.5947318366,8.365329665,0.3002169067
20,173,2007,8317,3698,1304,6059,975,4619,2279,6914,475149,17.632268514,7.8398616046,2.7645158281,16,2.0670267887,9.7924069096,4.8315426168
20,173,2008,8358,3834,2012,6059,1030,4524,3042,7714,482863,17.448633211,8.0040751055,4.2003649224,148,2.1502862177,9.4445581057,6.3506511401
20,175,2001,535,141,-772,414,369,394,-403,-14,22519,23.750332949,6.2594335435,-34.27150848,-5,16.381070763,17.490899405,-17.89043772
20,175,2002,491,148,-469,414,347,343,-122,211,22730,21.702137064,6.5415810294,-20.72973988,-10,15.337355522,15.160556034,-5.392384362
20,175,2003,554,132,-728,414,302,422,-426,6,22736,24.369858796,5.8065367527,-32.02392997,10,13.284652268,18.563322043,-18.7392777
20,175,2004,512,138,-646,414,266,374,-380,-40,22696,22.539179433,6.0750132066,-28.4381053,-34,11.709808065,16.464166226,-16.72829724
20,175,2005,540,147,-802,414,288,393,-514,-135,22561,23.863711691,6.496232627,-35.44203107,-14,12.727312902,17.367479064,-22.71471817
20,175,2006,495,142,-581,414,288,353,-293,51,22612,21.915746132,6.2869413145,-25.72333031,-9,12.750979567,15.628804817,-12.97235074
20,175,2007,558,114,-411,414,256,444,-155,277,22889,24.526933474,5.0108788818,-18.06553702,-12,11.252499945,19.516054592,-6.813037076
20,175,2008,533,112,-529,414,257,421,-272,127,23016,23.221871256,4.8796427404,-23.0475983,-22,11.19703736,18.342228515,-11.85056094
20,177,2001,2421,1770,-455,4857,220,651,-235,261,170310,14.226155324,10.400782703,-2.673647531,-155,1.2927526523,3.8253726213,-1.380894879
20,177,2002,2498,1739,-839,4857,193,759,-646,-25,170285,14.668447863,10.211541567,-4.926672441,-138,1.1333108237,4.4569062963,-3.793361617
20,177,2003,2450,1747,-219,4848,129,703,-90,377,170662,14.371735196,10.247927097,-1.284657146,-236,0.7567158532,4.1238080992,-0.527941293
20,177,2004,2508,1632,-529,4852,201,876,-328,417,171079,14.677782297,9.5510927866,-3.095911816,-131,1.1763294425,5.1266895105,-1.919582374
20,177,2005,2540,1612,-571,4856,177,928,-394,375,171454,14.830687846,9.4122318142,-3.333985339,-159,1.0334770664,5.418456032,-2.300508272
20,177,2006,2510,1658,-210,4843,192,852,-18,752,172206,14.607460862,9.649071757,-1.22213816,-82,1.1173834604,4.9583891055,-0.104754699
20,177,2007,2626,1562,-175,4839,166,1064,-9,1041,173247,15.203225909,9.0431983512,-1.013162427,-14,0.961056931,6.160027558,-0.052105496
20,177,2008,2675,1599,180,4839,174,1076,354,1462,174709,15.375507248,9.1908172298,1.0346135718,32,1.0001264528,6.1846900183,2.0347400246
20,179,2001,31,46,-72,44,1,-15,-71,-86,2708,11.268629589,16.721192294,-26.17230098,0,0.3635041803,-5.452562704,-25.8087968
20,179,2002,26,33,-65,44,1,-7,-64,-72,2636,9.7305389222,12.350299401,-24.32634731,-1,0.374251497,-2.619760479,-23.95209581
20,179,2003,31,38,-26,44,1,-7,-25,-32,2604,11.832061069,14.503816794,-9.923664122,0,0.3816793893,-2.671755725,-9.541984733
20,179,2004,28,26,-80,44,0,2,-80,-81,2523,10.922566803,10.14238346,-31.20733372,-3,0,0.7801833431,-31.20733372
20,179,2005,29,32,8,44,1,-3,9,3,2526,11.487423252,12.675777382,3.1689443454,-3,0.3961180432,-1.18835413,3.5650623886
20,179,2006,29,30,-23,44,0,-1,-23,-26,2500,11.539992041,11.937922801,-9.152407481,-2,0,-0.39793076,-9.152407481
20,179,2007,28,24,-20,44,1,4,-19,-15,2485,11.233701103,9.62888666,-8.024072217,0,0.4012036108,1.6048144433,-7.622868606
20,179,2008,25,22,20,44,0,3,20,25,2510,10.01001001,8.8088088088,8.008008008,2,0,1.2012012012,8.008008008
20,181,2001,79,65,-173,134,4,14,-169,-157,6589,11.848518935,9.7487814023,-25.94675666,-2,0.5999250094,2.0997375328,-25.34683165
20,181,2002,73,75,-231,134,4,-2,-227,-229,6360,11.275001931,11.583906093,-35.67843077,0,0.617808325,-0.308904162,-35.06062244
20,181,2003,66,76,-115,134,4,-10,-111,-121,6239,10.477021986,12.064449559,-18.2554171,0,0.6349710294,-1.587427574,-17.62044607
20,181,2004,76,67,-125,134,3,9,-122,-121,6118,12.30072024,10.844056001,-20.23144776,-8,0.4855547463,1.4566642389,-19.74589302
20,181,2005,76,77,-45,134,4,-1,-41,-48,6070,12.471283229,12.635379061,-7.384312438,-6,0.6563833279,-0.164095832,-6.727929111
20,181,2006,59,75,-147,134,3,-16,-144,-162,5908,9.8513942227,12.522958758,-24.54499917,-2,0.5009183503,-2.671564535,-24.04408081
20,181,2007,88,69,44,134,3,19,47,65,5973,14.813567881,11.615183907,7.4067839407,-1,0.505007996,3.1983839744,7.9117919367
20,181,2008,83,65,17,134,2,18,19,40,6013,13.849491073,10.845986985,2.8366427499,3,0.3337226765,3.0035040881,3.1703654263
20,183,2001,31,74,-64,109,0,-43,-64,-109,4406,6.9498935097,16.590068378,-14.34816725,-2,0,-9.640174868,-14.34816725
20,183,2002,31,77,-62,109,-1,-46,-63,-115,4291,7.1288950213,17.707255375,-14.25779004,-6,-0.229964356,-10.57836035,-14.4877544
20,183,2003,25,66,-27,109,-1,-41,-28,-72,4219,5.875440658,15.511163337,-6.345475911,-3,-0.235017626,-9.635722679,-6.580493537
20,183,2004,41,71,-31,109,0,-30,-31,-65,4154,9.7933834946,16.959273856,-7.404753374,-4,0,-7.165890362,-7.404753374
20,183,2005,26,68,-25,109,0,-42,-25,-70,4084,6.3122117019,16.508861374,-6.069434329,-3,0,-10.19664967,-6.069434329
20,183,2006,42,64,-55,109,0,-22,-55,-79,4005,10.384472741,15.823958462,-13.5987143,-2,0,-5.439485721,-13.5987143
20,183,2007,27,47,-37,109,0,-20,-37,-58,3947,6.7907444668,11.820925553,-9.30583501,-1,0,-5.030181087,-9.30583501
20,183,2008,39,70,-20,109,1,-31,-19,-46,3901,9.9388379205,17.838939857,-5.096839959,4,0.254841998,-7.900101937,-4.841997961
20,185,2001,44,67,-21,79,11,-23,-10,-37,4714,9.2974115161,14.157422081,-4.437400951,-4,2.324352879,-4.860010565,-2.113048072
20,185,2002,57,76,-74,79,11,-19,-63,-85,4629,12.201648293,16.26886439,-15.84073638,-3,2.3547040565,-4.067216098,-13.48603232
20,185,2003,47,60,-86,79,4,-13,-82,-97,4532,10.260888549,13.099006659,-18.77524288,-2,0.8732671106,-2.838118109,-17.90197577
20,185,2004,32,54,-72,79,3,-22,-69,-96,4436,7.136485281,12.042818912,-16.05709188,-5,0.6690454951,-4.906333631,-15.38804639
20,185,2005,50,62,7,79,4,-12,11,-4,4432,11.276499774,13.98285972,1.5787099684,-3,0.902119982,-2.706359946,2.4808299504
20,185,2006,56,64,-61,79,3,-8,-58,-67,4365,12.73161305,14.550414914,-13.86836422,-1,0.6820506991,-1.818801864,-13.18631352
20,185,2007,51,56,14,79,3,-5,17,8,4373,11.673151751,12.817578393,3.2043945983,-4,0.6866559854,-1.144426642,3.8910505837
20,185,2008,57,56,-46,79,2,1,-44,-47,4326,13.104954592,12.875043108,-10.57592827,-4,0.4598229682,0.2299114841,-10.1161053
20,187,2001,49,18,-42,55,20,31,-22,9,2411,20.361520881,7.4797423644,-17.45273218,0,8.3108248494,12.881778517,-9.141907334
20,187,2002,35,17,-34,55,20,18,-14,2,2413,14.510779436,7.048092869,-14.09618574,-2,8.2918739635,7.4626865672,-5.804311774
20,187,2003,36,22,-96,55,10,14,-86,-69,2344,15.135589657,9.2495270128,-40.36157242,3,4.2043304604,5.8860626445,-36.15724196
20,187,2004,40,24,-48,55,9,16,-39,-25,2319,17.156337122,10.293802273,-20.58760455,-2,3.8601758525,6.8625348488,-16.72742869
20,187,2005,42,18,-146,55,10,24,-136,-113,2206,18.563535912,7.955801105,-64.53038674,-1,4.4198895028,10.607734807,-60.11049724
20,187,2006,36,23,-50,55,9,13,-41,-29,2177,16.427104723,10.495094684,-22.81542323,-1,4.1067761807,5.9320100388,-18.70864705
20,187,2007,34,12,-72,55,10,22,-62,-39,2138,15.758980301,5.5619930475,-33.37195829,1,4.6349942063,10.196987254,-28.73696408
20,187,2008,37,8,-27,55,9,29,-18,10,2148,17.265515632,3.733084461,-12.59916006,-1,4.1997200187,13.532431171,-8.399440037
20,189,2001,101,54,-169,60,35,47,-134,-89,5359,18.691588785,9.9935227168,-31.2760248,-2,6.4772832423,8.6980660683,-24.79874156
20,189,2002,81,48,-107,60,34,33,-73,-41,5318,15.172801349,8.9912896881,-20.04308326,-1,6.3688301957,6.1815116606,-13.67425307
20,189,2003,89,42,-101,60,29,47,-72,-26,5292,16.776625825,7.9170593779,-19.03864279,-1,5.4665409991,8.8595664467,-13.57210179
20,189,2004,75,50,49,60,27,25,76,94,5386,14.047574452,9.3650496348,9.1777486421,-7,5.0571268028,4.6825248174,14.234875445
20,189,2005,96,53,-152,60,29,43,-123,-83,5303,17.962391243,9.9167368323,-28.4404528,-3,5.4261390214,8.0456544111,-23.01431378
20,189,2006,93,40,-232,60,28,53,-204,-152,5151,17.792232638,7.6525731777,-44.38492443,-1,5.3568012244,10.13965946,-39.02812321
20,189,2007,98,37,-198,60,24,61,-174,-111,5040,19.232656265,7.2613089981,-38.85781572,2,4.7100382691,11.971347267,-34.14777745
20,189,2008,96,37,-63,60,23,59,-40,16,5056,19.017432647,7.3296354992,-12.48019017,-3,4.5562599049,11.687797147,-7.923930269
20,191,2001,323,284,-340,408,4,39,-336,-313,25634,12.523991392,11.011806673,-13.18314883,-16,0.1550958686,1.5121847192,-13.02805297
20,191,2002,347,244,-368,408,3,103,-365,-274,25360,13.609444248,9.5697533043,-14.43307056,-12,0.1176609013,4.039690944,-14.31540966
20,191,2003,309,299,-336,408,0,10,-336,-338,25022,12.266285578,11.869318407,-13.33809694,-12,0,0.3969671708,-13.33809694
20,191,2004,304,290,-174,408,3,14,-171,-174,24848,12.191698416,11.63023862,-6.978143172,-17,0.1203128133,0.5614597955,-6.857830359
20,191,2005,287,277,-423,408,1,10,-422,-426,24422,11.650091333,11.244164806,-17.1706921,-14,0.0405926527,0.4059265273,-17.13009945
20,191,2006,319,283,-346,408,2,36,-344,-320,24102,13.148132883,11.664331053,-14.26098426,-12,0.082433435,1.48380183,-14.17855082
20,191,2007,291,273,-273,408,0,18,-273,-280,23822,12.144228362,11.393038978,-11.39303898,-25,0,0.7511893832,-11.39303898
20,191,2008,308,241,-228,408,2,67,-226,-206,23616,12.985370378,10.160630718,-9.612546903,-47,0.0843205869,2.8247396602,-9.528226316
20,193,2001,86,75,-61,281,2,11,-59,-55,8121,10.55408971,9.2041480027,-7.486040376,-7,0.2454439467,1.3499417071,-7.240596429
20,193,2002,120,75,-130,281,2,45,-128,-87,8034,14.856081708,9.2850510678,-16.09408852,-4,0.2476013618,5.5710306407,-15.84648716
20,193,2003,94,76,-142,281,1,18,-141,-126,7908,11.792748714,9.5345627901,-17.81457784,-3,0.1254547736,2.258185924,-17.68912307
20,193,2004,93,76,-166,281,0,17,-166,-159,7749,11.879670435,9.7081177748,-21.20457303,-10,0,2.1715526602,-21.20457303
20,193,2005,90,89,-188,281,1,1,-187,-190,7559,11.758557617,11.627906977,-24.56232036,-4,0.1306506402,0.1306506402,-24.43166972
20,193,2006,113,82,-162,281,0,31,-162,-135,7424,15.083761596,10.945738504,-21.62450778,-4,0,4.1380230928,-21.62450778
20,193,2007,106,55,-124,281,1,51,-123,-82,7342,14.357307328,7.4495462549,-16.79534065,-10,0.1354462955,6.9077610727,-16.65989435
20,193,2008,96,73,-75,281,0,23,-75,-65,7277,13.133593269,9.987003215,-10.26061974,-13,0,3.146590054,-10.26061974
20,195,2001,25,45,-41,109,2,-20,-39,-61,3231,7.665184731,13.797332516,-12.57090296,-2,0.6132147785,-6.132147785,-11.95768818
20,195,2002,28,51,-70,109,2,-23,-68,-93,3138,8.7925891035,16.01507301,-21.98147276,-2,0.6280420788,-7.222483906,-21.35343068
20,195,2003,28,32,-43,109,1,-4,-42,-48,3090,8.9916506101,10.276172126,-13.80860629,-2,0.3211303789,-1.284521516,-13.48747592
20,195,2004,32,55,42,109,0,-23,42,15,3105,10.330912026,17.756255044,13.559322034,-4,0,-7.425343019,13.559322034
20,195,2005,37,52,-85,109,1,-15,-84,-101,3004,12.113275495,17.024062858,-27.82779506,-2,0.3273858242,-4.910787363,-27.50040923
20,195,2006,30,46,-41,109,0,-16,-41,-58,2946,10.084033613,15.462184874,-13.78151261,-1,0,-5.378151261,-13.78151261
20,195,2007,31,38,-25,109,1,-7,-24,-40,2906,10.594668489,12.987012987,-8.544087491,-9,0.3417634997,-2.392344498,-8.202323992
20,195,2008,38,42,-12,109,0,-4,-12,-24,2882,13.130615066,14.512785073,-4.146510021,-8,0,-1.382170007,-4.146510021
20,197,2001,82,73,-97,112,1,9,-96,-91,6782,12.010252655,10.692054193,-14.20725009,-4,0.1464664958,1.3181984621,-14.0607836
20,197,2002,73,73,-68,112,0,0,-68,-75,6707,10.823634072,10.823634072,-10.08228927,-7,0,0,-10.08228927
20,197,2003,73,53,-28,112,-2,20,-30,-18,6689,10.898775754,7.912809794,-4.180352344,-8,-0.298596596,2.98596596,-4.47894894
20,197,2004,77,65,30,112,1,12,31,36,6725,11.480542717,9.6913672283,4.4729387207,-7,0.1490979574,1.7891754883,4.6220366781
20,197,2005,89,59,48,112,-1,30,47,73,6798,13.162759743,8.7258744361,7.0990164904,-4,-0.147896177,4.4368853065,6.9511203135
20,197,2006,83,71,-93,112,0,12,-93,-84,6714,12.285375962,10.509177028,-13.76554174,-3,0,1.7761989343,-13.76554174
20,197,2007,87,66,111,112,-1,21,110,131,6845,12.832804779,9.7352312117,16.372888856,0,-0.147503503,3.0975735674,16.225385353
20,197,2008,96,64,45,112,1,32,46,77,6922,13.94639355,9.2975956999,6.5373719765,-1,0.1452749328,4.6487978499,6.6826469093
20,199,2001,28,21,-54,25,4,7,-50,-43,1697,16.293279022,12.219959267,-31.4227524,0,2.3276112889,4.0733197556,-29.09514111
20,199,2002,11,18,-25,25,4,-7,-21,-29,1668,6.5378900446,10.698365527,-14.85884101,-1,2.3774145617,-4.160475483,-12.48142645
20,199,2003,21,25,-56,25,1,-4,-55,-57,1611,12.808783166,15.248551388,-34.15675511,2,0.6099420555,-2.439768222,-33.54681305
20,199,2004,15,17,-64,25,0,-2,-64,-68,1543,9.5117311351,10.779961953,-40.58338618,-2,0,-1.268230818,-40.58338618
20,199,2005,16,16,-39,25,1,0,-38,-39,1504,10.502133246,10.502133246,-25.59894979,-1,0.6563833279,0,-24.94256646
20,199,2006,17,20,-10,25,0,-3,-10,-15,1489,11.359839626,13.364517207,-6.682258603,-2,0,-2.004677581,-6.682258603
20,199,2007,9,13,-46,25,1,-4,-45,-50,1439,6.1475409836,8.8797814208,-31.42076503,-1,0.6830601093,-2.732240437,-30.73770492
20,199,2008,14,9,-35,25,0,5,-35,-35,1404,9.848751319,6.3313401337,-24.6218783,-5,0,3.5174111854,-24.6218783
20,201,2001,53,100,-101,204,7,-47,-94,-147,6325,8.283191373,15.628662968,-15.7849496,-6,1.0940064078,-7.345471595,-14.69094319
20,201,2002,62,113,-43,204,7,-51,-36,-93,6232,9.8749701362,17.997929442,-6.848769611,-6,1.1149159831,-8.122959306,-5.733853627
20,201,2003,60,86,-40,204,1,-26,-39,-71,6161,9.6828854999,13.87880255,-6.455257,-6,0.161381425,-4.19591705,-6.293875575
20,201,2004,53,86,-66,204,0,-33,-66,-104,6057,8.6757243411,14.07759044,-10.8037322,-5,0,-5.401866099,-10.8037322
20,201,2005,60,82,-47,204,1,-22,-46,-73,5984,9.965949672,13.620131218,-7.806660576,-5,0.1660991612,-3.654181546,-7.640561415
20,201,2006,55,95,-32,204,0,-40,-32,-74,5910,9.2483605179,15.974440895,-5.380864301,-2,0,-6.726080377,-5.380864301
20,201,2007,67,81,-73,204,1,-14,-72,-86,5824,11.419805693,13.806033748,-12.44247486,0,0.1704448611,-2.386228055,-12.27203
20,201,2008,67,78,-22,204,0,-11,-22,-33,5791,11.536805854,13.430908308,-3.788204907,0,0,-1.894102454,-3.788204907
20,203,2001,29,15,-34,25,6,14,-28,-17,2501,11.55608687,5.977286312,-13.54851564,-3,2.3909145248,5.5788005579,-11.15760112
20,203,2002,25,31,-68,25,6,-6,-62,-69,2432,10.135819988,12.568416785,-27.56943037,-1,2.4325967971,-2.432596797,-25.13683357
20,203,2003,45,19,-66,25,4,26,-62,-34,2398,18.633540373,7.867494824,-27.32919255,2,1.6563146998,10.766045549,-25.67287785
20,203,2004,38,36,-94,25,3,2,-91,-93,2305,16.159897937,15.309376993,-39.97448437,-4,1.2757814161,0.8505209441,-38.69870296
20,203,2005,35,25,-14,25,4,10,-10,-2,2303,15.190972222,10.850694444,-6.076388889,-2,1.7361111111,4.3402777778,-4.340277778
20,203,2006,34,20,-85,25,3,14,-82,-68,2235,14.984574703,8.8144557074,-37.46143676,0,1.3221683561,6.1701189952,-36.1392684
20,203,2007,44,20,-57,25,3,24,-54,-31,2204,19.824284749,9.0110385222,-25.68145979,-1,1.3516557783,10.813246227,-24.32980401
20,203,2008,35,9,-76,25,2,26,-74,-56,2148,16.084558824,4.1360294118,-34.92647059,-8,0.9191176471,11.948529412,-34.00735294
20,205,2001,105,151,-32,238,3,-46,-29,-87,10217,10.233419424,14.716631743,-3.118756396,-12,0.2923834121,-4.483212319,-2.826372984
20,205,2002,110,131,-89,238,3,-21,-86,-113,10104,10.826238866,12.893066286,-8.759411446,-6,0.29526106,-2.06682742,-8.464150386
20,205,2003,114,145,-6,238,2,-31,-4,-49,10055,11.310084826,14.385634208,-0.595267622,-14,0.1984225408,-3.075549382,-0.396845082
20,205,2004,108,140,-230,238,1,-32,-229,-276,9779,10.890390239,14.117172532,-23.19249773,-15,0.1008369467,-3.226782293,-23.09166078
20,205,2005,129,125,-15,238,2,4,-13,-18,9761,13.203684749,12.794268168,-1.53531218,-9,0.2047082907,0.4094165814,-1.330603889
20,205,2006,122,119,-25,238,1,3,-24,-25,9736,12.514745858,12.207006206,-2.564497102,-4,0.1025798841,0.3077396523,-2.461917218
20,205,2007,146,156,100,238,2,-10,102,89,9825,14.927662185,15.9501048,10.224426154,-3,0.2044885231,-1.022442615,10.428914677
20,205,2008,135,135,-133,238,1,0,-132,-127,9698,13.829841725,13.829841725,-13.62495518,5,0.102443272,0,-13.52251191
20,207,2001,31,63,17,114,0,-32,17,-18,3745,8.2578582845,16.782099094,4.5285029302,-3,0,-8.52424081,4.5285029302
20,207,2002,34,69,-114,114,0,-35,-114,-150,3595,9.2643051771,18.801089918,-31.0626703,-1,0,-9.536784741,-31.0626703
20,207,2003,35,60,-12,114,0,-25,-12,-42,3553,9.7929490767,16.787912703,-3.357582541,-5,0,-6.994963626,-3.357582541
20,207,2004,39,61,-72,114,0,-22,-72,-98,3455,11.130136986,17.408675799,-20.54794521,-4,0,-6.278538813,-20.54794521
20,207,2005,31,66,60,114,0,-35,60,21,3476,8.9453181359,19.04487087,17.313518973,-4,0,-10.09955273,17.313518973
20,207,2006,37,47,-80,114,0,-10,-80,-91,3385,10.785599767,13.700626731,-23.32021571,-1,0,-2.915026964,-23.32021571
20,207,2007,38,50,-61,114,0,-12,-61,-69,3316,11.341590807,14.923145799,-18.20623787,4,0,-3.581554992,-18.20623787
20,207,2008,32,52,-12,114,0,-20,-12,-31,3285,9.6955006817,15.755188608,-3.635812756,1,0,-6.059687926,-3.635812756
20,209,2001,2793,1571,-1709,1592,1035,1222,-674,409,158265,17.670448974,9.9392321295,-10.81231554,-139,6.5481255595,7.7312168442,-4.264189978
20,209,2002,2815,1521,-3165,1592,975,1294,-2190,-972,157293,17.841411088,9.6400661685,-20.05970376,-76,6.1795295952,8.2013449192,-13.88017417
20,209,2003,2902,1527,-3611,1592,856,1375,-2755,-1380,155913,18.530934912,9.750771058,-23.05830667,0,5.4660510974,8.7801638538,-17.59225558
20,209,2004,2751,1521,-3268,1592,788,1230,-2480,-1439,154474,17.726257865,9.8006681981,-21.05758295,-189,5.077532242,7.9255896671,-15.98005071
20,209,2005,2829,1494,-2624,1592,827,1335,-1797,-577,153897,18.348028835,9.689627105,-17.01846153,-115,5.3636690869,8.6584017304,-11.65479244
20,209,2006,2824,1412,-2859,1592,824,1412,-2035,-691,153206,18.391223791,9.1956118957,-18.61916035,-68,5.3662777635,9.1956118957,-13.25288258
20,209,2007,2895,1303,-1906,1592,759,1592,-1147,395,153601,18.871798883,8.4939391865,-12.42474911,-50,4.947735873,10.377859697,-7.477013236
20,209,2008,2864,1307,-1537,1592,762,1557,-775,686,154287,18.604167749,8.4901002962,-9.984150081,-96,4.9498518942,10.114067453,-5.034298186
21,0,2001,55280,39897,-1329,115044,4868,15383,3539,17611,4066442,13.623694483,9.8325712518,-0.327530571,-1311,1.1997131828,3.7911232315,0.8721826117
21,0,2002,53959,40328,4543,114974,3679,13631,8222,20312,4086754,13.236281821,9.8925623768,1.1144096131,-1541,0.9024681855,3.3437194445,2.0168777986
21,0,2003,54418,39674,10926,115008,1078,14744,12004,24168,4110922,13.276445666,9.6793286292,2.6656335283,-2580,0.2630013677,3.5971170366,2.928634896
21,0,2004,55784,40518,5941,115040,5020,15266,10961,24645,4135567,13.529151618,9.8267274715,1.4408556175,-1582,1.2174878303,3.7024241468,2.6583434477
21,0,2005,56069,39495,13606,114941,3757,16574,17363,30391,4165958,13.508120496,9.51511921,3.2779519426,-3546,0.9051348999,3.9930012859,4.1830868425
21,0,2006,56958,39575,10464,115019,4562,17383,15026,33482,4199440,13.61752304,9.4615940569,2.5017339283,1073,1.0906833124,4.1559289827,3.5924172406
21,0,2007,57562,40898,17044,115028,3295,16664,20339,36868,4236308,13.647159683,9.6963541348,4.0408983293,-135,0.7811992487,3.950805548,4.8220975781
21,0,2008,57613,40881,11828,115028,3684,16732,15512,32937,4269245,13.547149727,9.6127788517,2.7812418546,693,0.8662576084,3.9343708751,3.647499463
21,1,2001,213,155,59,752,11,58,70,112,17397,12.28302866,8.9383541895,3.4023412721,-16,0.6343348134,3.3446744709,4.0366760856
21,1,2002,227,171,44,752,11,56,55,95,17492,13.012697412,9.8025165525,2.5222849609,-16,0.6305712402,3.2101808593,3.1528562011
21,1,2003,206,187,40,752,9,19,49,45,17537,11.761683177,10.676867738,2.2838219761,-23,0.5138599446,1.0848154386,2.7976819207
21,1,2004,210,183,9,752,12,27,21,36,17573,11.962403874,10.424380518,0.5126744517,-12,0.6835659356,1.5380233552,1.1962403874
21,1,2005,216,173,-28,752,10,43,-18,11,17584,12.287737862,9.8415678243,-1.592854908,-14,0.5688767529,2.4461700373,-1.023978155
21,1,2006,212,151,80,752,11,61,91,141,17725,12.008269846,8.5530601263,4.5314225835,-11,0.6230706052,3.4552097199,5.1544931887
21,1,2007,210,181,56,752,10,29,66,88,17813,11.818335303,10.186279475,3.1515560808,-7,0.5627778716,1.6320558276,3.7143339524
21,1,2008,219,180,-77,752,12,39,-65,-40,17773,12.308211094,10.116337886,-4.32754454,-14,0.6744225257,2.1918732086,-3.653122014
21,3,2001,213,178,20,205,8,35,28,44,17854,11.944818304,9.9820547331,1.1215791835,-19,0.4486316734,1.9627635711,1.5702108569
21,3,2002,224,197,160,205,8,27,168,182,18036,12.482585678,10.977988298,8.9161326275,-13,0.4458066314,1.5045973809,9.3619392588
21,3,2003,243,200,81,205,7,43,88,111,18147,13.431722079,11.054915292,4.4772406931,-20,0.3869220352,2.3768067877,4.8641627284
21,3,2004,230,218,174,205,6,12,180,175,18322,12.613452521,11.955359346,9.5423510379,-17,0.3290465875,0.658093175,9.8713976254
21,3,2005,234,205,95,205,7,29,102,114,18436,12.731922303,11.154034496,5.1689428152,-17,0.3808694706,1.5778878067,5.5498122858
21,3,2006,238,187,194,205,6,51,200,242,18678,12.825348925,10.07705987,10.454276014,-9,0.3233281242,2.7482890553,10.777604139
21,3,2007,246,200,153,205,5,46,158,208,18886,13.097646683,10.648493238,8.1460973272,4,0.266212331,2.4491534448,8.4123096582
21,3,2008,243,202,147,205,4,41,151,204,19090,12.797556351,10.638297872,7.74173162,12,0.2106593638,2.159258479,7.9523909838
21,5,2001,228,159,215,141,5,69,220,274,19458,11.800631437,8.2293877129,11.127788417,-15,0.2587857771,3.5712437244,11.386574194
21,5,2002,230,168,-77,141,4,62,-73,-29,19429,11.829145987,8.6404196775,-3.960192352,-18,0.205724278,3.1887263096,-3.754468074
21,5,2003,235,179,183,141,0,56,183,222,19651,12.026612078,9.1606960082,9.3654042989,-17,0,2.8659160696,9.3654042989
21,5,2004,253,146,153,141,7,107,160,249,19900,12.793608253,7.3828727466,7.7368460974,-18,0.3539733509,5.4107355061,8.0908194483
21,5,2005,228,164,259,141,4,64,263,309,20209,11.369019422,8.1777157247,12.914807151,-18,0.1994564811,3.1913036974,13.114263632
21,5,2006,276,185,447,141,6,91,453,533,20742,13.47952431,9.0351883959,21.830968719,-11,0.2930331372,4.4443359137,22.124001856
21,5,2007,262,170,393,141,4,92,397,499,21241,12.481242408,8.098516066,18.721863611,10,0.1905533192,4.3827263416,18.912416931
21,5,2008,265,177,6,141,6,88,12,106,21347,12.444820137,8.3122006199,0.2817695125,6,0.2817695125,4.1326195172,0.5635390251
21,7,2001,84,106,-55,160,4,-22,-51,-81,8219,10.170107149,12.833706641,-6.658998729,-8,0.4842908166,-2.663599491,-6.174707912
21,7,2002,85,122,-23,160,4,-37,-19,-64,8155,10.382313424,14.901673385,-2.809331868,-8,0.4885794552,-4.519359961,-2.320752412
21,7,2003,107,94,73,160,2,13,75,79,8234,13.057538593,11.47110867,8.9084141802,-9,0.2440661419,1.5864299225,9.1524803222
21,7,2004,95,105,2,160,1,-10,3,-12,8222,11.54594069,12.761302868,0.2430724356,-5,0.1215362178,-1.215362178,0.3646086534
21,7,2005,101,75,2,160,2,26,4,23,8245,12.266958159,9.1091273456,0.2429100625,-7,0.2429100625,3.1578308131,0.4858201251
21,7,2006,79,135,22,160,1,-56,23,-37,8208,9.6031118945,16.410381086,2.674284325,-4,0.1215583784,-6.807269191,2.7958427035
21,7,2007,75,110,69,160,2,-35,71,31,8239,9.1202042926,13.376299629,8.3905879492,-5,0.2432054478,-4.256095337,8.633793397
21,7,2008,98,109,98,160,1,-11,99,84,8323,11.834319527,13.162661514,11.834319527,-4,0.1207583625,-1.328341988,11.955077889
21,9,2001,503,447,289,634,26,56,315,340,38458,13.137275387,11.674676139,7.5480568324,-31,0.6790639365,1.4625992478,8.2271207689
21,9,2002,436,406,108,634,26,30,134,129,38587,11.318060874,10.539295217,2.8035563632,-35,0.6749302356,0.7787656564,3.4784865987
21,9,2003,493,438,339,634,23,55,362,380,38967,12.713722052,11.295355494,8.7422956907,-37,0.5931351059,1.4183665575,9.3354307966
21,9,2004,518,422,304,634,19,96,323,386,39353,13.227783453,10.776302349,7.7630234934,-33,0.4851889683,2.4514811032,8.2482124617
21,9,2005,562,434,524,634,22,128,546,646,39999,14.164734348,10.938602682,13.20697651,-28,0.5544913802,3.2261316665,13.76146789
21,9,2006,554,413,388,634,21,141,409,527,40526,13.759701956,10.257683949,9.6367587706,-23,0.52157715,3.5020180068,10.158335921
21,9,2007,546,446,466,634,18,100,484,564,41090,13.379729465,10.929229563,11.419329543,-20,0.4410899824,2.450499902,11.860419526
21,9,2008,579,447,343,634,17,132,360,476,41566,14.009872242,10.815911731,8.2994579946,-16,0.4113433991,3.193960511,8.7108013937
21,11,2001,166,137,139,115,-1,29,138,159,11287,14.811510149,12.223957172,12.402409101,-8,-0.089225965,2.5875529779,12.313183136
21,11,2002,158,126,109,115,-2,32,107,131,11418,13.917639287,11.098876899,9.6014093812,-8,-0.176172649,2.8187623871,9.425236732
21,11,2003,152,134,27,115,-4,18,23,27,11445,13.296592748,11.721996238,2.3618947645,-14,-0.349910335,1.5745965096,2.011984429
21,11,2004,140,139,31,115,1,1,32,25,11470,12.219070478,12.131791403,2.7056513201,-8,0.0872790748,0.0872790748,2.7929303949
21,11,2005,166,116,55,115,-1,50,54,95,11565,14.412850011,10.071630128,4.7753418711,-9,-0.086824398,4.3412198828,4.6885174734
21,11,2006,158,132,50,115,1,26,51,70,11635,13.620689655,11.379310345,4.3103448276,-7,0.0862068966,2.2413793103,4.3965517241
21,11,2007,154,135,-79,115,-1,19,-80,-61,11574,13.270713947,11.633418071,-6.807703908,0,-0.086173467,1.6372958766,-6.893877375
21,11,2008,153,133,159,115,1,20,160,176,11750,13.119533528,11.404561825,13.634025039,-4,0.0857485851,1.714971703,13.719773624
21,13,2001,365,373,-406,776,15,-8,-391,-422,29621,12.235183695,12.503352105,-13.6095468,-23,0.5028157683,-0.26816841,-13.10673103
21,13,2002,341,355,182,776,12,-14,194,158,29779,11.481481481,11.952861953,6.1279461279,-22,0.404040404,-0.471380471,6.531986532
21,13,2003,367,414,-138,776,11,-47,-127,-210,29569,12.367729325,13.951607468,-4.650535823,-36,0.3706948844,-1.583878142,-4.279840938
21,13,2004,404,359,-229,776,12,45,-217,-196,29373,13.7083913,12.181466526,-7.770350514,-24,0.4071799396,1.5269247735,-7.363170574
21,13,2005,377,366,-144,776,12,11,-132,-148,29225,12.867333356,12.491893921,-4.91484351,-27,0.4095702925,0.3754394348,-4.505273218
21,13,2006,358,367,-109,776,13,-9,-96,-118,29107,12.274566276,12.583144758,-3.73722828,-13,0.4457244737,-0.308578482,-3.291503806
21,13,2007,398,399,-126,776,10,-1,-116,-114,28993,13.700516351,13.734939759,-4.337349398,3,0.3442340792,-0.034423408,-3.993115318
21,13,2008,362,371,43,776,12,-9,55,62,29055,12.472436604,12.782524807,1.4815325248,16,0.4134509372,-0.310088203,1.894983462
21,15,2001,1451,494,2118,588,192,957,2310,3214,90214,16.37568138,5.5751802905,23.903303351,-53,2.1668716919,10.800501089,26.070175043
21,15,2002,1447,589,2071,588,184,858,2255,3075,93289,15.770859332,6.4195135774,22.571838063,-38,2.0054168052,9.3513457546,24.577254868
21,15,2003,1451,547,2246,588,161,904,2407,3318,96607,15.282049122,5.7610481527,23.655053292,7,1.6956649956,9.521000969,25.350718288
21,15,2004,1632,605,3167,588,152,1027,3319,4184,100791,16.535121936,6.1297480218,32.087457826,-162,1.5400358666,10.405373915,33.627493693
21,15,2005,1643,608,3532,588,158,1035,3690,4645,105436,15.933898083,5.8964151154,34.253516756,-80,1.5322920859,10.037482968,35.785808842
21,15,2006,1707,585,2307,588,165,1122,2472,3531,108967,15.923284656,5.4570131948,21.520221266,-63,1.5391575678,10.466271461,23.059378833
21,15,2007,1744,678,1940,588,149,1066,2089,3122,112089,15.77880718,6.1341922409,17.552113492,-33,1.348074696,9.6446149392,18.900188188
21,15,2008,1857,682,1846,588,151,1175,1997,3142,115231,16.338201654,6.0003519268,16.241421784,-30,1.3285236671,10.337849727,17.569945451
21,17,2001,236,216,3,199,45,20,48,49,19415,12.170908435,11.139475516,0.1547149377,-19,2.3207240659,1.0314329182,2.4754390036
21,17,2002,227,202,-70,199,45,25,-25,-19,19396,11.697714565,10.40942001,-3.607224756,-19,2.3189302002,1.2882945557,-1.288294556
21,17,2003,230,200,22,199,35,30,57,61,19457,11.839497593,10.295215299,1.1324736829,-26,1.8016626773,1.5442822948,2.9341363601
21,17,2004,230,212,103,199,29,18,132,133,19590,11.780674572,10.858708736,5.2756933951,-17,1.4853894025,0.921965836,6.7610827977
21,17,2005,243,206,76,199,33,37,109,127,19717,12.364209937,10.481593609,3.8669957005,-19,1.6790902384,1.8826163279,5.5460859389
21,17,2006,248,210,-158,199,32,38,-126,-96,19621,12.608673547,10.676699375,-8.032945244,-8,1.626925619,1.9319741726,-6.406019625
21,17,2007,259,192,0,199,27,67,27,95,19716,13.168263975,9.7618018659,0,1,1.3727533874,3.4064621095,1.3727533874
21,17,2008,245,203,42,199,26,42,68,112,19828,12.391260368,10.267044305,2.1242160631,2,1.3149908962,2.1242160631,3.4392069593
21,19,2001,561,582,-120,2077,9,-21,-111,-183,49480,11.316986575,11.740617088,-2.420745791,-51,0.1815559344,-0.423630514,-2.239189857
21,19,2002,560,656,0,2077,7,-96,7,-137,49343,11.333394048,13.276261599,0,-48,0.1416674256,-1.942867551,0.1416674256
21,19,2003,591,574,85,2077,1,17,86,38,49381,11.972772578,11.628378105,1.7219723674,-65,0.0202584984,0.3443944735,1.7422308658
21,19,2004,637,646,-288,2077,11,-9,-277,-324,49057,12.942156484,13.125012698,-5.85139885,-38,0.2234909283,-0.182856214,-5.627907922
21,19,2005,568,602,-210,2077,7,-34,-203,-274,48783,11.610793132,12.305805397,-4.292722813,-37,0.1430907604,-0.695012265,-4.149632052
21,19,2006,622,573,-139,2077,9,49,-130,-106,48677,12.764210958,11.758670224,-2.852452288,-25,0.1846911553,1.0055407347,-2.667761133
21,19,2007,613,585,-207,2077,6,28,-201,-197,48480,12.618751094,12.04236442,-4.261144333,-24,0.12351143,0.5763866731,-4.137632903
21,19,2008,583,587,115,2077,8,-4,123,80,48560,12.015663644,12.098103875,2.3701566364,-39,0.1648804617,-0.082440231,2.5350370981
21,21,2001,334,302,-154,2526,51,32,-103,-94,27608,12.077382029,10.920267583,-5.568613271,-23,1.8441511481,1.1571144459,-3.724462123
21,21,2002,297,319,56,2526,50,-22,106,59,27667,10.746268657,11.542288557,2.026232474,-25,1.8091361375,-0.7960199,3.8353686115
21,21,2003,300,299,110,2526,38,1,148,112,27779,10.821339682,10.78526855,3.96782455,-37,1.3707030264,0.0360711323,5.3385275764
21,21,2004,317,295,315,2526,40,22,355,350,28129,11.340058668,10.553051442,11.268512556,-27,1.4309222294,0.7870072262,12.699434786
21,21,2005,289,339,169,2526,38,-50,207,139,28268,10.248772098,12.021916059,5.9932265901,-18,1.3475894108,-1.773143962,7.3408160009
21,21,2006,337,306,107,2526,39,31,146,161,28429,11.887754202,10.794221917,3.7744501473,-16,1.3757341658,1.0935322857,5.1501843131
21,21,2007,333,281,164,2526,31,52,195,232,28661,11.665790857,9.8441057979,5.7453144158,-15,1.0860045542,1.8216850587,6.83131897
21,21,2008,326,302,231,2526,33,24,264,272,28933,11.320623676,10.487203528,8.0216689238,-16,1.1459527034,0.8334201479,9.1676216273
21,23,2001,101,104,94,54,1,-3,95,84,8361,12.140882318,12.501502584,11.299435028,-8,0.1202067556,-0.360620267,11.419641784
21,23,2002,108,87,74,54,1,21,75,90,8451,12.847965739,10.349750178,8.803235784,-6,0.1189626457,2.4982155603,8.9221984297
21,23,2003,105,68,-37,54,1,37,-36,-11,8440,12.432656444,8.0516251258,-4.381031318,-12,0.1184062519,4.3810313185,-4.262625067
21,23,2004,119,86,203,54,0,33,203,224,8664,13.914873714,10.056127222,23.737137512,-12,0,3.858746492,23.737137512
21,23,2005,110,88,-63,54,1,22,-62,-46,8618,12.730008101,10.184006481,-7.290822821,-6,0.1157273464,2.5460016202,-7.175095475
21,23,2006,118,74,-103,54,0,44,-103,-64,8554,13.743303051,8.6186815747,-11.996273,-5,0,5.1246214768,-11.996273
21,23,2007,124,82,-40,54,1,42,-39,-4,8550,14.499532273,9.5884003742,-4.677268475,-7,0.1169317119,4.911131899,-4.560336763
21,23,2008,119,79,-10,54,0,40,-10,19,8569,13.902681231,9.2295110696,-1.16829254,-11,0,4.6731701618,-1.16829254
21,25,2001,162,193,-107,400,5,-31,-102,-147,15914,10.132916341,12.071931196,-6.692728694,-14,0.3127443315,-1.939014855,-6.379984363
21,25,2002,153,188,-96,400,5,-35,-91,-139,15775,9.6563476285,11.86531604,-6.058884787,-13,0.315566916,-2.208968412,-5.743317871
21,25,2003,195,179,-83,400,3,16,-80,-81,15694,12.393148813,11.376275064,-5.275032572,-17,0.1906638279,1.0168737488,-5.084368744
21,25,2004,182,180,69,400,2,2,71,61,15755,11.57429489,11.447104836,4.388056854,-12,0.1271900537,0.1271900537,4.5152469077
21,25,2005,171,202,23,400,3,-31,26,-15,15740,10.858866487,12.827432926,1.4605492935,-10,0.1905064296,-1.968566439,1.6510557231
21,25,2006,202,184,-49,400,2,18,-47,-35,15705,12.847829544,11.702973446,-3.116552711,-6,0.1272062331,1.1448560979,-2.989346478
21,25,2007,198,197,-13,400,2,1,-11,-18,15687,12.614678899,12.5509684,-0.828236493,-8,0.127420999,0.0637104995,-0.700815494
21,25,2008,178,206,163,400,1,-28,164,126,15813,11.301587302,13.079365079,10.349206349,-10,0.0634920635,-1.777777778,10.412698413
21,27,2001,223,197,53,273,5,26,58,64,18742,11.918760021,10.529128808,2.8327097809,-20,0.2672367718,1.3896312133,3.0999465526
21,27,2002,205,191,92,273,4,14,96,94,18836,10.910639204,10.16552238,4.8964819841,-16,0.212890521,0.7451168237,5.1093725052
21,27,2003,244,225,68,273,1,19,69,67,18903,12.930920268,11.924004346,3.6036990911,-21,0.0529955749,1.0069159225,3.656694666
21,27,2004,222,227,31,273,4,-5,35,15,18918,11.739509796,12.00391317,1.6393009175,-15,0.211522699,-0.264403374,1.8508236165
21,27,2005,242,197,102,273,2,45,104,140,19058,12.74489151,10.374973668,5.3718137771,-9,0.1053296819,2.3699178428,5.477143459
21,27,2006,260,212,-138,273,3,48,-135,-98,18960,13.677731601,11.152611921,-7.25971908,-11,0.15781998,2.5251196802,-7.1018991
21,27,2007,231,202,75,273,2,29,77,81,19041,12.157574801,10.631299176,3.9472645457,-25,0.1052603879,1.5262756243,4.0525249336
21,27,2008,247,201,81,273,4,46,85,91,19132,12.941084012,10.531003589,4.2438372672,-40,0.2095722107,2.4100804233,4.4534094779
21,29,2001,705,363,575,231,3,342,578,1563,63197,11.295271207,5.8158630468,9.2124552395,643,0.0480649839,5.4794081598,9.2605202233
21,29,2002,736,369,714,231,-8,367,706,1615,64812,11.499191463,5.765219633,11.155465631,542,-0.124991212,5.7339718301,11.03047442
21,29,2003,820,384,757,231,-29,436,728,1741,66553,12.484299471,5.8463060937,11.525139877,577,-0.441517908,6.6379933772,11.083621969
21,29,2004,767,363,1346,231,20,404,1366,2361,68914,11.323791034,5.3592387814,19.871998346,591,0.295274864,5.9645522526,20.16727321
21,29,2005,716,394,1220,231,2,322,1222,2184,71098,10.227694769,5.6280890209,17.427077679,640,0.0285689798,4.5996057481,17.455646659
21,29,2006,753,413,1008,231,12,340,1020,1360,72458,10.490679595,5.7538521553,14.043300176,0,0.1671821449,4.7368274402,14.21048232
21,29,2007,838,445,1029,231,1,393,1030,1429,73887,11.452389901,6.0815196966,14.062660152,6,0.0136663364,5.370870204,14.076326489
21,29,2008,834,472,750,231,6,362,756,1141,75028,11.201020717,6.3391867844,10.072860357,23,0.0805828829,4.8618339321,10.153443239
21,31,2001,164,128,52,238,19,36,71,96,13134,12.532477457,9.78144582,3.9737123644,-11,1.4519333639,2.7510316369,5.4256457283
21,31,2002,146,132,-15,238,18,14,3,4,13138,11.114494519,10.048721072,-1.141900122,-13,1.3702801462,1.065773447,0.2283800244
21,31,2003,180,123,8,238,12,57,20,59,13197,13.670020885,9.3411809379,0.6075564838,-18,0.9113347257,4.3288399468,1.5188912094
21,31,2004,179,130,106,238,13,49,119,158,13355,13.4829768,9.792106056,7.9843326303,-10,0.9792106056,3.6908707442,8.9635432359
21,31,2005,171,147,-116,238,13,24,-103,-91,13264,12.847965739,11.044742477,-8.715579098,-12,0.9767459334,1.8032232616,-7.738833164
21,31,2006,168,117,-8,238,14,51,6,51,13315,12.641559126,8.8039429625,-0.601979006,-6,1.0534632605,3.8376161631,0.4514842545
21,31,2007,151,143,-135,238,8,8,-127,-113,13202,11.388920315,10.785533809,-10.1821473,6,0.6033865068,0.6033865068,-9.578760795
21,31,2008,162,128,28,238,8,34,36,74,13276,12.236573759,9.668403958,2.1149633658,4,0.6042752474,2.5681698013,2.7192386132
21,33,2001,98,182,-97,233,1,-84,-96,-192,12847,7.5716603569,14.061654949,-7.494398517,-12,0.0772618404,-6.489994592,-7.417136676
21,33,2002,151,161,-33,233,1,-10,-32,-54,12793,11.778471139,12.55850234,-2.574102964,-12,0.0780031201,-0.780031201,-2.496099844
21,33,2003,141,182,43,233,1,-41,44,-12,12781,11.026824118,14.233205599,3.3627903339,-15,0.0782044264,-3.206381481,3.4409947603
21,33,2004,140,176,11,233,0,-36,11,-33,12748,10.967918837,13.788240824,0.8617650515,-8,0,-2.820321987,0.8617650515
21,33,2005,142,174,69,233,1,-32,70,27,12775,11.127218587,13.634760804,5.406887905,-11,0.0783606943,-2.507542217,5.4852485993
21,33,2006,125,161,13,233,1,-36,14,-28,12747,9.7954705744,12.6165661,1.0187289397,-6,0.0783637646,-2.821095525,1.0970927043
21,33,2007,154,158,27,233,2,-4,29,19,12766,12.072276878,12.385842512,2.1165680241,-6,0.1567828166,-0.313565633,2.2733508407
21,33,2008,144,160,117,233,1,-16,118,100,12866,11.235955056,12.484394507,9.1292134831,-2,0.0780274657,-1.248439451,9.2072409488
21,35,2001,353,375,199,2996,71,-22,270,219,34393,10.296498316,10.938206426,5.8045415433,-29,2.0709670833,-0.64170811,7.8755086266
21,35,2002,341,368,-6,2996,67,-27,61,0,34393,9.9148082459,10.699851714,-0.174454104,-34,1.9480708284,-0.785043468,1.7736167243
21,35,2003,335,354,298,2996,60,-19,358,311,34704,9.6965135968,10.246465114,8.6255553787,-28,1.7366890024,-0.549951517,10.362244381
21,35,2004,359,338,315,2996,57,21,372,362,35066,10.290955998,9.6889780708,9.0296689121,-31,1.6339400889,0.6019779275,10.663609001
21,35,2005,354,302,305,2996,59,52,364,382,35448,10.040559322,8.5656749014,8.6507643872,-34,1.6734265536,1.4748844201,10.324190941
21,35,2006,365,341,436,2996,59,24,495,501,35949,10.224519238,9.5522220822,12.213398322,-18,1.6527305069,0.6722971553,13.866128829
21,35,2007,389,355,81,2996,53,34,134,167,36116,10.795809339,9.8522167488,2.2479705821,-1,1.4708943315,0.94359259,3.7188649136
21,35,2008,388,340,10,2996,53,48,63,124,36240,10.724749848,9.3979766709,0.2764110786,13,1.4649787163,1.3267731771,1.7413897949
21,37,2001,1232,841,-422,2041,66,391,-356,-43,88613,13.899779431,9.488404628,-4.761125747,-78,0.744631041,4.4113748033,-4.016494706
21,37,2002,1167,871,-592,2041,61,296,-531,-302,88311,13.192105085,9.8460355859,-6.692138998,-67,0.6895616197,3.3460694988,-6.002577378
21,37,2003,1124,890,-872,2041,48,234,-824,-658,87653,12.775340411,10.115705485,-9.911118183,-68,0.5455661385,2.6596349253,-9.365552045
21,37,2004,1129,841,-862,2041,59,288,-803,-596,87057,12.924274512,9.6273825196,-9.867780894,-81,0.6754049568,3.2968919924,-9.192375937
21,37,2005,1145,851,-363,2041,55,294,-308,-94,86963,13.159406965,9.7804850017,-4.17193426,-80,0.6321112516,3.378921963,-3.539823009
21,37,2006,1196,814,-629,2041,59,382,-570,-225,86738,13.770790036,9.372427332,-7.242330211,-37,0.679328271,4.3983627037,-6.56300194
21,37,2007,1149,847,-295,2041,54,302,-241,72,86810,13.241293475,9.7609883145,-3.399635836,11,0.6223062208,3.4803051605,-2.777329615
21,37,2008,1140,849,-151,2041,56,291,-95,228,87038,13.114904974,9.7671529152,-1.737149694,32,0.6442409461,3.3477520593,-1.092908748
21,39,2001,74,88,-5,59,1,-14,-4,-23,5319,13.882375012,16.508770284,-0.937998312,-5,0.1875996623,-2.626395272,-0.750398649
21,39,2002,57,51,-1,59,1,6,0,0,5319,10.716300056,9.5882684715,-0.188005264,-6,0.1880052641,1.1280315849,0
21,39,2003,52,63,-26,59,1,-11,-25,-42,5277,9.8150245376,11.891279728,-4.907512269,-6,0.1887504719,-2.076255191,-4.718761797
21,39,2004,61,70,28,59,0,-9,28,15,5292,11.543192355,13.246286309,5.2985145236,-4,0,-1.703093954,5.2985145236
21,39,2005,71,59,-48,59,1,12,-47,-40,5252,13.46737481,11.191198786,-9.104704097,-5,0.1896813354,2.2761760243,-8.915022762
21,39,2006,64,61,-3,59,0,3,-3,-3,5249,12.189315303,11.617941148,-0.571374155,-3,0,0.5713741548,-0.571374155
21,39,2007,63,59,-107,59,1,4,-106,-98,5151,12.115384615,11.346153846,-20.57692308,4,0.1923076923,0.7692307692,-20.38461538
21,39,2008,62,63,9,59,0,-1,9,11,5162,12.023659459,12.21758945,1.7453699215,3,0,-0.193929991,1.7453699215
21,41,2001,166,115,-46,250,7,51,-39,0,10161,16.336974707,11.317783683,-4.527113473,-12,0.688908572,5.0191910245,-3.838204901
21,41,2002,129,120,99,250,6,9,105,106,10267,12.629723908,11.74858038,9.6925788134,-8,0.587429019,0.8811435285,10.280007832
21,41,2003,154,110,6,250,4,44,10,40,10307,14.970350928,10.693107806,0.5832604258,-14,0.3888402839,4.2772431224,0.9721007096
21,41,2004,155,112,-47,250,5,43,-42,-7,10300,15.043431844,10.870092687,-4.561556753,-8,0.485271995,4.1733391566,-4.076284758
21,41,2005,158,132,93,250,5,26,98,115,10415,15.254646392,12.744388125,8.9790007241,-9,0.4827419744,2.510258267,9.4617426985
21,41,2006,149,104,-44,250,5,45,-39,1,10416,14.305602227,9.9851183333,-4.224473141,-5,0.480053766,4.3204838942,-3.744419375
21,41,2007,163,129,65,250,5,34,70,101,10517,15.573496393,12.325037023,6.2102899728,-3,0.4777146133,3.2484593704,6.6880045861
21,41,2008,158,121,62,250,5,37,67,110,10627,14.945138101,11.44532728,5.8645478623,6,0.4729474082,3.499810821,6.3374952705
21,43,2001,360,307,15,625,1,53,16,42,26918,13.384392311,11.413912332,0.557683013,-27,0.0371788675,1.9704799792,0.5948618805
21,43,2002,347,283,144,625,0,64,144,187,27105,12.846380245,10.477019047,5.3310626955,-21,0,2.369361198,5.3310626955
21,43,2003,366,272,87,625,0,94,87,138,27243,13.4687569,10.009567969,3.2015897549,-43,0,3.4591889306,3.2015897549
21,43,2004,312,311,-46,625,1,1,-45,-60,27183,11.465108588,11.428361445,-1.690368574,-16,0.0367471429,0.0367471429,-1.653621431
21,43,2005,384,274,49,625,1,110,50,141,27324,14.089933403,10.053754564,1.7979342103,-19,0.0366925349,4.0361788394,1.8346267452
21,43,2006,388,299,43,625,1,89,44,119,27443,14.169116439,10.91898406,1.5702886775,-14,0.0365183413,3.250132379,1.6068070188
21,43,2007,343,289,-54,625,1,54,-53,-19,27424,12.502961707,10.534565404,-1.968396304,-20,0.0364517834,1.9683963038,-1.93194452
21,43,2008,356,297,-1,625,1,59,0,30,27454,12.974233755,10.824009621,-0.036444477,-29,0.0364444768,2.1502241335,0
21,45,2001,197,162,102,197,21,35,123,144,15625,12.666366617,10.415996914,6.558220279,-14,1.3502218222,2.2503697036,7.9084421012
21,45,2002,198,177,132,197,20,21,152,162,15787,12.606647141,11.269578505,8.4044314275,-11,1.2733987011,1.3370686362,9.6778301286
21,45,2003,205,195,35,197,17,10,52,43,15830,12.967707246,12.335136161,2.2139987981,-19,1.0753708448,0.6325710852,3.2893696429
21,45,2004,185,189,133,197,18,-4,151,134,15964,11.637415865,11.889035667,8.3663584324,-13,1.1322891112,-0.251619802,9.4986475436
21,45,2005,194,197,97,197,18,-3,115,97,16061,12.115534738,12.302888368,6.0577673692,-15,1.1241217799,-0.18735363,7.1818891491
21,45,2006,176,177,13,197,19,-1,32,23,16084,10.950381086,11.01259916,0.8088349666,-8,1.1821434127,-0.062218074,1.9909783792
21,45,2007,190,190,25,197,16,0,41,47,16131,11.795747323,11.795747323,1.5520720161,6,0.9933260903,0,2.5453981065
21,45,2008,189,183,52,197,18,6,70,83,16214,11.686504869,11.315504715,3.2153346731,7,1.1130004638,0.3710001546,4.3283351368
21,47,2001,1595,623,-85,6354,-49,972,-134,2335,74750,21.676349676,8.4666870519,-1.15516597,1497,-0.665919206,13.209662624,-1.821085177
21,47,2002,1531,539,-423,6279,-544,992,-967,1249,75999,20.3119092,7.150959542,-5.611977526,1224,-7.217294974,13.160949658,-12.8292725
21,47,2003,1539,578,518,6317,-1549,961,-1031,1161,77160,20.096762188,7.547711855,6.7642123545,1231,-20.22734544,12.549050333,-13.46313308
21,47,2004,1315,618,-2013,6351,680,697,-1333,543,77703,16.982752497,7.9812479417,-25.99717169,1179,8.781955664,9.0015045556,-17.21521603
21,47,2005,1646,580,61,6247,-89,1066,-28,378,78081,21.131823551,7.4462075695,0.7831356237,-660,-1.142607713,13.685615981,-0.35947209
21,47,2006,1596,599,-4017,6328,334,997,-3683,378,78459,20.390954389,7.6529960394,-51.32234573,3064,4.2672799285,12.737958349,-47.0550658
21,47,2007,1407,643,1909,6328,-117,764,1792,2585,81044,17.642301399,8.0625442782,23.936853852,29,-1.467057046,9.5797571206,22.469796806
21,47,2008,1680,658,-2330,6328,66,1022,-2264,-1224,79820,20.887209071,8.1808235528,-28.96856972,18,0.8205689278,12.706385518,-28.1480008
21,49,2001,399,287,117,423,16,112,133,216,33436,11.971915506,8.6113778205,3.5105616899,-29,0.4800768123,3.360537686,3.9906385022
21,49,2002,405,331,16,423,16,74,32,74,33510,12.099303917,9.8885669047,0.4779971918,-32,0.4779971918,2.2107370119,0.9559943835
21,49,2003,436,351,238,423,12,85,250,299,33809,12.953252425,10.427962388,7.0708121036,-36,0.3565115346,2.525290037,7.4273236382
21,49,2004,450,298,278,423,15,152,293,414,34223,13.229068674,8.7605832549,8.1726246472,-31,0.4409689558,4.4684854186,8.613593603
21,49,2005,419,310,313,423,13,109,326,403,34626,12.171563857,9.0052143096,9.0923615448,-32,0.3776380194,3.1663495476,9.4699995643
21,49,2006,447,312,292,423,15,135,307,425,35051,12.830632777,8.9556094551,8.3815319259,-17,0.4305581469,3.8750233219,8.8120900728
21,49,2007,472,357,340,423,13,115,353,470,35521,13.376409908,10.117326985,9.6355495097,2,0.3684180695,3.2590829224,10.003967579
21,49,2008,460,343,17,423,15,117,32,170,35691,12.919170926,9.6332078863,0.4774476212,21,0.4212773128,3.2859630399,0.898724934
21,51,2001,311,233,-186,2179,1,78,-185,-131,24372,12.726342711,9.5345268542,-7.611253197,-24,0.0409207161,3.1918158568,-7.570332481
21,51,2002,313,229,-30,2179,1,84,-29,32,24404,12.834180745,9.3898638675,-1.23011317,-23,0.0410037723,3.4443168772,-1.189109398
21,51,2003,285,242,-277,2179,1,43,-276,-250,24154,11.738539479,9.9674615923,-11.40903662,-17,0.0411878578,1.7710778862,-11.36784876
21,51,2004,295,246,-136,2179,0,49,-136,-103,24051,12.239394254,10.206410123,-5.642568198,-16,0,2.0329841303,-5.642568198
21,51,2005,277,235,-142,2179,1,42,-141,-118,23933,11.545515172,9.7949316439,-5.918639547,-19,0.0416805602,1.7505835278,-5.876958986
21,51,2006,265,223,-176,2179,0,42,-176,-144,23789,11.105988852,9.3457943925,-7.376052973,-10,0,1.7601944596,-7.376052973
21,51,2007,298,217,-114,2179,1,81,-113,-30,23759,12.534701775,9.1276184067,-4.79515437,2,0.0420627576,3.4070833684,-4.753091613
21,51,2008,270,246,143,2179,0,24,143,171,23930,11.323365975,10.316844555,5.9971901277,4,0,1.00652142,5.9971901277
21,53,2001,130,117,-44,63,7,13,-37,-33,9598,13.521243954,12.169119559,-4.576421031,-9,0.7280669822,1.3521243954,-3.848354049
21,53,2002,115,117,-21,63,7,-2,-14,-26,9572,11.997913406,12.20657277,-2.190923318,-10,0.7303077726,-0.208659364,-1.460615545
21,53,2003,128,120,-30,63,1,8,-29,-34,9538,13.396127682,12.558869702,-3.139717425,-13,0.1046572475,0.8372579801,-3.035060178
21,53,2004,134,132,-36,63,4,2,-32,-37,9501,14.076369557,13.866274489,-3.781711224,-7,0.420190136,0.210095068,-3.361521088
21,53,2005,107,124,-28,63,3,-17,-25,-50,9451,11.291684255,13.085690165,-2.954833263,-8,0.3165892782,-1.79400591,-2.638243985
21,53,2006,131,142,12,63,4,-11,16,0,9451,13.860967093,15.024865094,1.2697069093,-5,0.4232356364,-1.163898,1.6929425458
21,53,2007,140,123,67,63,1,17,68,89,9540,14.743826023,12.953504292,7.0559738824,4,0.105313043,1.7903217313,7.1612869254
21,53,2008,123,134,35,63,3,-11,38,28,9568,12.874188821,14.025539041,3.663387063,1,0.3140046054,-1.15135022,3.9773916684
21,55,2001,108,131,-90,131,1,-23,-89,-119,9285,11.557600728,14.018941623,-9.63133394,-7,0.1070148216,-2.461340896,-9.524319118
21,55,2002,71,144,-35,131,0,-73,-35,-116,9169,7.6948087136,15.606372602,-3.793215563,-8,0,-7.911563889,-3.793215563
21,55,2003,97,117,23,131,0,-20,23,-9,9160,10.58431993,12.766653936,2.5096841072,-12,0,-2.182334006,2.5096841072
21,55,2004,81,117,-86,131,1,-36,-85,-129,9031,8.9055027211,12.863503931,-9.455225111,-8,0.109944478,-3.958001209,-9.345280633
21,55,2005,113,113,-5,131,1,0,-4,-12,9019,12.520775623,12.520775623,-0.55401662,-8,0.1108033241,0,-0.443213296
21,55,2006,115,119,117,131,1,-4,118,108,9127,12.67496969,13.115838201,12.895403946,-6,0.1102171277,-0.440868511,13.005621074
21,55,2007,115,126,18,131,1,-11,19,6,9133,12.595837897,13.800657174,1.9715224535,-2,0.1095290252,-1.204819277,2.0810514786
21,55,2008,109,115,111,131,1,-6,112,111,9244,11.862654405,12.515644556,12.080317789,5,0.1088316918,-0.652990151,12.18914948
21,57,2001,74,118,18,108,1,-44,19,-33,7130,10.354719093,16.511579095,2.5187154551,-8,0.1399286364,-6.156860001,2.6586440915
21,57,2002,90,96,-4,108,1,-6,-3,-14,7116,12.635125649,13.477467359,-0.56156114,-5,0.140390285,-0.84234171,-0.421170855
21,57,2003,85,90,-23,108,1,-5,-22,-38,7078,11.976891644,12.681414682,-3.240805974,-11,0.1409046076,-0.704523038,-3.099901367
21,57,2004,88,89,23,108,0,-1,23,17,7095,12.417977845,12.55909123,3.2456078459,-5,0,-0.141113385,3.2456078459
21,57,2005,73,97,-117,108,1,-24,-116,-145,6950,10.395158419,13.812744749,-16.66073336,-5,0.1423994304,-3.41758633,-16.51833393
21,57,2006,79,108,33,108,0,-29,33,1,6951,11.366088771,15.538450471,4.7478598662,-3,0,-4.172361701,4.7478598662
21,57,2007,88,95,-80,108,1,-7,-79,-83,6868,12.736087995,13.749185903,-11.57826181,3,0.1447282727,-1.013097909,-11.43353354
21,57,2008,76,94,-33,108,0,-18,-33,-51,6817,11.107051516,13.737668981,-4.822798685,0,0,-2.630617464,-4.822798685
21,59,2001,1342,928,-406,2595,37,414,-369,-36,91570,14.652574573,10.132331747,-4.432895139,-81,0.4039830545,4.5202428266,-4.028912085
21,59,2002,1329,928,-348,2595,32,401,-316,8,91578,14.512852993,10.133880796,-3.800205298,-77,0.3494441654,4.3789721973,-3.450761133
21,59,2003,1276,866,127,2595,21,410,148,427,92005,13.901069271,9.4344247561,1.3835703742,-131,0.2287793532,4.466644515,1.6123497274
21,59,2004,1349,905,-222,2595,33,444,-189,187,92192,14.647361249,9.8264358269,-2.410462711,-68,0.3583120246,4.8209254222,-2.052150686
21,59,2005,1331,914,-126,2595,29,417,-97,235,92427,14.418884297,9.9014727628,-1.364973269,-85,0.3141605144,4.517411534,-1.050812755
21,59,2006,1310,889,193,2595,32,421,225,602,93029,14.127340178,9.5871797084,2.0813562247,-44,0.3450953326,4.5401604693,2.4264515572
21,59,2007,1376,933,180,2595,28,443,208,661,93690,14.738725036,9.9936267868,1.9280308913,10,0.2999159164,4.7450982492,2.2279468078
21,59,2008,1374,926,196,2595,30,448,226,728,94418,14.608629085,9.8454079571,2.0839092436,54,0.3189657006,4.7632211283,2.4028749442
21,61,2001,135,94,41,160,4,41,45,75,11729,11.546850276,8.040029081,3.5068211949,-11,0.3421288971,3.5068211949,3.8489500919
21,61,2002,138,129,16,160,4,9,20,17,11746,11.757188498,10.990415335,1.3631522897,-12,0.3407880724,0.7667731629,1.7039403621
21,61,2003,121,108,24,160,4,13,28,26,11772,10.289990645,9.1844544604,2.0409898801,-15,0.34016498,1.105536185,2.3811548601
21,61,2004,123,113,-25,160,3,10,-22,-20,11752,10.457405203,9.6072096582,-2.125488862,-8,0.2550586635,0.850195545,-1.870430199
21,61,2005,127,110,156,160,4,17,160,166,11918,10.730882974,9.2944655682,13.181242079,-11,0.3379805661,1.436417406,13.519222645
21,61,2006,117,115,-50,160,3,2,-47,-49,11869,9.8373060916,9.6691470131,-4.203976962,-4,0.2522386177,0.1681590785,-3.951738344
21,61,2007,115,116,79,160,3,-1,82,84,11953,9.654940811,9.7388968181,6.6325245571,3,0.2518680212,-0.083956007,6.8843925783
21,61,2008,122,108,116,160,2,14,118,132,12085,10.150594891,8.9857725268,9.6513853066,0,0.1664031949,1.1648223646,9.8177885015
21,63,2001,87,77,-70,57,1,10,-69,-66,6706,12.909927289,11.426027601,-10.38729782,-7,0.1483899688,1.4838996884,-10.23890785
21,63,2002,78,65,1,57,1,13,2,8,6714,11.624441133,9.6870342772,0.1490312966,-7,0.1490312966,1.9374068554,0.2980625931
21,63,2003,77,60,69,57,1,17,70,85,6799,11.396433064,8.8803374528,10.212388071,-2,0.1480056242,2.5160956116,10.360393695
21,63,2004,81,89,-21,57,0,-8,-21,-34,6765,11.943379534,13.122972574,-3.096431731,-5,0,-1.17959304,-3.096431731
21,63,2005,81,71,116,57,1,10,117,126,6891,11.862917399,10.398359695,16.988869361,-1,0.1464557704,1.4645577036,17.135325132
21,63,2006,77,76,200,57,0,1,200,196,7087,11.01731292,10.874230934,28.616397196,-5,0,0.143081986,28.616397196
21,63,2007,85,86,76,57,1,-1,77,48,7135,11.95331177,12.093938968,10.687666995,-28,0.1406271973,-0.140627197,10.828294192
21,63,2008,80,91,194,57,0,-11,194,145,7280,11.099549081,12.625737079,26.916406521,-38,0,-1.526187999,26.916406521
21,65,2001,220,163,-35,139,1,57,-34,8,15317,14.366877816,10.644550382,-2.285639653,-15,0.0653039901,3.7223274342,-2.220335663
21,65,2002,200,199,-66,139,1,1,-65,-81,15236,13.092004059,13.026544038,-4.320361339,-17,0.0654600203,0.0654600203,-4.254901319
21,65,2003,184,176,-163,139,1,8,-162,-171,15065,12.144813703,11.616778324,-10.75872083,-17,0.0660044223,0.5280353784,-10.69271641
21,65,2004,201,162,-109,139,1,39,-108,-80,14985,13.377703827,10.78202995,-7.254575707,-11,0.0665557404,2.5956738769,-7.188019967
21,65,2005,193,175,-124,139,1,18,-123,-119,14866,12.930890087,11.724900338,-8.307929383,-14,0.0669994305,1.2059897491,-8.240929952
21,65,2006,201,169,28,139,1,32,29,55,14921,13.495820324,11.347232014,1.8800147715,-6,0.0671433847,2.1485883103,1.9471581562
21,65,2007,180,170,24,139,0,10,24,31,14952,12.051015968,11.381515081,1.606802129,-3,0,0.6695008871,1.606802129
21,65,2008,191,190,-7,139,0,1,-7,-4,14948,12.775919732,12.7090301,-0.468227425,2,0,0.0668896321,-0.468227425
21,67,2001,3758,1958,-716,12692,1184,1800,468,2020,263188,14.333773238,7.4682086216,-2.730969036,-248,4.5160158366,6.8655646164,1.7850468003
21,67,2002,3608,2093,-1343,12697,1109,1515,-234,1065,264253,13.681151067,7.9364327005,-5.092512717,-216,4.2052096822,5.7447183666,-0.887303035
21,67,2003,3685,1964,763,12693,972,1721,1735,3110,267363,13.863390116,7.38879191,2.8704929874,-346,3.6567748149,6.4745982062,6.5272678023
21,67,2004,3883,1930,-956,12691,902,1953,-54,1695,269058,14.477434701,7.1958405804,-3.564364557,-204,3.3630301573,7.281594121,-0.2013344
21,67,2005,3876,1910,-186,12696,945,1966,759,2481,271539,14.339702218,7.0662619289,-0.688128125,-244,3.4961348287,7.2734402892,2.8080067037
21,67,2006,3928,1995,918,12693,951,1933,1869,3660,275199,14.368856747,7.2978282102,3.3580983945,-142,3.4788143498,7.0710285365,6.8369127443
21,67,2007,3998,1970,223,12702,858,2028,1081,3088,278287,14.446616536,7.1185179029,0.8058017728,-21,3.1003494217,7.328098633,3.9061511944
21,67,2008,4027,2040,912,12702,862,1987,1774,3827,282114,14.371851585,7.280500927,3.2548121791,66,3.076368529,7.0913506578,6.3311807081
21,69,2001,166,142,205,121,0,24,205,220,14076,11.886008879,10.167549764,14.678504941,-9,0,1.718459115,14.678504941
21,69,2002,203,149,52,121,-1,54,51,91,14167,14.375243423,10.551287045,3.6823283646,-14,-0.070814007,3.8239563786,3.6115143575
21,69,2003,184,160,181,121,-1,24,180,196,14363,12.89870312,11.216263582,12.688398177,-8,-0.070101647,1.6824395373,12.61829653
21,69,2004,187,151,59,121,0,36,59,84,14447,12.98160361,10.482471364,4.0958000694,-11,0,2.4991322457,4.0958000694
21,69,2005,168,178,59,121,0,-10,59,37,14484,11.613839826,12.305139815,4.0786699388,-12,0,-0.69129999,4.0786699388
21,69,2006,193,147,-57,121,0,46,-57,-18,14466,13.333333333,10.155440415,-3.937823834,-7,0,3.1778929188,-3.937823834
21,69,2007,194,159,152,121,0,35,152,193,14659,13.321888412,10.918454936,10.43776824,6,0,2.4034334764,10.43776824
21,69,2008,195,147,22,121,0,48,22,76,14735,13.26801388,10.002041233,1.4969041301,6,0,3.2659726475,1.4969041301
21,71,2001,522,482,-268,1043,2,40,-266,-260,42119,12.355322019,11.408554049,-6.343345405,-34,0.0473383985,0.9467679708,-6.296007006
21,71,2002,549,483,38,1043,2,66,40,67,42186,13.024138545,11.458395113,0.9014886424,-39,0.0474467707,1.5657434316,0.9489354131
21,71,2003,541,488,-139,1043,1,53,-138,-141,42045,12.845626907,11.587182866,-3.300447579,-56,0.0237442272,1.2584440408,-3.276703351
21,71,2004,610,543,-32,1043,2,67,-30,12,42057,14.506194859,12.912891489,-0.760980714,-25,0.0475612946,1.5933033697,-0.713419419
21,71,2005,530,467,-86,1043,2,63,-84,-54,42003,12.610040447,11.111111111,-2.046157507,-33,0.0475850583,1.4989293362,-1.998572448
21,71,2006,543,493,-80,1043,2,50,-78,-48,41955,12.935038948,11.743967222,-1.905714762,-20,0.0476428691,1.1910717263,-1.858071893
21,71,2007,569,501,11,1043,2,68,13,61,42016,13.552297817,11.932691048,0.2619952126,-20,0.0476354932,1.619606769,0.3096307058
21,71,2008,553,499,31,1043,2,54,33,78,42094,13.149447153,11.865414338,0.7371299489,-9,0.0475567709,1.2840328142,0.7846867198
21,73,2001,617,450,73,1825,68,167,141,263,48116,12.858318832,9.3780283216,1.5213245944,-45,1.4171242797,3.4802905105,2.9384488741
21,73,2002,592,473,-72,1825,64,119,-8,64,48180,12.295422447,9.8238763812,-1.495389217,-47,1.3292348592,2.4715460663,-0.166154357
21,73,2003,609,506,-195,1825,44,103,-151,-106,48074,12.654019573,10.513848775,-4.051779666,-58,0.9142477196,2.1401707981,-3.137531947
21,73,2004,613,460,83,1825,57,153,140,262,48336,12.716523182,9.5425785707,1.7218130899,-31,1.1824499533,3.1739446116,2.9042630433
21,73,2005,621,485,-106,1825,54,136,-52,44,48380,12.841722156,10.029364324,-2.19198478,-40,1.1166714918,2.8123578312,-1.075313288
21,73,2006,646,485,-190,1825,57,161,-133,5,48385,13.351935101,10.02428564,-3.927039735,-23,1.1781119206,3.32764946,-2.748927815
21,73,2007,618,446,-186,1825,46,172,-140,33,48418,12.768199333,9.2145904569,-3.84285611,1,0.9503837691,3.5536088758,-2.892472341
21,73,2008,614,487,238,1825,49,127,287,426,48844,12.625691431,10.014188481,4.8939976558,12,1.0075877527,2.6115029508,5.9015854085
21,75,2001,104,109,72,258,0,-5,72,62,7759,13.457556936,14.104554865,9.3167701863,-5,0,-0.64699793,9.3167701863
21,75,2002,95,119,-161,258,-1,-24,-162,-189,7570,12.394807228,15.526126949,-21.00593646,-3,-0.130471655,-3.131319721,-21.13640812
21,75,2003,86,118,-102,258,-1,-32,-103,-138,7432,11.465137982,15.731235835,-13.59818691,-3,-0.133315558,-4.266097854,-13.73150247
21,75,2004,75,94,-126,258,0,-19,-126,-154,7278,10.197144799,12.780421482,-17.13120326,-9,0,-2.583276683,-17.13120326
21,75,2005,88,123,-146,258,0,-35,-146,-185,7093,12.24688609,17.117806694,-20.31869738,-4,0,-4.870920604,-20.31869738
21,75,2006,84,107,-212,258,0,-23,-212,-237,6856,12.043874113,15.341601548,-30.39644419,-2,0,-3.297727436,-30.39644419
21,75,2007,84,108,-35,258,0,-24,-35,-60,6796,12.305889247,15.821857603,-5.127453853,-1,0,-3.515968356,-5.127453853
21,75,2008,74,95,85,258,0,-21,85,59,6855,10.841696579,13.918394257,12.453300125,-5,0,-3.076697678,12.453300125
21,77,2001,106,75,75,106,0,31,75,101,7985,13.359379923,9.452391455,9.452391455,-5,0,3.9069884681,9.452391455
21,77,2002,113,93,-167,106,0,20,-167,-151,7834,14.286617359,11.758012517,-21.11385043,-4,0,2.5286048423,-21.11385043
21,77,2003,111,80,131,106,-1,31,130,158,7992,14.027549602,10.109945659,16.555036017,-3,-0.126374321,3.9176039429,16.428661696
21,77,2004,142,91,-56,106,0,51,-56,-13,7979,17.782230292,11.395654624,-7.012710538,-8,0,6.3865756684,-7.012710538
21,77,2005,153,93,10,106,0,60,10,64,8043,19.098739234,11.609037573,1.24828361,-6,0,7.4897016602,1.24828361
21,77,2006,145,66,-82,106,0,79,-82,-6,8037,18.034825871,8.2089552239,-10.19900498,-3,0,9.8258706468,-10.19900498
21,77,2007,140,77,-48,106,0,63,-48,15,8052,17.403194729,9.5717571011,-5.966809621,0,0,7.8314376282,-5.966809621
21,77,2008,126,84,-25,106,0,42,-25,19,8071,15.629845562,10.419897041,-3.101159834,2,0,5.2099485207,-3.101159834
21,79,2001,187,135,194,98,20,52,214,255,15122,12.471239454,9.0033012104,12.938077295,-11,1.3338224015,3.467938244,14.271899697
21,79,2002,149,124,383,98,20,25,403,425,15547,9.7166519939,8.0863412566,24.976360494,-3,1.3042485898,1.6303107372,26.280609084
21,79,2003,204,130,204,98,17,74,221,287,15834,13.001497722,8.2852681559,13.001497722,-8,1.0834581435,4.7162295657,14.084955865
21,79,2004,156,141,154,98,13,15,167,168,16002,9.8002261591,8.8578967207,9.6745822339,-14,0.8166855133,0.9423294384,10.491267747
21,79,2005,170,134,346,98,15,36,361,382,16384,10.49836349,8.2751806336,21.367257457,-15,0.9263261903,2.2231828568,22.293583647
21,79,2006,175,142,258,98,14,33,272,297,16681,10.585210948,8.5891425979,15.605625284,-8,0.8468168759,1.9960683502,16.452442159
21,79,2007,205,138,229,98,11,67,240,309,16990,12.17665053,8.1969647471,13.602209617,2,0.653381248,3.979685783,14.255590865
21,79,2008,193,141,-37,98,10,52,-27,31,17021,11.349269354,8.2914351239,-2.175766664,6,0.5880450443,3.0578342301,-1.587721619
21,81,2001,375,214,402,179,10,161,412,561,23108,16.427554485,9.3746577593,17.610338408,-12,0.4380681196,7.0528967254,18.048406527
21,81,2002,389,196,225,179,9,193,234,411,23519,16.685611341,8.4071460742,9.6510605443,-16,0.3860424218,8.2784652669,10.037102966
21,81,2003,364,186,210,179,8,178,218,376,23895,15.354114818,7.8457839457,8.8581431645,-20,0.3374530729,7.5083308727,9.1955962374
21,81,2004,396,175,108,179,8,221,116,319,24214,16.462616143,7.2751460226,4.4898044025,-18,0.3325781039,9.1874701199,4.8223825064
21,81,2005,390,187,20,179,9,203,29,212,24426,16.036184211,7.6891447368,0.8223684211,-20,0.3700657895,8.3470394737,1.1924342105
21,81,2006,440,206,135,179,9,234,144,364,24790,17.880364109,8.3712613784,5.4860208062,-14,0.3657347204,9.5091027308,5.8517555267
21,81,2007,405,203,173,179,8,202,181,379,25169,16.213294902,8.1266638644,6.9256790568,-4,0.3202626153,8.0866310375,7.2459416722
21,81,2008,404,209,176,179,8,195,184,380,25549,15.931227572,8.2416499073,6.9403367641,1,0.3154698529,7.6895776647,7.255806617
21,83,2001,505,459,-187,765,70,46,-117,-103,36981,13.636670492,12.394518328,-5.049618578,-32,1.8902315534,1.2421521636,-3.159387025
21,83,2002,478,451,-93,765,66,27,-27,-36,36945,12.93185077,12.20139058,-2.516029543,-36,1.7855693531,0.7304601899,-0.73046019
21,83,2003,480,446,115,765,60,34,175,161,37106,12.964038298,12.045752252,3.1059675089,-48,1.6205047872,0.9182860461,4.7264722961
21,83,2004,474,484,-66,765,53,-10,-13,-51,37055,12.78299915,13.052682677,-1.779911274,-28,1.4293226898,-0.269683526,-0.350588584
21,83,2005,478,418,90,765,55,60,145,173,37228,12.869701008,11.254257367,2.4231654618,-32,1.4808233378,1.6154436412,3.9039887996
21,83,2006,443,419,-36,765,55,24,19,24,37252,11.895810956,11.251342642,-0.96670247,-19,1.4769065521,0.6444683136,0.5102040816
21,83,2007,508,447,135,765,53,61,188,232,37484,13.594519375,11.962106615,3.612716763,-17,1.4183258403,1.6324127596,5.0310426033
21,83,2008,472,436,-78,765,52,36,-26,3,37487,12.591535394,11.63116405,-2.080804578,-7,1.3872030518,0.9603713436,-0.693601526
21,85,2001,351,315,41,324,4,36,45,57,24173,14.537472302,13.046449502,1.6981093003,-24,0.1656692,1.4910228002,1.8637785003
21,85,2002,285,282,61,324,3,3,64,45,24218,11.779049823,11.655059825,2.5211299622,-22,0.1239899981,0.1239899981,2.6451199603
21,85,2003,297,251,346,324,0,46,346,380,24598,12.168141593,10.283513602,14.175680105,-12,0,1.8846279908,14.175680105
21,85,2004,327,266,252,324,5,61,257,295,24893,13.214523853,10.749429189,10.183669758,-23,0.2020569396,2.4650946637,10.385726698
21,85,2005,329,258,140,324,3,71,143,193,25086,13.165529522,10.324336221,5.6023529883,-21,0.1200504212,2.8411933012,5.7224034094
21,85,2006,343,258,51,324,5,85,56,128,25214,13.638170974,10.258449304,2.027833002,-13,0.1988071571,3.37972167,2.226640159
21,85,2007,321,298,82,324,2,23,84,97,25311,12.706580901,11.796140524,3.2459178624,-10,0.0791687284,0.9104403761,3.3250865908
21,85,2008,337,271,114,324,4,66,118,186,25497,13.26562746,10.6676114,4.4874822863,2,0.1574555188,2.5980160605,4.6449378051
21,87,2001,130,131,61,161,2,-1,63,52,11601,11.231101512,11.3174946,5.2699784017,-10,0.1727861771,-0.086393089,5.4427645788
21,87,2002,145,135,-10,161,1,10,-9,-11,11590,12.50485102,11.642447501,-0.862403519,-12,0.0862403519,0.8624035186,-0.776163167
21,87,2003,126,168,72,161,-1,-42,71,20,11610,10.862068966,14.482758621,6.2068965517,-9,-0.086206897,-3.620689655,6.1206896552
21,87,2004,132,140,-127,161,5,-8,-122,-142,11468,11.439466158,12.132767138,-11.00615305,-12,0.4333131121,-0.693300979,-10.57283993
21,87,2005,122,122,14,161,2,0,16,5,11473,10.635979251,10.635979251,1.2205222091,-11,0.1743603156,0,1.3948825247
21,87,2006,116,125,56,161,4,-9,60,46,11519,10.090466249,10.873347251,4.8712595685,-5,0.347947112,-0.782881002,5.2192066806
21,87,2007,131,161,56,161,2,-30,58,29,11548,11.358217367,13.959335848,4.8554211644,1,0.1734078987,-2.601118481,5.0288290632
21,87,2008,125,131,66,161,4,-6,70,65,11613,10.794007167,11.312119511,5.6992357843,1,0.3454082294,-0.518112344,6.0446440136
21,89,2001,437,399,65,447,0,38,65,65,36897,11.854222897,10.823420906,1.7632139321,-38,0,1.0308019911,1.7632139321
21,89,2002,369,417,-27,447,0,-48,-27,-112,36785,10.016014766,11.318910996,-0.732879129,-37,0,-1.30289623,-0.732879129
21,89,2003,420,392,170,447,-3,28,167,151,36936,11.394310983,10.634690251,4.6119830171,-44,-0.081387936,0.7596207322,4.5305950815
21,89,2004,432,410,-8,447,1,22,-7,-10,36926,11.697489914,11.101784409,-0.216620184,-25,0.0270775229,0.5957055049,-0.189542661
21,89,2005,446,384,8,447,-1,62,7,34,36960,12.072652465,10.39439136,0.21654982,-35,-0.027068727,1.6782611049,0.1894810925
21,89,2006,421,397,118,447,0,24,118,125,37085,11.371463299,10.723208859,3.187250996,-17,0,0.6482544399,3.187250996
21,89,2007,384,395,160,447,-1,-11,159,153,37238,10.333275029,10.629280304,4.3055312622,5,-0.02690957,-0.296005274,4.2786216918
21,89,2008,431,415,127,447,1,16,128,150,37388,11.550933991,11.122129017,3.4036394822,6,0.0268003109,0.4288049741,3.4304397931
21,91,2001,126,64,-39,72,2,62,-37,15,8436,14.949279231,7.5932846889,-4.627157857,-10,0.2372901465,7.3559945423,-4.389867711
21,91,2002,110,83,-20,72,2,27,-18,1,8437,13.038582351,9.8382030463,-2.370651336,-8,0.2370651336,3.2003793042,-2.133586203
21,91,2003,109,77,-22,72,2,32,-20,1,8438,12.918518519,9.1259259259,-2.607407407,-11,0.237037037,3.7925925926,-2.37037037
21,91,2004,115,69,-65,72,1,46,-64,-25,8413,13.6490416,8.1894249599,-7.714675687,-7,0.1186873183,5.45961664,-7.595988369
21,91,2005,127,76,81,72,2,51,83,125,8538,14.984366704,8.9670225945,9.5569582915,-9,0.2359742788,6.0173441095,9.7929325703
21,91,2006,114,68,-31,72,1,46,-30,13,8551,13.341915852,7.9583357715,-3.628064837,-3,0.1170343496,5.3835800808,-3.511030487
21,91,2007,104,74,-10,72,1,30,-9,22,8573,12.146694698,8.6428404578,-1.167951413,1,0.1167951413,3.5038542397,-1.051156272
21,91,2008,123,79,43,72,0,44,43,90,8663,14.272453005,9.1668600603,4.9895567417,3,0,5.105592945,4.9895567417
21,93,2001,1464,713,-325,3923,71,751,-254,410,94700,15.492883221,7.545372771,-3.439335415,-87,0.751362506,7.9475104503,-2.687972909
21,93,2002,1402,695,-61,3923,-234,707,-295,320,95020,14.779675311,7.3265865486,-0.64305292,-92,-2.466793169,7.4530887624,-3.109846089
21,93,2003,1524,659,361,3923,-856,865,-495,251,95271,16.017573085,6.926234031,3.7941889002,-119,-8.996747087,9.0913390544,-5.202558187
21,93,2004,1433,676,-935,3923,487,757,-448,218,95489,15.02411407,7.0874397148,-9.802893688,-91,5.1058922206,7.9366743552,-4.697001468
21,93,2005,1575,679,401,3923,25,896,426,1230,96719,16.388495796,7.0652626321,4.1725630567,-92,0.2601348539,9.3232331641,4.4326979106
21,93,2006,1588,753,-793,3923,274,835,-519,273,96992,16.395558332,7.774468151,-8.187454507,-43,2.8289565383,8.6210901807,-5.358497969
21,93,2007,1611,721,33,3923,-2,890,31,932,97924,16.530197624,7.3980586509,0.3386074001,11,-0.020521661,9.1321389727,0.3180857395
21,93,2008,1561,739,-339,3923,109,822,-230,622,98546,15.890466738,7.5227770143,-3.450908536,30,1.1095841604,8.3676897236,-2.341324375
21,95,2001,392,430,-533,377,11,-38,-522,-584,32416,11.984835514,13.146630794,-16.29570747,-24,0.3363091598,-1.161795279,-15.95939831
21,95,2002,397,461,1,377,10,-64,11,-87,32329,12.263495251,14.24048189,0.0308904162,-34,0.3089041625,-1.97698664,0.3397945787
21,95,2003,407,406,-514,377,6,1,-508,-522,31807,12.691779968,12.660596233,-16.02843957,-15,0.1871024074,0.0311837346,-15.84133716
21,95,2004,375,451,-437,377,7,-76,-430,-536,31271,11.890040902,14.299755858,-13.855861,-30,0.2219474302,-2.409714956,-13.63391357
21,95,2005,364,447,-102,377,7,-83,-95,-207,31064,11.678832117,14.341862517,-3.272639769,-29,0.2245929253,-2.6630304,-3.048046844
21,95,2006,452,431,2,377,7,21,9,16,31080,14.546858908,13.871009269,0.0643666323,-14,0.2252832132,0.6758496395,0.2896498455
21,95,2007,403,400,-19,377,6,3,-13,-9,31071,12.968415633,12.871876559,-0.611414137,1,0.1930781484,0.0965390742,-0.418335988
21,95,2008,387,423,-271,377,6,-36,-265,-288,30783,12.51333786,13.677369289,-8.762569923,13,0.1940052381,-1.164031429,-8.568564685
21,97,2001,224,195,-29,236,2,29,-27,-15,18009,12.433047484,10.823411872,-1.609635612,-17,0.1110093525,1.6096356118,-1.498626259
21,97,2002,234,191,-49,236,0,43,-49,-23,17986,13.001805806,10.612585081,-2.722600361,-17,0,2.3892207251,-2.722600361
21,97,2003,228,201,127,236,-3,27,124,129,18115,12.631229052,11.135425611,7.0358161824,-22,-0.166200382,1.4958034403,6.8696158001
21,97,2004,214,176,5,236,5,38,10,36,18151,11.801687531,9.7060607732,0.2757403629,-12,0.2757403629,2.0956267578,0.5514807257
21,97,2005,227,194,34,236,2,33,36,53,18204,12.487965892,10.672534727,1.8704442305,-16,0.1100261312,1.8154311649,1.9804703617
21,97,2006,228,199,82,236,4,29,86,106,18310,12.488360629,10.899928794,4.4914279454,-9,0.2190940461,1.5884318344,4.7105219916
21,97,2007,236,197,171,236,1,39,172,210,18520,12.815639424,10.697800706,9.285908227,-1,0.0543035569,2.1178387184,9.3402117839
21,97,2008,238,186,75,236,3,52,78,134,18654,12.80464841,10.006994136,4.0350782805,4,0.1614031312,2.7976542745,4.1964814117
21,99,2001,222,207,-237,244,7,15,-230,-227,17305,12.745069897,11.883916526,-13.60622327,-12,0.4018715733,0.8611533714,-13.2043517
21,99,2002,228,176,249,244,7,52,256,299,17604,13.062534017,10.083359592,14.26566215,-9,0.401042711,2.9791744249,14.666704861
21,99,2003,237,166,117,244,3,71,120,172,17776,13.397399661,9.3838326738,6.6139061617,-19,0.1695873375,4.013566987,6.7834934992
21,99,2004,241,205,71,244,4,36,75,96,17872,13.521095153,11.501346499,3.9833931777,-15,0.2244165171,2.0197486535,4.2078096948
21,99,2005,226,201,214,244,4,25,218,229,18101,12.56497929,11.175047953,11.897812248,-14,0.222389014,1.3899313374,12.120201262
21,99,2006,236,206,97,244,4,30,101,122,18223,12.994163638,11.342363176,5.3408214954,-9,0.2202400617,1.6518004625,5.5610615571
21,99,2007,238,199,93,244,4,39,97,131,18354,13.013642453,10.881154824,5.0851628072,-5,0.2187166799,2.1324876288,5.3038794871
21,99,2008,241,180,138,244,4,61,142,207,18561,13.05702289,9.7521332792,7.476635514,4,0.2167140729,3.3048896113,7.6933495869
21,101,2001,580,441,-148,822,23,139,-125,-31,44784,12.946573064,9.8438598645,-3.303608299,-45,0.513398587,3.1027131999,-2.790209712
21,101,2002,580,448,40,822,23,132,63,153,44937,12.928968692,9.9865137482,0.8916530132,-42,0.5127004826,2.9424549437,1.4043534958
21,101,2003,594,402,-133,822,18,192,-115,15,44952,13.216300103,8.9443647165,-2.959205242,-62,0.4004939425,4.271935387,-2.558711299
21,101,2004,657,464,-99,822,18,193,-81,81,45033,14.602433739,10.312829916,-2.200366728,-31,0.4000666778,4.2896038229,-1.80030005
21,101,2005,596,438,-62,822,19,158,-43,74,45107,13.223873974,9.7182161083,-1.375637897,-41,0.4215664522,3.5056578655,-0.954071444
21,101,2006,621,427,-174,822,19,194,-155,19,45126,13.764365587,9.4643866435,-3.856682145,-20,0.4211319584,4.2999789434,-3.435550187
21,101,2007,602,463,-105,822,18,139,-87,57,45183,13.332004562,10.253684572,-2.325349633,5,0.3986313656,3.0783199903,-1.926718267
21,101,2008,618,440,58,822,18,178,76,279,45462,13.635611451,9.7082023278,1.2797175796,25,0.3971537316,3.9274091235,1.6768713112
21,103,2001,223,159,54,61,17,64,71,120,15216,14.713644761,10.490894695,3.5629453682,-15,1.1216679863,4.222750066,4.6846133544
21,103,2002,195,161,-3,61,16,34,13,32,15248,12.801995798,10.569852941,-0.196953782,-15,1.0504201681,2.2321428571,0.8534663866
21,103,2003,222,153,107,61,10,69,117,172,15420,14.477631407,9.977827051,6.9779574801,-14,0.6521455589,4.4998043563,7.630103039
21,103,2004,192,135,41,61,11,57,52,97,15517,12.412321815,8.7274137764,2.6505478876,-12,0.711122604,3.6849080389,3.3616704916
21,103,2005,208,167,24,61,11,41,35,61,15578,13.378356649,10.741276733,1.5436565364,-15,0.7075092459,2.6370799164,2.2511657823
21,103,2006,197,135,33,61,11,62,44,98,15676,12.606386383,8.6388942215,2.1117296986,-8,0.7039098995,3.967492161,2.8156395981
21,103,2007,192,150,-53,61,9,42,-44,-9,15667,12.251539419,9.5715151709,-3.38193536,-7,0.5742909103,2.6800242478,-2.80764445
21,103,2008,199,153,28,61,9,46,37,74,15741,12.671930718,9.742740703,1.7829852267,-9,0.5731023943,2.9291900153,2.356087621
21,105,2001,45,62,6,151,1,-17,7,-14,5234,8.5861476817,11.829803473,1.1448196909,-4,0.1908032818,-3.243655791,1.3356229727
21,105,2002,57,74,3,151,1,-17,4,-18,5216,10.909090909,14.162679426,0.5741626794,-5,0.1913875598,-3.253588517,0.7655502392
21,105,2003,55,65,-38,151,1,-10,-37,-52,5164,10.597302505,12.524084778,-7.32177264,-5,0.1926782274,-1.926782274,-7.129094412
21,105,2004,53,72,-76,151,0,-19,-76,-100,5064,10.36370747,14.078998827,-14.86116543,-5,0,-3.715291357,-14.86116543
21,105,2005,53,68,-25,151,1,-15,-24,-43,5021,10.510659395,13.485374318,-4.957858205,-4,0.1983143282,-2.974714923,-4.759543877
21,105,2006,33,64,-40,151,0,-31,-40,-73,4948,6.6205236232,12.839803391,-8.024877119,-2,0,-6.219279767,-8.024877119
21,105,2007,49,49,-17,151,1,0,-16,-16,4932,9.9190283401,9.9190283401,-3.441295547,0,0.2024291498,0,-3.238866397
21,105,2008,49,70,25,151,0,-21,25,4,4936,9.9310903932,14.18727199,5.0668828537,0,0,-4.256181597,5.0668828537
21,107,2001,588,548,-402,805,12,40,-390,-384,46074,12.709116846,11.844551074,-8.688886007,-34,0.2593697316,0.8645657718,-8.429516275
21,107,2002,579,577,178,805,12,2,190,148,46222,12.546589235,12.503250412,3.8571552397,-44,0.2600329375,0.0433388229,4.1171881772
21,107,2003,529,579,283,805,8,-50,291,186,46408,11.421785599,12.501349455,6.1103314261,-55,0.172730217,-1.079563856,6.2830616431
21,107,2004,605,565,-6,805,12,40,6,15,46423,13.034438927,12.172657841,-0.129267163,-31,0.2585343258,0.8617810861,0.1292671629
21,107,2005,585,571,-192,805,10,14,-182,-210,46213,12.630079019,12.327820718,-4.145256704,-42,0.2158987866,0.3022583013,-3.929357917
21,107,2006,616,594,55,805,12,22,67,67,46280,13.319926913,12.844215238,1.1892791887,-22,0.2594790957,0.4757116755,1.4487582844
21,107,2007,610,554,-112,805,9,56,-103,-33,46247,13.185340495,11.974883007,-2.420914976,14,0.1945378106,1.2104574881,-2.226377166
21,107,2008,585,553,22,805,11,32,33,91,46338,12.637036237,11.945779554,0.4752389696,26,0.2376194848,0.691256683,0.7128584544
21,109,2001,176,144,67,111,2,32,69,87,13598,12.984617655,10.623778081,4.9430078572,-14,0.1475524733,2.3608395736,5.0905603305
21,109,2002,159,173,-46,111,2,-14,-44,-72,13526,11.723934523,12.756230644,-3.391830114,-14,0.1474708745,-1.032296122,-3.244359239
21,109,2003,168,148,-78,111,2,20,-76,-73,13453,12.454130991,10.971496349,-5.782275103,-17,0.1482634642,1.4826346418,-5.634011639
21,109,2004,180,151,-70,111,1,29,-69,-49,13404,13.404326619,11.244740664,-5.212793685,-9,0.0744684812,2.1595859552,-5.138325204
21,109,2005,192,138,53,111,2,54,55,98,13502,14.271909611,10.257935033,3.9396417156,-11,0.1486657251,4.0139745782,4.0883074407
21,109,2006,170,126,-12,111,1,44,-11,27,13529,12.578151012,9.3226295735,-0.887869483,-6,0.0739891236,3.2555214383,-0.81388036
21,109,2007,176,154,39,111,1,22,40,55,13584,12.982702025,11.359864272,2.8768487441,-7,0.0737653524,1.6228377531,2.9506140966
21,109,2008,167,166,62,111,0,1,62,61,13645,12.266333688,12.192882588,4.5539681957,-2,0,0.0734510999,4.5539681957
21,111,2001,9890,7204,-2550,12795,1475,2686,-1075,962,694966,14.240768339,10.373154208,-3.671785568,-649,2.1238759656,3.8676141313,-1.547909602
21,111,2002,9835,7153,-2457,12795,1366,2682,-1091,982,695948,14.141780153,10.285323176,-3.532928707,-609,1.9641760741,3.8564569772,-1.568752633
21,111,2003,9684,7017,-966,12795,1129,2667,163,1835,697783,13.896512311,10.069374937,-1.386207238,-995,1.6201117719,3.8271373744,0.2339045339
21,111,2004,9991,7107,-2451,12795,1111,2884,-1340,1039,698822,14.307552959,10.177537672,-3.509940176,-505,1.5910010347,4.1300152871,-1.918939142
21,111,2005,9823,6750,-2461,12795,1148,3073,-1313,1091,699913,14.045548299,9.651578033,-3.518893858,-669,1.6414831973,4.393970266,-1.87741066
21,111,2006,9986,6809,-1213,12795,1166,3177,-47,2802,702715,14.238985675,9.7089178314,-1.729610417,-328,1.6625933605,4.5300678441,-0.067017057
21,111,2007,10227,6980,1482,12795,1026,3247,2508,5898,708613,14.492733085,9.8913930709,2.1001496463,143,1.4539497551,4.6013400145,3.5540994014
21,111,2008,10074,7070,818,12795,1038,3004,1856,5264,713877,14.163895704,9.9403159249,1.1500959585,404,1.4594127199,4.2235797791,2.6095086784
21,113,2001,529,273,278,1796,37,256,315,532,39739,13.401565627,6.9161198794,7.0427887417,-39,0.9373495807,6.4854457477,7.9801383224
21,113,2002,543,343,675,1796,37,200,712,885,40624,13.513681669,8.5362666899,16.798775556,-27,0.9208217712,4.9774149795,17.719597327
21,113,2003,533,305,493,1796,25,228,518,711,41335,13.006503252,7.4427457631,12.030405447,-35,0.6100611281,5.5637574885,12.640466575
21,113,2004,620,317,501,1796,28,303,529,793,42128,14.856882691,7.5961803434,12.005319723,-39,0.6709559925,7.2607023471,12.676275715
21,113,2005,576,313,786,1796,27,263,813,1042,43170,13.505592159,7.3389762949,18.429505967,-34,0.6330746325,6.1666158644,19.0625806
21,113,2006,694,336,1021,1796,28,358,1049,1380,44550,15.823073415,7.6607387141,23.278613771,-27,0.6383948928,8.1623347013,23.917008664
21,113,2007,691,343,645,1796,23,348,668,1003,45553,15.338002064,7.6135089842,14.316948381,-13,0.5105268415,7.7244930801,14.827475223
21,113,2008,663,350,837,1796,25,313,862,1163,46716,14.371023854,7.5865133468,18.142604775,-12,0.5418938105,6.7845105073,18.684498586
21,115,2001,312,268,-19,516,6,44,-13,7,23348,13.365032449,11.48022018,-0.813896207,-24,0.2570198548,1.8848122684,-0.556876352
21,115,2002,305,269,-7,516,5,36,-2,10,23358,13.060420503,11.518862673,-0.299747356,-24,0.2141052541,1.5415578298,-0.085642102
21,115,2003,302,252,27,516,4,50,31,48,23406,12.915918228,10.77752117,1.1547344111,-33,0.1710717646,2.1383970576,1.3258061757
21,115,2004,312,288,159,516,5,24,164,168,23574,13.282247765,12.260536398,6.7688378033,-20,0.2128565347,1.0217113665,6.981694338
21,115,2005,293,268,164,516,5,25,169,175,23749,12.382985018,11.32641633,6.9310905902,-19,0.2113137375,1.0565686875,7.1424043277
21,115,2006,309,297,176,516,5,12,181,181,23930,12.961681243,12.458314981,7.3827051742,-12,0.2097359424,0.5033662619,7.5924411166
21,115,2007,315,289,51,516,2,26,53,73,24003,13.14334592,12.058498321,2.1279702919,-6,0.0834498154,1.0848475998,2.2114201072
21,115,2008,303,276,19,516,2,27,21,53,24056,12.609500822,11.485881937,0.790694771,5,0.0832310285,1.1236188851,0.8739257995
21,117,2001,2376,1314,-767,1866,123,1062,-644,272,151960,15.649699652,8.654758141,-5.051902203,-146,0.8101485931,6.9949415112,-4.241753609
21,117,2002,2200,1370,-1092,1866,116,830,-976,-267,151693,14.490224039,9.0234576968,-7.192420296,-121,0.7640299948,5.4667663418,-6.428390301
21,117,2003,2320,1293,-255,1866,98,1027,-157,652,152345,15.261250238,8.5055157579,-1.677421901,-218,0.6446562601,6.7557344806,-1.032765641
21,117,2004,2405,1333,-566,1866,95,1072,-471,488,152833,15.761293409,8.7358852866,-3.709310632,-113,0.6225874735,7.0254081225,-3.086723158
21,117,2005,2355,1333,-439,1866,99,1022,-340,541,153374,15.38175156,8.7065285901,-2.867341374,-141,0.6466214032,6.6752229701,-2.22071997
21,117,2006,2438,1355,538,1866,100,1083,638,1645,155019,15.810994413,8.7874886914,3.4890545505,-76,0.6485231507,7.0235057216,4.1375777012
21,117,2007,2439,1323,375,1866,87,1116,462,1574,156593,15.654082641,8.4913289604,2.4068392745,-4,0.5583867117,7.1627536809,2.9652259862
21,117,2008,2445,1307,-206,1866,89,1138,-117,1036,157629,15.562245801,8.3189592072,-1.311174902,15,0.566478477,7.2432865936,-0.744696425
21,119,2001,183,173,-109,573,1,10,-108,-113,17500,10.423489876,9.8539002649,-6.208526756,-15,0.0569589611,0.5695896107,-6.151567795
21,119,2002,166,169,131,573,0,-3,131,114,17614,9.4549182662,9.6257902831,7.4614114029,-14,0,-0.170872017,7.4614114029
21,119,2003,178,171,-98,573,0,7,-98,-109,17505,10.136962898,9.7383182892,-5.581024517,-18,0,0.3986446083,-5.581024517
21,119,2004,187,151,-160,573,1,36,-159,-138,17367,10.724936912,8.660243175,-9.176416609,-15,0.0573526038,2.0646937371,-9.119064006
21,119,2005,176,179,83,573,1,-3,84,68,17435,10.114361244,10.286765128,4.7698408137,-13,0.0574679616,-0.172403885,4.8273087754
21,119,2006,183,192,-116,573,1,-9,-115,-132,17303,10.536012436,11.054176982,-6.67856526,-8,0.0575738384,-0.518164546,-6.620991421
21,119,2007,194,195,-36,573,0,-1,-36,-44,17259,11.226202187,11.284069209,-2.083212777,-7,0,-0.057867022,-2.083212777
21,119,2008,180,172,118,573,0,8,118,126,17385,10.391409768,9.9295693338,6.8121464034,0,0,0.4618404341,6.8121464034
21,121,2001,446,351,-314,645,0,95,-314,-250,31596,14.060086378,11.06522493,-9.898805208,-31,0,2.9948614483,-9.898805208
21,121,2002,414,343,-84,645,-2,71,-86,-50,31546,13.113300181,10.864400874,-2.660669602,-35,-0.063349276,2.2488993063,-2.724018878
21,121,2003,475,347,74,645,-7,128,67,155,31701,15.020475279,10.972852467,2.3400319383,-40,-0.221354373,4.0476228121,2.1186775657
21,121,2004,495,369,-29,645,4,126,-25,80,31781,15.594971803,11.625342617,-0.913644813,-21,0.1260199742,3.9696291862,-0.787624839
21,121,2005,580,353,78,645,0,227,78,278,32059,18.170426065,11.058897243,2.4436090226,-27,0,7.1115288221,2.4436090226
21,121,2006,492,381,122,645,2,111,124,217,32276,15.294940546,11.84425274,3.7926478589,-18,0.0621745551,3.450687806,3.8548224139
21,121,2007,514,376,98,645,0,138,98,221,32497,15.870810369,11.609775678,3.0259521714,-15,0,4.2610346904,3.0259521714
21,121,2008,519,381,175,645,2,138,177,313,32810,15.894161422,11.667968212,5.3593029844,-2,0.061249177,4.2261932105,5.4205521613
21,123,2001,160,131,-36,214,1,29,-35,-19,13381,11.94876965,9.783055151,-2.688473171,-13,0.0746798103,2.1657144991,-2.613793361
21,123,2002,156,138,34,214,1,18,35,40,13421,11.640922319,10.297738975,2.5371240952,-13,0.0746212969,1.3431833445,2.6117453921
21,123,2003,156,154,-138,214,1,2,-137,-147,13274,11.687581944,11.53774115,-10.3390148,-12,0.0749203971,0.1498407942,-10.2640944
21,123,2004,162,161,111,214,0,1,111,101,13375,12.158054711,12.083004991,8.3305189688,-11,0,0.0750497204,8.3305189688
21,123,2005,146,165,143,214,1,-19,144,113,13488,10.869969847,12.284554964,10.646614302,-12,0.0744518483,-1.414585117,10.72106615
21,123,2006,191,155,91,214,0,36,91,121,13609,14.097501568,11.440380854,6.7166106949,-6,0,2.6571207145,6.7166106949
21,123,2007,172,163,51,214,1,9,52,59,13668,12.611357554,11.951460938,3.7394141584,-2,0.0733218462,0.6598966162,3.8127360047
21,123,2008,164,168,50,214,0,-4,50,54,13722,11.975173421,12.267250821,3.6509675064,8,0,-0.292077401,3.6509675064
21,125,2001,822,524,335,669,29,298,364,614,53537,15.442419688,9.8440728912,6.2934435469,-48,0.5448055608,5.5983467969,6.8382491076
21,125,2002,785,517,505,669,28,268,533,763,54300,14.559010358,9.5885456754,9.3659875553,-38,0.5193022803,4.9704646828,9.8852898356
21,125,2003,763,479,531,669,23,284,554,800,55100,13.9488117,8.7568555759,9.7074954296,-38,0.4204753199,5.1919561243,10.12797075
21,125,2004,749,529,165,669,25,220,190,365,55465,13.548591326,9.5690317913,2.9846696513,-45,0.4522226744,3.9795595351,3.4368923258
21,125,2005,742,510,355,669,25,232,380,560,56025,13.310610817,9.1488025832,6.368284151,-52,0.4484707149,4.1618082339,6.8167548659
21,125,2006,793,513,426,669,26,280,452,705,56730,14.065895082,9.0993747506,7.5562059332,-27,0.4611768879,4.9665203317,8.0173828212
21,125,2007,749,536,363,669,22,213,385,605,57335,13.132862841,9.3981501775,6.3647920046,7,0.38574497,3.7347126638,6.7505369745
21,125,2008,771,538,-3,669,24,233,21,251,57586,13.417913175,9.3629536812,-0.052209779,-3,0.4176782311,4.0549594939,0.3654684522
21,127,2001,211,177,60,144,2,34,62,80,15667,13.502271709,11.326550202,3.8395085429,-16,0.1279836181,2.1757215076,3.967492161
21,127,2002,187,185,137,144,2,2,139,130,15797,11.886600559,11.759471142,8.7083651157,-11,0.1271294177,0.1271294177,8.8354945334
21,127,2003,171,166,7,144,2,5,9,-9,15788,10.827924648,10.511318664,0.4432483774,-23,0.1266423935,0.3166059839,0.5698907709
21,127,2004,183,180,192,144,1,3,193,180,15968,11.52538103,11.336440358,12.092203048,-16,0.0629802242,0.1889406726,12.155183272
21,127,2005,210,166,131,144,2,44,133,162,16130,13.08492741,10.343323572,8.1625023366,-15,0.1246183563,2.7416038382,8.2871206929
21,127,2006,232,191,66,144,1,41,67,101,16231,14.338246655,11.804332375,4.0789839622,-7,0.0618027873,2.5339142795,4.1407867495
21,127,2007,196,174,56,144,2,22,58,76,16307,12.04745221,10.695187166,3.4421292028,-4,0.1229331858,1.3522650439,3.5650623886
21,127,2008,197,175,117,144,1,22,118,136,16443,12.030534351,10.687022901,7.1450381679,-4,0.0610687023,1.3435114504,7.2061068702
21,129,2001,82,99,-44,713,2,-17,-42,-66,7853,10.398173979,12.553892975,-5.579507989,-7,0.2536139995,-2.155718996,-5.325893989
21,129,2002,70,106,29,713,2,-36,31,-11,7842,8.9200382287,13.507486461,3.695444409,-6,0.2548582351,-4.587448232,3.9503026442
21,129,2003,86,98,3,713,2,-12,5,-17,7825,10.978489819,12.51037212,0.3829705751,-10,0.2553137167,-1.5318823,0.6382842918
21,129,2004,77,103,-89,713,1,-26,-88,-122,7703,9.9175682638,13.266357548,-11.46316332,-8,0.1287995878,-3.348789284,-11.33436373
21,129,2005,85,99,-166,713,2,-14,-164,-182,7521,11.166579086,13.005780347,-21.8076721,-4,0.2627430373,-1.839201261,-21.54492906
21,129,2006,82,92,-20,713,1,-10,-19,-34,7487,10.92750533,12.260127932,-2.665245203,-5,0.1332622601,-1.332622601,-2.531982942
21,129,2007,70,86,-28,713,1,-16,-27,-48,7439,9.3796060565,11.523516012,-3.751842423,-5,0.1339943722,-2.143909956,-3.61784805
21,129,2008,75,99,6,713,0,-24,6,-25,7414,10.098969905,13.330640275,0.8079175924,-7,0,-3.23167037,0.8079175924
21,131,2001,157,135,-186,110,1,22,-185,-170,12200,12.77981278,10.989010989,-15.14041514,-7,0.0814000814,1.7908017908,-15.05901506
21,131,2002,133,125,-7,110,1,8,-6,-10,12190,10.906109061,10.250102501,-0.57400574,-12,0.08200082,0.6560065601,-0.49200492
21,131,2003,145,142,-136,110,1,3,-135,-139,12051,11.963202838,11.715688297,-11.22065921,-7,0.0825048472,0.2475145415,-11.13815437
21,131,2004,122,158,-126,110,0,-36,-126,-173,11878,10.196832296,13.205733629,-10.53115467,-11,0,-3.008901333,-10.53115467
21,131,2005,145,128,-14,110,1,17,-13,-7,11871,12.211040465,10.779401238,-1.17899701,-11,0.0842140722,1.4316392269,-1.094782938
21,131,2006,139,132,-99,110,0,7,-99,-97,11774,11.757242546,11.165151195,-8.373863396,-5,0,0.5920913512,-8.373863396
21,131,2007,139,141,-28,110,1,-2,-27,-27,11747,11.819225373,11.98928617,-2.380851154,2,0.0850303984,-0.170060797,-2.295820756
21,131,2008,134,137,-110,110,0,-3,-110,-108,11639,11.459847772,11.716411528,-9.407337723,5,0,-0.256563756,-9.407337723
21,133,2001,278,321,-362,225,1,-43,-361,-423,24794,11.117554138,12.837175821,-14.4768151,-19,0.0399912019,-1.719621683,-14.4368239
21,133,2002,290,295,3,225,0,-5,3,-28,24766,11.702986279,11.904761905,0.1210653753,-26,0,-0.201775626,0.1210653753
21,133,2003,295,305,-41,225,-2,-10,-43,-90,24676,11.933174224,12.337688605,-1.65850896,-37,-0.080902876,-0.40451438,-1.739411836
21,133,2004,314,304,-242,225,1,10,-241,-251,24425,12.789963545,12.382639865,-9.85723305,-20,0.040732368,0.4073236798,-9.816500682
21,133,2005,313,285,-245,225,-1,28,-246,-240,24185,12.87800864,11.725982308,-10.08023041,-22,-0.041143798,1.152026332,-10.1213742
21,133,2006,347,296,-124,225,0,51,-124,-81,24104,14.371803102,12.259520802,-5.135745201,-8,0,2.1122823003,-5.135745201
21,133,2007,304,320,-92,225,-1,-16,-93,-104,24000,12.639281557,13.304506902,-3.825045734,5,-0.041576584,-0.665225345,-3.866622318
21,133,2008,295,304,-99,225,1,-9,-98,-110,23890,12.31989977,12.695761119,-4.134474838,-3,0.0417623721,-0.375861349,-4.092712466
21,135,2001,184,138,-175,212,2,46,-173,-138,13986,13.091426539,9.8185699039,-12.45108502,-11,0.1422981145,3.2728566346,-12.30878691
21,135,2002,148,168,-256,212,1,-20,-255,-282,13704,10.689779704,12.134344529,-18.49042976,-7,0.0722282412,-1.444564825,-18.41820152
21,135,2003,138,144,-19,212,0,-6,-19,-46,13658,10.086981946,10.525546378,-1.388787369,-21,0,-0.438564432,-1.388787369
21,135,2004,188,181,103,212,1,7,104,99,13757,13.71511946,13.204450119,7.5141345978,-12,0.0729527631,0.5106693416,7.5870873609
21,135,2005,176,154,-3,212,1,22,-2,7,13764,12.790232913,11.191453799,-0.218015334,-13,0.0726717779,1.5987791141,-0.145343556
21,135,2006,180,124,33,212,1,56,34,84,13848,13.037809648,8.9816022019,2.3902651021,-6,0.0724322758,4.056207446,2.462697378
21,135,2007,195,152,-17,212,1,43,-16,20,13868,14.071294559,10.968393708,-1.226728244,-7,0.0721604849,3.1029008515,-1.154567759
21,135,2008,185,156,-85,212,1,29,-84,-61,13807,13.369467028,11.273712737,-6.142728094,-6,0.0722673893,2.0957542909,-6.070460705
21,137,2001,335,221,219,241,13,114,232,328,23795,14.176293851,9.3521222123,9.2674876222,-18,0.550124836,4.8241716389,9.8176124582
21,137,2002,346,265,96,241,13,81,109,170,23965,14.489112228,11.097152429,4.0201005025,-20,0.5443886097,3.391959799,4.5644891122
21,137,2003,297,232,223,241,12,65,235,279,24244,12.321350785,9.6247588625,9.2513845962,-21,0.497832355,2.6965919227,9.7492169512
21,137,2004,341,242,147,241,8,99,155,235,24479,13.997496049,9.9337068736,6.0341112,-19,0.3283870041,4.0637891755,6.3624982041
21,137,2005,364,233,317,241,12,131,329,436,24915,14.738632223,9.4343442523,12.835567073,-24,0.4858889744,5.3042879702,13.321456047
21,137,2006,346,219,28,241,11,127,39,154,25069,13.844430218,8.7628040973,1.1203585147,-12,0.4401408451,5.0816261204,1.5604993598
21,137,2007,339,257,42,241,9,82,51,138,25207,13.48555971,10.223565916,1.6707773093,5,0.3580237091,3.2619937943,2.0288010184
21,137,2008,336,256,-239,241,8,80,-231,-135,25072,13.365420951,10.183177867,-9.506951212,16,0.3182243084,3.1822430836,-9.188726904
21,139,2001,108,102,-1,137,0,6,-1,-4,9810,11.006930289,10.395434162,-0.101916021,-9,0,0.6114961272,-0.101916021
21,139,2002,91,128,3,137,-1,-37,2,-45,9765,9.2975734355,13.077905492,0.30651341,-10,-0.102171137,-3.780332056,0.2043422733
21,139,2003,88,109,-47,137,-1,-21,-48,-82,9683,9.0497737557,11.209378856,-4.833401892,-13,-0.102838338,-2.159605101,-4.93624023
21,139,2004,99,137,-15,137,0,-38,-15,-60,9623,10.255879001,14.192479022,-1.553921061,-7,0,-3.936600021,-1.553921061
21,139,2005,103,107,80,137,0,-4,80,69,9692,10.665286047,11.079471913,8.2837173181,-7,0,-0.414185866,8.2837173181
21,139,2006,99,101,-39,137,0,-2,-39,-46,9646,10.23890785,10.445754473,-4.033509153,-5,0,-0.206846623,-4.033509153
21,139,2007,106,120,-13,137,0,-14,-13,-28,9618,11.004983389,12.458471761,-1.349667774,-1,0,-1.453488372,-1.349667774
21,139,2008,97,116,-16,137,0,-19,-16,-27,9591,10.099432558,12.077671925,-1.665885783,8,0,-1.978239367,-1.665885783
21,141,2001,403,272,-114,315,12,131,-102,5,26608,15.147243991,10.223450039,-4.284828325,-24,0.4510345605,4.9237939524,-3.833793764
21,141,2002,331,276,11,315,9,55,20,49,26657,12.428423918,10.36327795,0.4130291937,-26,0.3379329766,2.0651459683,0.7509621703
21,141,2003,325,281,-64,315,3,44,-61,-55,26602,12.204510036,10.552207139,-2.403349669,-38,0.1126570157,1.6523028972,-2.290692653
21,141,2004,341,287,90,315,11,54,101,136,26738,12.785901762,10.761154856,3.3745781777,-19,0.4124484439,2.0247469066,3.7870266217
21,141,2005,396,264,-3,315,8,132,5,112,26850,14.77942823,9.8529521535,-0.111965365,-25,0.2985743077,4.9264760767,0.1866089423
21,141,2006,372,308,42,315,10,64,52,101,26951,13.828739243,11.449601309,1.5613092693,-15,0.3717403022,2.3791379342,1.9330495716
21,141,2007,352,297,75,315,7,55,82,138,27089,13.027387121,10.991857883,2.7757216876,1,0.2590673575,2.0355292376,3.0347890452
21,141,2008,359,288,-67,315,9,71,-58,28,27117,13.245766151,10.626129949,-2.472051064,15,0.3320665609,2.6196362026,-2.139984504
21,143,2001,54,130,110,1543,6,-76,116,33,8141,6.6465628654,16.000984676,13.539294726,-7,0.738506985,-9.354421811,14.277801711
21,143,2002,49,98,37,1543,6,-49,43,-13,8128,6.0237261049,12.04745221,4.5485278751,-7,0.7375991149,-6.023726105,5.28612699
21,143,2003,66,91,48,1543,4,-25,52,16,8144,8.1120943953,11.184857424,5.8997050147,-11,0.4916420846,-3.072763029,6.3913470993
21,143,2004,48,102,53,1543,5,-54,58,-3,8141,5.8949953945,12.526865213,6.5090574148,-7,0.6140620203,-6.631869819,7.1231194351
21,143,2005,64,102,111,1543,5,-38,116,71,8212,7.8273099737,12.474775271,13.575490736,-7,0.6115085917,-4.647465297,14.186999327
21,143,2006,60,98,122,1543,5,-38,127,84,8296,7.2692028108,11.873031258,14.780712382,-5,0.6057669009,-4.603828447,15.386479283
21,143,2007,62,105,-13,1543,5,-43,-8,-48,8248,7.4951644101,12.693423598,-1.571566731,3,0.6044487427,-5.198259188,-0.967117988
21,143,2008,60,108,34,1543,5,-48,39,-3,8245,7.2758139817,13.096465167,4.1229612563,6,0.6063178318,-5.820651185,4.7292790881
21,145,2001,855,783,-632,1334,15,72,-617,-592,64848,13.124769741,12.019525973,-9.701584183,-47,0.2302591183,1.1052437677,-9.471325064
21,145,2002,830,750,-275,1334,13,80,-262,-234,64614,12.822295345,11.586411457,-4.248350867,-52,0.2008311319,1.2358838887,-4.047519736
21,145,2003,772,740,-136,1334,4,32,-132,-194,64420,11.965838461,11.469845157,-2.107971542,-94,0.061999163,0.4959933041,-2.045972379
21,145,2004,810,743,-195,1334,15,67,-180,-158,64262,12.589173311,11.54784663,-3.030726908,-45,0.2331328391,1.0413266813,-2.797594069
21,145,2005,818,714,85,1334,11,104,96,138,64400,12.71548709,11.098848145,1.3212914458,-62,0.1709906577,1.6166389455,1.4922821035
21,145,2006,819,756,26,1334,13,63,39,71,64471,12.710384803,11.732662895,0.4035042795,-31,0.2017521397,0.977721908,0.6052564192
21,145,2007,812,747,154,1334,8,65,162,236,64707,12.571800152,11.565436839,2.3843069253,9,0.1238601,1.0063633126,2.5081670253
21,145,2008,816,735,276,1334,10,81,286,402,65109,12.571639859,11.323719726,4.2521723054,35,0.154064214,1.2479201331,4.4062365194
21,147,2001,234,168,-93,429,6,66,-87,-37,17029,13.726352838,9.8548174219,-5.455345359,-16,0.3519577651,3.8715354158,-5.103387593
21,147,2002,247,174,-1,429,6,73,5,62,17091,14.478311841,10.1992966,-0.058616647,-16,0.3516998828,4.2790152403,0.2930832356
21,147,2003,180,167,-82,429,6,13,-76,-84,17007,10.557803977,9.7952959118,-4.809666256,-21,0.3519267992,0.762508065,-4.457739457
21,147,2004,282,224,-53,429,5,58,-48,-4,17003,16.583357836,13.172596295,-3.116730373,-14,0.2940311673,3.4107615407,-2.822699206
21,147,2005,246,176,103,429,6,70,109,167,17170,14.397331226,10.300529658,6.0281508793,-12,0.3511544202,4.0968015685,6.3793052995
21,147,2006,230,168,9,429,5,62,14,67,17237,13.369372511,9.765454704,0.5231493591,-9,0.2906385329,3.6039178074,0.813787892
21,147,2007,240,191,5,429,6,49,11,52,17289,13.902566182,11.064125587,0.2896367955,-8,0.3475641546,2.8384405955,0.63720095
21,147,2008,248,184,-41,429,5,64,-36,26,17315,14.333603052,10.634608716,-2.369668246,-2,0.2889839325,3.6989943359,-2.080684314
21,149,2001,130,111,-151,117,9,19,-142,-130,9847,13.115415658,11.198547215,-15.23405973,-7,0.9079903148,1.9168684423,-14.32606941
21,149,2002,140,111,59,117,9,29,68,89,9936,14.153566193,11.221756053,5.9647171814,-8,0.9098721124,2.93181014,6.8745892938
21,149,2003,120,102,-121,117,9,18,-112,-100,9836,12.138377504,10.317620878,-12.23953065,-6,0.9103783128,1.8207566255,-11.32915234
21,149,2004,128,119,-23,117,8,9,-15,-12,9824,13.021363174,12.105798576,-2.339776195,-6,0.8138351984,0.9155645982,-1.525940997
21,149,2005,107,117,-26,117,9,-10,-17,-36,9788,10.911686722,11.931470528,-2.651437895,-9,0.9178054252,-1.019783806,-1.73363247
21,149,2006,128,114,-98,117,8,14,-90,-80,9708,13.130898646,11.694706606,-10.05334428,-4,0.8206811654,1.4361920394,-9.23266311
21,149,2007,110,122,23,117,3,-12,26,13,9721,11.323279634,12.558546503,2.3675948325,-1,0.3088167173,-1.235266869,2.6764115497
21,149,2008,109,112,-43,117,2,-3,-41,-40,9681,11.235955056,11.545201526,-4.432532729,4,0.206164313,-0.309246469,-4.226368416
21,151,2001,967,493,852,5299,54,474,906,1330,72640,13.435220563,6.8496005557,11.837443557,-50,0.7502605071,6.5856200069,12.587704064
21,151,2002,958,590,772,5299,47,368,819,1138,73778,13.085822781,8.0591184144,10.545151552,-49,0.6419975686,5.0267043669,11.187149121
21,151,2003,962,543,978,5299,32,419,1010,1389,75167,12.91751989,7.2912820169,13.132364296,-40,0.4296888113,5.626237873,13.562053107
21,151,2004,954,560,1385,5299,47,394,1432,1734,76901,12.547018439,7.3651261278,18.215535155,-92,0.6181445143,5.1818923113,18.83367967
21,151,2005,1034,565,1303,5299,43,469,1346,1750,78651,13.294589591,7.2644517589,16.753240074,-65,0.5528697799,6.0301378317,17.306109854
21,151,2006,1099,534,966,5299,46,565,1012,1535,80186,13.838085585,6.7238741603,12.163412807,-42,0.5792101337,7.1142114243,12.74262294
21,151,2007,1069,630,366,5299,41,439,407,825,81011,13.26327413,7.81652264,4.5410274385,-21,0.5086943305,5.4467514904,5.049721769
21,151,2008,1079,584,632,5299,44,495,676,1181,82192,13.22279615,7.1567311875,7.7449556687,10,0.5392057744,6.066064962,8.2841614431
21,153,2001,188,150,-175,175,2,38,-173,-144,13173,14.194035485,11.325028313,-13.21253303,-9,0.1510003775,2.8690071725,-13.06153265
21,153,2002,189,115,5,175,2,74,7,68,13241,14.310592867,8.7075035966,0.3785871129,-13,0.1514348452,5.6030892708,0.5300219581
21,153,2003,161,100,-78,175,1,61,-77,-29,13212,12.172532416,7.5605791404,-5.897251729,-13,0.0756057914,4.6119532756,-5.821645938
21,153,2004,199,153,-46,175,0,46,-46,-11,13201,15.068337561,11.585204255,-3.483133306,-11,0,3.4831333056,-3.483133306
21,153,2005,184,139,-55,175,1,45,-54,-18,13183,13.94784718,10.536688902,-4.169193451,-9,0.0758035173,3.4111582777,-4.093389933
21,153,2006,193,135,-80,175,0,58,-80,-27,13156,14.655074225,10.250958654,-6.074642166,-5,0,4.4041155701,-6.074642166
21,153,2007,188,130,-8,175,1,58,-7,45,13201,14.265659976,9.8645521114,-0.607049361,-6,0.0758811701,4.4011078651,-0.531168191
21,153,2008,175,129,-101,175,0,46,-101,-50,13151,13.281724347,9.7905282332,-7.665452338,5,0,3.4911961141,-7.665452338
21,155,2001,244,189,65,1151,19,55,84,122,18329,13.356689293,10.345960149,3.5581344427,-17,1.0400700679,3.0107291439,4.5982045106
21,155,2002,238,191,51,1151,18,47,69,98,18427,12.950266623,10.392861029,2.7750571335,-18,0.9794319295,2.5574055936,3.754489063
21,155,2003,288,158,-47,1151,11,130,-36,66,18493,15.601300108,8.5590465872,-2.546045504,-28,0.5958829902,7.0422535211,-1.950162514
21,155,2004,267,202,20,1151,12,65,32,85,18578,14.404790807,10.898006528,1.0790105473,-12,0.6474063284,3.5067842788,1.7264168757
21,155,2005,265,177,78,1151,12,88,90,162,18740,14.202261643,9.4860389088,4.1802883327,-16,0.643121282,4.7162227343,4.8234096147
21,155,2006,254,177,9,1151,12,77,21,88,18828,13.522146508,9.4229131175,0.4791311755,-10,0.6388415673,4.0992333901,1.1179727428
21,155,2007,259,184,-20,1151,11,75,-9,64,18892,13.732767762,9.756097561,-1.060445387,-2,0.5832449629,3.9766702015,-0.477200424
21,155,2008,272,178,60,1151,11,94,71,171,19063,14.332762482,9.3795283889,3.1616387828,6,0.5796337768,4.953234093,3.7412725596
21,157,2001,286,369,99,572,14,-83,113,2,30123,9.494721466,12.250182591,3.2866343536,-28,0.4647765753,-2.755461125,3.7514109289
21,157,2002,324,365,135,572,13,-41,148,82,30205,10.741280997,12.100517173,4.4755337488,-25,0.430977324,-1.359236176,4.9065110728
21,157,2003,296,357,261,572,11,-61,272,189,30394,9.7691381046,11.782372646,8.6140035314,-22,0.3630422944,-2.013234542,8.9770458258
21,157,2004,308,377,239,572,12,-69,251,153,30547,10.108137379,12.372622701,7.8436520569,-29,0.3938235342,-2.264485322,8.2374755911
21,157,2005,323,375,225,572,12,-52,237,158,30705,10.546594397,12.244498139,7.3466988833,-27,0.3918239404,-1.697903742,7.7385228237
21,157,2006,311,355,303,572,12,-44,315,255,30960,10.086759102,11.513824698,9.8272926295,-16,0.3891997081,-1.427065596,10.216492338
21,157,2007,321,378,249,572,12,-57,261,204,31164,10.334170369,12.169209967,8.0162256133,0,0.3863241259,-1.835039598,8.4025497392
21,157,2008,340,374,54,572,12,-34,66,25,31189,10.905650089,11.996215098,1.7320738377,-7,0.3849052973,-1.090565009,2.1169791349
21,159,2001,179,125,-191,84,1,54,-190,-146,12414,14.334908305,10.010410827,-15.29590774,-10,0.0800832866,4.3244974774,-15.21582446
21,159,2002,169,125,-68,84,1,44,-67,-33,12381,13.631780601,10.082677959,-5.48497681,-10,0.0806614237,3.5491026417,-5.404315386
21,159,2003,177,119,-148,84,1,58,-147,-100,12281,14.354066986,9.6504744141,-12.0022707,-11,0.0810964236,4.7035925716,-11.92117428
21,159,2004,154,116,-226,84,0,38,-226,-201,12080,12.643159148,9.5234185789,-18.55424654,-13,0,3.1197405689,-18.55424654
21,159,2005,164,112,-240,84,1,52,-239,-197,11883,13.687768643,9.3477444393,-20.03088094,-10,0.0834620039,4.340024204,-19.94741894
21,159,2006,171,126,-185,84,0,45,-185,-143,11740,14.477416078,10.667569741,-15.6627016,-3,0,3.8098463362,-15.6627016
21,159,2007,147,134,-120,84,1,13,-119,-105,11635,12.577540107,11.465240642,-10.26737968,1,0.0855614973,1.1122994652,-10.18181818
21,159,2008,146,121,-50,84,0,25,-50,-33,11602,12.566166028,10.41442527,-4.303481517,-8,0,2.1517407583,-4.303481517
21,161,2001,219,197,-8,332,14,22,6,11,16796,13.043089842,11.732825109,-0.476459903,-17,0.8338048301,1.310264733,0.3573449272
21,161,2002,205,194,5,332,14,11,19,13,16809,12.200565392,11.545900908,0.2975747657,-17,0.8332093438,0.6546644845,1.1307841095
21,161,2003,202,199,-111,332,11,3,-100,-113,16696,12.057901806,11.878824056,-6.625876735,-16,0.6566184152,0.1790777496,-5.96925832
21,161,2004,201,181,53,332,12,20,65,73,16769,12.012550426,10.817271776,3.1674884207,-12,0.7171671896,1.1952786493,3.8846556103
21,161,2005,198,193,112,332,12,5,124,115,16884,11.767153003,11.470002674,6.6561673551,-14,0.713160788,0.2971503284,7.3693281431
21,161,2006,232,201,198,332,12,31,210,233,17117,13.646657451,11.823181671,11.646716273,-8,0.7058615923,1.8234757801,12.352577865
21,161,2007,243,193,56,332,11,50,67,110,17227,14.150943396,11.239226648,3.261122758,-7,0.6405776846,2.9117167482,3.9017004426
21,161,2008,204,186,163,332,11,18,174,187,17414,11.777950983,10.738720014,9.4108137756,-5,0.6350855922,1.0392309691,10.045899368
21,163,2001,309,164,135,108,10,145,145,266,26790,11.591701992,6.1522301834,5.0643358217,-24,0.3751359868,5.4394718085,5.4394718085
21,163,2002,299,178,334,108,-40,121,294,400,27190,11.078177103,6.5950351982,12.374953687,-15,-1.482030382,4.4831419044,10.892923305
21,163,2003,297,146,145,108,-152,151,-7,117,27307,10.899682551,5.358093106,5.3213938382,-27,-5.578288713,5.5415894453,-0.256894875
21,163,2004,287,171,326,108,75,116,401,489,27796,10.416855707,6.2065586266,11.832386621,-28,2.7221748362,4.21029708,14.554561458
21,163,2005,257,198,40,108,-4,59,36,70,27866,9.2343070677,7.1143688692,1.4372462362,-25,-0.143724624,2.1199381984,1.2935216126
21,163,2006,249,162,-500,108,41,87,-459,-383,27483,8.9974525285,5.8537642957,-18.06717375,-11,1.4815082477,3.1436882328,-16.5856655
21,163,2007,249,186,-328,108,-8,63,-336,-270,27213,9.1048705573,6.801228609,-11.99356443,3,-0.292525962,2.3036419482,-12.28609039
21,163,2008,251,166,-254,108,11,85,-243,-170,27043,9.2524329106,6.1191388971,-9.363019758,-12,0.4054851076,3.1332940136,-8.957534651
21,165,2001,77,56,79,243,1,21,80,97,6692,11.59027621,8.429291789,11.891322345,-4,0.1505230677,3.1609844209,12.041845413
21,165,2002,74,67,45,243,0,7,45,45,6737,11.020924864,9.9784049445,6.7019137687,-7,0,1.0425199196,6.7019137687
21,165,2003,82,59,-64,243,-2,23,-66,-49,6688,12.216014898,8.7895716946,-9.534450652,-6,-0.297951583,3.426443203,-9.832402235
21,165,2004,84,55,22,243,1,29,23,46,6734,12.516763523,8.1954999255,3.2781999702,-6,0.1490090896,4.3212635971,3.4272090598
21,165,2005,70,67,14,243,-1,3,13,9,6743,10.388068561,9.9428656229,2.0776137123,-7,-0.148400979,0.4452029383,1.9292127328
21,165,2006,76,64,-3,243,0,12,-3,6,6749,11.265935369,9.4871034687,-0.444707975,-3,0,1.7788319004,-0.444707975
21,165,2007,74,69,-7,243,-1,5,-8,-4,6745,10.967837557,10.226767452,-1.037498147,-1,-0.148214021,0.7410701052,-1.185712168
21,165,2008,74,77,-1,243,1,-3,0,-1,6744,10.971903032,11.416709912,-0.14826896,2,0.1482689599,-0.44480688,0
21,167,2001,282,239,-33,146,29,43,-4,19,20845,13.534592402,11.470807036,-1.583835281,-20,1.3918552471,2.0637853663,-0.191980034
21,167,2002,261,208,116,146,28,53,144,175,21020,12.46864923,9.9367013018,5.5416218799,-22,1.3376328676,2.5319479279,6.8792547474
21,167,2003,267,223,165,146,22,44,187,213,21233,12.638155871,10.555463517,7.8100963245,-18,1.0413461766,2.0826923532,8.8514425011
21,167,2004,275,264,104,146,26,11,130,126,21359,12.91322314,12.396694215,4.8835462059,-15,1.2208865515,0.5165289256,6.1044327573
21,167,2005,262,218,107,146,25,44,132,158,21517,12.221289299,10.168859035,4.991137233,-18,1.1661535591,2.052430264,6.1572907921
21,167,2006,240,244,59,146,27,-4,86,70,21587,11.135857461,11.321455085,2.7375649592,-12,1.2527839644,-0.185597624,3.9903489235
21,167,2007,272,235,124,146,24,37,148,176,21763,12.549019608,10.841983852,5.7208765859,-9,1.107266436,1.7070357555,6.8281430219
21,167,2008,272,232,92,146,26,40,118,157,21920,12.453357141,10.621981091,4.2121649154,-1,1.1903944326,1.8313760502,5.402559348
21,169,2001,132,121,64,127,1,11,65,68,10088,13.129102845,12.035010941,6.3656256216,-8,0.0994629003,1.0940919037,6.465088522
21,169,2002,126,143,-97,127,1,-17,-96,-119,9969,12.564192053,14.259360822,-9.672433564,-6,0.0997158099,-1.695168769,-9.572717754
21,169,2003,130,153,31,127,1,-23,32,-5,9964,13.043696383,15.351427281,3.1104199067,-14,0.100336126,-2.307730899,3.2107560327
21,169,2004,119,132,58,127,0,-13,58,37,10001,11.920861508,13.223140496,5.8101677936,-8,0,-1.302278988,5.8101677936
21,169,2005,150,117,55,127,1,33,56,81,10082,14.93800727,11.65164567,5.4772693323,-8,0.0995867151,3.2863615994,5.5768560474
21,169,2006,124,110,36,127,0,14,36,44,10126,12.272367379,10.886777514,3.5629453682,-6,0,1.3855898654,3.5629453682
21,169,2007,124,122,113,127,1,2,114,112,10238,12.178353958,11.981928894,11.098016107,-4,0.0982125319,0.1964250638,11.196228639
21,169,2008,134,129,49,127,0,5,49,50,10288,13.056611127,12.569424145,4.7744324272,-4,0,0.4871869824,4.7744324272
21,171,2001,136,136,43,131,13,0,56,46,11784,11.563642547,11.563642547,3.6561516878,-10,1.1053481847,0,4.7614998725
21,171,2002,128,125,-80,131,13,3,-67,-75,11709,10.896862895,10.641467671,-6.81053931,-11,1.1067126378,0.2553952241,-5.703826672
21,171,2003,146,151,-18,131,11,-5,-7,-27,11682,12.483433799,12.910948655,-1.539053482,-15,0.9405326835,-0.427514856,-0.598520799
21,171,2004,136,137,-89,131,13,-1,-76,-87,11595,11.685354642,11.771276367,-7.647033552,-10,1.116982429,-0.085921725,-6.530051123
21,171,2005,164,142,98,131,11,22,109,121,11716,14.070610441,12.183089529,8.4080477028,-10,0.9437604564,1.8875209129,9.3518081592
21,171,2006,131,122,-38,131,14,9,-24,-20,11696,11.190842303,10.422005809,-3.246198531,-5,1.1959678797,0.7688364941,-2.050230651
21,171,2007,152,149,-79,131,12,3,-67,-65,11631,13.032108715,12.774896043,-6.77326703,-1,1.028850688,0.257212672,-5.744416342
21,171,2008,148,135,-115,131,14,13,-101,-84,11547,12.770730865,11.648977479,-9.923203037,4,1.2080421089,1.1217533868,-8.715160928
21,173,2001,328,244,85,400,4,84,89,152,22815,14.424556929,10.730463081,3.7380711553,-21,0.1759092308,3.6940938476,3.9139803861
21,173,2002,327,209,242,400,4,118,246,347,23162,14.224503556,9.0915022729,10.527002632,-17,0.1740000435,5.1330012833,10.701002675
21,173,2003,321,237,203,400,4,84,207,274,23436,13.77741534,10.172110391,8.7128202927,-17,0.171681188,3.6053049487,8.8845014808
21,173,2004,358,207,116,400,2,151,118,251,23687,15.194278802,8.7855187488,4.9232858689,-18,0.0848842391,6.4087600535,5.008170108
21,173,2005,345,226,424,400,4,119,428,528,24215,14.404409002,9.4359316939,17.702809904,-19,0.1670076406,4.9684773078,17.869817544
21,173,2006,337,217,456,400,3,120,459,567,24782,13.755944241,8.8576851644,18.613384493,-12,0.1224564769,4.8982590771,18.73584097
21,173,2007,418,251,272,400,3,167,275,430,25212,16.722006641,10.041204945,10.881305757,-12,0.1200144017,6.6808016962,11.001320158
21,173,2008,361,222,270,400,2,139,272,406,25618,14.204210112,8.7349990163,10.623647452,-5,0.0786936848,5.4692110958,10.702341137
21,175,2001,150,114,70,1843,2,36,72,95,14062,10.703200257,8.1344321952,4.9948267865,-13,0.1427093368,2.5687680617,5.1375361233
21,175,2002,160,120,98,1843,2,40,100,129,14191,11.326230843,8.4946731321,6.9373163912,-11,0.1415778855,2.8315577107,7.0788942767
21,175,2003,147,119,-31,1843,2,28,-29,-21,14170,10.366348154,8.3918056486,-2.186100631,-20,0.1410387504,1.9745425056,-2.045061881
21,175,2004,156,128,79,1843,1,28,80,97,14267,10.971621479,9.0023560854,5.5561416464,-11,0.0703309069,1.9692653937,5.6264725534
21,175,2005,169,119,-114,1843,2,50,-112,-75,14192,11.876734952,8.3629080431,-8.011525352,-13,0.1405530764,3.5138269089,-7.870972276
21,175,2006,157,123,-40,1843,1,34,-39,-10,14182,11.066469303,8.6699090717,-2.819482625,-5,0.0704870656,2.3965602312,-2.748995559
21,175,2007,145,121,15,1843,2,24,17,43,14225,10.208751364,8.5190270004,1.0560777273,2,0.1408103636,1.6897243637,1.196888091
21,175,2008,153,126,-106,1843,1,27,-105,-69,14156,10.781861104,8.8791797329,-7.469786125,9,0.0704696804,1.9026813713,-7.399316444
21,177,2001,423,392,-90,1533,1,31,-89,-87,31709,13.321785686,12.345484608,-2.834422486,-29,0.0314935832,0.9763010787,-2.802928903
21,177,2002,351,379,-98,1533,0,-28,-98,-154,31555,11.096358118,11.981537683,-3.098128477,-28,0,-0.885179565,-3.098128477
21,177,2003,357,413,13,1533,-3,-56,10,-92,31463,11.330096163,13.107366149,0.4125805325,-46,-0.095210892,-1.777269986,0.3173696404
21,177,2004,367,380,13,1533,2,-13,15,-18,31445,11.66783239,12.081134355,0.4133019648,-20,0.0635849177,-0.413301965,0.4768868824
21,177,2005,380,357,-34,1533,0,23,-34,-42,31403,12.092668024,11.360743381,-1.08197556,-31,0,0.7319246436,-1.08197556
21,177,2006,382,369,-65,1533,2,13,-63,-63,31340,12.176657157,11.762268301,-2.071944281,-13,0.0637521317,0.4143888561,-2.008192149
21,177,2007,388,383,-36,1533,0,5,-36,-27,31313,12.385679856,12.226070579,-1.149186791,4,0,0.1596092765,-1.149186791
21,177,2008,365,369,-132,1533,2,-4,-130,-126,31187,11.68,11.808,-4.224,8,0.064,-0.128,-4.16
21,179,2001,517,324,322,705,32,193,354,517,38194,13.628395566,8.5408126952,8.4880916292,-30,0.8435370563,5.0875828709,9.3316286855
21,179,2002,521,302,386,705,31,219,417,603,38797,13.534049434,7.8450728007,10.02714603,-33,0.8052889299,5.6889766336,10.83243496
21,179,2003,541,301,426,705,21,240,447,658,39455,13.827122629,7.6930941062,10.887900629,-29,0.5367274958,6.1340285232,11.424628125
21,179,2004,564,320,459,705,28,244,487,690,40145,14.170854271,8.040201005,11.532663317,-41,0.7035175879,6.1306532663,12.236180905
21,179,2005,600,297,389,705,26,303,415,680,40825,14.820303816,7.336050389,9.6084969742,-38,0.6422131654,7.4842534272,10.25071014
21,179,2006,586,301,585,705,27,285,612,875,41700,14.201757043,7.2947591639,14.177521963,-22,0.6543471675,6.9069978794,14.831869131
21,179,2007,592,312,396,705,25,280,421,711,42411,14.076636825,7.4187680565,9.4161286871,10,0.5944525686,6.6578687687,10.010581256
21,179,2008,632,311,333,705,27,321,360,702,43113,14.779477106,7.27281231,7.7872877789,21,0.6314017118,7.5066647958,8.4186894907
21,181,2001,88,85,61,103,0,3,61,59,6843,12.915535334,12.475232993,8.9528142658,-5,0,0.4403023409,8.9528142658
21,181,2002,96,85,96,103,0,11,96,103,6946,13.924142432,12.328667779,13.924142432,-4,0,1.5954746537,13.924142432
21,181,2003,94,83,22,103,-1,11,21,23,6969,13.510600072,11.929572404,3.162055336,-9,-0.143729788,1.581027668,3.018325548
21,181,2004,99,99,36,103,0,0,36,30,6999,14.175257732,14.175257732,5.1546391753,-6,0,0,5.1546391753
21,181,2005,100,96,-40,103,0,4,-40,-42,6957,14.330753798,13.757523646,-5.732301519,-6,0,0.5732301519,-5.732301519
21,181,2006,84,92,-47,103,0,-8,-47,-58,6899,12.124711316,13.279445727,-6.784064665,-3,0,-1.154734411,-6.784064665
21,181,2007,85,93,-29,103,0,-8,-29,-42,6857,12.358243675,13.521372492,-4.21634196,-5,0,-1.163128817,-4.21634196
21,181,2008,90,86,-42,103,0,4,-42,-46,6811,13.169446883,12.584138133,-6.145741879,-8,0,0.5853087504,-6.145741879
21,183,2001,294,271,57,340,14,23,71,73,22989,12.809062194,11.806992702,2.483389609,-21,0.6099553426,1.0020694913,3.0933449515
21,183,2002,289,273,74,340,14,16,88,83,23072,12.548576887,11.853845987,3.213130414,-21,0.6078895378,0.6947309003,3.8210199518
21,183,2003,279,260,-59,340,13,19,-46,-57,23015,12.107535748,11.283008224,-2.560374943,-30,0.5641504112,0.824527524,-1.996224532
21,183,2004,325,256,202,340,12,69,214,261,23276,14.04160636,11.060465317,8.7273984144,-22,0.5184593117,2.9811410425,9.2458577261
21,183,2005,338,245,29,340,13,93,42,113,23389,14.486231651,10.500375013,1.2429015322,-22,0.5571627558,3.9858566377,1.800064288
21,183,2006,363,243,-113,340,12,120,-101,9,23398,15.517130827,10.387500802,-4.830401607,-10,0.5129630025,5.1296300254,-4.317438605
21,183,2007,347,266,45,340,12,81,57,140,23538,14.786091699,11.334583262,1.9175046872,2,0.5113345833,3.451508437,2.4288392705
21,183,2008,334,273,165,340,11,61,176,251,23789,14.114564625,11.536754918,6.9727639614,14,0.4648509308,2.5778097069,7.4376148921
21,185,2001,548,286,603,3880,27,262,630,858,47837,11.55923051,6.0327370908,12.719372258,-34,0.5695241309,5.5264934188,13.288896389
21,185,2002,511,246,845,3880,24,265,869,1114,48951,10.559160226,5.0832747861,17.460842253,-20,0.4959292474,5.4758854403,17.956771501
21,185,2003,566,274,975,3880,17,292,992,1276,50227,11.413821614,5.5254189437,19.661618504,-8,0.3428179637,5.8884026699,20.004436468
21,185,2004,553,249,1017,3880,26,304,1043,1284,51511,10.871060961,4.8949261829,19.992529832,-63,0.5111167902,5.9761347776,20.503646622
21,185,2005,538,310,1016,3880,24,228,1040,1226,52737,10.321540941,5.9473563042,19.491980661,-42,0.4604404881,4.3741846366,19.95242115
21,185,2006,547,324,1403,3880,26,223,1429,1621,54358,10.215229469,6.0507026472,26.201036463,-31,0.4855502124,4.164526822,26.686586675
21,185,2007,597,300,1080,3880,20,297,1100,1411,55769,10.842027841,5.4482551963,19.613718707,14,0.3632170131,5.3937726443,19.97693572
21,185,2008,651,314,725,3880,22,337,747,1105,56874,11.558641016,5.5751356054,12.872526477,21,0.3906145966,5.9835054109,13.263141074
21,187,2001,134,105,62,110,4,29,66,86,10660,12.621267778,9.8897993784,5.8396910615,-9,0.376754262,2.7314683997,6.2164453235
21,187,2002,139,105,174,110,4,34,178,208,10868,12.913415087,9.7547380156,16.164994426,-4,0.3716090673,3.1586770717,16.536603493
21,187,2003,122,112,31,110,2,10,33,31,10899,11.209629255,10.290807185,2.8483484173,-12,0.183764414,0.9188220701,3.0321128314
21,187,2004,145,106,184,110,6,39,190,214,11113,13.174632019,9.6311103035,16.718153734,-15,0.545157187,3.5435217154,17.263310921
21,187,2005,123,128,67,110,4,-5,71,55,11168,11.040797092,11.489609982,6.0140927247,-11,0.3590503119,-0.44881289,6.3731430367
21,187,2006,133,98,14,110,6,35,20,50,11218,11.882426517,8.7554721701,1.2507817386,-5,0.5360493165,3.1269543465,1.7868310551
21,187,2007,146,105,117,110,3,41,120,165,11383,12.919782311,9.2916242644,10.35352418,4,0.265474979,3.6281580461,10.618999159
21,187,2008,139,105,6,110,5,34,11,49,11432,12.184966031,9.2044707429,0.5259697567,4,0.4383081306,2.9804952882,0.9642778874
21,189,2001,51,75,-34,96,1,-24,-33,-60,4803,10.552451893,15.518311608,-7.034967929,-3,0.2069108214,-4.965859714,-6.828057107
21,189,2002,66,80,-44,96,1,-14,-43,-61,4742,13.829229963,16.762702986,-9.219486642,-4,0.2095337873,-2.933473023,-9.009952855
21,189,2003,54,67,-11,96,1,-13,-10,-29,4713,11.422527763,14.172395558,-2.326811211,-6,0.2115282919,-2.749867795,-2.115282919
21,189,2004,63,63,69,96,0,0,69,65,4778,13.275734907,13.275734907,14.540090612,-4,0,0,14.540090612
21,189,2005,62,77,-44,96,1,-15,-43,-63,4715,13.062256399,16.222479722,-9.269988413,-5,0.2106815548,-3.160223322,-9.059306858
21,189,2006,62,75,-60,96,0,-13,-60,-74,4641,13.253527148,16.032492518,-12.82599401,-1,0,-2.77896537,-12.82599401
21,189,2007,52,68,-25,96,1,-16,-24,-40,4601,11.252975546,14.715429561,-5.410084397,0,0.2164033759,-3.462454014,-5.193681021
21,189,2008,61,68,37,96,0,-7,37,33,4634,13.210611803,14.726583649,8.0129940444,3,0,-1.515971846,8.0129940444
21,191,2001,194,125,63,179,7,69,70,125,14613,13.332875159,8.5907700766,4.3297481186,-14,0.4810831243,4.7421050823,4.8108312429
21,191,2002,210,111,16,179,7,99,23,109,14722,14.317368331,7.5677518323,1.090847111,-13,0.477245611,6.7496164991,1.568092722
21,191,2003,174,100,62,179,6,74,68,124,14846,11.769480519,6.7640692641,4.1937229437,-18,0.4058441558,5.0054112554,4.5995670996
21,191,2004,169,126,-41,179,7,43,-34,0,14846,11.383537653,8.4871345817,-2.76168665,-9,0.4715074768,2.8964030715,-2.290179173
21,191,2005,183,135,33,179,7,48,40,76,14922,12.295081967,9.0701424348,2.2171459285,-12,0.4703036818,3.2249395324,2.6874496103
21,191,2006,187,135,40,179,7,52,47,91,15013,12.493736429,9.0195423417,2.6724569901,-8,0.4676799733,3.4741940872,3.1401369634
21,191,2007,164,134,-19,179,3,30,-16,7,15020,10.921319881,8.9235174641,-1.265274864,-7,0.1997802417,1.9978024173,-1.065494623
21,191,2008,178,130,-79,179,3,48,-76,-28,14992,11.861921898,8.6632013861,-5.264560842,0,0.199920032,3.1987205118,-5.06464081
21,193,2001,425,312,-198,383,15,113,-183,-95,29194,14.534138126,10.669767283,-6.771198468,-25,0.5129695809,3.8643708428,-6.258228887
21,193,2002,426,383,81,383,15,43,96,114,29308,14.563604663,13.093569451,2.7691360979,-25,0.5128029811,1.4700352125,3.281939079
21,193,2003,439,346,-44,383,14,93,-30,22,29330,14.973225553,11.801221051,-1.500733313,-41,0.4775060541,3.1720045022,-1.023227259
21,193,2004,401,338,-128,383,11,63,-117,-76,29254,13.68974464,11.538986754,-4.3697938,-22,0.3755291547,2.1507578861,-3.994264646
21,193,2005,400,340,-204,383,13,60,-191,-154,29100,13.70942866,11.653014361,-6.991808616,-23,0.4455564314,2.0564142989,-6.546252185
21,193,2006,370,385,105,383,12,-15,117,86,29186,12.696016196,13.210719555,3.6029235151,-16,0.4117626874,-0.514703359,4.0146862025
21,193,2007,399,387,-45,383,12,12,-33,-29,29157,13.677733404,13.266373001,-1.542601512,-8,0.4113604031,0.4113604031,-1.131241109
21,193,2008,382,365,55,383,11,17,66,84,29241,13.082639816,12.500428097,1.8836261516,1,0.3767252303,0.5822117196,2.2603513819
21,195,2001,745,771,-944,946,14,-26,-930,-1002,67487,10.957816085,11.340236512,-13.8848032,-46,0.2059186915,-0.382420427,-13.67888451
21,195,2002,750,773,-127,946,12,-23,-115,-201,67286,11.129825707,11.471140362,-1.884650486,-63,0.1780772113,-0.341314655,-1.706573275
21,195,2003,751,794,-513,946,8,-43,-505,-610,66676,11.212134784,11.854107881,-7.658888341,-62,0.1194368552,-0.641973097,-7.539451486
21,195,2004,785,767,-599,946,14,18,-585,-627,66049,11.828969674,11.557732153,-9.026181955,-60,0.2109625165,0.2712375212,-8.815219439
21,195,2005,788,807,-273,946,11,-19,-262,-342,65707,11.961504599,12.249916512,-4.144023802,-61,0.166975318,-0.288411913,-3.977048484
21,195,2006,736,775,-19,946,17,-39,-2,-70,65637,11.207211597,11.801071994,-0.289316604,-29,0.2588622244,-0.593860397,-0.030454379
21,195,2007,767,806,-97,946,13,-39,-84,-116,65521,11.695817259,12.290519831,-1.479132039,7,0.1982341908,-0.594702572,-1.280897848
21,195,2008,729,777,-168,946,15,-48,-153,-190,65331,11.142359307,11.876012594,-2.567786507,11,0.2292666524,-0.733653288,-2.338519854
21,197,2001,181,116,9,115,2,65,11,61,13341,13.598287067,8.7149243079,0.6761579204,-15,0.1502573157,4.8833627587,0.8264152361
21,197,2002,197,133,-122,115,2,64,-120,-66,13275,14.803125939,9.9939885783,-9.167418094,-10,0.1502855425,4.809137361,-9.017132552
21,197,2003,194,127,-50,115,1,67,-49,4,13279,14.611734579,9.5654138736,-3.765910974,-14,0.0753182195,5.046320705,-3.690592754
21,197,2004,183,144,156,115,0,39,156,184,13463,13.686336101,10.769575948,11.66704061,-11,0,2.9167601526,11.66704061
21,197,2005,197,142,111,115,1,55,112,163,13626,14.54464912,10.483960279,8.1952083872,-4,0.0738307062,4.0606888405,8.2690390934
21,197,2006,199,162,0,115,0,37,0,28,13654,14.589442815,11.876832845,0,-9,0,2.7126099707,0
21,197,2007,193,140,129,115,1,53,130,155,13809,14.055274369,10.195535812,9.394457998,-28,0.0728252558,3.8597385573,9.4672832538
21,197,2008,184,171,70,115,0,13,70,50,13859,13.300563828,12.36085008,5.0599971086,-33,0,0.9397137487,5.0599971086
21,199,2001,729,628,250,1220,24,101,274,323,56660,12.902997425,11.115339345,4.4248962362,-52,0.4247900387,1.7876580794,4.8496862749
21,199,2002,799,610,296,1220,23,189,319,459,57119,14.044771003,10.722541066,5.2030691077,-49,0.404292532,3.322229937,5.6073616397
21,199,2003,702,686,502,1220,10,16,512,478,57597,12.238920464,11.95997071,8.7520485373,-50,0.1743435964,0.2789497542,8.9263921336
21,199,2004,758,680,716,1220,14,78,730,751,58348,13.075164949,11.729699426,12.350683514,-57,0.2414938117,1.3454655224,12.592177325
21,199,2005,777,640,471,1220,14,137,485,570,58918,13.251922979,10.915354834,8.0330189484,-52,0.238773387,2.3365681442,8.2717923354
21,199,2006,737,622,441,1220,16,115,457,541,59459,12.45174316,10.508798162,7.4507716871,-31,0.2703227823,1.9429449978,7.7210944694
21,199,2007,779,680,483,1220,11,99,494,601,60060,13.0355843,11.378943934,8.0823969411,8,0.1840711519,1.6566403668,8.2664680929
21,199,2008,777,690,661,1220,13,87,674,791,60851,12.852428646,11.413353624,10.93366195,30,0.2150341987,1.4390750221,11.148696148
21,201,2001,20,35,-4,70,1,-15,-3,-20,2244,8.8731144632,15.527950311,-1.774622893,-2,0.4436557232,-6.654835847,-1.330967169
21,201,2002,22,33,44,70,1,-11,45,33,2277,9.7323600973,14.598540146,19.464720195,-1,0.4423800044,-4.866180049,19.907100199
21,201,2003,26,31,16,70,1,-5,17,10,2287,11.393514461,13.584574934,7.0113935145,-2,0.4382120947,-2.191060473,7.4496056091
21,201,2004,17,24,-6,70,0,-7,-6,-15,2272,7.457775828,10.528624698,-2.632156175,-2,0,-3.07084887,-2.632156175
21,201,2005,26,29,-49,70,1,-3,-48,-52,2220,11.576135352,12.911843277,-21.81656278,-1,0.4452359751,-1.335707925,-21.3713268
21,201,2006,25,29,46,70,0,-4,46,40,2260,11.160714286,12.946428571,20.535714286,-2,0,-1.785714286,20.535714286
21,201,2007,14,20,-72,70,1,-6,-71,-77,2183,6.3020481657,9.0029259509,-32.41053342,0,0.4501462975,-2.700877785,-31.96038713
21,201,2008,20,19,21,70,0,1,21,19,2202,9.1220068415,8.6659064994,9.5781071836,-3,0,0.4561003421,9.5781071836
21,203,2001,197,180,-116,310,-1,17,-117,-114,16522,11.88250196,10.85710839,-6.996803185,-14,-0.060317269,1.0253935702,-7.057120454
21,203,2002,232,177,2,310,-2,55,0,38,16560,14.025754187,10.700683151,0.120911674,-17,-0.120911674,3.3250710356,0
21,203,2003,208,191,-9,310,-4,17,-13,-20,16540,12.567975831,11.540785498,-0.543806647,-24,-0.241691843,1.0271903323,-0.785498489
21,203,2004,223,189,-20,310,1,34,-19,5,16545,13.480429198,11.425117123,-1.209007103,-10,0.0604503551,2.055312075,-1.148556748
21,203,2005,200,179,7,310,-1,21,6,12,16557,12.083862002,10.815056492,0.4229351701,-15,-0.06041931,1.2688055102,0.3625158601
21,203,2006,194,179,17,310,1,15,18,25,16582,11.708259151,10.802981381,1.025981472,-8,0.0603518513,0.9052777694,1.0863333233
21,203,2007,191,193,79,310,-1,-2,78,76,16658,11.492178099,11.612515042,4.7533092659,0,-0.060168472,-0.120336943,4.6931407942
21,203,2008,199,189,110,310,1,10,111,130,16788,11.899778748,11.301799916,6.577767147,9,0.0597978832,0.5979788315,6.6375650302
21,205,2001,261,160,124,3156,9,101,133,214,22283,11.769480519,7.215007215,5.5916305916,-20,0.4058441558,4.5544733045,5.9974747475
21,205,2002,258,170,-99,3156,8,88,-91,-24,22259,11.584571865,7.6332450272,-4.445242692,-21,0.3592115307,3.9513268376,-4.086031162
21,205,2003,259,170,-100,3156,4,89,-96,-37,22222,11.645421641,7.643713046,-4.496301792,-30,0.1798520717,4.0017085947,-4.31644972
21,205,2004,251,212,-231,3156,11,39,-220,-199,22023,11.345914793,9.5830037292,-10.44185784,-18,0.4972313256,1.7629110634,-9.944626511
21,205,2005,244,204,96,3156,8,40,104,123,22146,11.048472911,9.2372478435,4.3469401617,-21,0.3622450135,1.8112250674,4.7091851751
21,205,2006,264,180,179,3156,10,84,189,262,22408,11.850787808,8.0800825964,8.0351932486,-11,0.4488934776,3.7707052117,8.4840867262
21,205,2007,276,188,77,3156,7,88,84,165,22573,12.271848114,8.359084947,3.4236677708,-7,0.3112425246,3.9127631667,3.7349102955
21,205,2008,269,195,93,3156,9,74,102,160,22733,11.874806869,8.6081313733,4.1054165011,-16,0.3972983711,3.2666754955,4.5027148722
21,207,2001,204,209,56,171,4,-5,60,40,16368,12.478590653,12.784438463,3.4254954735,-15,0.2446782481,-0.30584781,3.6701737216
21,207,2002,193,191,55,171,4,2,59,45,16413,11.775113633,11.65309173,3.3556023306,-16,0.2440438059,0.1220219029,3.5996461365
21,207,2003,201,196,94,171,4,5,98,88,16501,12.213647688,11.909825606,5.7118551376,-15,0.2430576654,0.3038220818,5.9549128031
21,207,2004,205,195,251,171,3,10,254,245,16746,12.331939724,11.730381689,15.099106686,-19,0.1804674106,0.6015580353,15.279574097
21,207,2005,201,157,95,171,4,44,99,128,16874,11.957168352,9.3396787626,5.6513979774,-15,0.237953599,2.6174895895,5.8893515764
21,207,2006,212,197,154,171,3,15,157,163,17037,12.503317508,11.618648816,9.0825985668,-9,0.1769337383,0.8846686916,9.2595323052
21,207,2007,186,204,88,171,4,-18,92,81,17118,10.891523935,11.94554238,5.152979066,7,0.2342263212,-1.054018445,5.3872053872
21,207,2008,205,188,156,171,3,17,159,178,17296,11.91375603,10.925786017,9.0660777591,2,0.1743476492,0.9879700122,9.2404254083
21,209,2001,536,247,761,1468,41,289,802,1075,34488,15.787690903,7.2752978601,22.414986524,-16,1.2076405355,8.5123930428,23.62262706
21,209,2002,553,227,652,1468,39,326,691,999,35487,15.805644873,6.4880314398,18.635226867,-18,1.1146838156,9.3176134334,19.749910682
21,209,2003,532,235,707,1468,33,297,740,1031,36518,14.776751614,6.5273244914,19.637525172,-6,0.9166030137,8.2494271231,20.554128186
21,209,2004,622,237,905,1468,35,385,940,1272,37790,16.741131507,6.3788555741,24.358077192,-53,0.9420250848,10.362275933,25.300102277
21,209,2005,608,214,1104,1468,35,394,1139,1503,39293,15.775203352,5.5524564431,28.644448192,-30,0.9081120351,10.222746909,29.552560227
21,209,2006,665,227,1596,1468,37,438,1633,2045,41338,16.494896504,5.6305887314,39.587751609,-26,0.9177611589,10.864307772,40.505512768
21,209,2007,688,267,1046,1468,32,421,1078,1490,42828,16.348644346,6.3446047097,24.855642421,-9,0.7604020626,10.004039636,25.616044484
21,209,2008,714,236,1228,1468,34,478,1262,1721,44549,16.342973551,5.4018792131,28.108083363,-19,0.7782368358,10.941094338,28.886320199
21,211,2001,528,284,175,1488,129,244,304,519,34064,15.619222293,8.4012483545,5.1768255706,-29,3.816059992,7.2179739384,8.9928855626
21,211,2002,477,265,427,1488,120,212,547,738,34802,13.852989864,7.6961054802,12.400894491,-21,3.4850288967,6.1568843842,15.885923387
21,211,2003,546,278,593,1488,95,268,688,941,35743,15.479481182,7.8814940818,16.811963995,-15,2.6933163229,7.5979871004,19.505280318
21,211,2004,492,295,774,1488,95,197,869,1019,36762,13.571477829,8.1373698366,21.350251707,-47,2.6205089304,5.4341079926,23.970760637
21,211,2005,554,267,765,1488,97,287,862,1117,37879,14.844388473,7.154244986,20.498117657,-32,2.599107729,7.6901434868,23.097225386
21,211,2006,586,257,1016,1488,99,329,1115,1422,39301,15.185281161,6.6597564136,26.328064265,-22,2.5654314589,8.5255247473,28.893495724
21,211,2007,583,293,669,1488,86,290,755,1044,40345,14.639781031,7.3575571906,16.799337067,-1,2.1595560355,7.2822238405,18.958893102
21,211,2008,593,297,423,1488,88,296,511,812,41157,14.55179014,7.2881647076,10.380113371,5,2.1594562097,7.2636254325,12.539569581
21,213,2001,225,157,103,236,12,68,115,169,16582,13.638430065,9.5165934232,6.2433702076,-14,0.7273829368,4.1218366419,6.9707531444
21,213,2002,224,180,-27,236,12,44,-15,12,16594,13.503737642,10.851217748,-1.627682662,-17,0.7234145165,2.6525198939,-0.904268146
21,213,2003,212,172,10,236,9,40,19,35,16629,12.762243024,10.354272642,0.6019925955,-24,0.5417933359,2.407970382,1.1437859314
21,213,2004,209,185,89,236,8,24,97,108,16737,12.527722832,11.08913265,5.3347719235,-13,0.4795300605,1.4385901816,5.8143019841
21,213,2005,207,163,112,236,9,44,121,149,16886,12.31300003,9.6957439848,6.6621062963,-16,0.5353478274,2.617256045,7.1974541237
21,213,2006,207,173,26,236,8,34,34,60,16946,12.236935446,10.22700402,1.5370063845,-8,0.4729250414,2.0099314259,2.0099314259
21,213,2007,220,160,27,236,9,60,36,99,17045,12.944602983,9.414256715,1.5886558207,3,0.5295519402,3.5303462681,2.1182077609
21,213,2008,213,172,-82,236,8,41,-74,-26,17019,12.505871301,10.098637858,-4.814466886,7,0.4697040864,2.4072334429,-4.344762799
21,215,2001,192,93,592,119,3,99,595,693,12687,15.558526802,7.5361614197,47.972124306,-1,0.2431019813,8.0223653823,48.215226287
21,215,2002,176,95,615,119,3,81,618,707,13394,13.496415015,7.2849967409,47.160768375,8,0.2300525287,6.2114182738,47.390820904
21,215,2003,182,77,587,119,0,105,587,721,14115,13.232033153,5.5981678723,42.676942092,29,0,7.6338652805,42.676942092
21,215,2004,186,99,450,119,4,87,454,520,14635,12.939130435,6.8869565217,31.304347826,-21,0.2782608696,6.052173913,31.582608696
21,215,2005,180,99,559,119,2,81,561,628,15263,12.040939193,6.6225165563,37.393805606,-14,0.1337882133,5.418422637,37.527593819
21,215,2006,178,89,680,119,3,89,683,763,16026,11.377800505,5.6889002525,43.465754738,-9,0.1917606827,5.6889002525,43.657515421
21,215,2007,206,116,670,119,2,90,672,772,16798,12.551791372,7.0679990251,40.823787473,10,0.1218620522,5.4837923471,40.945649525
21,215,2008,211,106,469,119,4,105,473,584,17382,12.346401404,6.2024575775,27.442949093,6,0.2340550029,6.1439438268,27.677004096
21,217,2001,272,266,28,672,8,6,36,19,22936,11.864000174,11.602294288,1.2212941356,-23,0.3489411816,0.2617058862,1.5702353172
21,217,2002,294,256,313,672,7,38,320,344,23280,12.72286654,11.078414402,13.545092609,-14,0.3029253938,1.6444521378,13.848018002
21,217,2003,279,252,37,672,4,27,41,32,23312,11.976304945,10.817307692,1.5882554945,-36,0.1717032967,1.1589972527,1.7599587912
21,217,2004,279,242,96,672,5,37,101,121,23433,11.937105573,10.354048561,4.1073911648,-17,0.2139266232,1.5830570114,4.321317788
21,217,2005,290,275,167,672,5,15,172,168,23601,12.331504869,11.69366841,7.1012459072,-19,0.2126121529,0.6378364587,7.3138580601
21,217,2006,287,224,124,672,5,63,129,179,23780,12.114560689,9.4552668791,5.2341655938,-13,0.2110550643,2.6592938098,5.4452206581
21,217,2007,293,271,104,672,5,22,109,129,23909,12.287949003,11.365304368,4.3615928201,-2,0.2096919625,0.922644635,4.5712847827
21,217,2008,291,254,107,672,5,37,112,160,24069,12.13055984,10.588186252,4.4603776731,11,0.2084288632,1.5423735879,4.6688065363
21,219,2001,187,120,12,126,7,67,19,74,12017,15.609348915,10.016694491,1.0016694491,-12,0.5843071786,5.592654424,1.5859766277
21,219,2002,167,132,-102,126,6,35,-96,-68,11949,13.936409914,11.015605441,-8.51205875,-7,0.5007093382,2.920804473,-8.011349412
21,219,2003,181,138,-118,126,2,43,-116,-85,11864,15.20178054,11.590307815,-9.910553059,-12,0.1679754756,3.611472725,-9.742577584
21,219,2004,170,144,-112,126,9,26,-103,-87,11777,14.38179434,12.182225794,-9.475064507,-10,0.7613891121,2.1995685462,-8.713675394
21,219,2005,201,125,7,126,6,76,13,77,11854,17.011552622,10.57932377,0.5924421311,-12,0.5078075409,6.4322288519,1.100249672
21,219,2006,191,121,6,126,8,70,14,78,11932,16.059867149,10.174051963,0.5044984445,-6,0.6726645926,5.8858151854,1.1771630371
21,219,2007,183,148,52,126,3,35,55,91,12023,15.278647464,12.356501774,4.3414735963,1,0.2504696306,2.9221456898,4.5919432269
21,219,2008,186,122,81,126,5,64,86,150,12173,15.374442057,10.084311456,6.6953215408,0,0.4132914531,5.2901306001,7.1086129939
21,221,2001,143,148,66,111,3,-5,69,53,12686,11.295864766,11.690825072,5.2134760457,-11,0.2369761839,-0.394960306,5.4504522296
21,221,2002,119,159,63,111,-4,-40,59,9,12695,9.3770931011,12.529057169,4.9643434065,-10,-0.315196407,-3.151964068,4.6491469997
21,221,2003,128,162,104,111,-19,-34,85,39,12734,10.067246058,12.741358292,8.1796374218,-12,-1.494356837,-2.674112234,6.6852805852
21,221,2004,153,152,304,111,13,1,317,298,13032,11.876115812,11.79849414,23.596988279,-20,1.0090817356,0.077621672,24.606070015
21,221,2005,152,151,85,111,2,1,87,75,13107,11.630131222,11.5536172,6.5036918015,-13,0.1530280424,0.0765140212,6.6567198439
21,221,2006,132,146,69,111,8,-14,77,56,13163,10.049486106,11.115340693,5.2531404644,-7,0.609059764,-1.065854587,5.8622002284
21,221,2007,149,154,213,111,-1,-5,212,212,13375,11.229180797,11.605998945,16.052453086,5,-0.07536363,-0.376818148,15.977089457
21,221,2008,155,147,24,111,3,8,27,43,13418,11.570186243,10.97301534,1.7915127085,8,0.2239390886,0.5971709028,2.0154517971
21,223,2001,103,90,225,55,1,13,226,235,8410,12.420862225,10.853180585,27.132951462,-4,0.1205908954,1.56768164,27.253542358
21,223,2002,94,70,115,55,1,24,116,135,8545,11.08817458,8.2571512828,13.565319965,-5,0.117959304,2.831023297,13.683279269
21,223,2003,103,69,66,55,1,34,67,93,8638,11.988593377,8.0311936216,7.6820112902,-8,0.1163941105,3.9573997556,7.7984054007
21,223,2004,123,80,177,55,0,43,177,208,8846,14.070006863,9.1512239762,20.247083047,-12,0,4.9187828872,20.247083047
21,223,2005,110,93,-50,55,1,17,-49,-39,8807,12.462470968,10.536452728,-5.664759531,-7,0.1132951906,1.9260182405,-5.55146434
21,223,2006,102,89,64,55,0,13,64,73,8880,11.533894951,10.063888732,7.2369536948,-4,0,1.4700062193,7.2369536948
21,223,2007,125,79,25,55,1,46,26,74,8954,14.018167545,8.8594818885,2.803633509,2,0.1121453404,5.1586856566,2.9157788494
21,223,2008,118,89,28,55,0,29,28,58,9012,13.135923411,9.9076032506,3.1169987755,1,0,3.2283201603,3.1169987755
21,225,2001,209,166,-149,1389,3,43,-146,-115,15486,13.44613504,10.679705343,-9.586000579,-12,0.1930067231,2.7664296973,-9.392993856
21,225,2002,197,181,26,1389,3,16,29,28,15514,12.709677419,11.677419355,1.6774193548,-17,0.1935483871,1.0322580645,1.8709677419
21,225,2003,188,199,-28,1389,2,-11,-26,-57,15457,12.140389397,12.850731329,-1.808143102,-20,0.1291530787,-0.710341933,-1.678990023
21,225,2004,192,166,-30,1389,1,26,-29,-14,15443,12.427184466,10.74433657,-1.941747573,-11,0.0647249191,1.6828478964,-1.877022654
21,225,2005,149,163,-69,1389,2,-14,-67,-95,15348,9.678152707,10.587509337,-4.481829106,-14,0.12990809,-0.90935663,-4.351921016
21,225,2006,184,138,-146,1389,1,46,-145,-105,15243,12.029681933,9.0222614494,-9.545291099,-6,0.0653787062,3.0074204831,-9.479912393
21,225,2007,207,167,-141,1389,2,40,-139,-97,15146,13.623350554,10.990819046,-9.279673566,2,0.1316265754,2.6325315081,-9.148046991
21,225,2008,164,170,-125,1389,1,-6,-124,-122,15024,10.871726881,11.269472986,-8.286377196,8,0.0662910176,-0.397746105,-8.220086178
21,227,2001,1231,760,3,5559,377,471,380,757,93568,13.209642717,8.1554252357,0.032192468,-94,4.0455201498,5.0542174816,4.0777126178
21,227,2002,1264,805,140,5559,352,459,492,858,94426,13.447237678,8.5641031097,1.4894092365,-93,3.744800366,4.8831345681,5.2342096024
21,227,2003,1267,791,841,5559,304,476,1145,1537,95963,13.309592466,8.3093035837,8.8345440125,-84,3.1934618071,5.0002888822,12.02800582
21,227,2004,1309,781,754,5559,291,528,1045,1490,97453,13.535591678,8.0758572197,7.7966662531,-83,3.0090581958,5.4597344584,10.805724449
21,227,2005,1412,798,1158,5559,300,614,1458,1989,99442,14.342669951,8.1058432159,11.762614592,-83,3.0473094797,6.2368267351,14.809924071
21,227,2006,1412,771,1686,5559,301,641,1987,2572,102014,14.017949329,7.6542768644,16.738146295,-56,2.9882455722,6.3636724645,19.726391867
21,227,2007,1459,798,811,5559,271,661,1082,1731,103745,14.181639685,7.7566473398,7.8830087627,-12,2.6341496605,6.4249923454,10.517158423
21,227,2008,1502,847,1187,5559,274,655,1461,2117,105862,14.331582438,8.0817911616,11.325957625,1,2.6144165033,6.2497912761,13.940374129
21,229,2001,151,134,54,335,4,17,58,66,10981,13.792473511,12.23967848,4.9324077457,-9,0.3653635367,1.5527950311,5.2977712824
21,229,2002,122,103,121,335,3,19,124,135,11116,11.042222926,9.3225324705,10.951712902,-8,0.271530072,1.7196904557,11.223242974
21,229,2003,155,121,43,335,-2,34,41,60,11176,13.906334111,10.855912435,3.8578862372,-15,-0.179436569,3.0504216759,3.678449668
21,229,2004,159,118,-11,335,3,41,-8,25,11201,14.211020244,10.546543326,-0.983152344,-8,0.2681324574,3.6644769183,-0.715019886
21,229,2005,125,101,46,335,1,24,47,61,11262,11.129412812,8.9925655522,4.0956239149,-10,0.0890353025,2.1368472599,4.1846592174
21,229,2006,138,113,80,335,3,25,83,102,11364,12.198355874,9.9885087952,7.0715106515,-6,0.2651816494,2.2098470786,7.3366923009
21,229,2007,143,127,172,335,0,16,172,182,11546,12.483631602,11.086861632,15.015277172,-6,0,1.3967699694,15.015277172
21,229,2008,150,112,10,335,2,38,12,49,11595,12.964003284,9.6797891189,0.8642668856,-1,0.1728533771,3.2842141653,1.0371202627
21,231,2001,258,232,-61,184,28,26,-33,-27,19958,12.918408732,11.616553589,-3.054352452,-20,1.4019978469,1.3018551436,-1.652354605
21,231,2002,217,194,75,184,27,23,102,108,20066,10.843493904,9.6941834899,3.7477513492,-17,1.3491904857,1.1493104138,5.0969418349
21,231,2003,241,220,214,184,24,21,238,247,20313,11.936897892,10.896753263,10.599569083,-12,1.1887367196,1.0401446296,11.788305803
21,231,2004,255,229,71,184,20,26,91,101,20414,12.522405284,11.24561102,3.4866304908,-16,0.982149434,1.2767942642,4.4687799249
21,231,2005,254,221,-16,184,23,33,7,21,20435,12.436044946,10.820338319,-0.78337291,-19,1.1260985581,1.6157066268,0.3427256481
21,231,2006,219,182,-84,184,22,37,-62,-35,20400,10.726092813,8.9139218807,-4.114117791,-10,1.0775070405,1.8121709318,-3.036610751
21,231,2007,261,220,124,184,21,41,145,192,20592,12.734192037,10.733801717,6.049960968,6,1.0245901639,2.0003903201,7.0745511319
21,231,2008,250,222,51,184,20,28,71,104,20696,12.110056191,10.753729897,2.4704514629,5,0.9688044953,1.3563262934,3.4392559581
21,233,2001,182,150,-201,257,24,32,-177,-156,13956,12.968505059,10.688328345,-14.32235998,-11,1.7101325353,2.2801767137,-12.61222745
21,233,2002,195,147,-26,257,24,48,-2,30,13986,13.957483358,10.521795147,-1.860997781,-16,1.7178441056,3.4356882113,-0.143153675
21,233,2003,190,180,-104,257,22,10,-82,-84,13902,13.625932301,12.908777969,-7.458405049,-12,1.5777395295,0.7171543316,-5.880665519
21,233,2004,198,155,-3,257,19,43,16,49,13951,14.217499013,11.129860338,-0.215416652,-10,1.3643054608,3.0876386745,1.1488888091
21,233,2005,189,152,-27,257,22,37,-5,19,13970,13.538197056,10.887862183,-1.934028151,-13,1.5758747896,2.6503348734,-0.358153361
21,233,2006,208,161,-190,257,20,47,-170,-128,13842,14.957572271,11.577736229,-13.66316698,-5,1.438228103,3.379836042,-12.22493888
21,233,2007,186,166,-23,257,18,20,-5,16,13858,13.429602888,11.985559567,-1.660649819,1,1.2996389892,1.4440433213,-0.36101083
21,233,2008,193,152,-249,257,17,41,-232,-189,13669,14.022595997,11.043702547,-18.09132851,2,1.2351509427,2.9788934501,-16.85617757
21,235,2001,489,394,403,1205,9,95,412,475,36446,13.505116202,10.88142287,11.129983291,-32,0.2485604209,2.6236933317,11.378543712
21,235,2002,490,420,184,1205,9,70,193,227,36673,13.402809119,11.488122102,5.0328915877,-36,0.246174045,1.9146870171,5.2790656327
21,235,2003,528,415,227,1205,8,113,235,308,36981,14.337306867,11.268905966,6.1639557933,-40,0.2172319222,3.0684009015,6.3811877155
21,235,2004,486,508,400,1205,7,-22,407,351,37332,13.079811069,13.671901282,10.7652766,-34,0.1883923405,-0.592090213,10.953668941
21,235,2005,398,400,390,1205,8,-2,398,369,37701,10.608665521,10.661975397,10.395426013,-27,0.2132395079,-0.053309877,10.608665521
21,235,2006,470,415,203,1205,7,55,210,245,37946,12.42613719,10.972014753,5.3670337224,-20,0.1850701284,1.4541224371,5.5521038508
21,235,2007,497,449,354,1205,6,48,360,378,38324,13.032647175,11.773960928,9.2828110659,-30,0.1573357808,1.2586862462,9.4401468467
21,235,2008,488,466,347,1205,5,22,352,344,38668,12.676641729,12.105153782,9.0139235245,-30,0.1298836243,0.5714879468,9.1438071488
21,237,2001,106,86,-207,152,4,20,-203,-185,6910,15.13745091,12.281328097,-29.56087112,-2,0.5712245627,2.8561228133,-28.98964655
21,237,2002,125,88,-11,152,4,37,-7,24,6934,18.058364634,12.713088703,-1.589136088,-6,0.5778676683,5.3452759318,-1.01126842
21,237,2003,116,110,6,152,4,6,10,6,6940,16.721925905,15.856998703,0.864927202,-10,0.5766181346,0.864927202,1.4415453366
21,237,2004,112,95,-20,152,3,17,-17,-4,6936,16.142980686,13.692706832,-2.882675123,-4,0.4324012684,2.4502738541,-2.450273854
21,237,2005,108,107,93,152,4,1,97,93,7029,15.467239527,15.324024347,13.319011815,-5,0.5728607232,0.1432151808,13.891872538
21,237,2006,118,87,-52,152,3,31,-49,-21,7008,16.812709268,12.395811071,-7.408990525,-3,0.4274417611,4.4168981976,-6.981548764
21,237,2007,125,94,5,152,4,31,9,37,7045,17.789795773,13.377926421,0.7115918309,-3,0.5692734647,4.4118693517,1.2808652957
21,237,2008,113,108,-64,152,3,5,-61,-56,6989,16.10374804,15.391192817,-9.120706855,0,0.4275331338,0.712555223,-8.693173721
21,239,2001,323,197,-100,366,62,126,-38,67,23339,13.859389415,8.4529402931,-4.290832636,-21,2.6603162344,5.4064491215,-1.630516402
21,239,2002,305,202,-56,366,59,103,3,85,23424,13.044500994,8.6393088553,-2.39505592,-21,2.5233624874,4.4051921391,0.1283065672
21,239,2003,329,181,-27,366,50,148,23,140,23564,14.003575381,7.7040946625,-1.149229591,-31,2.1282029454,6.2994807185,0.9789733549
21,239,2004,294,195,11,366,48,99,59,143,23707,12.438916037,8.2503014533,0.4654016204,-15,2.0308434347,4.188614584,2.4962450551
21,239,2005,296,187,95,366,48,109,143,231,23938,12.425228251,7.8497219016,3.9878266345,-21,2.0149018785,4.575506349,6.002728513
21,239,2006,263,213,76,366,48,50,124,162,24100,10.949664849,8.8679795162,3.1641617053,-12,1.9984179191,2.0816853324,5.1625796245
21,239,2007,287,208,-19,366,43,79,24,104,24204,11.883073866,8.6121232196,-0.786684333,1,1.7803908579,3.2709506459,0.9937065253
21,239,2008,307,199,171,366,45,108,216,322,24526,12.600041042,8.1674533142,7.0182639031,-2,1.8469115535,4.4325877283,8.8651754566
22,0,2001,66431,42004,-33945,134953,3630,24427,-30315,-8484,4460395,14.879373172,9.408155691,-7.603081729,-2596,0.8130560222,5.4712174808,-6.790025706
22,0,2002,65211,41328,-18993,134790,2513,23883,-16480,4820,4465215,14.612110545,9.2605435371,-4.255843578,-2583,0.5630987686,5.3515670077,-3.69274481
22,0,2003,64539,42027,-10584,134810,112,22512,-10472,8343,4473558,14.440236932,9.4033040105,-2.368110254,-3697,0.0250593678,5.0369329213,-2.343050886
22,0,2004,65463,42647,-9846,133889,4122,22816,-5724,14272,4487830,14.610013538,9.5179452112,-2.197427452,-2820,0.9199467761,5.0920683269,-1.277480676
22,0,2005,65252,42801,-14335,132561,2747,22451,-11588,7797,4495627,14.527146955,9.5288484155,-3.191421743,-3066,0.6115685754,4.9982985392,-2.579853168
22,0,2006,58648,42803,-271330,123239,3632,15845,-267698,-251993,4243634,13.421729824,9.7955650941,-62.09449518,-140,0.8311915618,3.6261647295,-61.26330361
22,0,2007,64109,39785,27500,123036,2504,24324,30004,129676,4373310,14.879753193,9.2341321935,6.3827732895,75348,0.5811805206,5.6456209997,6.9639538101
22,0,2008,63649,40557,13555,123036,2868,23092,16423,37486,4410796,14.491856086,9.234178185,3.0862560174,-2029,0.6529975845,5.2576779014,3.7392536019
22,1,2001,904,631,-318,982,8,273,-310,-87,58732,15.380558226,10.735765753,-5.410417606,-50,0.1361111347,4.6447924731,-5.274306471
22,1,2002,924,630,-179,982,8,294,-171,71,58803,15.722976135,10.720211001,-3.045901221,-52,0.1361296635,5.0027651338,-2.909771557
22,1,2003,885,576,-301,982,5,309,-296,-56,58747,15.057422373,9.8000850702,-5.121225011,-69,0.0850701829,5.2573373033,-5.036154828
22,1,2004,949,626,-395,982,8,323,-387,-114,58633,16.169705231,10.666212302,-6.73027773,-50,0.1363094224,5.5034929289,-6.593968308
22,1,2005,960,656,-120,982,7,304,-113,135,58768,16.354204819,11.175373293,-2.044275602,-56,0.1192494101,5.1788315261,-1.925026192
22,1,2006,912,639,632,982,8,273,640,880,59648,15.403323875,10.792460478,10.674233212,-33,0.1351168761,4.6108633968,10.809350088
22,1,2007,946,661,-137,982,5,285,-132,155,59803,15.83913069,11.067299562,-2.293827595,2,0.0837163356,4.7718311274,-2.210111259
22,1,2008,1001,640,-104,982,7,361,-97,267,60070,16.701008567,10.677967516,-1.735169721,3,0.1167902697,6.0230410518,-1.618379452
22,3,2001,336,225,-97,4199,0,111,-97,-11,25399,13.226003267,8.8566986164,-3.818221181,-25,0,4.3693046508,-3.818221181
22,3,2002,336,231,-372,4012,0,105,-372,-283,25116,13.302979313,9.1457982777,-14.72829853,-16,0,4.1571810353,-14.72829853
22,3,2003,316,218,14,3983,-1,98,13,75,25191,12.562864015,8.6667859344,0.5565825829,-36,-0.039755899,3.8960780806,0.5168266842
22,3,2004,353,247,-85,4018,2,106,-83,6,25197,14.011272525,9.8039215686,-3.373819163,-17,0.0793839803,4.2073509566,-3.294435183
22,3,2005,337,254,-391,3737,0,83,-391,-325,24872,13.461423236,10.145998522,-15.61844654,-17,0,3.3154247139,-15.61844654
22,3,2006,342,192,573,4138,1,150,574,710,25582,13.556903318,7.6108930907,22.713759068,-14,0.0396400682,5.9460102271,22.753399136
22,3,2007,354,142,-189,4138,0,212,-189,-9,25573,13.840289317,5.5517544717,-7.389307008,-32,0,8.2885348451,-7.389307008
22,3,2008,336,223,-38,4138,2,113,-36,62,25635,13.122949539,8.7095766287,-1.484143103,-15,0.0781127949,4.4133729105,-1.406030308
22,5,2001,1337,518,960,646,89,819,1049,1808,79086,17.101123021,6.6255659871,12.279041212,-60,1.1383694457,10.475557034,13.417410657
22,5,2002,1351,495,1182,646,84,856,1266,2078,81164,16.861154446,6.1778471139,14.751950078,-44,1.0483619345,10.683307332,15.800312012
22,5,2003,1386,558,1564,646,65,828,1629,2445,83609,16.823144569,6.7729543068,18.983692717,-12,0.7889642114,10.050190262,19.772656928
22,5,2004,1468,563,1401,646,71,905,1472,2279,85888,17.321840505,6.6431854251,16.53126604,-98,0.8377729399,10.678655079,17.36903898
22,5,2005,1472,554,2311,646,71,918,2382,3230,89118,16.822280379,6.3312115013,26.410523068,-70,0.811400752,10.491068878,27.22192382
22,5,2006,1593,542,5350,646,73,1051,5423,6400,95518,17.255573128,5.8710110704,57.951862042,-74,0.7907450335,11.384562057,58.742607076
22,5,2007,1678,646,2439,646,65,1032,2504,3571,99089,17.245011742,6.6390212068,25.065902049,35,0.6680129697,10.605990535,25.733915018
22,5,2008,1724,653,1531,646,67,1071,1598,2700,101789,17.164647199,6.5014585968,15.243082866,31,0.6670715559,10.663188602,15.910154422
22,7,2001,324,209,-312,200,8,115,-304,-205,23174,13.919618499,8.9790131678,-13.40407707,-16,0.3436942839,4.9406053316,-13.06038279
22,7,2002,293,195,-150,200,8,98,-142,-63,23111,12.660689208,8.4260559577,-6.481581506,-19,0.345684347,4.2346332505,-6.135897159
22,7,2003,289,183,-127,200,5,106,-122,-43,23068,12.516511834,7.9256805041,-5.50033565,-27,0.2165486477,4.5908313303,-5.283787003
22,7,2004,254,206,-63,200,6,48,-57,-26,23042,11.017132943,8.935155064,-2.732595966,-17,0.2602472349,2.081977879,-2.472348731
22,7,2005,288,200,-281,200,5,88,-276,-206,22836,12.555037273,8.7187758839,-12.24988012,-18,0.2179693971,3.8362613889,-12.03191072
22,7,2006,250,194,129,200,6,56,135,179,23015,10.904887571,8.4621927548,5.6269219864,-12,0.2617173017,2.4426948158,5.8886392881
22,7,2007,290,175,-159,200,4,115,-155,-57,22958,12.616100755,7.6131642486,-6.917103517,-17,0.1740151828,5.0029365062,-6.743088334
22,7,2008,284,213,-141,200,6,71,-135,-77,22881,12.39119527,9.2933964528,-6.151966666,-13,0.2617858156,3.0977988176,-5.89018085
22,9,2001,636,466,-270,3088,0,170,-270,-133,41343,15.35879448,11.253456332,-6.520242939,-33,0,4.105338147,-6.520242939
22,9,2002,601,482,-55,3101,-1,119,-56,25,41368,14.532528926,11.655039838,-1.329931932,-38,-0.024180581,2.8774890885,-1.354112512
22,9,2003,643,502,166,3106,-5,141,161,244,41612,15.497710292,12.099301036,4.0009640877,-58,-0.120510966,3.3984092552,3.8804531212
22,9,2004,631,484,-242,3095,2,147,-240,-127,41485,15.187070532,11.649036668,-5.824518334,-34,0.0481365152,3.538033864,-5.776381819
22,9,2005,622,514,-233,3037,-1,108,-234,-163,41322,15.022884539,12.41440941,-5.627543565,-37,-0.024152547,2.6084751289,-5.651696113
22,9,2006,592,488,873,3048,1,104,874,953,42275,14.163187674,11.67506011,20.885916959,-25,0.0239243035,2.4881275644,20.909841262
22,9,2007,654,486,-326,3048,-1,168,-327,-144,42131,15.496528683,11.515769021,-7.724569343,15,-0.023694998,3.9807596616,-7.748264341
22,9,2008,654,499,51,3048,1,155,52,229,42360,15.480938798,11.811908961,1.2072291723,22,0.0236711602,3.6690298375,1.2309003326
22,11,2001,421,325,-28,1190,4,96,-24,36,33063,12.740202754,9.8350733848,-0.847329399,-36,0.121047057,2.905129369,-0.726282342
22,11,2002,442,311,-79,1190,-4,131,-83,18,33081,13.364779874,9.4037252056,-2.388727625,-30,-0.120948234,3.9610546686,-2.509675859
22,11,2003,426,304,170,1190,-20,122,150,236,33317,12.831711799,9.1569023163,5.1206361637,-36,-0.602427784,3.6748094822,4.5182083798
22,11,2004,442,332,302,1190,15,110,317,394,33711,13.188518231,9.9063078117,9.0111595154,-33,0.4475741481,3.2822104195,9.4587336635
22,11,2005,436,333,451,1190,2,103,453,525,34236,12.833532018,9.801757252,13.275052615,-31,0.0588694129,3.0317747656,13.333922027
22,11,2006,491,373,340,1190,9,118,349,447,34683,14.248610688,10.824300991,9.8666550588,-20,0.2611761633,3.4243096969,10.127831222
22,11,2007,508,323,-71,1190,2,185,-69,90,34773,14.627965906,9.3008523382,-2.044459802,-26,0.057590417,5.3271135683,-1.986869385
22,11,2008,472,316,77,1190,6,156,83,205,34978,13.533856145,9.0608019957,2.2078536508,-34,0.1720405442,4.4730541498,2.3798941951
22,13,2001,195,224,-244,373,1,-29,-243,-285,15443,12.511629399,14.372333258,-15.6555773,-13,0.064162202,-1.860703859,-15.5914151
22,13,2002,185,243,-25,373,1,-58,-24,-96,15347,12.0168886,15.784345567,-1.623903865,-14,0.0649561546,-3.767456967,-1.55894771
22,13,2003,201,232,-133,373,-3,-31,-136,-181,15166,13.174712418,15.206633238,-8.717595779,-14,-0.196637499,-2.031920821,-8.914233278
22,13,2004,188,223,8,373,1,-35,9,-38,15128,12.411698686,14.722387271,0.5281573909,-12,0.0660196739,-2.310688585,0.5941770648
22,13,2005,195,222,-101,373,-1,-27,-102,-143,14985,12.951217082,14.744462524,-6.708066284,-14,-0.066416498,-1.793245442,-6.774482782
22,13,2006,184,206,-93,373,0,-22,-93,-122,14863,12.32913428,13.803269901,-6.231573305,-7,0,-1.47413562,-6.231573305
22,13,2007,196,212,24,373,-1,-16,23,11,14874,13.182230891,14.258331372,1.6141507213,4,-0.06725628,-1.076100481,1.5468944413
22,13,2008,200,211,-143,373,1,-11,-142,-146,14728,13.5126005,14.255793527,-9.661509357,7,0.0675630025,-0.743193027,-9.593946355
22,15,2001,1541,796,306,2005,30,745,336,990,99797,15.518317859,8.0159513404,3.0815089323,-91,0.3021087189,7.5023665183,3.3836176512
22,15,2002,1498,776,627,2022,-165,722,462,1101,100898,14.928124766,7.7331273823,6.248287202,-83,-1.644286106,7.1949973841,4.6040010962
22,15,2003,1577,817,931,2086,-548,760,383,1050,101948,15.54874141,8.0553720556,9.1793774588,-93,-5.403113692,7.4933693541,3.7762637666
22,15,2004,1630,826,680,2150,302,804,982,1698,103646,15.856493867,8.0352539471,6.6149790364,-88,2.937828925,7.8212399195,9.5528079613
22,15,2005,1628,854,937,2092,-1,774,936,1611,105257,15.586181146,8.1760434269,8.9706705983,-99,-0.009573821,7.4101377194,8.961096777
22,15,2006,1683,872,1422,2137,169,811,1591,2345,107602,15.813284851,8.1932171062,13.360957253,-57,1.5879056089,7.6200677444,14.948862862
22,15,2007,1743,879,279,2142,0,864,279,1144,108746,16.11292917,8.1257973265,2.579177991,1,0,7.9871318431,2.579177991
22,15,2008,1770,867,543,2142,65,903,608,1504,110250,16.164678807,7.9179528393,4.9589946848,-7,0.5936181483,8.2467259676,5.5526128331
22,17,2001,3787,2684,-2148,6445,121,1103,-2027,-1136,250666,15.073596727,10.683267392,-8.549798196,-212,0.4816227103,4.3903293344,-8.068175486
22,17,2002,3773,2671,-1999,6429,47,1102,-1952,-1034,249632,15.083010526,10.677636129,-7.991237223,-184,0.1878880187,4.4053743969,-7.803349204
22,17,2003,3559,2584,-944,6433,-122,975,-1066,-421,249211,14.269018509,10.359972977,-3.78475793,-330,-0.489131851,3.9090455314,-4.273889781
22,17,2004,3669,2725,-310,6490,188,944,-122,665,249876,14.702847399,10.91993981,-1.242268382,-157,0.753375664,3.7829075893,-0.488892718
22,17,2005,3700,2643,-594,6447,79,1057,-515,312,250188,14.798105842,10.570646957,-2.375695911,-230,0.3159595572,4.2274588853,-2.059736354
22,17,2006,3674,2657,2040,6441,140,1017,2180,3072,253260,14.595350463,10.555211263,8.1041140297,-125,0.5561646883,4.0401392001,8.660278718
22,17,2007,3809,2647,-2052,6441,68,1162,-1984,-783,252477,15.063165242,10.467891414,-8.114889755,39,0.2689144753,4.5952738281,-7.84597528
22,17,2008,3817,2596,-917,6441,93,1221,-824,418,252895,15.105704313,10.273620224,-3.629009917,21,0.3680457168,4.8320840886,-3.260964201
22,19,2001,2735,1716,-1498,4517,78,1019,-1420,-542,182976,14.925210235,9.3644097857,-8.174758659,-141,0.4256549903,5.5608004497,-7.749103669
22,19,2002,2693,1713,-1035,4634,72,980,-963,-134,182842,14.723168351,9.3653128058,-5.65855152,-151,0.3936383666,5.3578555457,-5.264913154
22,19,2003,2749,1709,-66,4751,52,1040,-14,748,183590,15.004148109,9.3277879661,-0.360230548,-278,0.2838180072,5.6763601432,-0.07641254
22,19,2004,2697,1795,-352,4710,69,902,-283,492,184082,14.670684741,9.7641376009,-1.914750103,-127,0.3753345373,4.9065471398,-1.539415566
22,19,2005,2743,1797,-516,4455,64,946,-452,319,184401,14.888068106,9.7535028753,-2.800671944,-175,0.3473701636,5.134565231,-2.453301781
22,19,2006,2647,1960,-1879,4467,70,687,-1809,-1197,183204,14.401327512,10.663619918,-10.2229295,-75,0.3808435685,3.7377075937,-9.842085935
22,19,2007,2906,1764,157,4467,61,1142,218,1267,184471,15.807438635,9.5954307473,0.8540150949,-93,0.3318147821,6.2120078874,1.1858298769
22,19,2008,2817,1788,151,4467,64,1029,215,1147,185618,15.223365191,9.6625406321,0.8160199303,-97,0.3458627519,5.5608245584,1.1618826823
22,21,2001,146,114,-123,708,0,32,-123,-101,10478,13.867122572,10.827753241,-11.68257587,-10,0,3.0393693309,-11.68257587
22,21,2002,140,126,23,708,-1,14,22,26,10504,13.344771709,12.010294538,2.1923553522,-10,-0.095319798,1.3344771709,2.0970355543
22,21,2003,132,108,-64,708,-2,24,-66,-54,10450,12.599026439,10.308294359,-6.108618879,-12,-0.19089434,2.2907320798,-6.299513219
22,21,2004,122,151,91,708,1,-29,92,53,10503,11.645110485,14.413210519,8.6861070014,-10,0.0954517253,-2.768100033,8.7815587267
22,21,2005,125,118,-115,708,-1,7,-116,-116,10387,11.96744854,11.297271422,-11.01005266,-7,-0.095739588,0.6701771182,-11.10579225
22,21,2006,152,127,-52,708,0,25,-52,-32,10355,14.656253013,12.245685083,-5.013981294,-5,0,2.4105679298,-5.013981294
22,21,2007,119,111,-49,708,-1,8,-50,-50,10305,11.519845111,10.745401742,-4.743465634,-8,-0.096805421,0.7744433688,-4.840271055
22,21,2008,121,112,53,708,0,9,53,48,10353,11.714589989,10.84325685,5.1311840449,-14,0,0.8713331397,5.1311840449
22,23,2001,110,69,-165,65,13,41,-152,-117,9833,11.120659152,6.9756861952,-16.68098873,-6,1.3142597179,4.1449729566,-15.36672901
22,23,2002,113,87,-133,65,13,26,-120,-100,9733,11.550649085,8.8929776142,-13.59501176,-6,1.3288357355,2.6576714709,-12.26617602
22,23,2003,94,63,-78,65,8,31,-70,-51,9682,9.6832346124,6.489827453,-8.035024466,-12,0.8241050734,3.1934071594,-7.210919392
22,23,2004,99,78,-76,65,7,21,-69,-56,9626,10.254816656,8.0795525171,-7.872384504,-8,0.7250880464,2.1752641392,-7.147296457
22,23,2005,87,71,-82,65,8,16,-74,-66,9560,9.0691128948,7.4012300636,-8.54789951,-8,0.8339414156,1.6678828312,-7.713958094
22,23,2006,67,67,-1885,49,7,0,-1878,-1876,7684,7.7708188355,7.7708188355,-218.6267687,2,0.8118765948,0,-217.8148921
22,23,2007,72,43,-293,49,7,29,-286,-275,7409,9.5408467501,5.698005698,-38.8259458,-18,0.9275823229,3.8428410521,-37.89836348
22,23,2008,58,53,-153,49,6,5,-147,-171,7238,7.9197105209,7.2369768553,-20.89165017,-29,0.8192803987,0.6827336656,-20.07236977
22,25,2001,133,133,-101,508,2,0,-99,-109,10794,12.259759414,12.259759414,-9.310042863,-10,0.1843572844,0,-9.125685579
22,25,2002,126,130,-121,508,2,-4,-119,-131,10663,11.744419071,12.117257771,-11.27837069,-8,0.1864193503,-0.372838701,-11.09195134
22,25,2003,131,126,-100,508,1,5,-99,-103,10560,12.3450973,11.87391038,-9.423738397,-9,0.094237384,0.4711869199,-9.329501013
22,25,2004,139,125,-104,508,0,14,-104,-99,10461,13.224870368,11.892869036,-9.894867038,-9,0,1.332001332,-9.894867038
22,25,2005,147,139,-204,508,1,8,-203,-203,10258,14.189874029,13.417635986,-19.69207008,-8,0.0965297553,0.7722380424,-19.59554033
22,25,2006,154,111,68,508,0,43,68,105,10363,14.936230057,10.765724262,6.5952184666,-6,0,4.1705057951,6.5952184666
22,25,2007,151,113,18,508,1,38,19,51,10414,14.535303461,10.877412523,1.7326851807,-6,0.0962602878,3.6578909371,1.8289454685
22,25,2008,155,109,73,508,0,46,73,108,10522,14.807030951,10.412686282,6.973633932,-11,0,4.3943446695,6.973633932
22,27,2001,185,225,-116,1159,1,-40,-115,-173,16606,11.082821626,13.479107384,-6.949228696,-18,0.0599071439,-2.396285757,-6.889321552
22,27,2002,146,209,-43,1291,1,-63,-42,-122,16484,8.8244182532,12.632215171,-2.598972499,-17,0.0604412209,-3.807796917,-2.538531278
22,27,2003,175,190,-18,1321,1,-15,-17,-55,16429,10.63409595,11.545589888,-1.093792726,-23,0.0607662626,-0.911493939,-1.033026464
22,27,2004,163,180,-259,1167,0,-17,-259,-294,16135,10.011055153,11.05515293,-15.90713672,-18,0,-1.044097777,-15.90713672
22,27,2005,168,217,225,1455,1,-49,226,165,16300,10.359179898,13.380607369,13.873901649,-12,0.0616617851,-3.02142747,13.935563435
22,27,2006,184,191,140,1570,0,-7,140,124,16424,11.245569001,11.673389561,8.5564111967,-9,0,-0.42782056,8.5564111967
22,27,2007,192,166,-146,1570,1,26,-145,-134,16290,11.738093782,10.148560249,-8.925842147,-15,0.0611359051,1.589533533,-8.864706242
22,27,2008,170,193,-113,1570,0,-23,-113,-148,16142,10.483473113,11.901825358,-6.968426246,-12,0,-1.418352245,-6.968426246
22,29,2001,280,219,-325,689,0,61,-325,-281,19931,13.950128291,10.910993199,-16.1921132,-17,0,3.039135092,-16.1921132
22,29,2002,286,213,-255,689,0,73,-255,-193,19738,14.419319872,10.7388641,-12.8563866,-11,0,3.6804557715,-12.8563866
22,29,2003,225,192,-273,689,-2,33,-275,-255,19483,11.473445348,9.7906733638,-13.92111369,-13,-0.101986181,1.6827719844,-14.02309987
22,29,2004,225,214,-279,689,2,11,-277,-286,19197,11.633919338,11.065149948,-14.42605998,-20,0.1034126163,0.5687693899,-14.32264736
22,29,2005,270,237,-289,689,0,33,-289,-270,18927,14.164305949,12.433113,-15.1610534,-14,0,1.7311929493,-15.1610534
22,29,2006,291,257,239,689,2,34,241,266,19193,15.267576076,13.483735572,12.539349423,-9,0.1049317943,1.7838405037,12.644281217
22,29,2007,294,231,-214,689,0,63,-214,-146,19047,15.376569038,12.081589958,-11.19246862,5,0,3.2949790795,-11.19246862
22,29,2008,272,224,-31,689,2,48,-29,17,19064,14.274094094,11.755136312,-1.6268269,-2,0.1049565742,2.5189577812,-1.521870326
22,31,2001,371,315,-101,322,9,56,-92,-61,25452,14.559011086,12.361424507,-3.963504366,-25,0.3531835573,2.197586579,-3.610320808
22,31,2002,359,263,52,322,8,96,60,132,25584,14.068500666,10.306450349,2.0377772553,-24,0.3135041931,3.7620503174,2.3512814484
22,31,2003,304,295,69,322,4,9,73,47,25631,11.871522015,11.520062482,2.6945230889,-35,0.156204237,0.3514595333,2.850727326
22,31,2004,365,276,196,322,7,89,203,268,25899,14.166504949,10.712206482,7.6072190957,-24,0.2716863963,3.4542984669,7.8789054919
22,31,2005,366,300,1,322,5,66,6,47,25946,14.119008583,11.572957855,0.0385765262,-25,0.1928826309,2.5460507281,0.2314591571
22,31,2006,393,306,25,322,6,87,31,105,26051,15.116256707,11.769909802,0.9615939381,-13,0.2307825451,3.3463469046,1.1923764833
22,31,2007,381,292,131,322,5,89,136,226,26277,14.561993579,11.160373032,5.006879682,1,0.1911022779,3.4016205473,5.1979819599
22,31,2008,379,297,15,322,6,82,21,111,26388,14.392860534,11.278837938,0.5696382797,8,0.2278553119,3.1140225957,0.7974935916
22,33,2001,6008,3265,-4812,14652,828,2743,-3984,-1534,411356,14.578172051,7.9223921014,-11.67612582,-293,2.0091089311,6.6557799492,-9.667016886
22,33,2002,5990,3332,-4173,14511,767,2658,-3406,-1016,410340,14.579601215,8.1100553003,-10.15704105,-268,1.8668704728,6.4695459148,-8.290170574
22,33,2003,5723,3323,-1544,14787,658,2400,-886,1004,411344,13.929929267,8.0882675092,-3.758135731,-510,1.601588932,5.841661758,-2.156546799
22,33,2004,5791,3391,-1485,14682,635,2400,-850,1251,412595,14.05686586,8.2311918722,-3.60463578,-299,1.5413762427,5.825673988,-2.063259537
22,33,2005,5646,3352,-3596,13661,653,2294,-2943,-1011,411584,13.700907206,8.1341553231,-8.726259708,-362,1.5846072273,5.5667518828,-7.141652481
22,33,2006,5921,3644,16387,13006,667,2277,17054,19030,430614,14.060826551,8.6535470281,38.914839503,-301,1.5839505674,5.4072795233,40.498790071
22,33,2007,6346,3530,-3947,13006,600,2816,-3347,-700,429914,14.749084283,8.2042652883,-9.173437703,-169,1.3944926836,6.5448189948,-7.77894502
22,33,2008,6192,3507,-4604,13006,606,2685,-3998,-1554,428360,14.428958584,8.1722153997,-10.72850861,-241,1.4121364506,6.2567431846,-9.316372161
22,35,2001,149,113,-263,1057,3,36,-260,-229,9174,16.041341444,12.165581095,-28.31458255,-5,0.3229800291,3.8757603488,-27.99160252
22,35,2002,141,94,-262,1057,3,47,-259,-214,8960,15.550898864,10.367265909,-28.89599647,-2,0.3308701886,5.1836329547,-28.56512628
22,35,2003,141,100,-197,1057,2,41,-195,-151,8809,15.870335978,11.255557431,-22.17344814,3,0.2251111486,4.6147785469,-21.94833699
22,35,2004,144,112,-171,1057,1,32,-170,-147,8662,16.484459962,12.821246637,-19.57529621,-9,0.1144754164,3.6632133249,-19.46082079
22,35,2005,151,92,-260,1057,2,59,-258,-205,8457,17.641217361,10.748291372,-30.37560605,-6,0.2336585081,6.8929259887,-30.14194754
22,35,2006,136,93,-199,1057,1,43,-198,-158,8299,16.232991167,11.100501313,-23.75268561,-3,0.1193602292,5.1324898544,-23.63332538
22,35,2007,135,74,-87,1057,2,61,-85,-29,8270,16.295491581,8.9323435331,-10.50153902,-5,0.2414146901,7.3631480476,-10.26012433
22,35,2008,146,87,-166,1057,1,59,-165,-104,8166,17.765879776,10.586517401,-20.19956194,2,0.1216841081,7.1793623753,-20.07787783
22,37,2001,287,225,-214,2696,2,62,-212,-167,21198,13.485891502,10.572563024,-10.05568217,-17,0.093978338,2.9133284778,-9.961703827
22,37,2002,286,237,-208,2679,2,49,-206,-170,21028,13.546156397,11.22531142,-9.851750107,-13,0.0947283664,2.320844977,-9.75702174
22,37,2003,251,228,-111,2664,1,23,-110,-113,20915,11.968624085,10.871897575,-5.292897504,-26,0.0476837613,1.0967265098,-5.245213742
22,37,2004,282,215,-271,2586,0,67,-271,-226,20689,13.556388809,10.335544659,-13.0275935,-22,0,3.2208441496,-13.0275935
22,37,2005,257,252,-143,2576,1,5,-142,-154,20535,12.468464972,12.225887832,-6.937706191,-17,0.0485154279,0.2425771395,-6.889190763
22,37,2006,270,232,448,2774,0,38,448,475,21010,12.997954026,11.168612348,21.566975569,-11,0,1.8293416777,21.566975569
22,37,2007,267,235,-217,2774,1,32,-216,-183,20827,12.763821498,11.234075101,-10.37359275,1,0.0478045749,1.5297463967,-10.32578818
22,37,2008,262,234,22,2774,0,28,22,47,20874,12.565645908,11.222752452,1.0551305724,-3,0,1.3428934558,1.0551305724
22,39,2001,535,409,-212,1772,7,126,-205,-110,35289,15.136939792,11.571978271,-5.998189226,-31,0.1980534178,3.5649615211,-5.800135808
22,39,2002,504,385,-219,1772,7,119,-212,-121,35168,14.306598351,10.928651518,-6.216557617,-28,0.1987027549,3.3779468328,-6.017854862
22,39,2003,475,406,-310,1772,3,69,-307,-266,34902,13.557870701,11.588411588,-8.848294563,-28,0.0856286571,1.9694591123,-8.762665906
22,39,2004,504,388,-69,1772,3,116,-66,28,34930,14.434643144,11.112384007,-1.976171383,-22,0.0859204949,3.3222591362,-1.890250888
22,39,2005,565,395,128,1772,3,170,131,268,35198,16.113392653,11.265115218,3.6504677162,-33,0.0855578371,4.8482774355,3.7360255533
22,39,2006,520,372,315,1772,3,148,318,448,35646,14.680142284,10.501947942,8.8927784992,-18,0.0846931286,4.1781943425,8.9774716278
22,39,2007,553,369,63,1772,3,184,66,252,35898,15.459018227,10.315330426,1.7611539752,2,0.083864475,5.1436878005,1.8450184502
22,39,2008,555,393,-460,1772,3,162,-457,-274,35624,15.519700232,10.98962557,-12.86317497,21,0.0838902715,4.5300746623,-12.7792847
22,41,2001,336,299,-317,789,5,37,-312,-288,20958,15.922661359,14.169273055,-15.02227277,-13,0.2369443655,1.7533883044,-14.7853284
22,41,2002,324,258,-287,789,5,66,-282,-227,20731,15.543668594,12.377365732,-13.76862002,-11,0.2398714289,3.1663028617,-13.52874859
22,41,2003,306,251,-148,789,5,55,-143,-108,20623,14.799052087,12.139091744,-7.157711467,-20,0.2418145766,2.6599603424,-6.91589689
22,41,2004,293,287,-131,789,3,6,-128,-138,20485,14.255132821,13.963218838,-6.373455289,-16,0.1459569913,0.2919139827,-6.227498297
22,41,2005,287,264,-340,789,5,23,-335,-330,20155,14.124015748,12.992125984,-16.73228346,-18,0.2460629921,1.1318897638,-16.48622047
22,41,2006,292,262,-115,789,3,30,-112,-91,20064,14.520500261,13.028668042,-5.718690171,-9,0.1491832219,1.4918322186,-5.569506949
22,41,2007,320,244,-86,789,4,76,-82,-3,20061,15.950155763,12.161993769,-4.286604361,3,0.199376947,3.7881619938,-4.087227414
22,41,2008,300,249,-116,789,3,51,-113,-55,20006,14.974917014,12.429181122,-5.790301245,7,0.1497491701,2.5457358924,-5.640552075
22,43,2001,269,201,-97,219,1,68,-96,-44,18643,14.412001072,10.768818645,-5.19689258,-16,0.0535762122,3.643182427,-5.143316368
22,43,2002,261,178,-35,219,-1,83,-36,27,18670,13.989762281,9.5409106746,-1.876021762,-20,-0.053600622,4.4488516067,-1.929622384
22,43,2003,234,195,63,219,-6,39,57,70,18740,12.510024058,10.425020048,3.3680834002,-26,-0.320769848,2.0850040096,3.0473135525
22,43,2004,254,200,206,219,4,54,210,246,18986,13.465514499,10.602767322,10.920850342,-18,0.2120553464,2.862747177,11.132905688
22,43,2005,247,204,274,219,0,43,274,299,19285,12.907945964,10.660813671,14.318936009,-18,0,2.2471322934,14.318936009
22,43,2006,266,208,388,219,2,58,390,437,19722,13.638577691,10.66475248,19.893865204,-11,0.1025456969,2.9738252109,19.996410901
22,43,2007,257,198,-17,219,0,59,-17,43,19765,13.016942285,10.028617013,-0.861042875,1,0,2.9883252716,-0.861042875
22,43,2008,260,193,131,219,2,67,133,209,19974,13.085382118,9.7133798032,6.5930194519,9,0.1006567855,3.3720023151,6.6936762374
22,45,2001,1167,666,-440,1615,37,501,-403,37,73270,15.931414374,9.0919639871,-6.006702934,-61,0.5051091104,6.8394503867,-5.501593824
22,45,2002,1170,630,-452,1615,34,540,-418,64,73334,15.961365311,8.5945813211,-6.166271043,-58,0.4638345475,7.3667839895,-5.702436496
22,45,2003,1145,646,-396,1615,21,499,-375,44,73378,15.608811822,8.8063689405,-5.398331425,-80,0.2862751513,6.8024428813,-5.112056274
22,45,2004,1121,701,-383,1615,35,420,-348,15,73393,15.275497203,9.5522957532,-5.219014655,-57,0.4769334542,5.7232014499,-4.742081201
22,45,2005,1112,653,-219,1615,30,459,-189,205,73598,15.130178038,8.8848977148,-2.979774272,-65,0.4081882564,6.2452803233,-2.571586015
22,45,2006,1116,694,603,1615,34,422,637,1017,74615,15.059407744,9.3649005148,8.1369380554,-42,0.4587991607,5.6945072295,8.595737216
22,45,2007,1211,705,-200,1615,29,506,-171,328,74943,16.194386124,9.4277805266,-2.674547667,-7,0.3878094117,6.7666055978,-2.286738255
22,45,2008,1158,692,-339,1615,31,466,-308,154,75097,15.435883764,9.2242068782,-4.518794988,-4,0.4132231405,6.2116768862,-4.105571848
22,47,2001,528,319,-271,3350,4,209,-267,-84,33231,15.868722388,9.5873531091,-8.144741983,-26,0.1202175938,6.2813692784,-8.024524389
22,47,2002,432,326,-279,3280,3,106,-276,-193,33038,13.0377703,9.8386877726,-8.420226652,-23,0.0905400715,3.1990825273,-8.32968658
22,47,2003,448,315,-404,3337,1,133,-403,-292,32746,13.620333212,9.5767967895,-12.28262191,-22,0.0304025295,4.0435364222,-12.25221938
22,47,2004,440,370,-436,3279,4,70,-432,-397,32349,13.518703433,11.368000614,-13.39580613,-35,0.1228973039,2.150702819,-13.27290883
22,47,2005,471,334,-258,3334,2,137,-256,-146,32203,14.592886355,10.348246375,-7.993555583,-27,0.0619655472,4.2446399802,-7.931590036
22,47,2006,435,350,525,3295,3,85,528,597,32800,13.383997662,10.768733751,16.153100626,-16,0.0923034321,2.6152639109,16.245404058
22,47,2007,484,328,-489,3295,3,156,-486,-333,32467,14.831384927,10.05102119,-14.98460171,-3,0.0919300719,4.7803637367,-14.89267164
22,47,2008,470,337,-51,3295,3,133,-48,78,32545,14.458869132,10.367316803,-1.568941119,-7,0.092290654,4.0915523288,-1.476650465
22,49,2001,205,206,5,278,0,-1,5,-12,15369,13.333333333,13.398373984,0.325203252,-16,0,-0.06504065,0.325203252
22,49,2002,216,224,-143,278,-1,-8,-144,-162,15207,14.128728414,14.652014652,-9.353741497,-10,-0.06541078,-0.523286238,-9.419152276
22,49,2003,219,210,-6,278,-1,9,-7,-18,15189,14.409790762,13.81760758,-0.394788788,-20,-0.065798131,0.592183182,-0.460586919
22,49,2004,197,195,-30,278,0,2,-30,-38,15151,12.986156889,12.854317732,-1.977587343,-10,0,0.1318391562,-1.977587343
22,49,2005,195,216,-59,278,0,-21,-59,-93,15058,12.910059916,14.300374061,-3.906120693,-13,0,-1.390314145,-3.906120693
22,49,2006,200,194,182,278,0,6,182,181,15239,13.202627323,12.806548503,12.014390864,-7,0,0.3960788197,12.014390864
22,49,2007,199,172,-172,278,0,27,-172,-137,15102,13.117563693,11.337793744,-11.33779374,8,0,1.7797699483,-11.33779374
22,49,2008,202,192,78,278,0,10,78,89,15191,13.336414353,12.676195821,5.1497045522,1,0,0.6602185323,5.1497045522
22,51,2001,6257,4155,-5730,4353,855,2102,-4875,-2712,451981,13.802094248,9.1653670448,-12.63960365,61,1.8860141572,4.6367272029,-10.75358949
22,51,2002,6234,4184,-3545,4343,745,2050,-2800,-768,451213,13.804343253,9.2648976853,-7.849919286,-18,1.6497009502,4.5394455676,-6.200218336
22,51,2003,6218,4147,-2510,4302,519,2071,-1991,-69,451144,13.781685076,9.19148408,-5.563208353,-149,1.150320771,4.5902009958,-4.412887582
22,51,2004,6308,4190,-1961,4246,734,2118,-1227,972,452116,13.967185528,9.277505923,-4.342049908,81,1.6252241879,4.689679605,-2.71682572
22,51,2005,6335,4231,-4007,4249,671,2104,-3336,-1268,450848,14.03156715,9.3713592125,-8.875215402,-36,1.4862165048,4.6602079374,-7.388998897
22,51,2006,4882,4113,-30146,3579,727,769,-29419,-28626,422222,11.183524803,9.4219249316,-69.05746389,24,1.6653876551,1.7615998717,-67.39207624
22,51,2007,5670,4039,1553,3579,611,1631,2164,18117,440339,13.146896277,9.3651347557,3.6009047476,14322,1.4167113978,3.7817615218,5.0176161454
22,51,2008,5513,4153,-5569,3579,634,1360,-4935,-4158,436181,12.579290832,9.4761100716,-12.70706886,-583,1.4466298544,3.1031807603,-11.26043901
22,53,2001,512,350,-447,415,4,162,-443,-299,31100,16.384262148,11.200179203,-14.30422887,-18,0.128002048,5.1840829453,-14.17622682
22,53,2002,444,301,-277,415,3,143,-274,-153,30947,14.311731429,9.702322433,-8.928715329,-22,0.096700888,4.6094089964,-8.832014441
22,53,2003,479,346,-173,415,0,133,-173,-73,30874,15.496352372,11.19360735,-5.596803675,-33,0,4.3027450219,-5.596803675
22,53,2004,450,309,-172,415,6,141,-166,-49,30825,14.586946304,10.016369795,-5.575455032,-24,0.1944926174,4.5705765085,-5.380962414
22,53,2005,456,355,0,415,3,101,3,76,30901,14.774973269,11.502446295,0,-28,0.0972037715,3.272526974,0.0972037715
22,53,2006,457,361,218,415,5,96,223,303,31204,14.717011513,11.625472989,7.0203687304,-16,0.1610176314,3.0915385235,7.1813863618
22,53,2007,472,321,-232,415,3,151,-229,-68,31136,15.14276548,10.298363811,-7.443054219,10,0.0962463908,4.8444016683,-7.346807828
22,53,2008,463,340,-15,415,5,123,-10,127,31263,14.83998141,10.897610539,-0.480776936,14,0.1602589785,3.9423708713,-0.320517957
22,55,2001,2790,1348,-1188,4849,242,1442,-946,336,190780,14.637063774,7.0719576942,-6.232556187,-160,1.2695947789,7.5651060794,-4.962961409
22,55,2002,2986,1452,342,4849,227,1534,569,1920,192700,15.573172004,7.5727547721,1.7836653802,-183,1.1838948576,8.0004172317,2.9675602378
22,55,2003,2928,1426,-290,4849,183,1502,-107,1120,193820,15.150574356,7.3786608714,-1.500569181,-275,0.9469108972,7.7719134844,-0.553658284
22,55,2004,2966,1445,94,4942,200,1521,294,1694,195514,15.23627528,7.422932495,0.4828758855,-121,1.027395501,7.8133427854,1.5102713865
22,55,2005,2971,1470,184,4867,200,1501,384,1698,197212,15.130141625,7.4861353717,0.9370400737,-187,1.0185218193,7.6440062537,1.955561893
22,55,2006,2988,1486,4400,4930,206,1502,4606,5991,203203,14.924515815,7.4222993644,21.977198656,-117,1.0289324825,7.5022164504,23.006131139
22,55,2007,3159,1556,-235,4930,184,1603,-51,1446,204649,15.490913371,7.6302188049,-1.152378804,-106,0.9022880849,7.8606945657,-0.250090719
22,55,2008,3191,1558,635,4930,188,1633,823,2327,206976,15.50440328,7.5699969633,3.0853325235,-129,0.9134527786,7.9344063164,3.9987853022
22,57,2001,1185,760,-336,1712,60,425,-276,68,90040,13.165788947,8.443881519,-3.733084461,-81,0.6666222252,4.7219074284,-3.066462236
22,57,2002,1159,725,206,1710,55,434,261,612,90652,12.828459478,8.0247050229,2.2801230824,-83,0.6087707259,4.8037544551,2.8888938082
22,57,2003,1271,750,143,1693,39,521,182,569,91221,13.976785999,8.2475133747,1.5725258834,-134,0.4288706955,5.7292726243,2.0013965789
22,57,2004,1206,724,-83,1636,49,482,-34,387,91608,13.192655432,7.9199689327,-0.90795224,-61,0.5360199968,5.2726864994,-0.371932243
22,57,2005,1184,731,-680,1447,47,453,-633,-261,91347,12.943073433,7.9910360471,-7.433521904,-81,0.5137875434,4.9520373862,-6.919734361
22,57,2006,1103,808,1133,1462,50,295,1183,1428,92775,11.981186387,8.7767893027,12.307057277,-50,0.5431181499,3.2043970845,12.850175427
22,57,2007,1310,779,-591,1462,42,531,-549,-71,92704,14.125588342,8.3998727619,-6.372689091,-53,0.4528814583,5.7257155797,-5.919807633
22,57,2008,1209,780,-532,1462,44,429,-488,-132,92572,13.050799888,8.4198708953,-5.742783739,-73,0.4749670761,4.6309289924,-5.267816663
22,59,2001,177,170,-140,924,4,7,-136,-143,14121,12.471375727,11.978157478,-9.864364982,-14,0.2818389995,0.4932182491,-9.582525982
22,59,2002,206,162,36,924,3,44,39,71,14192,14.551619397,11.443506516,2.5430014481,-12,0.2119167873,3.108112881,2.7549182354
22,59,2003,184,180,-79,924,0,4,-79,-92,14100,13.007210519,12.724445073,-5.58461756,-17,0,0.2827654461,-5.58461756
22,59,2004,179,171,-70,924,1,8,-69,-70,14030,12.726626378,12.157838606,-4.976892997,-9,0.0710984714,0.5687877711,-4.905794525
22,59,2005,177,175,-126,924,1,2,-125,-135,13895,12.676812892,12.533572068,-9.024171889,-12,0.0716204118,0.1432408236,-8.952551477
22,59,2006,175,187,150,924,1,-12,151,131,14026,12.535367644,13.394935711,10.744600838,-8,0.0716306723,-0.859568067,10.81623151
22,59,2007,191,156,-23,924,1,35,-22,13,14039,13.611259576,11.117049706,-1.6390522,0,0.0712631391,2.4942098699,-1.567789061
22,59,2008,181,163,3,924,1,18,4,23,14062,12.88210384,11.60101064,0.2135155333,1,0.0711718444,1.2810931995,0.2846873777
22,61,2001,516,374,-484,5103,50,142,-434,-323,42187,12.184611025,8.8314816345,-11.42897623,-31,1.1806793629,3.3531293907,-10.24829687
22,61,2002,556,278,-491,5015,47,278,-444,-197,41990,13.210259334,6.6051296672,-11.66589448,-31,1.116694584,6.6051296672,-10.5491999
22,61,2003,565,310,132,5255,40,255,172,376,42366,13.395609085,7.3498032149,3.129593627,-51,0.9483617052,6.0458058704,4.0779553322
22,61,2004,508,364,228,5292,42,144,270,378,42744,11.937492657,8.5536364705,5.3577722947,-36,0.9869580543,3.3838561861,6.344730349
22,61,2005,574,367,-287,5187,42,207,-245,-76,42668,13.440734323,8.5936402379,-6.720367162,-38,0.9834683651,4.8470940851,-5.736898796
22,61,2006,593,329,-384,4841,44,264,-340,-94,42574,13.91332911,7.7191994557,-9.009643134,-18,1.0323549424,6.1941296544,-7.977288191
22,61,2007,563,336,-281,4841,33,227,-248,-16,42558,13.226518818,7.8936240192,-6.601512945,5,0.7752666447,5.3328947987,-5.8262463
22,61,2008,591,346,-286,4841,35,245,-251,3,42561,13.886441335,8.1297947579,-6.720003759,9,0.8223780824,5.7566465771,-5.897625677
22,63,2001,1465,687,1925,584,24,778,1949,2667,95197,15.607770859,7.3191389624,20.508504371,-60,0.2556904441,8.2886318963,20.764194815
22,63,2002,1427,718,2390,584,22,709,2412,3099,98296,14.749887593,7.421457107,24.703736052,-22,0.2273984072,7.3284304859,24.93113446
22,63,2003,1573,716,1889,584,12,857,1901,2755,101051,15.781526685,7.1834539772,18.951877881,-3,0.1203930834,8.5980727074,19.072270965
22,63,2004,1578,695,2809,584,21,883,2830,3561,104612,15.345492383,6.7586294083,27.316532386,-152,0.2042175792,8.5868629749,27.520749965
22,63,2005,1645,789,1997,584,17,856,2014,2778,107390,15.518721521,7.4433260064,18.839444911,-92,0.1603758455,8.0753955151,18.999820756
22,63,2006,1716,796,4933,584,19,920,4952,5796,113186,15.55926302,7.2174669955,44.728347599,-76,0.1722762223,8.341796025,44.900623821
22,63,2007,1820,863,2260,584,17,957,2277,3283,116469,15.849861749,7.515621258,19.681696458,49,0.1480481592,8.3342404912,19.829744617
22,63,2008,1818,844,2770,584,19,974,2789,3787,120256,15.359594466,7.1306368149,23.402682437,24,0.1605238146,8.2289576513,23.563206252
22,65,2001,240,164,-385,1377,1,76,-384,-313,13394,17.71152356,12.102874433,-28.41223571,-5,0.0737980148,5.6086491273,-28.3384377
22,65,2002,190,145,-412,1339,1,45,-411,-366,13028,14.381954432,10.975702066,-31.18613277,0,0.075694497,3.4062523655,-31.11043827
22,65,2003,178,157,-444,1178,1,21,-443,-408,12620,13.880224579,12.242669994,-34.62258266,14,0.0779787898,1.6375545852,-34.54460387
22,65,2004,164,157,-348,990,0,7,-348,-359,12261,13.182749889,12.620071541,-27.9731522,-18,0,0.5626783489,-27.9731522
22,65,2005,238,158,-239,990,1,80,-238,-168,12093,19.545043935,12.975281268,-19.62716597,-10,0.0821220333,6.5697626673,-19.54504394
22,65,2006,207,167,-192,990,0,40,-192,-157,11936,17.229181406,13.899870989,-15.98069,-5,0,3.3293104166,-15.98069
22,65,2007,191,145,-174,990,1,46,-173,-122,11814,16.084210526,12.210526316,-14.65263158,5,0.0842105263,3.8736842105,-14.56842105
22,65,2008,211,155,-86,990,0,56,-86,-24,11790,17.878325708,13.133367226,-7.286900525,6,0,4.7449584816,-7.286900525
22,67,2001,486,331,-468,955,2,155,-466,-331,30630,15.781526522,10.748323619,-15.19702554,-20,0.0649445536,5.033202903,-15.13208099
22,67,2002,445,365,-333,955,2,80,-331,-269,30361,14.592316899,11.96897903,-10.91964388,-18,0.0655834467,2.6233378695,-10.85406044
22,67,2003,435,398,-100,955,2,37,-98,-98,30263,14.350752177,13.130113486,-3.299023489,-37,0.0659804698,1.2206386909,-3.233043019
22,67,2004,431,391,-329,955,1,40,-328,-315,29948,14.316320938,12.987660062,-10.9282357,-27,0.0332165219,1.3286608759,-10.89501918
22,67,2005,414,392,-529,955,2,22,-527,-527,29421,13.946672506,13.205544981,-17.8207482,-22,0.0673752295,0.7411275245,-17.75337297
22,67,2006,387,392,-180,955,1,-5,-179,-196,29225,13.197831054,13.368345667,-6.138526072,-12,0.0341029226,-0.170514613,-6.104423149
22,67,2007,402,364,-517,955,2,38,-515,-465,28760,13.865654911,12.554971113,-17.83219798,12,0.0689833578,1.3106837975,-17.76321462
22,67,2008,380,390,-156,955,1,-10,-155,-158,28602,13.249189359,13.597852237,-5.439140895,7,0.0348662878,-0.348662878,-5.404274607
22,69,2001,634,381,-576,2543,32,253,-544,-315,38782,16.281667715,9.7844091475,-14.79217761,-24,0.8217876449,6.4972585678,-13.97038996
22,69,2002,574,351,31,2735,30,223,61,245,39027,14.754077292,9.02209256,0.7968229896,-39,0.7711190222,5.7319847318,1.5679420118
22,69,2003,598,397,-544,2437,25,201,-519,-336,38691,15.38897038,10.21642348,-13.99933091,-18,0.6433516045,5.1725469003,-13.35597931
22,69,2004,583,366,-213,2138,26,217,-187,-1,38690,15.06829842,9.4596864863,-5.505227381,-31,0.6719995865,5.6086119332,-4.833227795
22,69,2005,579,398,-84,2121,26,181,-58,88,38778,14.948107606,10.275210409,-2.168637373,-35,0.6712449011,4.6728971963,-1.497392472
22,69,2006,605,383,406,2121,27,222,433,634,39412,15.475124696,9.7966491879,10.384959714,-21,0.6906253997,5.6784755084,11.075585113
22,69,2007,601,381,-176,2121,22,220,-154,75,39487,15.234667106,9.6579170839,-4.461400018,9,0.5576750022,5.5767500222,-3.903725016
22,69,2008,639,384,-210,2121,22,255,-188,89,39576,16.164324652,9.7137725611,-5.312219369,22,0.5565182196,6.4505520914,-4.75570115
22,71,2001,7448,5086,-8760,17661,533,2362,-8227,-5800,477835,15.492943098,10.57963327,-18.22209741,65,1.1087189408,4.9133098277,-17.11337847
22,71,2002,7192,4985,-7943,17710,404,2207,-7539,-5279,472556,15.134823457,10.490419206,-16.71522563,53,0.8501764011,4.6444042505,-15.86504923
22,71,2003,6945,5023,-7230,17794,142,1922,-7088,-5041,467515,14.775479724,10.686426876,-15.38181691,125,0.302104841,4.0890528481,-15.07971206
22,71,2004,6961,4947,-8365,17685,537,2014,-7828,-5915,461600,14.984151585,10.648843254,-18.00638242,-101,1.1559387159,4.335308331,-16.8504437
22,71,2005,6738,4916,-8796,17574,409,1822,-8387,-6554,455046,14.701422359,10.726060006,-19.19170541,11,0.8923837556,3.9753623536,-18.29932166
22,71,2006,2444,4032,-243096,10461,511,-1588,-242585,-244278,210768,7.3413896373,12.111490596,-730.2219539,-105,1.534963218,-4.770100959,-728.6869907
22,71,2007,3314,2549,28313,10253,375,765,28688,77345,288113,13.285733472,10.218869831,113.50602649,47892,1.5033645298,3.0668636408,115.00939102
22,71,2008,3738,2844,22856,10253,409,894,23265,23740,311853,12.460706107,9.4805372304,76.190984156,-419,1.3634105933,2.9801688762,77.554394749
22,73,2001,2365,1427,-1533,4647,43,938,-1490,-669,146599,16.09571677,9.7118764611,-10.43329125,-117,0.2926493958,6.3838403087,-10.14064185
22,73,2002,2235,1347,-52,4476,37,888,-15,727,147326,15.207961215,9.1656034703,-0.35383176,-146,0.251764906,6.0423577443,-0.102066854
22,73,2003,2221,1331,-124,4313,19,890,-105,561,147887,15.046762846,9.0172180764,-0.840071406,-224,0.1287206187,6.0295447694,-0.711350787
22,73,2004,2346,1334,-379,4380,44,1012,-335,574,148461,15.832737187,9.0029289889,-2.557803663,-103,0.2969481825,6.8298081985,-2.260855481
22,73,2005,2299,1394,-1089,4333,37,905,-1052,-280,148181,15.500165182,9.3985342602,-7.342183507,-133,0.2494589438,6.1016309221,-7.092724564
22,73,2006,2270,1503,702,4316,43,767,745,1437,149618,15.245182153,10.09405673,4.7145893707,-75,0.2887853888,5.1511254235,5.0033747595
22,73,2007,2432,1413,-1207,4316,34,1019,-1173,-125,149493,16.261521642,9.4479975661,-8.070582493,29,0.2273403519,6.8135240763,-7.843242141
22,73,2008,2388,1401,-493,4316,37,987,-456,558,150051,15.944235238,9.354218412,-3.291670005,27,0.2470421708,6.5900168256,-3.044627834
22,75,2001,392,227,-19,729,-3,165,-22,116,26853,14.629595074,8.4717298003,-0.709087516,-27,-0.111961187,6.1578652734,-0.821048703
22,75,2002,394,212,130,728,-18,182,112,270,27123,14.599081073,7.8553431155,4.816955684,-24,-0.666963095,6.7437379576,4.1499925893
22,75,2003,415,233,404,718,-49,182,355,529,27652,15.15289822,8.5075308079,14.751255135,-8,-1.78913738,6.6453674121,12.962117754
22,75,2004,464,226,748,713,21,238,769,963,28615,16.492793289,8.0331277658,26.587520216,-44,0.7464410756,8.4596655233,27.333961292
22,75,2005,405,232,-194,710,-4,173,-198,-50,28565,14.165792235,8.1147254285,-6.785589367,-25,-0.139909059,6.0510668066,-6.925498426
22,75,2006,240,191,-7034,493,9,49,-7025,-6955,21610,9.5665171898,7.6133532636,-280.3786746,21,0.3587443946,1.9531639263,-280.0199302
22,75,2007,297,149,-110,493,-6,148,-116,-13,21597,13.747772352,6.8970305737,-5.091767538,-45,-0.277732775,6.850741778,-5.369500312
22,75,2008,270,162,-381,493,1,108,-380,-321,21276,12.595339724,7.5572038346,-17.77342383,-49,0.0466494064,5.0381358897,-17.72677443
22,77,2001,344,244,-312,337,0,100,-312,-232,22524,15.19434629,10.777385159,-13.78091873,-20,0,4.4169611307,-13.78091873
22,77,2002,305,223,-239,337,-1,82,-240,-172,22352,13.593011855,9.9384971923,-10.65157322,-14,-0.044567252,3.6545146626,-10.69614048
22,77,2003,295,247,-170,337,-4,48,-174,-146,22206,13.241168814,11.086673549,-7.630504062,-20,-0.179541272,2.1544952646,-7.810045334
22,77,2004,301,249,-123,337,1,52,-122,-87,22119,13.581500282,11.235194585,-5.549915398,-17,0.0451212634,2.3463056966,-5.504794134
22,77,2005,284,237,-339,337,-1,47,-340,-312,21807,12.930838228,10.790875563,-15.43504986,-19,-0.045531121,2.1399626645,-15.48058098
22,77,2006,302,241,515,337,1,61,516,563,22370,13.672272902,10.910654866,23.315299817,-14,0.0452724268,2.7616180365,23.360572243
22,77,2007,317,228,-86,337,-1,89,-87,-11,22359,14.174249368,10.194728252,-3.845379955,-13,-0.04471372,3.9795211161,-3.890093675
22,77,2008,313,252,-15,337,1,61,-14,42,22401,13.985701519,11.260053619,-0.670241287,-5,0.0446827525,2.7256478999,-0.625558534
22,79,2001,1897,1378,-718,5476,79,519,-639,-125,126272,15.015692467,10.907550986,-5.683324824,-5,0.6253240405,4.1081414815,-5.058000784
22,79,2002,1893,1319,-436,5466,63,574,-373,181,126453,14.980710258,10.438223365,-3.450390741,-20,0.4985656346,4.5424868929,-2.951825106
22,79,2003,1858,1409,-62,5414,19,449,-43,325,126778,14.674348717,11.128179409,-0.489671486,-81,0.1500606166,3.5461693079,-0.339610869
22,79,2004,1916,1346,-135,5372,74,570,-61,544,127322,15.080676899,10.594254231,-1.06257379,35,0.5824478552,4.4864226682,-0.480125935
22,79,2005,1905,1367,-137,5306,57,538,-80,443,127765,14.936080631,10.717911928,-1.074143331,-15,0.4469063496,4.2181687032,-0.627236982
22,79,2006,1915,1340,2022,5291,72,575,2094,4658,132423,14.720125448,10.300244439,15.542607653,1989,0.5534459698,4.4198810091,16.096053623
22,79,2007,2035,1376,-593,5291,45,659,-548,468,132891,15.340313741,10.37261509,-4.470174962,357,0.339220697,4.9676986514,-4.130954266
22,79,2008,1997,1374,-488,5291,51,623,-437,240,133131,15.013795851,10.329972709,-3.668869492,54,0.3834269346,4.6838231424,-3.285442557
22,81,2001,134,123,-128,283,2,11,-126,-119,9479,14.04833045,12.895109294,-13.41930073,-4,0.2096765739,1.1532211564,-13.20962415
22,81,2002,138,112,-64,283,1,26,-63,-46,9433,14.593908629,11.844331641,-6.768189509,-9,0.1057529611,2.7495769882,-6.662436548
22,81,2003,146,108,-48,283,1,38,-47,-20,9413,15.494004033,11.461318052,-5.093919134,-11,0.1061233153,4.0326859811,-4.987795819
22,81,2004,154,107,-92,283,2,47,-90,-51,9362,16.404793609,11.398135819,-9.800266312,-8,0.2130492676,5.0066577896,-9.587217044
22,81,2005,149,96,-206,283,2,53,-204,-158,9204,16.050845632,10.341484434,-22.19110201,-7,0.2154475924,5.7093611979,-21.97565442
22,81,2006,142,138,-8,283,2,4,-6,-8,9196,15.434782609,15,-0.869565217,-6,0.2173913043,0.4347826087,-0.652173913
22,81,2007,145,71,-89,283,2,74,-87,-10,9186,15.776302905,7.724948319,-9.683385921,3,0.217604178,8.051354586,-9.465781743
22,81,2008,144,95,-122,283,2,49,-120,-68,9118,15.734265734,10.380244755,-13.33041958,3,0.2185314685,5.354020979,-13.11188811
22,83,2001,324,269,-119,1169,2,55,-117,-79,20851,15.509442091,12.876666427,-5.696369163,-17,0.0957372969,2.6327756636,-5.600631866
22,83,2002,320,268,-166,1169,1,52,-165,-128,20723,15.394236783,12.892673305,-7.985760331,-15,0.0481069899,2.5015634772,-7.937653341
22,83,2003,267,243,-256,1169,-1,24,-257,-246,20477,12.961165049,11.796116505,-12.42718447,-13,-0.048543689,1.1650485437,-12.47572816
22,83,2004,273,247,-130,1169,2,26,-128,-119,20358,13.370882821,12.09746541,-6.367087058,-17,0.0979551855,1.2734174115,-6.269131872
22,83,2005,310,251,-95,1169,0,59,-95,-57,20301,15.248776409,12.346589931,-4.673012125,-21,0,2.9021864778,-4.673012125
22,83,2006,316,247,89,1169,1,69,90,151,20452,15.508060756,12.121806984,4.3677766054,-8,0.0490761416,3.3862537727,4.416852747
22,83,2007,304,229,-76,1169,0,75,-76,3,20455,14.862981886,11.196127802,-3.715745471,4,0,3.6668540837,-3.715745471
22,83,2008,309,245,-30,1169,1,64,-29,46,20501,15.089364196,11.96405899,-1.464986815,11,0.0488328938,3.1253052056,-1.416153921
22,85,2001,338,276,-198,417,15,62,-183,-146,23349,14.430876953,11.783793015,-8.453590641,-25,0.6404235334,2.6470839382,-7.813167108
22,85,2002,298,279,-60,417,15,19,-45,-53,23296,12.777360918,11.962696966,-2.572623004,-27,0.6431557509,0.8146639511,-1.929467253
22,85,2003,356,263,2,417,11,93,13,73,23369,15.257687775,11.271831137,0.085717347,-33,0.4714454088,3.9858566377,0.5571627558
22,85,2004,342,257,-121,417,10,85,-111,-43,23326,14.648249277,11.007602527,-5.182567727,-17,0.4283113824,3.6406467502,-4.754256344
22,85,2005,312,269,54,417,11,43,65,87,23413,13.350734932,11.510729797,2.3107041229,-21,0.470698988,1.8400051349,2.7814031109
22,85,2006,318,242,83,417,10,76,93,158,23571,13.536523072,10.301379193,3.5331176571,-11,0.4256768262,3.2351438788,3.9587944832
22,85,2007,356,244,-19,417,7,112,-12,82,23653,15.077079451,10.333728613,-0.804675589,-18,0.2964594274,4.7433508386,-0.508216161
22,85,2008,350,227,-70,417,6,123,-64,35,23688,14.786337424,9.5899959866,-2.957267485,-24,0.2534800701,5.1963414377,-2.703787415
22,87,2001,827,739,-554,788,21,88,-533,-448,66540,12.386915104,11.068839494,-8.297885088,-3,0.3145407705,1.3180756096,-7.983344317
22,87,2002,855,728,-420,788,11,127,-409,-285,66255,12.876990851,10.964268233,-6.325539365,-3,0.1656688881,1.9127226176,-6.159870477
22,87,2003,854,801,-600,788,-12,53,-612,-571,65684,12.945376272,12.1419747,-9.095112135,-12,-0.181902243,0.8034015719,-9.277014378
22,87,2004,926,813,-457,788,30,113,-427,-308,65376,14.130932397,12.40653136,-6.973905082,6,0.4578055852,1.7244010377,-6.516099496
22,87,2005,832,800,-527,788,15,32,-512,-486,64890,12.773862712,12.2825603,-8.091136597,-6,0.2302980056,0.491302412,-7.860838592
22,87,2006,234,563,-50589,170,27,-329,-50562,-50966,13924,5.9380313142,14.286801837,-1283.756693,-75,0.6851574593,-8.348770523,-1283.071536
22,87,2007,304,216,5917,170,17,88,5934,19515,33439,12.837024682,9.1210438528,249.85748369,13493,0.7178599329,3.7159808289,250.57534362
22,87,2008,393,194,4194,170,21,199,4215,4283,37722,11.045375978,5.4524247832,117.87355433,-131,0.5902109301,5.5929511952,118.46376526
22,89,2001,722,345,-127,430,46,377,-81,248,48410,14.952574245,7.1449281365,-2.630161952,-48,0.9526570849,7.8076461086,-1.677504867
22,89,2002,658,304,191,430,45,354,236,549,48959,13.515595313,6.2442871961,3.923219916,-41,0.9243188284,7.2713081165,4.8475387444
22,89,2003,670,361,-207,430,35,309,-172,78,49037,13.674027511,7.3676476591,-4.224662231,-59,0.71431487,6.3063798522,-3.510347361
22,89,2004,679,346,149,430,38,333,187,485,49522,13.778548889,7.0211751337,3.0235696385,-35,0.7711117199,6.7573737558,3.7946813584
22,89,2005,689,352,267,430,37,337,304,594,50116,13.830064835,7.0655773902,5.3594010317,-47,0.7426885325,6.7644874445,6.1020895642
22,89,2006,646,373,1476,430,40,273,1516,1752,51868,12.668653906,7.3148729212,28.945716975,-37,0.7844367744,5.3537809853,29.73015375
22,89,2007,743,380,-238,430,35,363,-203,114,51982,14.309099663,7.3182474723,-4.583533943,-46,0.6740491093,6.9908521907,-3.909484834
22,89,2008,721,396,-744,430,37,325,-707,-435,51547,13.928464488,7.6500304263,-14.37278444,-53,0.7147755701,6.278434062,-13.65800887
22,91,2001,127,88,-113,72,0,39,-113,-83,10425,12.133951178,8.4077771939,-10.79635026,-9,0,3.7261739837,-10.79635026
22,91,2002,118,116,17,72,-1,2,16,5,10430,11.31623112,11.124430592,1.6303044833,-13,-0.095900264,0.1918005275,1.5344042196
22,91,2003,102,93,-106,72,-1,9,-107,-108,10322,9.8303777949,8.9629915189,-10.21588281,-10,-0.096376253,0.867386276,-10.31225906
22,91,2004,94,105,-45,72,1,-11,-44,-63,10259,9.1346387445,10.203585832,-4.372965356,-8,0.0971770079,-1.068947087,-4.275788348
22,91,2005,109,94,-97,72,0,15,-97,-88,10171,10.670582477,9.2021536955,-9.495839452,-6,0,1.4684287812,-9.495839452
22,91,2006,111,118,511,72,0,-7,511,496,10667,10.653613591,11.325463096,49.045013917,-8,0,-0.671849506,49.045013917
22,91,2007,111,95,-86,72,0,16,-86,-77,10590,10.443618573,8.9382321118,-8.091452228,-7,0,1.5053864609,-8.091452228
22,91,2008,113,113,-39,72,0,0,-39,-44,10546,10.692657078,10.692657078,-3.690386071,-5,0,0,-3.690386071
22,93,2001,363,170,-211,265,1,193,-210,-32,21206,17.104891151,8.0105550843,-9.942512487,-15,0.0471209123,9.0943360663,-9.895391575
22,93,2002,309,199,-143,265,0,110,-143,-50,21156,14.588546339,9.3952126906,-6.751333743,-17,0,5.1933336481,-6.751333743
22,93,2003,279,190,-305,265,-1,89,-306,-226,20930,13.258565794,9.0291308274,-14.49413106,-9,-0.047521741,4.2294349665,-14.54165281
22,93,2004,292,186,-252,265,2,106,-250,-164,20766,14.006139678,8.9217191097,-12.08749041,-20,0.0959324635,5.0844205679,-11.99155794
22,93,2005,324,173,-92,265,0,151,-92,41,20807,15.587039665,8.3227094508,-4.425949535,-18,0,7.2643302143,-4.425949535
22,93,2006,286,195,344,265,1,91,345,423,21230,13.607060447,9.2775412137,16.366534244,-13,0.0475771344,4.3295192331,16.414111378
22,93,2007,335,190,11,265,1,145,12,141,21371,15.727330344,8.9199784043,0.5164198024,-16,0.0469472548,6.8073519401,0.5633670571
22,93,2008,331,197,-256,265,1,134,-255,-140,21231,15.539176564,9.2483920943,-12.01821511,-19,0.0469461528,6.2907844702,-11.97126895
22,95,2001,662,308,79,443,23,354,102,414,43567,15.267527675,7.1033210332,1.8219557196,-42,0.5304428044,8.1642066421,2.352398524
22,95,2002,681,307,22,443,22,374,44,373,43940,15.564469128,7.0165815306,0.5028169175,-45,0.5028169175,8.5478875976,1.005633835
22,95,2003,685,325,173,443,18,360,191,495,44435,15.502121641,7.3550212164,3.9151343706,-56,0.4073550212,8.1471004243,4.3224893918
22,95,2004,713,321,207,443,24,392,231,590,45025,15.940084954,7.1763916834,4.6277665996,-33,0.5365526492,8.7636932707,5.1643192488
22,95,2005,688,367,238,443,22,321,260,543,45568,15.188811498,8.1021712494,5.2542690936,-38,0.4856887397,7.0866402481,5.7399578334
22,95,2006,723,370,1736,443,26,353,1762,2079,47647,15.512524808,7.9386364855,37.247224159,-36,0.5578501314,7.5738883227,37.805074291
22,95,2007,765,332,-375,443,21,433,-354,31,47678,16.050354052,6.96564385,-7.867820614,-48,0.4405979544,9.0847102019,-7.427222659
22,95,2008,753,357,-1047,443,23,396,-1024,-684,46994,15.907554504,7.5418286294,-22.1184722,-56,0.485888119,8.3657258746,-21.63258408
22,97,2001,1358,905,-490,1528,13,453,-477,-103,87610,15.491407288,10.323802353,-5.589683042,-79,0.1482977134,5.1676049349,-5.441385329
22,97,2002,1394,871,-268,1528,11,523,-257,187,87797,15.894462593,9.9311886071,-3.055750341,-79,0.1254225886,5.9632739856,-2.930327752
22,97,2003,1337,918,-147,1528,6,419,-141,160,87957,15.214447466,10.446419427,-1.672792653,-118,0.0682772512,4.7680280392,-1.604515402
22,97,2004,1417,946,-79,1528,15,471,-64,348,88305,16.078337929,10.734020946,-0.89639287,-59,0.1702011778,5.3443169827,-0.726191692
22,97,2005,1307,923,14,1528,12,384,26,330,88635,14.773369504,10.432915112,0.158245733,-80,0.1356391997,4.3404543913,0.2938849327
22,97,2006,1428,936,1652,1528,14,492,1666,2104,90739,15.922039983,10.436295115,18.419614883,-54,0.1560984312,5.4857448683,18.575713314
22,97,2007,1446,938,103,1528,11,508,114,626,91365,15.881035013,10.301805562,1.1312217195,4,0.1208100865,5.5792294513,1.252031806
22,97,2008,1443,952,266,1528,13,491,279,808,92173,15.724264185,10.37387353,2.8985823099,38,0.1416600377,5.3503906548,3.0402423476
22,99,2001,775,419,96,792,8,356,104,413,49068,15.861158581,8.5752586392,1.9647370629,-47,0.1637280886,7.2858999417,2.1284651515
22,99,2002,714,388,-9,792,7,326,-2,272,49340,14.511015365,7.8855377612,-0.182911958,-52,0.1422648565,6.6254776034,-0.040647102
22,99,2003,676,435,58,792,4,241,62,235,49575,13.668301067,8.7954304201,1.172724056,-68,0.0808775211,4.8728706465,1.2536015771
22,99,2004,700,405,24,792,7,295,31,292,49867,14.078558356,8.14545162,0.4826934293,-34,0.1407855836,5.9331067356,0.6234790129
22,99,2005,783,409,-200,792,5,374,-195,135,50002,15.680541509,8.1907298561,-4.005246873,-44,0.1001311718,7.4898116533,-3.905115702
22,99,2006,735,457,905,792,6,278,911,1161,51163,14.530717145,9.0347452182,17.891563288,-28,0.1186180991,5.495971927,18.010181387
22,99,2007,777,457,136,792,5,320,141,461,51624,15.118643408,8.8921750805,2.6462490393,0,0.0972885676,6.2264683277,2.7435376069
22,99,2008,768,454,160,792,6,314,166,473,52097,14.808958649,8.7542542012,3.0851997185,-7,0.1156949894,6.0547044475,3.2008947079
22,101,2001,798,483,-1053,629,32,315,-1021,-732,52526,15.087347803,9.1318157755,-19.90849278,-26,0.6050064282,5.9555320275,-19.30348635
22,101,2002,795,470,-670,629,31,325,-639,-347,52179,15.185521226,8.9776037439,-12.79786066,-33,0.5921398214,6.2079174825,-12.20572083
22,101,2003,747,509,-510,629,21,238,-489,-296,51883,14.356825739,9.7826295862,-9.801848898,-45,0.4036055428,4.5741961523,-9.398243355
22,101,2004,790,577,-547,629,26,213,-521,-357,51526,15.279134311,11.15957025,-10.57934996,-49,0.5028575849,4.1195640612,-10.07649237
22,101,2005,782,515,-921,629,25,267,-896,-671,50855,15.276271965,10.060460437,-17.99161954,-42,0.4883718659,5.2158115275,-17.50324767
22,101,2006,742,557,571,629,30,185,601,759,51614,14.482428832,10.871580673,11.144834047,-27,0.5855429447,3.610848159,11.730376992
22,101,2007,807,580,-596,629,26,227,-570,-328,51286,15.685131195,11.273080661,-11.5840622,15,0.5053449951,4.4120505345,-11.0787172
22,101,2008,781,513,-490,629,28,268,-462,-203,51083,15.25852553,10.022565425,-9.57321064,-9,0.547040608,5.2359601051,-9.026170032
22,103,2001,2661,1510,2426,2303,113,1151,2539,3521,195693,13.721268998,7.7862142756,12.509507174,-169,0.5826769623,5.9350547226,13.092184136
22,103,2002,2741,1508,3941,2312,70,1233,4011,5140,200833,13.825070739,7.6060586191,19.87763728,-104,0.3530663815,6.2190121203,20.230703661
22,103,2003,2881,1554,3720,2302,-27,1327,3693,5000,205833,14.168875687,7.6426354797,18.295111959,-20,-0.132787103,6.526240207,18.162324856
22,103,2004,2943,1626,4456,2296,153,1317,4609,5655,211488,14.104250685,7.7925625598,21.355263694,-271,0.7332485065,6.311688125,22.0885122
22,103,2005,2900,1635,4705,2298,89,1265,4794,5879,217367,13.524384699,7.6249548216,21.942148279,-180,0.4150587028,5.8994298772,22.357206981
22,103,2006,2719,1848,5676,2083,130,871,5806,6496,223863,12.324637944,8.3765836412,25.728078326,-181,0.5892618362,3.9480543027,26.317340163
22,103,2007,3182,1800,1095,2083,85,1382,1180,2400,226263,14.138263508,7.997760627,4.8653043814,-162,0.3776720296,6.1405028814,5.242976411
22,103,2008,3161,1863,1027,2083,100,1298,1127,2193,228456,13.9030918,8.1940715035,4.5170753806,-232,0.4398320721,5.7090202961,4.9569074527
22,105,2001,1633,946,168,3247,29,687,197,781,101608,16.13357374,9.3462098945,1.659792032,-103,0.2865117198,6.7873638452,1.9463037518
22,105,2002,1588,917,83,3224,22,671,105,677,102285,15.576797634,8.994913999,0.8141525212,-99,0.2157994634,6.581883635,1.0299519846
22,105,2003,1494,1002,659,3266,9,492,668,1052,103337,14.531519001,9.746038848,6.4098199609,-108,0.0875392711,4.7854801529,6.497359232
22,105,2004,1639,1015,812,3241,32,624,844,1377,104714,15.755752195,9.7572229886,7.8057783909,-91,0.3076168824,5.9985292068,8.1133952733
22,105,2005,1636,1073,971,3543,23,563,994,1468,106182,15.514756088,10.175631591,9.2083301722,-89,0.2181169866,5.3391244974,9.4264471588
22,105,2006,1688,1120,6351,3672,28,568,6379,6859,113041,15.399843994,10.217905968,57.941000716,-88,0.2554476492,5.1819380266,58.196448365
22,105,2007,1964,1069,1471,3672,21,895,1492,2414,115455,17.190672922,9.3568377565,12.875498915,27,0.1838106575,7.8338351656,13.059309572
22,105,2008,1893,1103,710,3672,24,790,734,1546,117001,16.28695323,9.4899679939,6.1086829335,22,0.2064906907,6.7969852359,6.3151736243
22,107,2001,118,88,-148,491,6,30,-142,-114,6463,18.098159509,13.496932515,-22.6993865,-2,0.9202453988,4.6012269939,-21.7791411
22,107,2002,81,65,-144,491,6,16,-138,-129,6334,12.659217004,10.158630929,-22.50527467,-7,0.9377197781,2.5005860749,-21.5675549
22,107,2003,75,72,-187,491,6,3,-181,-175,6159,12.006723765,11.526454815,-29.93676459,3,0.9605379012,0.4802689506,-28.97622669
22,107,2004,99,74,-153,491,3,25,-150,-133,6026,16.249487074,12.146081247,-25.11284366,-8,0.4924086992,4.1034058268,-24.62043496
22,107,2005,77,75,-78,491,6,2,-72,-77,5949,12.860125261,12.526096033,-13.02713987,-7,1.0020876827,0.3340292276,-12.02505219
22,107,2006,65,84,66,491,5,-19,71,50,5999,10.880482089,14.0609307,11.047874121,-2,0.8369601607,-3.180448611,11.884834282
22,107,2007,92,61,-205,491,3,31,-202,-171,5828,15.557622389,10.315380063,-34.66644119,0,0.5073137736,5.2422423269,-34.15912742
22,107,2008,85,73,-147,491,2,12,-145,-134,5694,14.75438292,12.671411213,-25.5164034,-1,0.3471619511,2.0829717063,-25.16924145
22,109,2001,1778,846,-632,1413,57,932,-575,269,104724,16.999794434,8.0887660807,-6.042671587,-88,0.5449877856,8.9110283537,-5.497683802
22,109,2002,1639,845,-575,1413,53,794,-522,188,104912,15.636627297,8.0615924746,-5.485699021,-84,0.5056383446,7.5750348223,-4.980060677
22,109,2003,1703,820,-552,1413,38,883,-514,245,105157,16.213720254,7.806958666,-5.255416078,-124,0.3617858894,8.4067615879,-4.893630188
22,109,2004,1701,823,-564,1413,50,878,-514,278,105435,16.154459809,7.8160613888,-5.356328825,-86,0.4748518462,8.3383984197,-4.881476979
22,109,2005,1687,860,-39,1413,47,827,8,732,106167,15.945028875,8.1284675948,-0.368616554,-103,0.4442302058,7.8165612801,0.075613652
22,109,2006,1622,969,1229,1413,51,653,1280,1876,108043,15.144017553,9.0471966762,11.474721068,-57,0.4761682461,6.0968208767,11.950889314
22,109,2007,1765,930,-504,1413,47,835,-457,273,108316,16.315475668,8.5968228731,-4.658923363,-105,0.4344630914,7.7186527947,-4.224460272
22,109,2008,1744,861,-511,1413,49,883,-462,260,108576,16.081736532,7.939435295,-4.712022573,-161,0.451837781,8.1423012375,-4.260184792
22,111,2001,344,256,-56,450,18,88,-38,26,22805,15.093015093,11.232011232,-2.457002457,-24,0.7897507898,3.861003861,-1.667251667
22,111,2002,316,230,-248,450,17,86,-231,-161,22644,13.905696495,10.121234791,-10.91333143,-16,0.7480912671,3.7844617043,-10.16524016
22,111,2003,304,286,107,450,11,18,118,111,22755,13.392365471,12.599396462,4.713760215,-25,0.4845921716,0.7929690081,5.1983523866
22,111,2004,316,237,-170,450,13,79,-157,-97,22658,13.916719882,10.437539911,-7.486842974,-19,0.5725232863,3.4791799705,-6.914319688
22,111,2005,348,244,-34,450,12,104,-22,60,22718,15.338504937,10.754583921,-1.498589563,-22,0.5289139633,4.5839210155,-0.969675599
22,111,2006,305,251,28,450,13,54,41,85,22803,13.400408603,11.027877243,1.2302014455,-10,0.5711649568,2.3725313592,1.8013664023
22,111,2007,342,258,-167,450,9,84,-158,-65,22738,15.019433038,11.330449485,-7.334050636,9,0.3952482379,3.6889835533,-6.938802398
22,111,2008,321,257,-131,450,9,64,-122,-46,22692,14.131631081,11.314109619,-5.767114242,12,0.3962139555,2.8175214616,-5.370900286
22,113,2001,802,516,-323,767,57,286,-266,-26,53938,14.865340772,9.5642342125,-5.986914052,-46,1.0565142444,5.3011065597,-4.930399807
22,113,2002,812,563,12,767,55,249,67,262,54200,15.017847565,10.41262091,0.221938634,-54,1.017218739,4.6052266548,1.239157373
22,113,2003,809,553,-308,767,42,256,-266,-69,54131,14.935706308,10.209450665,-5.68627632,-59,0.7754013163,4.7262556424,-4.910875003
22,113,2004,783,562,-27,767,46,221,19,205,54336,14.437570874,10.362598763,-0.497847272,-35,0.8481842404,4.0749721113,0.3503369688
22,113,2005,816,495,228,767,45,321,273,540,54876,14.943412812,9.0649379189,4.1753653445,-54,0.8240852654,5.8784748929,4.9994506098
22,113,2006,749,602,330,767,47,147,377,495,55371,13.58767132,10.920932089,5.9865574573,-29,0.8526309106,2.666739231,6.8391883679
22,113,2007,837,503,-46,767,41,334,-5,297,55668,15.075784184,9.059879862,-0.828537721,-32,0.738479273,6.0159043219,-0.090058448
22,113,2008,808,559,150,767,43,249,193,428,56096,14.459038689,10.003221073,2.6842274793,-14,0.7694785441,4.4558176157,3.4537060234
22,115,2001,1025,350,-932,3399,-10,675,-942,-300,52223,19.571153075,6.6828327573,-17.79542894,-33,-0.190938079,12.888320318,-17.98636702
22,115,2002,980,339,-949,3422,-381,641,-1330,-709,51514,18.893933698,6.5357586975,-18.29626845,-20,-7.345498713,12.358175,-25.64176716
22,115,2003,1046,351,102,3419,-1125,695,-1023,-396,51118,20.383506119,6.8399719386,1.9876841531,-68,-21.92298698,13.54353418,-19.93530283
22,115,2004,890,372,-1877,3422,524,518,-1353,-925,50193,17.569661735,7.3437237812,-37.05421919,-90,10.344385111,10.225937953,-26.70983408
22,115,2005,969,339,-484,3792,-65,630,-549,37,50230,19.298367904,6.7514414029,-9.639226074,-44,-1.294524163,12.546926501,-10.93375024
22,115,2006,906,354,-2578,3419,259,552,-2319,-1777,48453,18.361825238,7.1744880071,-52.24810758,-10,5.249131056,11.187337231,-46.99897652
22,115,2007,917,319,-1500,3419,-61,598,-1561,-926,47527,19.108147531,6.6472181705,-31.25651177,37,-1.271098145,12.46092936,-32.52760992
22,115,2008,853,319,-2519,3419,64,534,-2455,-1888,45639,18.311401155,6.8479917566,-54.07552111,33,1.3738917631,11.463409398,-52.70162935
22,117,2001,641,548,-171,1719,1,93,-170,-116,43775,14.623685351,12.501996213,-3.901170351,-39,0.0228138617,2.1216891383,-3.878356489
22,117,2002,669,497,-142,1708,0,172,-142,-9,43766,15.284266801,11.354679522,-3.244194149,-39,0,3.9295872791,-3.244194149
22,117,2003,628,560,-85,1705,-4,68,-89,-76,43690,14.361507501,12.80643981,-1.943834614,-55,-0.09147457,1.5550676912,-2.035309184
22,117,2004,633,587,36,1657,4,46,40,58,43748,14.478830714,13.426656602,0.8234406093,-28,0.091493401,1.0521741119,0.9149340104
22,117,2005,571,580,221,1645,1,-9,222,171,43919,13.026566439,13.231888852,5.0418059247,-42,0.0228136015,-0.205322413,5.0646195262
22,117,2006,612,600,116,1649,3,12,119,109,44028,13.917473024,13.644581396,2.6379524032,-22,0.068222907,0.2728916279,2.7061753101
22,117,2007,712,551,782,1649,1,161,783,967,44995,15.995866237,12.37882345,17.568493535,23,0.0224661043,3.6170427867,17.59095964
22,117,2008,665,560,302,1649,3,105,305,435,45430,14.708321814,12.385955212,6.6795687033,25,0.0663533315,2.3223666022,6.7459220348
22,119,2001,564,559,-376,936,8,5,-368,-396,41314,13.586432839,13.465985739,-9.057621892,-33,0.1927153594,0.1204470996,-8.864906533
22,119,2002,515,530,-20,936,7,-15,-13,-68,41246,12.475775194,12.839147287,-0.484496124,-40,0.1695736434,-0.363372093,-0.314922481
22,119,2003,513,545,-268,936,4,-32,-264,-338,40908,12.488740658,13.267765416,-6.524332351,-42,0.0973780948,-0.779024758,-6.426954257
22,119,2004,525,540,-14,936,9,-15,-5,-46,40862,12.840895194,13.207777914,-0.342423872,-26,0.2201296319,-0.36688272,-0.12229424
22,119,2005,518,518,14,936,7,0,21,-19,40843,12.67976256,12.67976256,0.3426962854,-40,0.1713481427,0,0.5140444281
22,119,2006,492,545,142,936,9,-53,151,79,40922,12.034489085,13.330887299,3.4733688008,-19,0.220143093,-1.296398214,3.6935118938
22,119,2007,533,559,-34,936,6,-26,-28,-52,40870,13.033059468,13.668818466,-0.831377152,2,0.146713615,-0.635758998,-0.684663537
22,119,2008,542,546,-149,936,8,-4,-141,-116,40754,13.280407723,13.378418112,-3.650886994,29,0.1960207782,-0.098010389,-3.454866216
22,121,2001,311,155,-85,570,5,156,-80,57,21621,14.403149242,7.1784184323,-3.936552044,-19,0.2315618849,7.2247308093,-3.704990159
22,121,2002,293,165,-87,570,4,128,-83,23,21644,13.544435456,7.6274124581,-4.021726569,-22,0.1849069687,5.9170229978,-3.8368196
22,121,2003,299,175,-173,570,4,124,-169,-71,21573,13.837147419,8.0986648772,-8.006108707,-26,0.1851123401,5.7384825416,-7.820996367
22,121,2004,323,186,24,570,5,137,29,150,21723,14.920546933,8.5920177384,1.1086474501,-16,0.2309682188,6.3285291944,1.3396156689
22,121,2005,320,198,-316,570,5,122,-311,-205,21518,14.80076779,9.15797507,-14.61575819,-16,0.2312619967,5.6427927199,-14.3844962
22,121,2006,311,205,570,570,5,106,575,666,22184,14.232758226,9.3817216603,26.085762665,-15,0.2288224795,4.8510365658,26.314585145
22,121,2007,357,200,291,570,2,157,293,436,22620,15.936077136,8.9277743059,12.989911615,-14,0.0892777431,7.0083028301,13.079189358
22,121,2008,336,214,-171,570,2,122,-169,-67,22553,14.876142829,9.4746862064,-7.570894118,-20,0.0885484692,5.4014566223,-7.482345649
22,123,2001,159,155,-210,790,1,4,-209,-213,12070,13.057939474,12.729437852,-17.24633515,-8,0.0821254055,0.328501622,-17.16420975
22,123,2002,157,127,-12,790,0,30,-12,7,12077,13.003685758,10.51890504,-0.993912287,-11,0,2.4847807181,-0.993912287
22,123,2003,146,155,6,790,0,-9,6,-20,12057,12.099113284,12.844949035,0.4972238336,-17,0,-0.74583575,0.4972238336
22,123,2004,135,173,-131,790,1,-38,-130,-178,11879,11.280080214,14.455213904,-10.94585561,-10,0.0835561497,-3.17513369,-10.86229947
22,123,2005,136,129,-87,790,1,7,-86,-89,11790,11.49182475,10.90033377,-7.351387891,-10,0.0844987114,0.5914909798,-7.26688918
22,123,2006,147,158,-89,790,1,-11,-88,-105,11685,12.523961661,13.46112886,-7.582534611,-6,0.0851970181,-0.937167199,-7.497337593
22,123,2007,154,130,-166,790,1,24,-165,-135,11550,13.255863998,11.190015063,-14.28878847,6,0.0860770389,2.0658489348,-14.20271143
22,123,2008,137,132,-66,790,1,5,-65,-55,11495,11.889780864,11.455847255,-5.727923628,5,0.0867867216,0.4339336082,-5.641136906
22,125,2001,133,87,-93,5152,3,46,-90,-57,15080,8.8029916934,5.7583479498,-6.155475395,-13,0.1985637224,3.0446437436,-5.956911672
22,125,2002,118,93,-27,5161,3,25,-24,-16,15064,7.8290870488,6.1703821656,-1.791401274,-17,0.199044586,1.6587048832,-1.592356688
22,125,2003,121,103,22,5138,2,18,24,20,15084,8.0270664721,6.8329574101,1.4594666313,-22,0.1326787847,1.194109062,1.5921454159
22,125,2004,129,96,-130,5149,2,33,-128,-106,14978,8.5822633225,6.3868006121,-8.648792496,-11,0.1330583461,2.1954627104,-8.515734149
22,125,2005,103,114,83,5144,3,-11,86,62,15040,6.8625491372,7.5954427344,5.5300153241,-13,0.199880072,-0.732893597,5.7298953961
22,125,2006,100,133,237,5150,3,-33,240,199,15239,6.6052379537,8.7849664784,15.65441395,-8,0.1981571386,-2.179728525,15.852571089
22,125,2007,124,99,-184,5150,2,25,-182,-177,15062,8.1845483647,6.5344378073,-12.1448137,-20,0.1320088446,1.6501105574,-12.01280486
22,125,2008,123,115,-41,5150,2,8,-39,-59,15003,8.1822717446,7.6500914685,-2.727423915,-28,0.133045069,0.5321802761,-2.594378846
22,127,2001,201,209,-323,1711,2,-8,-321,-336,16494,12.063377746,12.543512183,-19.38542792,-7,0.1200336094,-0.480134438,-19.26539431
22,127,2002,192,201,-42,1772,2,-9,-40,-66,16428,11.663932932,12.210679789,-2.551485329,-17,0.1214993014,-0.546746856,-2.429986028
22,127,2003,204,204,-280,1698,1,0,-279,-282,16146,12.525326948,12.525326948,-17.19162522,-3,0.0613986615,0,-17.13022656
22,127,2004,186,222,-209,1692,0,-36,-209,-262,15884,11.61411177,13.862004371,-13.05026538,-17,0,-2.247892601,-13.05026538
22,127,2005,207,209,-154,1700,1,-2,-153,-169,15715,13.101680433,13.228266717,-9.747143897,-14,0.0632931422,-0.126586284,-9.683850755
22,127,2006,202,178,-81,1679,0,24,-81,-64,15651,12.880188739,11.349869285,-5.164828158,-7,0,1.5303194542,-5.164828158
22,127,2007,198,173,-182,1679,1,25,-181,-154,15497,12.713496854,11.108257352,-11.68614357,2,0.0642095801,1.6052395017,-11.62193399
22,127,2008,198,188,-103,1679,0,10,-103,-89,15408,12.813460605,12.16631613,-6.665588093,4,0,0.647144475,-6.665588093
23,0,2001,13723,12279,6260,36681,856,1444,7116,7484,1284663,10.713385135,9.5860712722,4.8871085727,-1076,0.6682691595,1.1273138624,5.5553777321
23,0,2002,13346,12552,8664,37771,587,794,9251,9004,1293667,10.35243743,9.7365348889,6.7206292445,-1041,0.4553334911,0.6159025416,7.1759627356
23,0,2003,13786,12694,9194,38681,45,1092,9239,9062,1302729,10.619335417,9.7781694318,7.0821246066,-1269,0.0346634335,0.8411659855,7.11678804
23,0,2004,14048,12533,3711,37493,962,1515,4673,5175,1307904,10.762140829,9.6015027773,2.8429886545,-1013,0.7369860107,1.1606380522,3.5799746651
23,0,2005,13991,12861,2586,37499,638,1130,3224,3140,1311044,10.684442761,9.8215008469,1.974838752,-1214,0.487218532,0.8629419141,2.4620572841
23,0,2006,14097,12407,395,38328,835,1690,1230,2311,1313355,10.743031071,9.4551171525,0.3010213005,-609,0.6363361669,1.2879139186,0.9373574674
23,0,2007,14350,11967,-963,37872,563,2383,-400,2043,1315398,10.917724107,9.1046971701,-0.732666782,60,0.4283399772,1.8130269371,-0.304326804
23,0,2008,14284,12213,-2063,37872,656,2071,-1407,1058,1316456,10.854705466,9.2809099593,-1.567716142,394,0.498507896,1.5737955069,-1.069208246
23,1,2001,1187,1027,170,3752,58,160,228,292,104138,11.414339565,9.8757596738,1.6347411339,-96,0.5577352104,1.5385798908,2.1924763443
23,1,2002,1244,1045,545,3776,42,199,587,704,104842,11.905445497,10.000957029,5.2158101254,-82,0.4019523399,1.9044884678,5.6177624653
23,1,2003,1275,1054,775,3766,12,221,787,904,105746,12.108952077,10.01006705,7.3603434194,-104,0.1139666078,2.0988850267,7.4743100272
23,1,2004,1303,1045,368,3701,68,258,436,616,106362,12.286193826,9.8534708733,3.4699304128,-78,0.6411827937,2.4327229525,4.1111132065
23,1,2005,1330,1047,-25,3411,51,283,26,222,106584,12.491429752,9.8334789101,-0.234801311,-87,0.4789946747,2.657950842,0.2441933636
23,1,2006,1388,1030,-39,3440,65,358,26,332,106916,13.00234192,9.6487119438,-0.365339578,-52,0.6088992974,3.3536299766,0.243559719
23,1,2007,1433,1005,-682,3440,42,428,-640,-215,106701,13.416535201,9.409363487,-6.3852596,-3,0.3932271308,4.0071717139,-5.992032469
23,1,2008,1388,1019,-248,3440,48,369,-200,176,106877,12.997593385,9.5421813108,-2.32233657,7,0.4494844975,3.4554120743,-1.872852073
23,3,2001,684,804,-898,2297,59,-120,-839,-1011,72852,9.3241999796,10.960024537,-12.24142044,-52,0.8042804076,-1.635824558,-11.43714003
23,3,2002,717,807,1,2332,50,-90,51,-109,72743,9.8492393283,11.08554552,0.0137367355,-70,0.6868367732,-1.236306192,0.7005735087
23,3,2003,676,928,159,2240,25,-252,184,-161,72582,9.3032857389,12.771374505,2.1881988646,-93,0.3440564253,-3.468088767,2.5322552899
23,3,2004,674,901,98,2196,56,-227,154,-122,72460,9.2938597096,12.423987535,1.3513327174,-49,0.7721901242,-3.130127825,2.1235228417
23,3,2005,718,880,17,2135,47,-162,64,-166,72294,9.9202785415,12.158558658,0.2348812468,-68,0.6493775647,-2.238280117,0.8842588115
23,3,2006,682,791,-180,2095,54,-109,-126,-269,72025,9.4512850006,10.961827618,-2.494474047,-34,0.7483422141,-1.510542617,-1.746131833
23,3,2007,729,778,-57,2095,40,-49,-17,-73,71952,10.126617446,10.807281719,-0.791793134,-7,0.5556443043,-0.680664273,-0.236148829
23,3,2008,720,837,-226,2095,44,-117,-182,-276,71676,10.025900242,11.655109032,-3.147018687,23,0.6126939037,-1.629208789,-2.534324783
23,5,2001,3033,2371,1125,9580,378,662,1503,1920,267948,11.360061126,8.8805489385,4.2136725246,-245,1.4157939683,2.4795121878,5.6294664929
23,5,2002,2879,2446,1259,9693,284,433,1543,1722,269670,10.710206876,9.0993977136,4.6836229442,-254,1.0565122448,1.6108091619,5.7401351889
23,5,2003,3072,2451,1705,9968,105,621,1810,2125,271795,11.346993804,9.0532167361,6.2977293085,-306,0.3878367023,2.2937770678,6.6855660107
23,5,2004,3071,2412,504,10152,387,659,891,1375,273170,11.270448561,8.8519446203,1.8496600699,-175,1.4202746965,2.4185039406,3.2699347665
23,5,2005,2960,2351,89,10175,292,609,381,737,273907,10.821145835,8.5947681953,0.3253655336,-253,1.0674914135,2.2263776397,1.392856947
23,5,2006,3073,2368,-742,9869,353,705,-389,194,274101,11.215164742,8.6422096028,-2.707989664,-122,1.2883023605,2.5729551393,-1.419687304
23,5,2007,3089,2251,-362,9712,263,838,-99,781,274882,11.253536084,8.2006182341,-1.318802222,42,0.9581353157,3.0529178499,-0.360666906
23,5,2008,2983,2289,45,9712,289,694,334,1165,276047,10.828981593,8.3096006926,0.163360433,137,1.0491370031,2.5193809003,1.2124974361
23,7,2001,272,258,69,1250,8,14,77,59,29539,9.2173706772,8.7429471865,2.3382300615,-32,0.2710991376,0.4744234907,2.6093291991
23,7,2002,274,283,302,1283,7,-9,309,276,29815,9.2327391583,9.5360043131,10.176230751,-24,0.2358728982,-0.303265155,10.412103649
23,7,2003,258,257,-65,1343,3,1,-62,-102,29713,8.6681897594,8.6345921247,-2.183846257,-41,0.1007929042,0.0335976347,-2.083053353
23,7,2004,264,281,5,1391,6,-17,11,-28,29685,8.8891881882,9.4615980336,0.1683558369,-22,0.2020270043,-0.572409845,0.3703828412
23,7,2005,281,268,5,1399,4,13,9,0,29685,9.4660602998,9.0281286845,0.1684352367,-22,0.1347481893,0.4379316153,0.303183426
23,7,2006,318,275,172,1388,5,43,177,204,29889,10.675798167,9.232215396,5.774331084,-16,0.1678584617,1.443582771,5.9421895458
23,7,2007,267,278,30,1388,2,-11,32,11,29900,8.9314087876,9.2993694492,1.0035290773,-10,0.0669019385,-0.367960662,1.0704310157
23,7,2008,301,274,-67,1388,2,27,-65,-43,29857,10.074133574,9.170473752,-2.242415115,-5,0.0669377646,0.9036598223,-2.17547735
23,9,2001,503,551,118,1319,29,-48,147,52,51915,9.6937693924,10.618820945,2.2740850662,-47,0.5588853129,-0.925051552,2.8329703791
23,9,2002,475,597,291,1322,7,-122,298,130,52045,9.13813005,11.48518661,5.5983070412,-46,0.1346671797,-2.34705656,5.7329742209
23,9,2003,510,558,719,1362,-40,-48,679,606,52651,9.7424925499,10.659433025,13.735004203,-25,-0.764117063,-0.916940475,12.97088714
23,9,2004,526,560,469,1400,48,-34,517,434,53085,9.9493077098,10.592418855,8.8711507906,-49,0.9079216161,-0.643111145,9.7790724067
23,9,2005,479,588,129,1362,16,-109,145,-16,53069,9.024624602,11.078244814,2.4304312602,-52,0.3014488385,-2.053620212,2.7318800987
23,9,2006,591,563,94,1335,33,28,127,130,53199,11.122821546,10.595851997,1.7691120563,-25,0.6210712538,0.5269695487,2.3901833101
23,9,2007,518,505,-20,1335,12,13,-8,13,53212,9.7358355809,9.4914999389,-0.375900988,8,0.2255405926,0.244335642,-0.150360395
23,9,2008,540,541,-134,1335,20,-1,-114,-75,53137,10.155243585,10.174049591,-2.52000489,40,0.3761201328,-0.018806007,-2.143884757
23,11,2001,1267,1076,612,3817,47,191,659,752,117965,10.774817372,9.1505157795,5.2045684545,-98,0.3996972506,1.6243015928,5.6042657051
23,11,2002,1238,1175,461,3942,36,63,497,457,118422,10.474349266,9.9413250306,3.9003836928,-103,0.3045852775,0.5330242357,4.2049689704
23,11,2003,1168,1173,829,3875,11,-5,840,725,119147,9.832932748,9.875025782,6.9790250411,-110,0.0926046749,-0.042093034,7.071629716
23,11,2004,1295,1133,464,3422,48,162,512,582,119729,10.842445453,9.4860932032,3.8848607646,-92,0.4018821481,1.3563522497,4.2867429126
23,11,2005,1212,1223,519,3337,35,-11,554,428,120157,10.10479978,10.196510009,4.3270553513,-115,0.2918052742,-0.091710229,4.6188606255
23,11,2006,1257,1104,192,3558,43,153,235,331,120488,10.446923892,9.1753412703,1.5957115253,-57,0.3573728937,1.2715826217,1.953084419
23,11,2007,1269,1104,7,3554,30,165,37,198,120686,10.523522436,9.1552157364,0.0580493751,-4,0.2487830363,1.3683066997,0.3068324115
23,11,2008,1300,1134,47,3554,34,166,81,273,120959,10.759585342,9.38566906,0.3890003931,26,0.2814045397,1.3739162821,0.6704049329
23,13,2001,386,452,362,1242,14,-66,376,280,39964,9.6926476497,11.349939735,9.0899959823,-30,0.3515468059,-1.657292085,9.4415427883
23,13,2002,377,465,568,1418,8,-88,576,468,40432,9.3785760486,11.567739689,14.130056222,-20,0.1990148764,-2.18916364,14.329071098
23,13,2003,424,456,285,1554,-3,-32,282,210,40642,10.459580137,11.248982411,7.030614007,-40,-0.074006463,-0.789402274,6.9566075437
23,13,2004,390,427,248,1553,17,-37,265,195,40837,9.5730188147,10.481228292,6.087458118,-33,0.4172854355,-0.908209477,6.5047435536
23,13,2005,443,429,142,1560,9,14,151,125,40962,10.831428257,10.489125784,3.4719250847,-40,0.2200515899,0.3423024731,3.6919766745
23,13,2006,390,403,-137,1513,13,-13,-124,-157,40805,9.5393006959,9.8572773857,-3.350985116,-20,0.3179766899,-0.31797669,-3.033008426
23,13,2007,426,434,-98,1513,8,-8,-90,-82,40723,10.450397409,10.646649004,-2.404082033,16,0.1962515945,-0.196251595,-2.207830439
23,13,2008,419,416,-73,1513,11,3,-62,-37,40686,10.293702171,10.220000246,-1.793413505,22,0.2702403911,0.0737019248,-1.523173114
23,15,2001,308,404,421,419,5,-96,426,296,33995,9.0997725057,11.936065235,12.438325406,-34,0.1477235796,-2.836292729,12.586048985
23,15,2002,273,367,376,445,1,-94,377,262,34257,7.9997655746,10.754263611,11.017992147,-21,0.0293031706,-2.754498037,11.047295317
23,15,2003,310,371,361,438,-8,-61,353,268,34525,9.0139862173,10.787706086,10.496932337,-24,-0.232618999,-1.773719869,10.264313338
23,15,2004,284,343,394,400,8,-59,402,307,34832,8.1895122338,9.8908545641,11.361506409,-36,0.2306904855,-1.70134233,11.592196894
23,15,2005,339,408,152,424,1,-69,153,50,34882,9.7254496945,11.704966004,4.3606736093,-34,0.0286886422,-1.979516309,4.3893622515
23,15,2006,309,383,-2,381,5,-74,3,-88,34794,8.869625122,10.993742465,-0.057408577,-17,0.1435214421,-2.124117343,0.0861128653
23,15,2007,320,393,38,378,0,-73,38,-25,34769,9.2002932593,11.299110159,1.0925348245,10,0,-2.0988169,1.0925348245
23,15,2008,318,379,-100,378,3,-61,-97,-141,34628,9.1646612966,10.922662363,-2.881968961,17,0.0864590688,-1.758001066,-2.795509892
23,17,2001,526,582,296,835,12,-56,308,204,55006,9.5803584438,10.60032056,5.3912283258,-48,0.2185633105,-1.019962116,5.6097916363
23,17,2002,516,572,551,835,12,-56,563,472,55478,9.3407190181,10.354440462,9.9742949205,-35,0.2172260237,-1.013721444,10.191520944
23,17,2003,525,616,264,825,5,-91,269,125,55603,9.4525616442,11.091005663,4.7532881411,-53,0.0900243966,-1.638444018,4.8433125377
23,17,2004,589,636,447,821,8,-47,455,349,55952,10.559813545,11.402447223,8.0139841334,-59,0.1434270091,-0.842633678,8.1574111425
23,17,2005,568,632,356,818,6,-64,362,244,56196,10.129471769,11.270820701,6.348753433,-54,0.1070014624,-1.141348932,6.4557548953
23,17,2006,573,616,291,884,7,-43,298,230,56426,10.175631759,10.939248104,5.1677292181,-25,0.1243096375,-0.763616345,5.2920388556
23,17,2007,597,583,204,884,6,14,210,230,56656,10.558709609,10.311101678,3.6080012734,6,0.1061176845,0.2476079305,3.7141189579
23,17,2008,596,584,52,884,7,12,59,85,56741,10.511741933,10.300096122,0.9171318465,14,0.1234600563,0.2116458107,1.0405919028
23,19,2001,1572,1368,479,6667,118,204,597,668,145572,10.823613655,9.4190225699,3.2980349495,-133,0.8124595492,1.404591085,4.1104944987
23,19,2002,1476,1343,534,6801,97,133,631,635,146207,10.117246272,9.2055973871,3.6603045456,-129,0.6648867807,0.9116488849,4.3251913263
23,19,2003,1557,1394,798,7039,55,163,853,854,147061,10.61827407,9.5066628476,5.4421211997,-162,0.3750835413,1.1116112225,5.8172047411
23,19,2004,1573,1340,-727,6418,112,233,-615,-495,146566,10.714273551,9.1272260385,-4.951860694,-113,0.7628726241,1.5870475127,-4.18898807
23,19,2005,1621,1445,212,6550,91,176,303,336,146902,11.047201058,9.847751714,1.4447912549,-143,0.6201698311,1.1994493437,2.064961086
23,19,2006,1603,1439,741,7073,104,164,845,937,147839,10.877346552,9.7645051079,5.028143353,-72,0.7057043302,1.1128414438,5.7338476832
23,19,2007,1655,1289,252,7070,84,366,336,688,148527,11.168622582,8.69870363,1.7005999339,-14,0.5668666446,2.4699189516,2.2674665785
23,19,2008,1698,1315,-354,7070,90,383,-264,124,148651,11.427494633,8.8499148658,-2.382410542,5,0.6056975954,2.577579767,-1.776712946
23,21,2001,154,187,-63,208,4,-33,-59,-107,17137,8.9584363457,10.878101277,-3.664814869,-15,0.2326866583,-1.919664931,-3.43212821
23,21,2002,162,244,96,214,3,-82,99,0,17137,9.4532298535,14.238198051,5.6019139873,-17,0.1750598121,-4.784968197,5.7769737994
23,21,2003,149,246,184,217,1,-97,185,76,17213,8.6754002911,14.323144105,10.713245997,-12,0.058224163,-5.647743814,10.77147016
23,21,2004,176,228,86,206,4,-52,90,25,17238,10.217410235,13.236190531,4.9925981829,-13,0.232213869,-3.018780297,5.2248120519
23,21,2005,162,210,111,234,2,-48,113,50,17288,9.3842321729,12.164745409,6.4299368592,-15,0.1158547182,-2.780513236,6.5457915774
23,21,2006,141,202,-44,245,3,-61,-41,-110,17178,8.1819764406,11.721696745,-2.553240875,-8,0.1740846051,-3.539720304,-2.37915627
23,21,2007,170,206,22,245,3,-36,25,-16,17162,9.900990099,11.997670355,1.281304601,-5,0.1747233547,-2.096680256,1.4560279557
23,21,2008,175,209,-164,245,3,-34,-161,-201,16961,10.2570114,12.249802186,-9.612284969,-6,0.1758344811,-1.992790786,-9.436450488
23,23,2001,386,274,189,335,8,112,197,274,35500,10.915363516,7.7482114074,5.3445691825,-35,0.2262251506,3.1671521081,5.5707943331
23,23,2002,395,308,277,309,-27,87,250,307,35807,11.078856213,8.6387030726,7.7692232179,-30,-0.757288906,2.4401531406,7.0119343122
23,23,2003,430,323,858,649,-86,107,772,884,36691,11.862396204,8.910590637,23.669618472,5,-2.372479241,2.9518055671,21.297139231
23,23,2004,462,301,-273,379,53,161,-220,-94,36597,12.607793909,8.2141687589,-7.450060037,-35,1.4463486519,4.3936251501,-6.003711385
23,23,2005,395,371,-259,300,3,24,-256,-264,36333,10.83230495,10.174139586,-7.10270122,-32,0.0822706705,0.658165364,-7.02043055
23,23,2006,417,342,-2,502,31,75,29,88,36421,11.463287242,9.4015449322,-0.054979795,-16,0.8521868213,2.0617423097,0.7972070264
23,23,2007,417,322,-179,371,2,95,-177,-77,36344,11.461554319,8.8504088504,-4.919947777,5,0.0549714835,2.6111454683,-4.864976294
23,23,2008,410,310,-132,371,14,100,-118,-12,36332,11.282954483,8.5310143651,-3.632560955,6,0.3852716165,2.7519401178,-3.247289339
23,25,2001,556,516,-122,897,10,40,-112,-119,50774,10.937669057,10.150786391,-2.399992131,-47,0.1967206665,0.786882666,-2.203271465
23,25,2002,557,479,-22,888,9,78,-13,12,50786,10.968885388,9.4328475778,-0.433241434,-53,0.1772351319,1.5360378102,-0.256006302
23,25,2003,558,529,196,894,5,29,201,163,50949,10.969676119,10.399567504,3.8531478842,-67,0.0982945889,0.5701086155,3.9514424731
23,25,2004,520,495,-121,885,10,25,-111,-121,50828,10.2184187,9.7271485699,-2.377747428,-35,0.1965080519,0.4912701298,-2.181239376
23,25,2005,560,505,107,874,8,55,115,122,50950,11.004342785,9.9235591189,2.1026154965,-48,0.1572048969,1.0807836664,2.2598203934
23,25,2006,513,497,470,867,10,16,480,472,51422,10.022271715,9.7096862423,9.1821982573,-24,0.1953659204,0.3125854726,9.3775641777
23,25,2007,573,507,71,867,8,66,79,158,51580,11.125997553,9.8444690394,1.3786140075,13,0.1553367896,1.281528514,1.5339507971
23,25,2008,542,527,-267,867,10,15,-257,-203,51377,10.528667308,10.237283526,-5.186631312,39,0.1942558544,0.2913837816,-4.992375458
23,27,2001,399,358,526,506,5,41,531,550,37018,10.859211278,9.7433524753,14.315651961,-22,0.1360803418,1.115858803,14.451732303
23,27,2002,387,337,473,550,2,50,475,506,37524,10.383408012,9.0418824287,12.690832014,-19,0.0536610233,1.3415255829,12.744493037
23,27,2003,384,338,287,552,-6,46,281,298,37822,10.192976402,8.9719427707,7.6181880923,-29,-0.159265256,1.2210336315,7.458922836
23,27,2004,389,353,176,569,7,36,183,189,38011,10.259385756,9.3099310327,4.6417786452,-30,0.1846161961,0.9494547229,4.8263948413
23,27,2005,428,342,74,517,2,86,76,134,38145,11.240086139,8.9815641578,1.9433793792,-28,0.052523767,2.2585219812,1.9959031462
23,27,2006,429,336,241,776,5,93,246,320,38465,11.1995823,8.7717008223,6.2916068398,-19,0.1305312622,2.4278814776,6.4221381021
23,27,2007,401,356,-29,776,2,45,-27,4,38469,10.424519718,9.2546858346,-0.753892947,-14,0.051992617,1.1698338836,-0.70190033
23,27,2008,404,357,-158,776,4,47,-154,-127,38342,10.519326659,9.295543607,-4.113994089,-20,0.1041517491,1.2237830519,-4.00984234
23,29,2001,365,435,-391,958,21,-70,-370,-462,33430,10.843409287,12.922967232,-11.61581652,-22,0.6238673836,-2.079557945,-10.99194914
23,29,2002,335,440,-113,957,13,-105,-100,-234,33196,10.056134242,13.208056915,-3.392069162,-29,0.3902380452,-3.151922673,-3.001831117
23,29,2003,354,419,81,982,-13,-65,68,-40,33156,10.670364119,12.629611768,2.4415239932,-43,-0.39184953,-1.959247649,2.0496744635
23,29,2004,332,446,76,942,21,-114,97,-40,33116,10.019314341,13.459681313,2.2935779817,-23,0.6337518107,-3.440366972,2.9273297924
23,29,2005,362,431,-183,881,9,-69,-174,-275,32841,10.976848553,13.069120791,-5.549069849,-32,0.2729050745,-2.092272238,-5.276164774
23,29,2006,356,442,-27,851,16,-86,-11,-111,32730,10.85845877,13.481569596,-0.823534794,-14,0.4880206189,-2.623110826,-0.335514175
23,29,2007,359,372,-20,851,4,-13,-16,-26,32704,10.972888712,11.370235657,-0.611302992,3,0.1222605985,-0.397346945,-0.489042394
23,29,2008,354,414,-179,851,8,-60,-171,-205,32499,10.858396086,12.698802202,-5.490544914,26,0.2453874822,-1.840406116,-5.245157431
23,31,2001,2125,1616,3367,2599,80,509,3447,3836,191910,11.18468146,8.5056212893,17.721798813,-120,0.4210703609,2.679060171,18.142869173
23,31,2002,2041,1644,3065,3006,43,397,3108,3396,195306,10.541919755,8.4913846535,15.830957398,-109,0.2220982604,2.0505351019,16.053055659
23,31,2003,2136,1581,1758,2977,-21,555,1737,2127,197433,10.877452965,8.0511484726,8.9525104459,-165,-0.106941251,2.8263044923,8.8455691948
23,31,2004,2200,1632,1497,3058,109,568,1606,2003,199436,11.086781784,8.2243763055,7.5440510597,-171,0.549299643,2.8624054789,8.0933507026
23,31,2005,2133,1731,1140,3522,62,402,1202,1413,200849,10.657406598,8.6488377031,5.6959416416,-191,0.3097792823,2.0085688947,6.0057209238
23,31,2006,2057,1616,-633,3551,88,441,-545,-192,200657,10.24642222,8.0496929062,-3.153128471,-88,0.4383496137,2.1967293141,-2.714778858
23,31,2007,2127,1584,-140,3393,57,543,-83,474,201131,10.587673101,7.8847551445,-0.696884924,14,0.2837317192,2.7029179567,-0.413153205
23,31,2008,2136,1608,-105,3393,69,528,-36,555,201686,10.60531209,7.9837742697,-0.521328544,63,0.3425873287,2.6215378199,-0.178741215
24,0,2001,73807,43790,8893,136056,20557,30017,29450,65208,5375659,13.813632837,8.1956858015,1.6644036043,5741,3.8474243668,5.6179470359,5.5118279711
24,0,2002,73116,44118,12872,136818,17715,28998,30587,63668,5439327,13.52123803,8.1586790773,2.3804006774,4083,3.2760097886,5.3625589529,5.656410466
24,0,2003,73806,43847,7579,138498,12307,29959,19886,55682,5495009,13.499859525,8.020057185,1.3862753074,5837,2.2510740478,5.4798023401,3.6373493553
24,0,2004,75198,44152,-10944,136381,17663,31046,6719,43980,5538989,13.630236293,8.0029015775,-1.983687146,6215,3.2015593985,5.6273347158,1.2178722527
24,0,2005,74926,44032,-12488,138871,15978,30894,3490,36563,5575552,13.482518081,7.9233141522,-2.247146328,2179,2.8751524692,5.5592039293,0.6280061408
24,0,2006,76062,43011,-25890,140752,17409,33051,-8481,26706,5602258,13.60946375,7.6957829843,-4.632392213,2136,3.1149214381,5.9136807657,-1.517470775
24,0,2007,76502,44424,-33716,142849,14606,32078,-19110,16641,5618899,13.635314077,7.9179000882,-6.009362493,3673,2.6032966119,5.7174139886,-3.406065881
24,0,2008,76369,44374,-32161,142849,15092,31995,-17069,14698,5633597,13.57369956,7.8869612573,-5.716242867,-228,2.6824270811,5.6867383023,-3.033815786
24,1,2001,751,885,-300,6232,14,-134,-286,-487,74320,10.071952095,11.869078034,-4.023416283,-67,0.1877594265,-1.79712594,-3.835656856
24,1,2002,684,932,-286,6246,13,-248,-273,-583,73737,9.239684716,12.589745841,-3.863376943,-62,0.1756080428,-3.350061125,-3.6877689
24,1,2003,707,852,-177,6245,4,-145,-173,-410,73327,9.6148615569,11.586792145,-2.40711527,-92,0.0543980852,-1.971930588,-2.352717184
24,1,2004,665,943,395,6525,12,-278,407,71,73398,9.0645765889,12.853978531,5.3842221844,-58,0.1635713069,-3.789401942,5.5477934912
24,1,2005,632,960,-293,6448,9,-328,-284,-682,72716,8.6507795283,13.1404246,-4.010567091,-70,0.1231914806,-4.489645072,-3.887375611
24,1,2006,702,909,-72,6516,11,-207,-61,-301,72415,9.6740186452,12.526613887,-0.992207041,-33,0.1515871867,-2.852595242,-0.840619854
24,1,2007,693,870,351,6750,8,-177,359,188,72603,9.5574342495,11.99851053,4.8407783861,6,0.1103311313,-2.44107628,4.9511095174
24,1,2008,714,882,-220,6750,8,-168,-212,-365,72238,9.8590868608,12.178872004,-3.037813879,15,0.1104659592,-2.319785144,-2.927347919
24,3,2001,6805,3585,2230,16267,543,3220,2773,5550,496881,13.772348443,7.255528166,4.5132016207,-443,1.0989544754,6.5168202774,5.6121560961
24,3,2002,6817,3616,2690,16358,-91,3201,2599,5386,502267,13.645626073,7.2381669182,5.3845876687,-414,-0.182155196,6.4074591552,5.2024324725
24,3,2003,6855,3614,1426,16289,-1281,3241,145,2733,505000,13.611088222,7.1758530757,2.8314240415,-653,-2.543516267,6.4352351462,0.2879077742
24,3,2004,6934,3567,-1085,16193,1206,3367,121,3132,508132,13.688245954,7.0415306199,-2.141872925,-356,2.3807361726,6.6467153342,0.2388632478
24,3,2005,6724,3611,-1661,16040,306,3113,-1355,1282,509414,13.216110132,7.0974678295,-3.264717271,-476,0.6014470107,6.1186423022,-2.66327026
24,3,2006,6813,3703,-4091,15663,820,3110,-3271,-377,509037,13.379141461,7.2718275106,-8.033768929,-216,1.6102885657,6.1073139503,-6.423480364
24,3,2007,6954,3771,-2103,15351,294,3183,-1809,1470,510507,13.641392623,7.3974247311,-4.125373696,96,0.5767284198,6.2439678915,-3.548645277
24,3,2008,6674,3758,-1212,15351,471,2916,-741,2283,512790,13.044111338,7.3448861865,-2.368813746,108,0.9205538568,5.6992251516,-1.448259889
24,5,2001,9266,7689,3434,18229,1974,1577,5408,6277,762269,12.206069971,10.128693288,4.523596404,-708,2.6003434192,2.0773766829,7.1239398233
24,5,2002,8934,7703,3436,18390,1821,1231,5257,5778,768047,11.676019855,10.067201807,4.4905758026,-710,2.3799006218,1.608818048,6.8704764245
24,5,2003,9316,7719,3638,18569,1552,1597,5190,5874,773921,12.083259834,10.011880921,4.7186452637,-913,2.0130119432,2.0713789132,6.7316572069
24,5,2004,9368,7589,2157,18516,1503,1779,3660,4889,778810,12.066481573,9.7750350833,2.7783305672,-550,1.9359438306,2.2914464901,4.7142743978
24,5,2005,9515,7758,79,18480,1548,1757,1627,2642,781452,12.196669534,9.9444836829,0.1012650439,-742,1.984282127,2.2521858508,2.0855471709
24,5,2006,9833,7589,301,19197,1579,2244,1880,3748,785200,12.552883474,9.6881758042,0.3842589165,-376,2.0157635518,2.8647076696,2.4000224683
24,5,2007,9825,7796,-2881,19106,1401,2029,-1480,630,785830,12.507717867,9.9246990828,-3.667657524,81,1.7835432805,2.5830187839,-1.884114244
24,5,2008,9682,7673,-3848,19106,1411,2009,-2437,-212,785618,12.322393105,9.7655156264,-4.897393996,216,1.7957959792,2.5568774786,-3.101598017
24,9,2001,993,502,1681,571,45,491,1726,2169,77333,13.023207014,6.5837360735,22.046335338,-48,0.5901755444,6.4394709404,22.636510882
24,9,2002,1011,520,2551,585,16,491,2567,3047,80380,12.820756691,6.5942566561,32.349901403,-11,0.2029002048,6.2265000349,32.552801608
24,9,2003,1013,578,2524,602,-45,435,2479,2962,83342,12.374635052,7.060749319,30.832753081,48,-0.549712317,5.3138857331,30.283040764
24,9,2004,1013,562,1540,622,77,451,1617,1969,85311,12.012831079,6.6645716353,18.262349321,-99,0.913117466,5.3482594439,19.175466787
24,9,2005,1031,581,1017,636,32,450,1049,1427,86738,11.984957774,6.7538898802,11.822213439,-72,0.3719870502,5.2310678934,12.194200489
24,9,2006,1020,612,378,633,58,408,436,798,87536,11.70570481,7.0234228858,4.3379964883,-46,0.6656185088,4.6822819239,5.0036149971
24,9,2007,1011,625,229,686,30,386,259,609,88145,11.509497328,7.115168971,2.606997911,-36,0.3415281106,4.3943283565,2.9485260216
24,9,2008,1077,626,67,686,38,451,105,553,88698,12.180295516,7.0797260847,0.7577342615,-3,0.4297597304,5.1005694316,1.1874939918
24,11,2001,392,333,-18,456,55,59,37,66,29891,13.128809699,11.152789872,-0.602853507,-30,1.8420523813,1.9760198272,1.2391988747
24,11,2002,404,327,147,453,54,77,201,253,30144,13.458815691,10.893645374,4.8971433331,-25,1.7989506121,2.5651703173,6.6960939452
24,11,2003,414,285,336,453,41,129,377,490,30634,13.623350554,9.3783934976,11.056632334,-16,1.3491723979,4.2449570568,12.405804732
24,11,2004,405,319,-10,453,46,86,36,102,30736,13.198631253,10.395958938,-0.32589213,-20,1.4991037966,2.8026723155,1.1732116669
24,11,2005,453,293,579,453,43,160,622,753,31489,14.560064283,9.4174367216,18.609883487,-29,1.3820811571,5.1426275613,19.991964644
24,11,2006,480,298,509,456,46,182,555,720,32209,15.071116833,9.3566517002,15.981663475,-17,1.4443153631,5.7144651323,17.425978838
24,11,2007,471,337,403,464,41,134,444,588,32797,14.490970064,10.368273698,12.39885549,10,1.2614220226,4.1226963665,13.660277513
24,11,2008,501,306,91,464,41,195,132,341,33138,15.196784712,9.2818685069,2.7602942292,14,1.2436490483,5.9149162054,4.0039432775
24,13,2001,1930,1195,2193,3662,74,735,2267,2874,154451,12.613224934,7.8097428993,14.332021906,-128,0.4836158783,4.8034820343,14.815637785
24,13,2002,1903,1203,3457,3738,64,700,3521,4146,158597,12.157879942,7.6857223173,22.086069868,-75,0.4088829828,4.4721576244,22.494952851
24,13,2003,1917,1235,2947,3878,35,682,2982,3632,162229,11.950403022,7.698877273,18.371329007,-32,0.2181868053,4.2515257492,18.589515812
24,13,2004,1938,1283,2216,3878,63,655,2279,2771,165000,11.844915946,7.8416032809,13.544031855,-163,0.3850514472,4.0033126648,13.929083303
24,13,2005,2027,1284,1155,3905,55,743,1210,1820,166820,12.217467302,7.739135676,6.9616056898,-133,0.3315050328,4.4783316256,7.2931107227
24,13,2006,1896,1301,787,3935,64,595,851,1360,168180,11.319402985,7.7671641791,4.6985074627,-86,0.3820895522,3.552238806,5.0805970149
24,13,2007,1960,1295,-54,3868,53,665,-1,606,168786,11.633221156,7.6862354065,-0.320507113,-58,0.3145717966,3.9469857493,-0.005935317
24,13,2008,2088,1317,-233,3868,55,771,-178,567,169353,12.34995076,7.7896959534,-1.378131478,-26,0.3253100056,4.5602548065,-1.052821473
24,15,2001,1132,746,1416,1277,53,386,1469,1791,88256,12.957801295,8.539328415,16.208698439,-64,0.6066815094,4.4184728796,16.815379949
24,15,2002,1170,735,1373,1322,49,435,1422,1803,90059,13.122844405,8.2438381516,15.399713989,-54,0.5495892101,4.879006253,15.949303199
24,15,2003,1175,703,1812,1435,32,472,1844,2308,92367,12.881935689,7.7072347143,19.865589335,-8,0.3508271847,5.1747009746,20.21641652
24,15,2004,1213,752,1916,1487,48,461,1964,2306,94673,12.970487596,8.0410607357,20.487596236,-119,0.5132591959,4.9294268606,21.000855432
24,15,2005,1237,738,1502,1363,43,499,1545,1953,96626,12.932634253,7.7156702335,15.703166248,-91,0.4495580217,5.2169640197,16.152724269
24,15,2006,1283,722,1333,1429,52,561,1385,1894,98520,13.14912937,7.3995880008,13.661566212,-52,0.5329343158,5.749541369,14.194500528
24,15,2007,1343,772,233,1363,42,571,275,848,99368,13.573334411,7.802393273,2.3548673997,2,0.4244825356,5.7709411384,2.7793499353
24,15,2008,1347,779,-88,1363,43,568,-45,558,99926,13.517717543,7.8175961143,-0.883117404,35,0.4315232772,5.7001214286,-0.451594127
24,17,2001,1763,761,2496,1640,57,1002,2553,3487,124691,14.339453832,6.1896337868,20.301348136,-68,0.4636125175,8.1498200451,20.764960654
24,17,2002,1665,870,2399,1590,-51,795,2348,3086,127777,13.189790389,6.8919625457,19.004388675,-57,-0.404011598,6.2978278435,18.600377077
24,17,2003,1862,801,2840,1539,-258,1061,2582,3671,131448,14.365898351,6.1799594946,21.911466872,28,-1.990548751,8.1859388562,19.920918121
24,17,2004,1858,869,2048,1481,193,989,2241,3083,134531,13.971027788,6.5343504562,15.399712007,-147,1.4512423913,7.4366773317,16.850954399
24,17,2005,1879,810,1637,1453,30,1069,1667,2613,137144,13.832704518,5.9630072697,12.051164075,-123,0.2208521211,7.8696972486,12.272016196
24,17,2006,1921,854,898,1433,125,1067,1023,2020,139164,13.904772935,6.181507593,6.4999927617,-70,0.9047874111,7.7232653416,7.4047801729
24,17,2007,1899,874,-22,1441,31,1025,9,1005,140169,13.596674936,6.2577640307,-0.157518088,-29,0.2219573054,7.3389109056,0.0644392177
24,17,2008,1936,866,-513,1441,62,1070,-451,595,140764,13.782645684,6.165171055,-3.652116341,-24,0.4413863804,7.6174746292,-3.210729961
24,19,2001,366,399,68,685,9,-33,77,16,30602,11.963130025,13.041772897,2.2226580375,-28,0.2941753285,-1.078642871,2.516833366
24,19,2002,296,415,-27,696,7,-119,-20,-169,30433,9.6993528303,13.598754813,-0.884738265,-30,0.2293765872,-3.899401982,-0.655361678
24,19,2003,321,398,142,709,0,-77,142,32,30465,10.542218135,13.071036816,4.6635357483,-33,0,-2.52881868,4.6635357483
24,19,2004,387,354,380,726,8,33,388,389,30854,12.622515044,11.546176552,12.394200819,-32,0.2609305436,1.0763384921,12.655131362
24,19,2005,306,396,374,733,5,-90,379,262,31116,9.8757463289,12.780377602,12.070356624,-27,0.1613684041,-2.904631273,12.231725028
24,19,2006,379,376,242,723,12,3,254,242,31358,12.133047348,12.037007395,7.7472228447,-15,0.3841598105,0.0960399526,8.1313826552
24,19,2007,405,392,458,767,10,13,468,487,31845,12.815847349,12.404474471,14.492982928,6,0.3164406753,0.4113728779,14.809423603
24,19,2008,394,411,152,767,10,-17,162,153,31998,12.342778378,12.875334806,4.7616809987,8,0.3132684868,-0.532556427,5.0749494855
24,21,2001,2902,1311,3700,4610,289,1591,3989,5441,201942,14.566700883,6.5806150441,18.572292649,-139,1.4506466421,7.9860858391,20.022939291
24,21,2002,3000,1364,4771,4723,223,1636,4994,6556,208498,14.61845824,6.6465256798,23.248221421,-74,1.0866387292,7.9719325602,24.33486015
24,21,2003,2985,1347,2655,4740,90,1638,2745,4237,212735,14.172678779,6.3955103233,12.605849969,-146,0.4273169481,7.7771684555,13.033166917
24,21,2004,3047,1432,1776,4824,295,1615,2071,3497,216232,14.206220991,6.6765042532,8.2803572303,-189,1.3753971751,7.5297167381,9.6557544054
24,21,2005,3037,1497,1371,5020,227,1540,1598,2946,219178,13.950070049,6.8762775315,6.2975126892,-192,1.0426953906,7.0737925174,7.3402080797
24,21,2006,3056,1368,457,5161,278,1688,735,2314,221492,13.869789185,6.2087276193,2.0741144167,-109,1.2617151156,7.6610615653,3.3358295323
24,21,2007,3059,1448,822,5237,213,1611,1035,2655,224147,13.728600953,6.4985335664,3.6890846627,9,0.9559306973,7.2300673864,4.64501536
24,21,2008,3102,1457,-396,5237,228,1645,-168,1574,225721,13.790711942,6.4774556092,-1.760516418,97,1.013630665,7.313256333,-0.746885753
24,23,2001,332,290,-119,620,6,42,-113,-98,29726,11.150293871,9.7397145256,-3.996641478,-27,0.201511335,1.4105793451,-3.795130143
24,23,2002,306,318,130,619,5,-12,135,97,29823,10.277250668,10.680280105,4.3661522444,-26,0.1679289325,-0.403029438,4.5340811768
24,23,2003,308,300,121,617,3,8,124,96,29919,10.311003984,10.043185699,4.0507515651,-36,0.100431857,0.2678182853,4.151183422
24,23,2004,336,296,-132,617,4,40,-128,-108,29811,11.250627825,9.9112673698,-4.419889503,-20,0.1339360455,1.3393604554,-4.285953457
24,23,2005,330,335,-123,617,4,-5,-119,-151,29660,11.097846009,11.265995191,-4.136469876,-27,0.1345193456,-0.168149182,-4.001950531
24,23,2006,290,261,-76,620,4,29,-72,-57,29603,9.7868822031,8.8081939828,-2.564838095,-14,0.1349914787,0.9786882203,-2.429846616
24,23,2007,314,304,29,673,4,10,33,38,29641,10.600229559,10.26264263,0.979002093,-5,0.1350347715,0.3375869286,1.1140368645
24,23,2008,322,312,53,673,3,10,56,57,29698,10.852896072,10.51584961,1.7863462478,-9,0.1011139386,0.3370464619,1.8874601864
24,25,2001,2846,1536,1533,1593,156,1310,1689,2787,222251,12.886136989,6.9547106166,6.9411271974,-212,0.706337797,5.9314263722,7.6474649944
24,25,2002,2928,1580,3205,1627,65,1348,3270,4481,226732,13.042810084,7.0381283924,14.276709809,-137,0.2895432566,6.0046816917,14.566253065
24,25,2003,2889,1600,2881,1608,-120,1289,2761,3922,230654,12.632656006,6.9962788542,12.597674612,-128,-0.524720914,5.6363771519,12.072953698
24,25,2004,2968,1720,1843,1615,241,1248,2084,3130,233784,12.781038589,7.4068013384,7.9364737597,-202,1.0378134433,5.3742372502,8.974287203
24,25,2005,2931,1740,2231,1681,110,1191,2341,3310,237094,12.449084476,7.3904493308,9.4759152052,-222,0.467212314,5.0586351454,9.9431275192
24,25,2006,3047,1717,691,1645,192,1330,883,2099,239193,12.794806493,7.2099385455,2.9016118433,-114,0.8062365758,5.5848679473,3.7078484191
24,25,2007,2973,1711,-1203,1629,115,1262,-1088,213,239406,12.423761855,7.1500358338,-5.027173061,39,0.4805693284,5.2737260212,-4.546603733
24,25,2008,3012,1727,-516,1629,141,1285,-375,945,240351,12.556356656,7.1994780691,-2.151088989,35,0.5877975725,5.3568785865,-1.563291416
24,27,2001,3556,1274,2363,3683,1078,2282,3441,5496,255016,14.096119999,5.0501847242,9.367022373,-227,4.2732332282,9.0459352752,13.640255601
24,27,2002,3577,1310,1126,3696,961,2267,2087,4113,259129,13.91436268,5.0958387225,4.3800873294,-241,3.7382450476,8.8185239572,8.1183323771
24,27,2003,3549,1336,774,3730,778,2213,1552,3388,262517,13.606928837,5.1222476545,2.9675297041,-377,2.9828657749,8.4846811823,5.9503954789
24,27,2004,3556,1241,-630,3702,904,2315,274,2398,264915,13.484202703,4.7058198972,-2.38893355,-191,3.427930046,8.7783828057,1.0389964962
24,27,2005,3359,1289,-475,3642,866,2070,391,2218,267133,12.6266803,4.8454274802,-1.785553183,-243,3.2553453824,7.7812528193,1.4697921992
24,27,2006,3364,1273,-380,3594,917,2091,537,2498,269631,12.534372648,4.7432391144,-1.415892273,-130,3.4167716166,7.7911335335,2.0008793436
24,27,2007,3366,1361,154,3702,809,2005,963,2980,272611,12.415120924,5.0198988643,0.5680120684,12,2.9839075542,7.3952220595,3.5519196226
24,27,2008,3424,1332,-544,3702,824,2092,280,2384,274995,12.505341432,4.8648115616,-1.986829947,12,3.0094630081,7.64052987,1.022633061
24,29,2001,181,251,173,1434,13,-70,186,100,19367,9.3699849873,12.993736087,8.9558420045,-16,0.6729823472,-3.6237511,9.6288243516
24,29,2002,158,243,218,1523,13,-85,231,130,19497,8.1309180733,12.505146151,11.218608481,-16,0.6689995883,-4.374228077,11.887608069
24,29,2003,163,236,139,1573,10,-73,149,58,19555,8.3478439004,12.086448837,7.1187135102,-18,0.5121376626,-3.738604937,7.6308511728
24,29,2004,180,282,145,1545,13,-102,158,40,19595,9.1954022989,14.406130268,7.4074074074,-16,0.6641123883,-5.210727969,8.0715197957
24,29,2005,189,217,211,1545,11,-28,222,173,19768,9.6029266062,11.0255824,10.720727587,-21,0.5589004903,-1.422655794,11.279628077
24,29,2006,194,234,64,1528,14,-40,78,30,19798,9.8063994339,11.828337461,3.2351008442,-8,0.7076783097,-2.021938028,3.9427791538
24,29,2007,208,265,125,1468,13,-57,138,81,19879,10.484663659,13.357864758,6.3008796028,0,0.6552914787,-2.873201099,6.9561710815
24,29,2008,232,229,240,1468,13,3,253,272,20151,11.59130652,11.441418936,11.991006745,16,0.6495128654,0.1498875843,12.64051961
24,31,2001,13227,5366,-2582,9528,9863,7861,7281,17383,894878,14.925752085,6.0551588181,-2.913607914,2241,11.12971141,8.8705932668,8.2161034951
24,31,2002,13024,5543,-5086,9484,9113,7481,4027,13355,908233,14.44614336,6.1482626416,-5.641360959,1847,10.108085415,8.2978807184,4.4667244557
24,31,2003,13441,5349,-8826,9460,7731,8092,-1095,8927,917160,14.726691732,5.8606557602,-9.670246352,1930,8.4705047078,8.8660359714,-1.199741645
24,31,2004,13606,5654,-11494,9537,7603,7952,-3891,5934,923094,14.787089174,6.1448039238,-12.49175386,1873,8.2629897829,8.6422852498,-4.228764073
24,31,2005,13596,5539,-10575,9493,7776,8057,-2799,7192,930286,14.671573018,5.9771876248,-11.41158316,1934,8.3911556184,8.6943853932,-3.020427543
24,31,2006,13682,5341,-12443,9618,7869,8341,-4574,5784,936070,14.661725844,5.723452546,-13.33400487,2017,8.4324748333,8.9382732983,-4.90153004
24,31,2007,13277,5499,-11593,9465,7056,7778,-4537,5421,941491,14.142816132,5.8575993004,-12.34899958,2180,7.5161339632,8.2852168318,-4.832865617
24,31,2008,13029,5455,-5558,9465,7106,7574,1548,9189,950680,13.771482599,5.7658636561,-5.874733309,67,7.5109490633,8.0056189425,1.6362157543
24,33,2001,12411,5018,150,17459,4760,7393,4910,11482,814689,15.342148074,6.2031181238,0.1854260101,-821,5.8841853865,9.13902995,6.0696113965
24,33,2002,12362,5245,-1947,17280,4139,7117,2192,8497,823186,15.095169045,6.4046401587,-2.377470808,-812,5.0541097459,8.6905288865,2.6766389376
24,33,2003,12300,5252,-3208,17374,2946,7048,-262,5636,828822,14.890969051,6.35832272,-3.883758432,-1150,3.5665686849,8.532646331,-0.317189747
24,33,2004,12563,5297,-6609,17289,4019,7266,-2590,3984,832806,15.121314759,6.3756749405,-7.9548491,-692,4.8374245018,8.7456398183,-3.117424598
24,33,2005,12407,5209,-7438,19679,3692,7198,-3746,2782,835588,14.872985638,6.2443283781,-8.916359085,-670,4.4258130873,8.6286572596,-4.490545998
24,33,2006,12555,5161,-15008,19404,3979,7394,-11029,-3986,831602,15.061270761,6.1912559456,-18.00394676,-351,4.7733011834,8.8700148153,-13.23064558
24,33,2007,12488,5308,-16833,20050,3360,7180,-13473,-6284,825318,15.073751298,6.4070685368,-20.31842213,9,4.0557178379,8.6666827608,-16.26270429
24,33,2008,12239,5422,-14323,20050,3463,6817,-10860,-4466,820852,14.869667167,6.5874119927,-17.40160494,-423,4.2073418906,8.2822551741,-13.19426305
24,35,2001,481,353,385,506,45,128,430,524,41291,11.723415145,8.6036705745,9.3836067172,-34,1.0967852007,3.1197445709,10.480391918
24,35,2002,517,343,1089,493,40,174,1129,1293,42584,12.327868852,8.1788375559,25.967213115,-10,0.9538002981,4.1490312966,26.921013413
24,35,2003,500,366,1017,509,28,134,1045,1190,43774,11.579703096,8.4763426666,23.553116098,11,0.6484633734,3.1033604298,24.201579472
24,35,2004,521,359,602,505,35,162,637,753,44527,11.80054586,8.1312782415,13.63517967,-46,0.792743004,3.6692676187,14.427922674
24,35,2005,514,358,340,493,35,156,375,487,45014,11.48077417,7.9963368736,7.5942864163,-44,0.7817647781,3.4844372969,8.3760511944
24,35,2006,519,366,641,516,35,153,676,806,45820,11.427439065,8.0586564502,14.113657881,-23,0.7706365458,3.3687826144,14.884294427
24,35,2007,513,356,494,543,28,157,522,695,46515,11.111712785,7.7110521471,10.700167867,16,0.6064872475,3.4006606379,11.306655115
24,35,2008,533,361,353,543,28,172,381,576,47091,11.388158879,7.713180779,7.5422515651,23,0.5982522488,3.6749780997,8.1405038139
24,37,2001,1230,595,348,2989,34,635,382,931,87451,14.140287749,6.8402204965,4.0006667778,-86,0.3908697427,7.3000672526,4.3915365205
24,37,2002,1353,590,1784,2970,-102,763,1682,2409,89860,15.261320505,6.6549734647,20.122835019,-36,-1.150520836,8.6063470399,18.972314182
24,37,2003,1339,622,2350,3132,-364,717,1986,2746,92606,14.676706893,6.8177085046,25.75822345,43,-3.989784398,7.8589983887,21.768439052
24,37,2004,1402,600,1356,3217,219,802,1575,2278,94884,14.955464291,6.4003413515,14.464771454,-99,2.3361245933,8.5551229399,16.800896048
24,37,2005,1436,649,1292,3598,6,787,1298,2001,96885,14.976351757,6.7685600905,13.474544895,-84,0.0625752859,8.207791666,13.537120181
24,37,2006,1406,667,814,3213,123,739,937,1625,98510,14.391361089,6.8271961923,8.3318406305,-51,1.2589882034,7.5641648967,9.5908288339
24,37,2007,1559,680,865,3245,12,879,877,1752,100262,15.686313968,6.842009941,8.7034391162,-4,0.1207413519,8.8443040267,8.8241804681
24,37,2008,1610,685,322,3245,52,925,374,1316,101578,15.953230281,6.7875544986,3.1906460563,17,0.5152596116,9.1656757828,3.7059056679
24,39,2001,272,270,421,5317,31,2,452,439,25160,10.905956176,10.825765321,16.880174816,-15,1.2429582406,0.0801908542,18.123133057
24,39,2002,235,256,222,5262,31,-21,253,214,25374,9.3006688566,10.131792457,8.7861637709,-18,1.2268967428,-0.8311236,10.013060514
24,39,2003,267,275,52,5354,22,-8,74,33,25407,10.515744078,10.830822552,2.0480100825,-33,0.8664658041,-0.315078474,2.9144758867
24,39,2004,272,268,200,5313,25,4,225,206,25613,10.6624853,10.505684045,7.8400627205,-23,0.9800078401,0.1568012544,8.8200705606
24,39,2005,259,253,-91,5242,24,6,-67,-83,25530,10.128463328,9.8938271122,-3.558649278,-22,0.9385448644,0.2346362161,-2.620104413
24,39,2006,278,226,180,5380,26,52,206,245,25775,10.837150375,8.8100574993,7.0168599552,-13,1.013546438,2.0270928759,8.0304063931
24,39,2007,275,266,339,5576,20,9,359,372,26147,10.592812295,10.246138438,13.058048611,4,0.7703863488,0.3466738569,13.82843496
24,39,2008,292,263,-77,5576,20,29,-57,-28,26119,11.173611908,10.063903876,-2.946466154,0,0.7653158841,1.109708032,-2.18115027
24,41,2001,340,411,281,612,30,-71,311,206,34098,10.001470805,12.090013237,8.265921459,-34,0.882482718,-2.088542433,9.1484041771
24,41,2002,357,400,293,612,30,-43,323,246,34344,10.43219076,11.688729143,8.5619940972,-34,0.8766546857,-1.256538383,9.4386487829
24,41,2003,349,430,279,612,26,-81,305,195,34539,10.133124283,12.484938229,8.1006924786,-29,0.7549032417,-2.351813945,8.8555957203
24,41,2004,379,373,631,612,28,6,659,624,35163,10.874867292,10.702705805,18.105649766,-41,0.8034202749,0.1721614875,18.909070041
24,41,2005,355,435,523,612,27,-80,550,440,35603,10.033066727,12.29403951,14.781109572,-30,0.7630783144,-2.260972784,15.544187887
24,41,2006,379,442,482,612,31,-63,513,432,36035,10.580976577,12.339819649,13.456545409,-18,0.8654624641,-1.758843072,14.322007873
24,41,2007,373,445,153,620,29,-72,182,97,36132,10.337134701,12.332506547,4.2401651724,-13,0.8036914379,-1.995371846,5.0438566104
24,41,2008,424,447,75,620,29,-23,104,83,36215,11.721287683,12.357112251,2.0733409817,2,0.8016918462,-0.635824568,2.8750328279
24,43,2001,1614,1282,591,9365,79,332,670,884,132982,12.177455862,9.6725516825,4.4590312359,-118,0.5960464765,2.5049041799,5.0550777124
24,43,2002,1613,1292,1277,9505,69,321,1346,1568,134550,12.058370587,9.6586576559,9.5465215376,-99,0.5158261442,2.3997129315,10.062347682
24,43,2003,1661,1348,1522,9471,36,313,1558,1781,136331,12.263687745,9.9527098615,11.237406832,-90,0.2657993732,2.3109778833,11.503206205
24,43,2004,1738,1362,2083,9321,72,376,2155,2376,138707,12.638253623,9.9040859808,15.146997869,-155,0.5235640166,2.7341676423,15.670561886
24,43,2005,1710,1356,2133,9291,60,354,2193,2412,141119,12.22188074,9.691737008,15.245188081,-135,0.4288379207,2.5301437322,15.674026002
24,43,2006,1879,1293,1278,9133,71,586,1349,1865,142984,13.227597033,9.1023326047,8.9967370989,-70,0.4998187277,4.1252644287,9.4965558266
24,43,2007,1867,1319,1037,9163,56,548,1093,1678,144662,12.981233878,9.1709949035,7.2102514897,37,0.3893674864,3.8102389743,7.5996189761
24,43,2008,1910,1350,34,9163,58,560,92,722,145384,13.170324707,9.3088682485,0.2344455707,70,0.3999365618,3.8614564586,0.6343821325
24,45,2001,1145,802,-2,3093,154,343,152,410,85271,13.460136835,9.4279735735,-0.023511156,-85,1.8103590154,4.0321632615,1.7868478593
24,45,2002,1138,801,270,3030,143,337,413,664,85935,13.293926615,9.3571486981,3.1540950668,-86,1.670502202,3.9367779167,4.8245972688
24,45,2003,1141,801,935,3046,110,340,1045,1317,87252,13.176508629,9.2501169256,10.797577185,-68,1.2703031983,3.9263917038,12.067880384
24,45,2004,1173,876,948,3068,127,297,1075,1289,88541,13.345241278,9.9662671437,10.785412388,-83,1.4448811955,3.3789741344,12.230293584
24,45,2005,1223,828,1338,3068,123,395,1461,1789,90330,13.674659391,9.258068664,14.960502261,-67,1.3752928088,4.4165907274,16.33579507
24,45,2006,1234,856,1308,3115,132,378,1440,1766,92096,13.528773311,9.3846271913,14.340061175,-52,1.447162137,4.1441461195,15.787223312
24,45,2007,1361,908,613,3158,113,453,726,1122,93218,14.688582622,9.7995834098,6.6157980509,-57,1.2195516799,4.8889992121,7.8353497307
24,45,2008,1354,889,296,3158,114,465,410,828,94046,14.460868079,9.4946172249,3.1613123718,-47,1.2175324675,4.9662508544,4.3788448394
24,47,2001,529,566,824,681,58,-37,882,814,47590,11.211665218,11.995845961,17.463917089,-31,1.2292562999,-0.784180743,18.693173389
24,47,2002,465,562,675,681,56,-97,731,601,48191,9.7096501394,11.735104039,14.094653428,-33,1.1693342103,-2.0254539,15.263987638
24,47,2003,479,527,527,710,46,-48,573,490,48681,9.8893385085,10.880336939,10.880336939,-35,0.9497068296,-0.990998431,11.830043769
24,47,2004,448,584,317,681,50,-136,367,187,48868,9.1851274744,11.973469743,6.4992977888,-44,1.0251258342,-2.788342269,7.524423623
24,47,2005,506,534,-62,693,49,-28,-13,-83,48785,10.363224888,10.936683973,-1.269802259,-42,1.0035533983,-0.573459085,-0.266248861
24,47,2006,438,521,339,698,52,-83,391,284,49069,8.9521123306,10.648517179,6.9286896805,-24,1.0628078566,-1.696404848,7.9914975371
24,47,2007,502,571,233,710,46,-69,279,201,49270,10.209581143,11.612890105,4.7387099726,-9,0.9355393079,-1.403308962,5.6742492805
24,47,2008,511,573,36,710,46,-62,82,4,49274,10.371001786,11.629322942,0.7306380906,-16,0.9335931158,-1.258321156,1.6642312064
24,510,2001,9343,8370,-12373,25547,1137,973,-11236,-3334,645253,14.442280344,12.938230384,-19.12601249,6929,1.7575588945,1.5040499598,-17.3684536
24,510,2002,9199,7950,-10895,25935,1047,1249,-9848,-3303,641950,14.293005843,12.352364002,-16.92817683,5296,1.6267830327,1.9406418413,-15.3013938
24,510,2003,8855,7873,-9127,26843,885,982,-8242,374,642324,13.789892188,12.260623512,-14.21347781,7634,1.3782105688,1.5292686763,-12.83526724
24,510,2004,9228,7570,-11537,24654,872,1658,-10665,-1320,641004,14.381358468,11.797451626,-17.97981498,7687,1.3589666866,2.5839068422,-16.62084829
24,510,2005,9270,7362,-7552,24686,897,1908,-6655,-940,640064,14.472299675,11.493535082,-11.79016258,3807,1.4003940462,2.9787645933,-10.38976854
24,510,2006,9414,6921,-4522,26530,919,2493,-3603,897,640961,14.697605433,10.80540973,-7.059971507,2007,1.4347885482,3.8921957027,-5.625182959
24,510,2007,9806,7251,-5565,27814,822,2555,-4743,-811,640150,15.308587624,11.319862213,-8.687771786,1377,1.2832611694,3.988725411,-7.404510616
24,510,2008,9962,7254,-6352,27814,828,2708,-5524,-3231,636919,15.601349653,11.360388515,-9.947778859,-415,1.2967192845,4.2409611384,-8.651059575
25,0,2001,81618,57234,-15550,220161,30526,24384,14976,44686,6407269,12.782920272,8.9639253454,-2.435423684,5326,4.7809481269,3.8189949265,2.345524443
25,0,2002,80663,56626,-30885,224113,28579,24037,-2306,25774,6433043,12.564024924,8.8200349026,-4.81063077,4043,4.4514494663,3.7439900214,-0.359181303
25,0,2003,80295,56201,-43558,228673,24830,24094,-18728,8397,6441440,12.473510587,8.7306030075,-6.766562976,3031,3.8572422675,3.7429075793,-2.909320708
25,0,2004,79512,55969,-54506,232405,23411,23543,-31095,-4026,6437414,12.347682488,8.6916118468,-8.464417719,3526,3.6355719228,3.6560706411,-4.828845796
25,0,2005,77498,54720,-55443,236051,24290,22778,-31153,-3071,6434343,12.041557341,8.5023357728,-8.614674749,5304,3.7741545307,3.5392215686,-4.840520218
25,0,2006,77414,53611,-44064,240369,26276,23803,-17788,9081,6443424,12.022891857,8.326132939,-6.843422466,3066,4.0808317156,3.6967589179,-2.76259075
25,0,2007,78374,53787,-32607,243596,23482,24587,-9125,24491,6467915,12.14033649,8.3317462271,-5.050909127,9029,3.6374228885,3.8085902632,-1.413486239
25,0,2008,78776,54178,-18675,243596,23551,24598,4876,30052,6497967,12.15127517,8.3570095733,-2.880637044,578,3.6327648208,3.7942655964,0.7521277766
25,1,2001,2023,2744,2294,5634,406,-721,2700,1814,225042,9.0258103375,12.242621634,10.234903072,-165,1.811408303,-3.216811297,12.046311375
25,1,2002,1995,2756,2521,5702,326,-761,2847,1960,227002,8.8265744043,12.193503287,11.15378149,-126,1.4423374716,-3.366928883,12.596118962
25,1,2003,2000,2786,1907,5813,188,-786,2095,1133,228135,8.7885625647,12.242467653,8.3798944054,-176,0.8261248811,-3.453905088,9.2060192865
25,1,2004,1940,2867,-582,5820,360,-927,-222,-1306,226829,8.528147282,12.603194978,-2.558444185,-157,1.5825427946,-4.075047696,-0.97590139
25,1,2005,1976,2707,-1275,5853,296,-731,-979,-1916,224913,8.7483563627,11.98471694,-5.644814961,-206,1.3104825321,-3.236360577,-4.334332429
25,1,2006,1931,2706,-1067,5929,345,-775,-722,-1598,223315,8.616150709,12.074212231,-4.760969864,-101,1.5393951293,-3.458061522,-3.221574734
25,1,2007,1980,2734,-866,6046,270,-754,-596,-1325,221990,8.8927813521,12.279224352,-3.889469016,25,1.2126520026,-3.386443,-2.676817013
25,1,2008,1986,2750,-542,6046,282,-764,-260,-941,221049,8.9653506802,12.414256984,-2.446737195,83,1.2730256253,-3.448906304,-1.173711569
25,3,2001,1202,1622,-671,6226,143,-420,-528,-1069,133718,8.9532783375,12.0817117,-4.998044729,-121,1.0651570734,-3.128433363,-3.932887656
25,3,2002,1240,1570,-326,6359,136,-330,-190,-635,133083,9.2953174838,11.76907133,-2.443768951,-115,1.0194864337,-2.473753846,-1.424282518
25,3,2003,1264,1583,-124,6346,111,-319,-13,-518,132565,9.5163524664,11.918026863,-0.933566223,-186,0.8356923448,-2.401674396,-0.097873878
25,3,2004,1297,1546,-343,6481,106,-249,-237,-580,131985,9.8053298053,11.687771688,-2.593082593,-94,0.8013608014,-1.882441882,-1.791721792
25,3,2005,1237,1558,-452,6538,109,-321,-343,-792,131193,9.4004818032,11.839895432,-3.434937571,-128,0.8283367151,-2.439413629,-2.606600856
25,3,2006,1283,1468,-723,6533,119,-185,-604,-843,130350,9.8110062208,11.225687554,-5.52872759,-54,0.9099842091,-1.414681333,-4.618743381
25,3,2007,1258,1467,-242,6720,106,-209,-136,-318,130032,9.6627263021,11.268060004,-1.858807444,27,0.8141883848,-1.605333702,-1.04461906
25,3,2008,1307,1489,-634,6720,106,-182,-528,-637,129395,10.076052223,11.479144422,-4.887694804,73,0.8171855667,-1.403092199,-4.070509238
25,5,2001,6685,5298,866,13212,822,1387,1688,2571,538640,12.440576938,9.8594131062,1.6115990468,-504,1.5297164163,2.5811638313,3.1413154631
25,5,2002,6651,5172,2626,13639,754,1479,3380,4423,543063,12.297275685,9.5626988184,4.8553068633,-436,1.3940980103,2.7345768663,6.2494048736
25,5,2003,6646,5157,1865,14846,636,1489,2501,3330,546393,12.200584512,9.4671101908,3.4237270711,-660,1.1675551835,2.7334743211,4.5912822546
25,5,2004,6676,5289,-1826,14748,639,1387,-1187,-189,546204,12.22042528,9.6815202678,-3.342494991,-389,1.1696901968,2.5389050126,-2.172804794
25,5,2005,6618,4887,-2593,15493,658,1731,-1935,-705,545499,12.12417663,8.9529844656,-4.750376247,-501,1.2054560627,3.1711921649,-3.544920184
25,5,2006,6626,4899,-3182,15581,833,1727,-2349,-858,544641,12.156236814,8.9878364247,-5.837782303,-236,1.5282440787,3.1684003889,-4.309538224
25,5,2007,6457,4878,-1753,16088,698,1579,-1055,571,545212,11.849304447,8.9516659586,-3.216947607,47,1.2809066911,2.8976384889,-1.936040916
25,5,2008,6494,4983,-1810,16088,703,1511,-1107,611,545823,11.904292713,9.1344457327,-3.317950387,207,1.2886845977,2.7698469802,-2.029265789
25,7,2001,129,118,67,189,52,11,119,116,15192,8.5238535747,7.7970133474,4.4271177481,-14,3.4359719836,0.7268402273,7.8630897317
25,7,2002,152,110,88,182,52,42,140,169,15361,9.9499230845,7.2006022322,5.7604817857,-13,3.4039210552,2.7493208523,9.164402841
25,7,2003,167,144,50,194,44,23,94,97,15458,10.837470392,9.3448846491,3.2447516143,-20,2.8553814206,1.4925857426,6.1001330348
25,7,2004,159,145,-18,179,37,14,19,22,15480,10.27862176,9.3735858814,-1.163617558,-11,2.3918805353,0.9050358782,1.2282629776
25,7,2005,164,126,-77,192,41,38,-36,-13,15467,10.598765632,8.1429540828,-4.976249717,-15,2.6496914079,2.4558115488,-2.326558309
25,7,2006,166,135,-142,182,40,31,-102,-77,15390,10.759309071,8.7500405094,-9.203746314,-6,2.5926045954,2.0092685614,-6.611141718
25,7,2007,198,131,-43,188,34,67,-9,62,15452,12.839634265,8.4949095389,-2.788405421,4,2.2047856819,4.344724726,-0.583619739
25,7,2008,186,140,-14,188,33,46,19,75,15527,12.008134543,9.0383808386,-0.903838084,10,2.1304754834,2.9697537041,1.2266373995
25,9,2001,9630,6643,366,16804,2873,2987,3239,5521,730862,13.226177944,9.1237279418,0.5026771679,-705,3.9458784249,4.1024500018,4.4485555929
25,9,2002,9576,6586,-2717,16930,2713,2990,-4,2354,733216,13.08127026,8.9967884225,-3.711550887,-632,3.7060866976,4.0844818377,-0.00546419
25,9,2003,9599,6550,-5439,17138,2393,3049,-3046,-720,732496,13.098071108,8.9376357702,-7.421649001,-723,3.2653072363,4.1604353379,-4.156341764
25,9,2004,9490,6601,-5742,17679,2198,2889,-3544,-1290,731206,12.967120356,9.0195955188,-7.845859335,-635,3.0033435768,3.9475248377,-4.842515758
25,9,2005,9178,6339,-5101,17939,2297,2839,-2804,-654,730552,12.557482155,8.673118259,-6.97926743,-689,3.1427910776,3.8843638961,-3.836476352
25,9,2006,9026,6151,-4506,18116,2580,2875,-1926,627,731179,12.349741505,8.416049191,-6.165293067,-322,3.5300612767,3.9336923141,-2.63523179
25,9,2007,9206,6273,-3998,18289,2303,2933,-1695,1396,732575,12.578616352,8.571112359,-5.462666541,158,3.1467036128,4.0075039932,-2.315962928
25,9,2008,9237,6301,-1672,18289,2306,2936,634,3882,736457,12.575628033,8.5784380463,-2.276328902,312,3.1394823258,3.9971899863,0.8631534235
25,11,2001,711,660,78,1488,120,51,198,176,71669,9.9328033975,9.2203238289,1.0896746343,-73,1.6764225144,0.7124795686,2.7660971487
25,11,2002,668,624,128,1511,113,44,241,218,71887,9.3064727354,8.6934715372,1.7832762128,-67,1.5742985316,0.6130011981,3.3575747444
25,11,2003,691,625,-29,1504,88,66,59,17,71904,9.6111717701,8.6931727299,-0.403363215,-108,1.2239987204,0.9179990403,0.8206355057
25,11,2004,679,648,-32,1518,92,31,60,46,71950,9.4401267952,9.0091342611,-0.444895519,-45,1.2790746173,0.4309925341,0.8341790983
25,11,2005,664,640,-58,1530,89,24,31,-13,71937,9.2294647883,8.8958696755,-0.806188189,-68,1.2370818768,0.3335951128,0.4308936874
25,11,2006,671,663,-315,1519,95,8,-220,-244,71693,9.3434519251,9.2320545847,-4.386270278,-32,1.3228434171,0.1113973404,-3.063426861
25,11,2007,699,613,-236,1619,82,86,-154,-46,71647,9.7530347426,8.5530905539,-3.292870099,22,1.144132831,1.1999441886,-2.148737268
25,11,2008,712,621,-128,1619,82,91,-46,88,71735,9.9315116263,8.6621751684,-1.785440292,43,1.1437976873,1.2693364579,-0.641642605
25,13,2001,5747,4659,-2224,14030,1325,1088,-899,-204,456361,12.590286617,10.206741839,-4.872245943,-393,2.9027544401,2.383544778,-1.969491503
25,13,2002,5759,4608,405,14852,1259,1151,1664,2386,458747,12.586492523,10.070942446,0.8851414259,-429,2.7515877907,2.5155500771,3.6367292167
25,13,2003,5768,4515,-387,15051,1120,1253,733,1294,460041,12.555671167,9.8281649303,-0.842414137,-692,2.4379944013,2.7275062365,1.5955802644
25,13,2004,5745,4671,-1819,15338,1138,1074,-681,47,460088,12.487379487,10.15292421,-3.953793435,-346,2.4735662065,2.3344552775,-1.480227229
25,13,2005,5682,4457,-1823,15990,1158,1225,-665,129,460217,12.348080256,9.685919342,-3.961730079,-431,2.516557011,2.662160914,-1.445173068
25,13,2006,5780,4505,-2334,16765,1775,1275,-559,510,460727,12.552337601,9.7834396011,-5.068712104,-206,3.8547403534,2.7688980003,-1.213971751
25,13,2007,5862,4403,-3176,17213,1521,1459,-1655,-98,460629,12.724723125,9.5576519825,-6.894186395,98,3.3016553862,3.167071143,-3.592531009
25,13,2008,5980,4375,-3062,17213,1527,1605,-1535,211,460840,12.979275483,9.4957073976,-6.645909955,141,3.3142731877,3.4835680853,-3.331636767
25,15,2001,1326,1240,-382,18330,327,86,-55,-114,152265,8.7052428408,8.1406494137,-2.507845223,-145,2.1467680309,0.5645934271,-0.361077192
25,15,2002,1267,1165,370,18224,304,102,674,629,152894,8.3038678197,7.6353638595,2.4249653459,-147,1.9924039599,0.6685039602,4.4173693058
25,15,2003,1323,1192,601,18332,246,131,847,777,153671,8.6311222742,7.7764911193,3.9208650694,-201,1.6048798787,0.8546311549,5.5257449481
25,15,2004,1255,1208,-97,18604,253,47,156,105,153776,8.164008756,7.8582650018,-0.631003067,-98,1.6458121237,0.3057437542,1.0148090565
25,15,2005,1182,1132,-171,18903,254,50,83,1,153777,7.6864800538,7.3613328434,-1.11200346,-132,1.6517478288,0.3251472104,0.5397443693
25,15,2006,1234,1227,294,19278,293,7,587,518,154295,8.011114285,7.9656703628,1.9086447324,-76,1.9021527435,0.0454439222,3.8107974759
25,15,2007,1264,1196,49,19565,263,68,312,370,154665,8.1822889694,7.7421025375,0.3171931642,-10,1.7024857587,0.4401864319,2.0196789228
25,15,2008,1283,1179,-81,19565,265,104,184,318,154983,8.2868289154,7.6150984344,-0.523174702,30,1.7116209373,0.6717304811,1.1884462357
25,17,2001,19190,11857,-11313,53673,10013,7333,-1300,6555,1475675,13.033165297,8.0528525755,-7.683387129,522,6.8004733776,4.9803127213,-0.882913751
25,17,2002,18791,11712,-20018,54410,9360,7079,-10658,-2987,1472688,12.746734374,7.9447476447,-13.57906065,592,6.3492860275,4.8019867296,-7.229774624
25,17,2003,18536,11424,-20335,53594,8113,7112,-12222,-4372,1468316,12.60521917,7.768775561,-13.82861091,738,5.5171635265,4.8364436091,-8.311447383
25,17,2004,18217,11325,-18018,53963,7618,6892,-10400,-3169,1465147,12.420132792,7.7212495948,-12.28445697,339,5.1938613168,4.6988831971,-7.090595654
25,17,2005,17706,11069,-18110,54734,7929,6637,-10181,-3123,1462024,12.097687494,7.5629336311,-12.37372193,421,5.4175174597,4.534753863,-6.956204472
25,17,2006,17798,10903,-13379,54924,8116,6895,-5263,1630,1463654,12.166752459,7.4533150948,-9.145914212,-2,5.5481156846,4.7134373639,-3.597798527
25,17,2007,18127,11028,-8139,54919,7311,7099,-828,6144,1469798,12.358818211,7.51878674,-5.549093696,-127,4.9845710787,4.8400314715,-0.564522617
25,17,2008,17988,11111,-1331,54919,7334,6877,6003,12680,1482478,12.185852542,7.527074027,-0.901677214,-200,4.9683701659,4.6587785153,4.0666929515
25,19,2001,146,55,-50,759,51,91,1,172,9743,15.118566843,5.6953505229,-5.177591384,80,5.2811432122,9.4232163198,0.1035518277
25,19,2002,136,67,155,761,45,69,200,339,10082,13.720050441,6.7591424968,15.636822194,70,4.5397225725,6.9609079445,20.176544767
25,19,2003,137,64,59,761,30,73,89,227,10309,13.43730077,6.2772791918,5.7868667549,65,2.9424746212,7.1600215781,8.7293413761
25,19,2004,163,58,2,761,48,105,50,232,10541,15.635491607,5.5635491607,0.1918465228,77,4.6043165468,10.071942446,4.7961630695
25,19,2005,151,77,-115,761,39,74,-76,69,10610,14.278284715,7.2809796227,-10.87419035,71,3.6877688998,6.997305092,-7.186421446
25,19,2006,151,64,2,762,45,87,47,210,10820,14.09239384,5.9729351377,0.1866542231,76,4.1997200187,8.1194587028,4.3863742417
25,19,2007,161,52,18,762,40,109,58,240,11060,14.716636197,4.7531992687,1.6453382084,73,3.6563071298,9.9634369287,5.3016453382
25,19,2008,170,70,19,762,41,100,60,155,11215,15.263748597,6.2850729517,1.7059483726,-5,3.6812570146,8.9786756453,5.3872053872
25,21,2001,8522,5800,-2377,17178,2552,2722,175,2288,653500,13.06341936,8.8908510077,-3.643716008,-609,3.9119744434,4.1725683522,0.2682584356
25,21,2002,8222,5817,-3672,17452,2389,2405,-1283,576,654076,12.575942048,8.8973795787,-5.616499538,-546,3.6540897049,3.6785624698,-1.962409833
25,21,2003,8322,5797,-4718,18149,2060,2525,-2658,-814,653262,12.731214116,8.8684028155,-7.217720284,-681,3.1514420907,3.8628113005,-4.066278193
25,21,2004,8222,5562,-4480,18213,1899,2660,-2581,-457,652805,12.590472005,8.5171740807,-6.860291241,-536,2.9079672023,4.0732979242,-3.952324039
25,21,2005,7765,5609,-4980,18590,1988,2156,-2992,-1376,651429,11.90737245,8.6012172662,-7.636666426,-540,3.048532702,3.3061551838,-4.588133724
25,21,2006,7685,5433,-2371,19222,1989,2252,-382,1551,652980,11.783114039,8.3302093132,-3.635362835,-319,3.0496569711,3.4529047254,-0.585705864
25,21,2007,7739,5392,-1566,19561,1814,2347,248,2378,655358,11.830276274,8.2425183706,-2.393876812,-217,2.7729837397,3.5877579035,0.379106928
25,21,2008,7701,5410,664,19561,1818,2291,2482,4551,659909,11.710169874,8.2264665653,1.0096809241,-222,2.7644577109,3.4837033089,3.774138635
25,23,2001,6412,4108,1708,12066,864,2304,2572,4442,478807,13.454025087,8.6196405266,3.5838232764,-434,1.8128942101,4.8343845602,5.3967174865
25,23,2002,6423,4088,1298,11782,787,2335,2085,3943,482750,13.359582427,8.5028760645,2.6997879481,-477,1.63692844,4.8567063627,4.3367163881
25,23,2003,6424,4079,-11,11860,669,2345,658,2279,485029,13.275758205,8.4296104793,-0.022732463,-724,1.3825470484,4.8461477259,1.3598145858
25,23,2004,6321,4163,-1298,11754,648,2158,-650,1151,486180,13.016765701,8.5728200624,-2.672957108,-357,1.3344192651,4.4439456389,-1.338537843
25,23,2005,6092,4057,-698,11857,665,2035,-33,1585,487765,12.50994666,8.3310659226,-1.433345825,-417,1.3655801919,4.1788807376,-0.067765634
25,23,2006,5904,3996,-1874,12030,723,1908,-1151,529,488294,12.097629344,8.1880296171,-3.839931807,-228,1.4814678211,3.9095997271,-2.358463986
25,23,2007,5904,4026,-983,12146,630,1878,-353,1514,489808,12.072360551,8.232270254,-2.010015315,-11,1.2882092052,3.8400902973,-0.72180611
25,23,2008,6007,4019,-529,12146,634,1988,105,2258,492066,12.235785854,8.1863864406,-1.077531333,165,1.2914080625,4.0493994138,0.2138767296
25,25,2001,9713,5569,-6770,36794,8314,4144,1544,14258,704979,13.918463853,7.9802249767,-9.701225192,8570,11.913735043,5.9382388765,2.2125098517
25,25,2002,9713,5487,-13468,38040,7846,4226,-5622,5681,710660,13.722424997,7.751976316,-19.02744979,7077,11.084746888,5.9704486808,-7.942702907
25,25,2003,9365,5468,-17665,40080,6948,3897,-10717,687,711347,13.171524472,7.6905387948,-24.84516602,7507,9.7721037941,5.4809856773,-15.07306223
25,25,2004,9278,5178,-18109,41648,6301,4100,-11808,-1378,709969,13.055506305,7.2862051789,-25.48201807,6330,8.8664308289,5.7693011266,-16.61558724
25,25,2005,9263,5206,-18015,41825,6631,4057,-11384,1362,711331,13.034545838,7.3256877507,-25.35003166,8689,9.3308942517,5.7088580877,-16.01913741
25,25,2006,9301,4807,-12127,43058,6819,4494,-5308,4119,715450,13.0377402,6.7382450425,-16.99910498,4933,9.558579768,6.2994951573,-7.44052521
25,25,2007,9591,5064,-7480,43855,6189,4527,-1291,12096,727546,13.293176142,7.0187304747,-10.36731911,8860,8.5779863562,6.2744456672,-1.789332749
25,25,2008,9748,5125,-5372,43855,6193,4623,821,5138,732684,13.351321367,7.0194421427,-7.357745013,-306,8.4822254028,6.3318792245,1.1244803901
25,27,2001,10182,6861,2858,23778,2664,3321,5522,8160,760816,13.45515477,9.0665701116,3.7767464479,-683,3.5203822733,4.3885846583,7.2971287212
25,27,2002,10070,6864,1725,24269,2495,3206,4220,6718,767534,13.177609841,8.9822357444,2.2573363431,-708,3.2649589427,4.1953740962,5.5222952858
25,27,2003,10053,6817,668,25005,2184,3236,2852,4980,772514,13.055437233,8.8529708165,0.8675054284,-1108,2.836275233,4.2024664166,3.7037806614
25,27,2004,10070,6708,-2144,25699,2074,3362,-70,2740,775254,13.012286079,8.6679657416,-2.770441048,-552,2.6799882153,4.3443203374,-0.090452833
25,27,2005,9820,6856,-1975,25846,2136,2964,161,2375,777629,12.647443497,8.8300277613,-2.543655897,-750,2.7510121497,3.8174157358,0.2073562529
25,27,2006,9858,6654,-2340,26470,2504,3204,164,3007,780636,12.652533427,8.5402675411,-3.003340253,-361,3.2138307669,4.1122658855,0.2104905135
25,27,2007,9928,6530,-4192,26625,2221,3398,-1971,1507,782143,12.705571293,8.3569077905,-5.364802061,80,2.842372466,4.3486635026,-2.522429595
25,27,2008,9977,6605,-4183,26625,2227,3372,-1956,1663,783806,12.742432863,8.4357791984,-5.342447296,247,2.8442816465,4.306653665,-2.498165649
26,0,2001,135012,87490,-25441,251938,23328,47522,-2113,49195,10004341,13.528604217,8.7667583841,-2.549263916,3786,2.3375350278,4.761845833,-0.211728889
26,0,2002,131195,87061,-34999,254995,21852,44134,-13147,32962,10037303,13.092239339,8.6880098259,-3.492627651,1975,2.1806594309,4.4042295133,-1.31196822
26,0,2003,130097,86751,-32954,255814,18757,43346,-14197,28578,10065881,12.942924862,8.630573147,-3.278485637,-571,1.8660725585,4.312351715,-1.412413078
26,0,2004,131449,86680,-39853,255668,17598,44769,-22255,24399,10090280,13.043059142,8.6008441786,-3.954423662,1885,1.7461658497,4.4422149635,-2.208257813
26,0,2005,128346,87384,-57267,256544,18279,40962,-38988,2986,10093266,12.717884162,8.6589343617,-5.674622289,1012,1.8112773642,4.0589498,-3.863344925
26,0,2006,127355,85256,-73991,257833,18527,42099,-55464,-9388,10083878,12.623689458,8.4507500169,-7.334140055,3977,1.8364343338,4.1729394408,-5.497705721
26,0,2007,128552,84319,-95787,259263,16627,44233,-79160,-34088,10049790,12.769853958,8.3759203738,-9.515106736,839,1.651661287,4.3939335843,-7.863445449
26,0,2008,129689,84277,-109257,258347,16621,45412,-92636,-46368,10003422,12.934486505,8.405336761,-10.89670822,856,1.6576895512,4.5291497442,-9.239018667
26,1,2001,81,165,76,199,2,-84,78,-16,11690,6.9242605574,14.104975209,6.4968370662,-10,0.1709693965,-7.180714652,6.6678064626
26,1,2002,71,177,-70,199,2,-106,-68,-186,11504,6.1222730016,15.262567905,-6.036043804,-12,0.1724583944,-9.140294904,-5.86358541
26,1,2003,81,175,106,199,0,-94,106,7,11511,7.0388876819,15.207473387,9.2113838801,-5,0,-8.168585705,9.2113838801
26,1,2004,66,178,79,199,1,-112,80,-43,11468,5.7443752992,15.49240611,6.8758431611,-11,0.0870359894,-9.748030811,6.9628791505
26,1,2005,62,159,152,199,1,-97,153,44,11512,5.3959965187,13.838120104,13.228894691,-12,0.0870322019,-8.442123586,13.315926893
26,1,2006,69,139,110,199,1,-70,111,36,11548,5.9843885516,12.055507372,9.540329575,-5,0.0867302689,-6.07111882,9.6270598439
26,1,2007,91,169,72,199,1,-78,73,2,11550,7.879470084,14.633301585,6.2343060005,7,0.0865875833,-6.753831501,6.3208935839
26,1,2008,72,167,88,199,0,-95,88,6,11556,6.2321474942,14.455119882,7.6170691595,13,0,-8.222972388,7.6170691595
26,3,2001,89,97,-2,992,1,-8,-1,-20,9807,9.0659060813,9.8808189875,-0.203728227,-11,0.1018641133,-0.814912906,-0.101864113
26,3,2002,75,105,-34,994,1,-30,-33,-71,9736,7.6753824899,10.745535486,-3.479506729,-8,0.1023384332,-3.070152996,-3.377168296
26,3,2003,85,131,-35,992,0,-46,-35,-93,9643,8.7723824759,13.519789463,-3.61215749,-12,0,-4.747406987,-3.61215749
26,3,2004,66,110,18,1001,1,-44,19,-32,9611,6.8557182923,11.426197154,1.8697413524,-7,0.1038745196,-4.570478862,1.973615872
26,3,2005,81,120,-25,992,1,-39,-24,-72,9539,8.4595300261,12.532637076,-2.610966057,-9,0.1044386423,-4.07310705,-2.506527415
26,3,2006,77,97,28,994,1,-20,29,4,9543,8.0704328687,10.166649198,2.9347028613,-5,0.1048108165,-2.09621633,3.0395136778
26,3,2007,82,121,81,998,1,-39,82,45,9588,8.5724739951,12.649626261,8.4679316293,2,0.1045423658,-4.077152266,8.5724739951
26,3,2008,84,97,-130,956,0,-13,-130,-150,9438,8.8300220751,10.19657311,-13.66551035,-7,0,-1.366551035,-13.66551035
26,5,2001,1505,847,1003,1917,119,658,1122,1688,107736,14.079631778,7.9238857913,9.3833027729,-92,1.1132732103,6.1557459866,10.496575983
26,5,2002,1400,926,550,1917,116,474,666,1043,108779,12.932129414,8.5536798836,5.0804794125,-97,1.0715192943,4.3784495301,6.1519987068
26,5,2003,1466,777,472,1917,94,689,566,1112,109891,13.40833219,7.1065989848,4.3170073627,-143,0.8597429917,6.3017332053,5.1767503544
26,5,2004,1519,824,541,1917,88,695,629,1237,111128,13.745424602,7.4563725291,4.8955067211,-87,0.7963116293,6.2890520724,5.6918183505
26,5,2005,1496,889,204,1917,94,607,298,802,111930,13.413551632,7.9710209901,1.8291206771,-103,0.8428301159,5.4425306423,2.6719507931
26,5,2006,1550,807,-455,1917,96,743,-359,335,112265,13.827248601,7.1990900778,-4.058966525,-49,0.8563973327,6.6281585227,-3.202569192
26,5,2007,1535,855,-450,1917,83,680,-367,335,112600,13.652636026,7.6045627376,-4.002401441,22,0.7382207102,6.0480732884,-3.264180731
26,5,2008,1541,823,-465,1917,82,718,-383,375,112975,13.662861576,7.296907902,-4.122797296,40,0.727030921,6.3659536739,-3.395766375
26,7,2001,350,375,-105,567,12,-25,-93,-151,31128,11.216690435,12.017882609,-3.365007131,-33,0.3845722435,-0.801192174,-2.980434887
26,7,2002,312,341,-230,567,6,-29,-224,-282,30846,10.068738503,11.004614838,-7.422467486,-29,0.1936295866,-0.935876335,-7.2288379
26,7,2003,296,335,-128,567,-5,-39,-133,-208,30638,9.6285212413,10.897143972,-4.163684861,-36,-0.16264394,-1.268622731,-4.326328801
26,7,2004,261,314,-104,567,19,-53,-85,-158,30480,8.5408553945,10.27520534,-3.403252724,-20,0.6217480939,-1.734349946,-2.78150463
26,7,2005,287,369,-211,567,9,-82,-202,-312,30168,9.4644506002,12.168579343,-6.958184936,-28,0.2967946181,-2.704128743,-6.661390318
26,7,2006,316,356,-316,567,15,-40,-301,-354,29814,10.536494282,11.870227735,-10.53649428,-13,0.500150045,-1.333733453,-10.03634424
26,7,2007,282,339,-55,567,8,-57,-47,-112,29702,9.4764433094,11.391894617,-1.848242489,-8,0.2688352712,-1.915451307,-1.579407218
26,7,2008,297,335,-139,567,9,-38,-130,-182,29520,10.030056398,11.313363277,-4.694201479,-14,0.303941103,-1.283306879,-4.390260376
26,9,2001,222,239,250,286,8,-17,258,224,23482,9.4993581515,10.226786478,10.697475396,-17,0.3423192127,-0.727428327,11.039794608
26,9,2002,233,234,293,286,8,-1,301,286,23768,9.8624338624,9.9047619048,12.402116402,-14,0.3386243386,-0.042328042,12.740740741
26,9,2003,243,218,315,286,2,25,317,335,24103,10.152284264,9.1078105743,13.16036849,-7,0.0835578952,1.0444736897,13.243926385
26,9,2004,248,268,172,286,3,-20,175,133,24236,10.260865967,11.088355158,7.1164070419,-22,0.1241233786,-0.827489191,7.2405304206
26,9,2005,240,247,8,286,3,-7,11,-17,24219,9.9060984419,10.195026313,0.3302032814,-21,0.1238262305,-0.288927871,0.4540295119
26,9,2006,244,218,5,286,3,26,8,22,24241,10.070160957,8.9971110194,0.2063557573,-12,0.1238134544,1.0730499381,0.3301692117
26,9,2007,261,234,-14,286,2,27,-12,-2,24239,10.767326733,9.6534653465,-0.577557756,-17,0.0825082508,1.1138613861,-0.495049505
26,9,2008,249,233,-121,286,1,16,-120,-130,24109,10.300322661,9.6384545379,-5.005377678,-26,0.0413667577,0.6618681228,-4.964010921
26,11,2001,165,180,-58,773,0,-15,-58,-92,17171,9.5835511413,10.454783063,-3.368763431,-19,0,-0.871231922,-3.368763431
26,11,2002,178,184,34,785,0,-6,34,12,17183,10.362694301,10.711998603,1.9793910462,-16,0,-0.349304302,1.9793910462
26,11,2003,162,185,-45,779,-1,-23,-46,-93,17090,9.453505675,10.795670061,-2.625973799,-24,-0.058354973,-1.342164386,-2.684328772
26,11,2004,168,224,-13,778,0,-56,-13,-82,17008,9.8539503783,13.138600504,-0.762508065,-13,0,-3.284650126,-0.762508065
26,11,2005,184,229,-6,782,0,-45,-6,-65,16943,10.83915054,13.490029749,-0.353450561,-14,0,-2.650879208,-0.353450561
26,11,2006,175,165,-202,791,0,10,-202,-201,16742,10.390381475,9.7966453911,-11.9934689,-9,0,0.5937360843,-11.9934689
26,11,2007,174,187,-159,793,0,-13,-159,-190,16552,10.452333754,11.233255241,-9.551270499,-18,0,-0.780921487,-9.551270499
26,11,2008,179,172,-163,846,-1,7,-164,-191,16361,10.877161,10.451797162,-9.904900799,-34,-0.060766263,0.425363838,-9.965667062
26,13,2001,85,110,28,1017,3,-25,31,-3,8869,9.5823234316,12.400653853,3.1565300716,-9,0.3381996505,-2.818330421,3.4947297221
26,13,2002,95,105,-38,1023,3,-10,-35,-53,8816,10.743567995,11.87446989,-4.297427198,-8,0.3392705683,-1.130901894,-3.95815663
26,13,2003,88,105,-25,1025,3,-17,-22,-50,8766,10.010237743,11.944033671,-2.843817541,-11,0.3412581049,-1.933795928,-2.502559436
26,13,2004,89,115,13,1029,2,-26,15,-18,8748,10.163297933,13.132351262,1.4845266644,-7,0.2283887176,-2.969053329,1.712915382
26,13,2005,105,106,-65,1010,3,-1,-62,-71,8677,12.051649928,12.166427547,-7.460545194,-8,0.3443328551,-0.114777618,-7.116212339
26,13,2006,91,101,63,1068,2,-10,65,51,8728,10.456765297,11.605860385,7.239299052,-4,0.2298190175,-1.149095088,7.4691180695
26,13,2007,94,66,-104,1072,3,28,-101,-77,8651,10.81765349,7.5953737269,-11.96846769,-4,0.3452442603,3.2222797629,-11.62322343
26,13,2008,97,94,-130,1043,2,3,-128,-123,8528,11.292857559,10.943593923,-15.13475755,2,0.2328424239,0.3492636358,-14.90191513
26,15,2001,703,475,350,439,11,228,361,540,57443,12.296013853,8.308117468,6.1217707659,-49,0.1923985098,3.9878963847,6.3141692757
26,15,2002,719,445,183,480,10,274,193,416,57859,12.47159633,7.7188600371,3.1742727793,-51,0.1734575289,4.7527362925,3.3477303082
26,15,2003,694,472,280,452,4,222,284,439,58298,11.949344422,8.1269316528,4.82106115,-67,0.0688723021,3.8224127689,4.8899334521
26,15,2004,714,486,-12,435,10,228,-2,190,58488,12.227493021,8.3229154179,-0.205504084,-36,0.1712534037,3.9045776035,-0.034250681
26,15,2005,715,527,362,453,7,188,369,500,58988,12.172699104,8.9720453539,6.1629609452,-57,0.1191732779,3.2006537506,6.2821342232
26,15,2006,676,486,-276,476,9,190,-267,-104,58884,11.470069228,8.2462332021,-4.683046016,-27,0.1527080223,3.2238360255,-4.530337994
26,15,2007,759,466,-49,435,3,293,-46,231,59115,12.864515801,7.8983720201,-0.830515513,-16,0.0508478885,4.9661437809,-0.779667624
26,15,2008,740,472,-484,435,3,268,-481,-225,58890,12.541841447,7.9996610313,-8.203042244,-12,0.0508453032,4.5421804161,-8.152196941
26,17,2001,1319,1095,-594,1773,25,224,-569,-439,109651,12.0050423,9.9662784824,-5.406364766,-94,0.2275406046,2.0387638174,-5.178824161
26,17,2002,1326,1115,-203,1773,19,211,-184,-75,109576,12.09705009,10.172104713,-1.851961665,-102,0.1733363135,1.9249453763,-1.678625352
26,17,2003,1230,1114,-451,1773,8,116,-443,-454,109122,11.248388188,10.187564587,-4.124409002,-127,0.0731602484,1.0608236015,-4.051248754
26,17,2004,1309,1122,-329,1773,28,187,-301,-193,108929,12.006365483,10.291170414,-3.017642662,-79,0.256820652,1.715195069,-2.76082201
26,17,2005,1230,1104,-442,1773,19,126,-423,-398,108531,11.312425274,10.153591465,-4.065115424,-101,0.1747447806,1.1588338085,-3.890370643
26,17,2006,1233,1075,-741,1773,25,158,-716,-604,107927,11.392510325,9.9326428222,-6.846593796,-46,0.2309916935,1.4598675032,-6.615602103
26,17,2007,1273,1106,-759,1773,18,167,-741,-561,107366,11.825744451,10.274370277,-7.050856275,13,0.1672139828,1.5513741738,-6.883642292
26,17,2008,1282,1058,-118,1773,19,224,-99,129,107495,11.93329641,9.8482274587,-1.098384537,4,0.1768585271,2.0850689516,-0.92152601
26,19,2001,187,163,338,264,7,24,345,359,16465,11.482607227,10.008903626,20.754659053,-10,0.4298302171,1.4737036014,21.18448927
26,19,2002,180,172,251,264,6,8,257,257,16722,10.847621056,10.365504565,15.126404918,-8,0.3615873685,0.4821164914,15.487992286
26,19,2003,220,165,333,264,3,55,336,394,17116,13.003132573,9.7523494296,19.682014303,3,0.1773154442,3.2507831432,19.859329748
26,19,2004,195,179,127,264,5,16,132,130,17246,11.349746813,10.418485536,7.3918863861,-18,0.2910191491,0.931261277,7.6829055352
26,19,2005,188,154,195,264,3,34,198,220,17466,10.831988938,8.8730122148,11.235307675,-12,0.1728508873,1.9589767227,11.408158562
26,19,2006,232,171,79,264,4,61,83,135,17601,13.231813386,9.7527590042,4.5056605926,-9,0.2281347135,3.4790543816,4.7337953061
26,19,2007,191,190,-111,264,1,1,-110,-120,17481,10.88877487,10.831765578,-6.328031469,-11,0.0570092925,0.0570092925,-6.271022177
26,19,2008,204,180,-86,264,0,24,-86,-85,17396,11.698253864,10.321988703,-4.931616825,-23,0,1.3762651604,-4.931616825
26,21,2001,2239,1625,-1777,4334,368,614,-1409,-908,161630,13.81382493,10.025665704,-10.96345105,-113,2.2704276795,3.7881592261,-8.693023371
26,21,2002,2036,1578,-858,4435,355,458,-503,-181,161449,12.6037285,9.768508631,-5.311394427,-136,2.1976049202,2.8352198688,-3.113789507
26,21,2003,2128,1551,-784,4383,291,577,-493,-97,161352,13.184593604,9.6096356579,-4.857481854,-181,1.8029683923,3.5749579462,-3.054513462
26,21,2004,2086,1671,-846,4387,275,415,-571,-286,161066,12.939724209,10.365426248,-5.247845964,-130,1.7058600947,2.574297961,-3.541985869
26,21,2005,2096,1631,-1637,4379,286,465,-1351,-1032,160034,13.055123015,10.158829025,-10.19620056,-146,1.7813765182,2.8962939894,-8.414824042
26,21,2006,2159,1622,-1432,4397,294,537,-1138,-668,159366,13.519098309,10.156543519,-8.966812774,-67,1.8409517846,3.3625547902,-7.125860989
26,21,2007,2025,1562,-778,4457,260,463,-518,-20,159346,12.707397274,9.8019528603,-4.882150656,35,1.6315670574,2.9054444138,-3.250583599
26,21,2008,2086,1560,-711,4457,260,526,-451,135,159481,13.085466413,9.7858713346,-4.460099051,60,1.6309785558,3.2995950782,-2.829120495
26,23,2001,653,387,-172,3264,84,266,-88,135,46009,14.213728328,8.4237562988,-3.743891688,-43,1.8284122199,5.7899720296,-1.915479468
26,23,2002,542,427,344,3753,83,115,427,507,46516,11.715752499,9.2299378546,7.4358281546,-35,1.7941097001,2.4858146447,9.2299378546
26,23,2003,599,434,-259,3620,66,165,-193,-82,46434,12.888649812,9.3383539537,-5.57288865,-54,1.4201183432,3.550295858,-4.152770307
26,23,2004,624,421,-187,3617,62,203,-125,43,46477,13.432209319,9.0624360948,-4.0253576,-35,1.3346105413,4.3697732238,-2.690747059
26,23,2005,574,408,-349,3805,64,166,-285,-154,46323,12.370689655,8.7931034483,-7.521551724,-35,1.3793103448,3.5775862069,-6.142241379
26,23,2006,618,407,-360,4053,65,211,-295,-106,46217,13.356386427,8.7961962395,-7.780419278,-22,1.4047979252,4.560190188,-6.375621353
26,23,2007,658,419,-316,4046,55,239,-261,-50,46167,14.24489089,9.0708347766,-6.841011431,-28,1.1906823692,5.1740561136,-5.650329061
26,23,2008,638,423,-671,4047,54,215,-617,-441,45726,13.885714908,9.2063595704,-14.60394154,-39,1.1752799452,4.6793553372,-13.4286616
26,25,2001,1923,1429,-554,4223,175,494,-379,-7,138005,13.93392436,10.354434691,-4.014245499,-122,1.2680378382,3.5794896691,-2.746207661
26,25,2002,1855,1500,-130,4331,165,355,35,260,138265,13.428892026,10.858942339,-0.941108336,-130,1.1944836573,2.5699496869,0.2533753212
26,25,2003,1915,1459,-251,4458,139,456,-112,153,138418,13.842556283,10.546365335,-1.814350719,-191,1.00475996,3.2961909478,-0.809590759
26,25,2004,1888,1399,-210,4563,155,489,-55,336,138754,13.623309714,10.094814772,-1.515304576,-98,1.118439092,3.5284949418,-0.396865484
26,25,2005,1849,1387,-1188,4567,148,462,-1040,-694,138060,13.35915091,10.02116945,-8.583380898,-116,1.0693100782,3.3379814605,-7.51407082
26,25,2006,1818,1394,-1387,4467,154,424,-1233,-868,137192,13.209713281,10.128900062,-10.07803758,-59,1.1189746124,3.0808132184,-8.959062968
26,25,2007,1881,1396,-1507,4567,136,485,-1371,-858,136334,13.753719939,10.207439147,-11.01906217,28,0.9944210057,3.5462807923,-10.02464117
26,25,2008,1882,1346,-1146,4567,137,536,-1009,-473,135861,13.828321608,9.8899685887,-8.42043388,0,1.0066312754,3.938353019,-7.413802605
26,27,2001,530,451,-56,744,21,79,-35,-8,51111,10.368776289,8.8232417099,-1.095568815,-52,0.4108383058,1.5455345789,-0.68473051
26,27,2002,550,497,-97,744,20,53,-77,-74,51037,10.76868857,9.7309785801,-1.899205075,-50,0.3915886753,1.0377099894,-1.5076164
26,27,2003,481,452,-75,744,12,29,-63,-109,50928,9.4346099152,8.8657872799,-1.471093022,-75,0.2353748835,0.5688226352,-1.235718139
26,27,2004,560,458,151,744,15,102,166,228,51156,10.971356922,8.9730026253,2.9583480271,-40,0.2938756318,1.9983542965,3.2522236589
26,27,2005,502,505,-209,744,13,-3,-196,-224,50932,9.8346524567,9.8934252802,-4.0945067,-25,0.2546822349,-0.058772823,-3.839824465
26,27,2006,495,495,-318,744,14,0,-304,-332,50600,9.750620494,9.750620494,-6.264034984,-28,0.2757751251,0,-5.988259859
26,27,2007,541,460,-124,744,9,81,-115,-124,50476,10.704816178,9.1020618149,-2.453599272,-90,0.1780838181,1.6027543631,-2.275515454
26,27,2008,535,452,-253,744,9,83,-244,-291,50185,10.629737436,8.9806379829,-5.02677303,-130,0.1788180129,1.6490994526,-4.847955017
26,29,2001,298,217,164,288,11,81,175,235,26408,11.334892832,8.2539320287,6.2379947129,-21,0.4184020844,3.0809608033,6.6563967973
26,29,2002,306,239,26,288,6,67,32,73,26481,11.571404262,9.0377961391,0.9831912118,-26,0.2268902796,2.5336081227,1.2100814914
26,29,2003,290,267,90,288,-6,23,84,76,26557,10.935555639,10.068252951,3.3937931295,-31,-0.226252875,0.8673026886,3.1675402542
26,29,2004,298,212,-167,288,12,86,-155,-92,26465,11.240617102,7.9966806231,-6.299272,-23,0.4526422994,3.2439364792,-5.846629701
26,29,2005,264,238,-117,288,6,26,-111,-105,26360,9.9952673923,9.0108849976,-4.429720776,-20,0.227165168,0.9843823947,-4.202555608
26,29,2006,294,241,-279,288,11,53,-268,-227,26133,11.201493532,9.1821766712,-10.62998876,-12,0.4191034995,2.0193168613,-10.21088526
26,29,2007,292,259,-22,288,5,33,-17,9,26142,11.171688187,9.9091343855,-0.841702535,-7,0.1912960306,1.262553802,-0.650406504
26,29,2008,298,247,-253,288,6,51,-247,-206,25936,11.444371904,9.485771343,-9.716194938,-10,0.2304235954,1.9586005607,-9.485771343
26,31,2001,280,276,323,361,3,4,326,312,26880,10.477473432,10.32779524,12.086513995,-18,0.1122586439,0.1496781919,12.198772639
26,31,2002,283,268,224,361,-2,15,222,219,27099,10.485559199,9.92978751,8.2995238889,-18,-0.074102892,0.555771689,8.2254209971
26,31,2003,274,311,126,361,-13,-37,113,48,27147,10.102127346,11.466283228,4.6455038159,-28,-0.479298013,-1.364155882,4.1662058032
26,31,2004,286,310,-20,361,8,-24,-12,-53,27094,10.54552829,11.430467727,-0.737449531,-17,0.2949798123,-0.884939437,-0.442469718
26,31,2005,268,281,35,361,-1,-13,34,-1,27093,9.8916714341,10.371491317,1.2918227619,-22,-0.036909222,-0.479819883,1.2549135401
26,31,2006,251,259,-125,361,5,-8,-120,-142,26951,9.2887277034,9.5847827696,-4.62586041,-14,0.1850344164,-0.296055066,-4.440825994
26,31,2007,271,266,-232,361,0,5,-232,-239,26712,10.100068949,9.9137208132,-8.646553491,-12,0,0.1863481356,-8.646553491
26,31,2008,270,271,-341,361,1,-1,-340,-358,26354,10.176007236,10.213696152,-12.85192025,-17,0.0376889157,-0.037688916,-12.81423133
26,33,2001,391,308,-210,5976,14,83,-196,-147,38453,10.148858578,7.9944972941,-5.45079361,-34,0.3633862406,2.1543612838,-5.087407369
26,33,2002,392,314,109,6005,6,78,115,158,38611,10.1733624,8.1490709021,2.8288176061,-35,0.1557147306,2.024291498,2.9845323368
26,33,2003,372,295,-44,5941,-6,77,-50,-30,38581,9.6383044875,7.6432790963,-1.140014509,-57,-0.155456524,1.9950253912,-1.295471033
26,33,2004,393,316,-145,5849,21,77,-124,-75,38506,10.196271745,8.1985289348,-3.761983214,-28,0.5448389482,1.9977428101,-3.217144266
26,33,2005,393,301,39,5922,10,92,49,106,38612,10.192173034,7.806219041,1.0114370186,-35,0.2593428253,2.3859539926,1.2707798439
26,33,2006,406,305,-84,6116,17,101,-67,17,38629,10.512551624,7.8973602103,-2.175010681,-17,0.440180733,2.6151914139,-1.734829948
26,33,2007,408,311,189,6456,10,97,199,301,38930,10.521022705,8.0197011308,4.8737090473,5,0.2578682036,2.5013215745,5.1315772509
26,33,2008,416,296,-95,6569,11,120,-84,41,38971,10.680222333,7.599388968,-2.438993081,5,0.2824097252,3.0808333654,-2.156583356
26,35,2001,350,364,-34,501,1,-14,-33,-80,31301,11.167480297,11.614179509,-1.084840943,-33,0.0319070866,-0.446699212,-1.052933857
26,35,2002,349,349,232,501,0,0,232,209,31510,11.112703189,11.112703189,7.3872410883,-23,0,0,7.3872410883
26,35,2003,329,368,-22,501,0,-39,-22,-105,31405,10.458555194,11.698323134,-0.699356274,-44,0,-1.239767941,-0.699356274
26,35,2004,324,410,132,501,1,-86,133,20,31425,10.313544485,13.051090244,4.2018144199,-27,0.0318319274,-2.737545758,4.2336463473
26,35,2005,348,427,-119,501,1,-79,-118,-216,31209,11.112175496,13.634767059,-3.799853115,-19,0.0319315388,-2.522591564,-3.767921576
26,35,2006,328,371,-139,501,1,-43,-138,-198,31011,10.543233687,11.925425908,-4.468016715,-17,0.0321440051,-1.382192221,-4.43587271
26,35,2007,369,361,-290,501,0,8,-290,-331,30680,11.962847093,11.703489974,-9.401695547,-49,0,0.2593571185,-9.401695547
26,35,2008,341,381,-261,501,-1,-40,-262,-368,30312,11.181794334,12.493441763,-8.558499475,-66,-0.032791186,-1.311647429,-8.591290661
26,37,2001,757,442,306,805,15,315,321,580,65519,11.605267596,6.7761271827,4.6911649726,-56,0.2299590673,4.829140413,4.9211240399
26,37,2002,808,484,675,805,13,324,688,967,66486,12.241960532,7.3330555661,10.226885345,-45,0.1969622363,4.9089049657,10.423847582
26,37,2003,811,484,640,805,6,327,646,922,67408,12.114060376,7.229599534,9.5598010366,-51,0.0896231347,4.8844608422,9.6494241714
26,37,2004,836,457,606,805,15,379,621,938,68346,12.316395834,6.732766622,8.9279137263,-62,0.2209879635,5.5836292117,9.1489016898
26,37,2005,808,504,261,805,11,304,272,511,68857,11.778168116,7.3467781317,3.8045815325,-65,0.1603463481,4.4313899842,3.9649278806
26,37,2006,842,430,81,805,13,412,94,473,69330,12.186385116,6.2234508311,1.1723244589,-33,0.1881508391,5.9629342847,1.360475298
26,37,2007,852,467,-85,805,11,385,-74,307,69637,12.261903905,6.7210200983,-1.223312009,-4,0.1583109659,5.5408838069,-1.065001043
26,37,2008,885,472,-335,805,11,413,-324,89,69726,12.700645078,6.7736773749,-4.807588815,0,0.1578611253,5.926967703,-4.64972769
26,39,2001,144,151,94,497,2,-7,96,77,14428,10.007296987,10.493762813,6.532541089,-12,0.1389902359,-0.486465826,6.6715313249
26,39,2002,132,161,140,497,1,-29,141,103,14531,9.1163368901,11.11916848,9.6688421562,-9,0.0690631583,-2.002831589,9.7379053144
26,39,2003,138,158,121,525,-1,-20,120,90,14621,9.4676180022,10.839736553,8.3013172338,-10,-0.068605928,-1.372118551,8.2327113063
26,39,2004,124,170,-10,537,2,-46,-8,-64,14557,8.4995544588,11.652614984,-0.68544794,-10,0.137089588,-3.153060525,-0.548358352
26,39,2005,135,151,241,738,0,-16,241,214,14771,9.2062193126,10.297326787,16.434806328,-11,0,-1.091107474,16.434806328
26,39,2006,142,151,-42,741,1,-9,-41,-59,14712,9.632669674,10.243190991,-2.849099481,-9,0.0678357019,-0.610521317,-2.781263779
26,39,2007,136,151,-146,729,-1,-15,-147,-173,14539,9.2988273905,10.324433353,-9.982564699,-11,-0.068373731,-1.025605962,-10.05093843
26,39,2008,135,144,-50,737,-1,-9,-51,-76,14463,9.3097027791,9.9303496311,-3.448038066,-16,-0.068960761,-0.620646852,-3.516998828
26,41,2001,453,413,-222,569,8,40,-214,-209,38339,11.783526474,10.743038485,-5.774708338,-35,0.2080975978,1.0404879889,-5.56661074
26,41,2002,427,417,-63,569,7,10,-56,-82,38257,11.14940728,10.888297039,-1.644994517,-36,0.1827771685,0.2611102407,-1.462217348
26,41,2003,387,420,-116,569,6,-33,-110,-187,38070,10.140579349,11.005279914,-3.0395535,-44,0.1572182845,-0.864700565,-2.882335216
26,41,2004,400,402,-37,569,7,-2,-30,-59,38011,10.515108897,10.567684442,-0.972647573,-27,0.1840144057,-0.052575544,-0.788633167
26,41,2005,405,415,-139,569,7,-10,-132,-178,37833,10.679816465,10.943515637,-3.665418491,-36,0.1845894204,-0.263699172,-3.48082907
26,41,2006,421,428,-122,569,7,-7,-115,-139,37694,11.14833106,11.333695235,-3.230632754,-17,0.1853641744,-0.185364174,-3.045268579
26,41,2007,411,357,-432,569,6,54,-426,-375,37319,10.958100596,9.5183501526,-11.51800355,-3,0.1599722715,1.4397504433,-11.35803127
26,41,2008,418,402,-169,569,5,16,-164,-140,37179,11.221777766,10.792236033,-4.537034551,8,0.1342317915,0.4295417327,-4.40280276
26,43,2001,272,303,-245,467,4,-31,-241,-292,27184,9.9524332236,11.086717892,-8.964507867,-20,0.1463593121,-1.134284669,-8.818148555
26,43,2002,288,332,-22,467,3,-44,-19,-88,27096,10.611643331,12.232866618,-0.810611643,-25,0.1105379514,-1.621223287,-0.700073692
26,43,2003,281,331,24,467,2,-50,26,-62,27034,10.38241271,12.229817107,0.8867541105,-38,0.0738961759,-1.847404397,0.9606502863
26,43,2004,286,305,357,467,5,-19,362,321,27355,10.516832448,11.215503135,13.127654489,-22,0.1838607071,-0.698670687,13.311515196
26,43,2005,280,339,-58,467,3,-59,-55,-138,27217,10.261672653,12.423953676,-2.125632192,-24,0.1099464927,-2.162281023,-2.0156857
26,43,2006,259,323,-132,467,4,-64,-128,-203,27014,9.551732404,11.912006048,-4.868064391,-11,0.1475171028,-2.360273644,-4.720547288
26,43,2007,284,271,-99,467,4,13,-95,-78,26936,10.528266914,10.046339203,-3.670064875,4,0.1482854495,0.4819277108,-3.521779425
26,43,2008,286,308,-126,467,3,-22,-123,-124,26812,10.642256456,11.460891568,-4.688546551,21,0.1116320607,-0.818635112,-4.57691449
26,45,2001,1327,784,169,1670,95,543,264,703,104637,12.724683681,7.5178236668,1.6205512751,-104,0.9109607759,5.2068600141,2.5315120511
26,45,2002,1256,798,342,1691,86,458,428,792,105429,11.958146487,7.597612179,3.2561195053,-94,0.818790285,4.3605343083,4.0749097903
26,45,2003,1251,751,648,1800,59,500,707,1082,106511,11.805227895,7.08691139,6.1149381901,-125,0.5567613476,4.7183165047,6.6716995376
26,45,2004,1205,873,-57,1762,76,332,19,283,106794,11.298375566,8.1854621317,-0.534445981,-68,0.7125946415,3.1129134338,0.1781486604
26,45,2005,1167,868,79,1812,70,299,149,345,107139,10.909957791,8.1146901133,0.738548985,-103,0.654410493,2.7952676773,1.392959478
26,45,2006,1129,834,-355,1812,76,295,-279,-30,107109,10.53918823,7.7853702252,-3.313916583,-46,0.709458198,2.7538180053,-2.604458385
26,45,2007,1209,840,-436,1812,64,369,-372,9,107118,11.287092663,7.8421487488,-4.070448636,12,0.5974970475,3.4449439146,-3.472951589
26,45,2008,1256,814,-854,1812,65,442,-789,-337,106781,11.74386042,7.6110687755,-7.985077069,10,0.6077634772,4.1327916447,-7.377313592
26,47,2001,371,304,508,725,26,67,534,577,32140,11.647803086,9.5442914776,15.94901339,-24,0.8162880869,2.1035116086,16.765301477
26,47,2002,382,280,249,588,24,102,273,347,32487,11.821684435,8.6651090102,7.7057576555,-28,0.7427236294,3.1565754251,8.4484812849
26,47,2003,378,304,143,588,13,74,156,188,32675,11.601853841,9.330591449,4.3890611092,-42,0.3990055554,2.2712623922,4.7880666646
26,47,2004,409,271,395,588,14,138,409,514,33189,12.419531155,8.2290781003,11.994412729,-33,0.4251184258,4.1904530548,12.419531155
26,47,2005,333,273,65,588,14,60,79,109,33298,10.016995804,8.2121316949,1.9552694512,-30,0.4211349587,1.8048641088,2.3764044099
26,47,2006,363,293,77,588,14,70,91,145,33443,10.877871174,8.7802100658,2.3074272187,-16,0.4195322216,2.0976611079,2.7269594402
26,47,2007,366,264,-198,588,11,102,-187,-71,33372,10.955623737,7.9024171219,-5.926812841,14,0.3292673801,3.0532066153,-5.597545461
26,47,2008,372,281,45,588,10,91,55,163,33535,11.119912715,8.399719013,1.3451507316,17,0.2989223848,2.7201937017,1.6440731164
26,49,2001,6369,3928,-1241,5294,184,2441,-1057,981,437844,14.562590673,8.9812931645,-2.837521593,-403,0.4207123071,5.5812975088,-2.416809286
26,49,2002,6226,4027,-1113,5294,175,2199,-938,841,438685,14.206033115,9.1885151547,-2.539562296,-420,0.3993022478,5.01751796,-2.140260048
26,49,2003,6260,3893,-1117,5294,147,2367,-970,763,439448,14.257521355,8.8665384401,-2.544033763,-634,0.3348012203,5.3909829149,-2.209232542
26,49,2004,6296,4013,-1769,5294,134,2283,-1635,330,439778,14.321687484,9.1284834616,-4.023993831,-318,0.3048135519,5.1932040226,-3.719180279
26,49,2005,6060,3918,-2562,5294,139,2142,-2423,-665,439113,13.79010594,8.9157813654,-5.830074492,-384,0.3163077105,4.8743245749,-5.513766781
26,49,2006,6001,4042,-3578,5294,139,1959,-3439,-1668,437445,13.692191504,9.2224359369,-8.163749575,-188,0.3171495782,4.4697555667,-7.846599997
26,49,2007,6105,3757,-5925,5294,119,2348,-5806,-3418,434027,14.010777168,8.6221932546,-13.597683,40,0.2731011438,5.3885839132,-13.32458186
26,49,2008,6058,3813,-7581,5294,119,2245,-7462,-5237,428790,14.04237515,8.8384906649,-17.57267184,-20,0.2758406476,5.2038844854,-17.29683119
26,51,2001,297,312,361,338,2,-15,363,330,26449,11.299649977,11.87033937,13.734591386,-18,0.076091919,-0.570689393,13.810683305
26,51,2002,269,288,333,338,2,-19,335,302,26751,10.112781955,10.827067669,12.518796992,-14,0.0751879699,-0.714285714,12.593984962
26,51,2003,269,304,168,338,0,-35,168,108,26859,10.035441149,11.341167693,6.2674874091,-25,0,-1.305726544,6.2674874091
26,51,2004,253,290,157,338,1,-37,158,98,26957,9.4024082057,10.777463951,5.8346960012,-23,0.0371636688,-1.375055746,5.87185967
26,51,2005,271,328,-149,338,1,-57,-148,-223,26734,10.094801736,12.218062618,-5.550278445,-18,0.0372501909,-2.123260882,-5.513028254
26,51,2006,260,296,-38,338,1,-36,-37,-89,26645,9.7416587047,11.090503756,-1.423780888,-16,0.0374679181,-1.348845051,-1.38631297
26,51,2007,257,328,-368,338,1,-71,-367,-458,26187,9.7289521502,12.416717141,-13.93095094,-20,0.0378558449,-2.687764991,-13.89309509
26,51,2008,262,292,-190,338,0,-30,-190,-267,25920,10.056230449,11.207707218,-7.292686203,-47,0,-1.151476769,-7.292686203
26,53,2001,125,248,508,1549,3,-123,511,384,17587,7.1859729807,14.256970394,29.203794194,-4,0.1724633515,-7.070997413,29.376257545
26,53,2002,128,260,-116,1547,3,-132,-113,-258,17329,7.3318822316,14.892885783,-6.644518272,-13,0.1718409898,-7.561003551,-6.472677283
26,53,2003,119,259,-79,1543,2,-140,-77,-243,17086,6.9155891326,15.051576348,-4.591021357,-26,0.1162283888,-8.135987215,-4.474792968
26,53,2004,132,249,-158,1534,1,-117,-157,-287,16799,7.7910579903,14.696768482,-9.325660322,-13,0.0590231666,-6.905710491,-9.266637155
26,53,2005,129,246,-109,1542,2,-117,-107,-235,16564,7.7331175254,14.746875281,-6.534184576,-11,0.119893295,-7.013757756,-6.414291281
26,53,2006,142,248,-151,1621,1,-106,-150,-264,16300,8.6416747809,15.092502434,-9.189386563,-8,0.0608568647,-6.450827653,-9.128529698
26,53,2007,148,231,-35,1665,1,-83,-34,-130,16170,9.1161071759,14.228518633,-2.155836156,-13,0.0615953188,-5.112411457,-2.094240838
26,53,2008,134,226,-21,1666,0,-92,-21,-127,16043,8.3196225127,14.031602148,-1.303821439,-14,0,-5.711979636,-1.303821439
26,55,2001,989,626,1533,2636,59,363,1592,1906,79931,12.522474613,7.9262579453,19.410468738,-49,0.7470434805,4.5962166679,20.157512219
26,55,2002,925,613,756,2644,51,312,807,1057,80988,11.496467167,7.6187398629,9.3960315438,-62,0.6338592708,3.8777273038,10.029890815
26,55,2003,955,648,516,2647,29,307,545,768,81756,11.736223762,7.9634272231,6.3412476036,-84,0.3563879467,3.7727965394,6.6976355503
26,55,2004,1012,667,524,2652,53,345,577,856,82612,12.313832376,8.1159349752,6.375936922,-66,0.6448943833,4.197897401,7.0208313054
26,55,2005,938,713,675,2837,43,225,718,870,83482,11.294808964,8.5854997772,8.1279275591,-73,0.5177790889,2.7093091864,8.645706648
26,55,2006,951,707,675,2877,49,244,724,926,84408,11.328846268,8.4221811901,8.0409792126,-42,0.583715528,2.9066650783,8.6246947406
26,55,2007,1067,682,551,2849,42,385,593,993,85401,12.567060639,8.0325542227,6.4896442474,15,0.4946734272,4.534506416,6.9843176746
26,55,2008,1055,698,225,2864,43,357,268,670,86071,12.305216012,8.141270878,2.6243351684,45,0.50153961,4.1639451339,3.1258747784
26,57,2001,522,429,-71,5278,14,93,-57,-7,42469,12.290305492,10.100653364,-1.671669904,-43,0.3296250515,2.1896521278,-1.342044853
26,57,2002,455,411,-169,5262,13,44,-156,-147,42322,10.732271114,9.6944251159,-3.986272128,-35,0.3066363175,1.0378459978,-3.67963581
26,57,2003,467,471,76,5236,8,-4,84,21,42343,11.031713223,11.126203272,1.7953109313,-59,0.188980098,-0.094490049,1.9842910294
26,57,2004,518,418,-96,5203,11,100,-85,-16,42327,12.23573875,9.8736270226,-2.267627259,-31,0.2598322901,2.3621117279,-2.007794969
26,57,2005,481,478,-145,5199,9,3,-136,-169,42158,11.386636681,11.315618157,-3.432561993,-36,0.213055572,0.071018524,-3.219506421
26,57,2006,490,400,11,5531,15,90,26,96,42254,11.609723736,9.4773254987,0.2606264512,-20,0.3553997062,2.1323982372,0.6160261574
26,57,2007,502,427,-58,5659,11,75,-47,34,42288,11.875754063,10.101488018,-1.372099075,6,0.2602256866,1.7742660453,-1.111873388
26,57,2008,515,417,-172,5802,10,98,-162,-43,42245,12.184590633,9.865969503,-4.069416678,21,0.2365939929,2.3186211302,-3.832822685
26,59,2001,617,439,-239,1354,18,178,-221,-83,46590,13.231399376,9.4142371573,-5.125290844,-40,0.3860051682,3.8171622187,-4.739285676
26,59,2002,616,459,64,1412,18,157,82,196,46786,13.193968472,9.8312200137,1.3708019191,-43,0.3855380398,3.3627484578,1.7563399589
26,59,2003,584,425,54,1392,11,159,65,157,46943,12.461458033,9.068698055,1.1522581058,-67,0.2347192438,3.3927599782,1.3869773496
26,59,2004,582,445,-196,1406,12,137,-184,-81,46862,12.408720217,9.4877671766,-4.178881723,-34,0.2558499014,2.9209530409,-3.923031821
26,59,2005,585,433,-172,1506,12,152,-160,-48,46814,12.489858662,9.2446304283,-3.672231948,-40,0.256202229,3.2452282335,-3.416029719
26,59,2006,570,408,-142,1506,12,162,-130,10,46824,12.174544523,8.7144108161,-3.032956706,-22,0.2563062005,3.4601337064,-2.776650505
26,59,2007,573,408,-338,1487,7,165,-331,-149,46675,12.256815581,8.7273660681,-7.230023851,17,0.1497342218,3.5294495128,-7.080289629
26,59,2008,583,431,-657,1487,6,152,-651,-463,46212,12.552886841,9.2800930162,-14.14622068,36,0.1291892299,3.2727938248,-14.01703145
26,61,2001,379,410,-400,3059,62,-31,-338,-393,35559,10.599767868,11.46676735,-11.1870901,-24,1.7339989652,-0.866999483,-9.453091133
26,61,2002,391,374,52,3129,59,17,111,94,35653,10.981295287,10.503847666,1.4604280177,-34,1.6570240971,0.4774476212,3.1174521148
26,61,2003,385,395,-273,3011,43,-10,-230,-272,35381,10.839879494,11.121434806,-7.686460005,-32,1.2106878396,-0.281555312,-6.475772165
26,61,2004,408,363,183,3170,49,45,232,248,35629,11.491339248,10.223912125,5.1542036333,-29,1.3800873116,1.2674271229,6.5342909449
26,61,2005,393,400,-130,3085,47,-7,-83,-124,35505,11.04956842,11.246380071,-3.655073523,-34,1.3214496584,-0.196811651,-2.333623865
26,61,2006,414,392,-514,2845,49,22,-465,-455,35050,11.735525477,11.111898519,-14.57019347,-12,1.3889873149,0.6236269577,-13.18120615
26,61,2007,408,353,-178,2946,40,55,-138,-82,34968,11.654146077,10.083121483,-5.084406867,1,1.1425633409,1.5710245937,-3.941843526
26,61,2008,433,342,72,2937,40,91,112,206,35174,12.346383052,9.7516466596,2.0529782441,3,1.140543469,2.5947363919,3.1935217131
26,63,2001,358,451,-287,682,7,-93,-280,-400,35624,9.9933005806,12.589325592,-8.011389013,-27,0.195399732,-2.596025011,-7.815989281
26,63,2002,344,456,-229,682,6,-112,-223,-366,35258,9.7062723964,12.866454107,-6.461442962,-31,0.1692954488,-3.16018171,-6.292147513
26,63,2003,366,475,-176,682,1,-109,-175,-325,34933,10.428687439,13.534498725,-5.014887949,-41,0.0284936815,-3.105811286,-4.986394267
26,63,2004,321,455,-255,682,8,-134,-247,-410,34523,9.2432619212,13.101819857,-7.342778162,-29,0.2303616678,-3.858557936,-7.112416494
26,63,2005,330,422,-324,682,5,-92,-319,-440,34083,9.6201498411,12.302131009,-9.445238026,-29,0.1457598461,-2.681981168,-9.29947818
26,63,2006,359,443,-325,682,7,-84,-318,-415,33668,10.597629555,13.077297752,-9.593954333,-13,0.2066390164,-2.479668197,-9.387315316
26,63,2007,315,412,-325,682,2,-97,-323,-416,33252,9.4142259414,12.313209803,-9.713090257,4,0.0597728631,-2.898983861,-9.653317394
26,63,2008,333,440,-355,682,2,-107,-353,-447,32805,10.082201735,13.321828118,-10.74829314,13,0.0605537642,-3.239626383,-10.68773938
26,65,2001,3709,1897,-1837,16748,1206,1812,-631,946,280564,13.242124881,6.7727988404,-6.558582746,-235,4.3057434905,6.4693260405,-2.252839256
26,65,2002,3647,1845,-2292,16948,1131,1802,-1161,438,281002,12.988678089,6.5709106321,-8.162887354,-203,4.0280216395,6.4177674574,-4.134865715
26,65,2003,3643,1911,-2969,16719,1000,1732,-1969,-453,280549,12.974778782,6.8061493969,-10.57428444,-216,3.5615643103,6.1686293854,-7.012720127
26,65,2004,3690,1923,-1535,17116,927,1767,-608,938,281487,13.130831477,6.8429780299,-5.462283555,-221,3.2987210784,6.2878534471,-2.163562476
26,65,2005,3690,1983,-3583,17190,962,1707,-2621,-1153,280334,13.135856438,7.0591878908,-12.7549522,-239,3.424578291,6.0766685475,-9.330373909
26,65,2006,3637,1859,-3959,16920,971,1778,-2988,-1323,279011,13.004496331,6.647060401,-14.15584299,-113,3.471918047,6.3574359295,-10.68392495
26,65,2007,3647,1872,-3447,17044,884,1775,-2563,-695,278316,13.087469295,6.7177796877,-12.36975779,93,3.1722848525,6.3696896077,-9.197472938
26,65,2008,3711,1858,-3617,17044,886,1853,-2731,-788,277528,13.352667295,6.6853289772,-13.0144429,90,3.187944819,6.6673383179,-9.826498082
26,67,2001,864,494,-106,5779,24,370,-82,229,61906,13.982505684,7.9946270927,-1.715446299,-59,0.3884029357,5.9878785917,-1.327043364
26,67,2002,829,431,635,6472,23,398,658,1014,62920,13.282489225,6.9056126128,10.174162434,-42,0.3685129701,6.3768766122,10.542675404
26,67,2003,825,464,33,6355,11,361,44,310,63230,13.079667063,7.3563218391,0.5231866825,-95,0.1743955608,5.7233452239,0.6975822434
26,67,2004,861,419,222,6437,14,442,236,632,63862,13.549239921,6.5936486954,3.4935322444,-46,0.2203128442,6.9555912253,3.7138450886
26,67,2005,864,490,-314,6495,13,374,-301,18,63880,13.527265895,7.6717132971,-4.916159133,-55,0.2035352507,5.8555525982,-4.712623883
26,67,2006,802,455,-136,6624,15,347,-121,195,64075,12.535657067,7.1118752686,-2.125747333,-31,0.2344574264,5.4237817983,-1.891289907
26,67,2007,899,417,-511,6703,11,482,-500,-34,64041,14.034156546,6.5097255612,-7.977145712,-16,0.1717193793,7.5244309844,-7.805426332
26,67,2008,856,435,-616,6804,11,421,-605,-208,63833,13.388178989,6.8035722664,-9.634483945,-24,0.1720443562,6.5846067222,-9.462439589
26,69,2001,259,376,-43,395,3,-117,-40,-184,27140,9.5108695652,13.807285546,-1.579024677,-27,0.1101645123,-4.296415981,-1.468860165
26,69,2002,248,372,-108,395,2,-124,-106,-249,26891,9.1799152338,13.769872851,-3.997705021,-19,0.0740315745,-4.589957617,-3.923673447
26,69,2003,219,401,22,395,0,-182,22,-196,26695,8.1737767327,14.966595753,0.8211099914,-36,0,-6.79281902,0.8211099914
26,69,2004,228,380,92,395,3,-152,95,-79,26616,8.5535818124,14.255969687,3.4514452927,-22,0.1125471291,-5.702387875,3.5639924218
26,69,2005,211,413,137,395,1,-202,138,-84,26532,7.9400918191,15.541506736,5.1554150674,-20,0.0376307669,-7.601414917,5.1930458343
26,69,2006,248,370,63,395,2,-122,65,-71,26461,9.3597267564,13.964108467,2.3776725228,-14,0.0754816674,-4.604381711,2.4531541902
26,69,2007,220,393,-67,395,1,-173,-66,-264,26197,8.3558053857,14.926506894,-2.544722549,-25,0.0379809336,-6.570701508,-2.506741616
26,69,2008,252,377,-101,395,1,-125,-100,-265,25932,9.6683228146,14.464117861,-3.875002398,-40,0.0383663604,-4.795795047,-3.836636038
26,71,2001,97,207,-136,582,0,-110,-136,-254,12855,7.4718841473,15.94515483,-10.47604375,-8,0,-8.473270682,-10.47604375
26,71,2002,87,200,-41,581,0,-113,-41,-165,12690,6.8115091016,15.658641613,-3.210021531,-11,0,-8.847132511,-3.210021531
26,71,2003,93,234,24,578,0,-141,24,-131,12559,7.3666283813,18.53538754,1.9010653887,-14,0,-11.16875916,1.9010653887
26,71,2004,96,198,-128,582,0,-102,-128,-238,12321,7.7170418006,15.916398714,-10.28938907,-8,0,-8.199356913,-10.28938907
26,71,2005,107,188,-9,583,0,-81,-9,-102,12219,8.7204563977,15.32192339,-0.733496333,-12,0,-6.601466993,-0.733496333
26,71,2006,82,223,98,631,0,-141,98,-49,12170,6.7243429415,18.286932634,8.0364098569,-6,0,-11.56258969,8.0364098569
26,71,2007,80,204,56,630,0,-124,56,-67,12103,6.5916862357,16.808799901,4.614180365,1,0,-10.21711367,4.614180365
26,71,2008,97,191,-12,629,-1,-94,-13,-102,12001,8.0484566877,15.847992035,-0.995685363,5,-0.08297378,-7.799535347,-1.078659144
26,73,2001,681,419,148,6125,105,262,253,454,63875,10.699472097,6.5830819507,2.32528909,-61,1.6496983409,4.1163901458,3.9749874309
26,73,2002,734,394,-27,5825,103,340,76,352,64227,11.459618117,6.1513481444,-0.421539086,-64,1.6080935505,5.3082699724,1.1865544644
26,73,2003,698,429,511,6412,73,269,584,797,65024,10.80069013,6.6382465126,7.9070954964,-56,1.1295850709,4.1624436175,9.0366805673
26,73,2004,731,461,401,6754,73,270,474,692,65716,11.182499618,7.0521646015,6.1343123757,-52,1.116720208,4.1303350161,7.2510325838
26,73,2005,704,419,91,6671,73,285,164,391,66107,10.680988902,6.3570090197,1.3806391904,-58,1.1075457242,4.3239798821,2.4881849146
26,73,2006,778,428,198,6840,75,350,273,590,66697,11.716514563,6.4455889883,2.9818378964,-33,1.1294840517,5.2709255745,4.1113219481
26,73,2007,760,407,-339,6834,69,353,-270,93,66790,11.386876625,6.0979720872,-5.079146284,10,1.0338085357,5.2889045375,-4.045337748
26,73,2008,808,408,-514,6802,69,400,-445,-12,66778,12.098706277,6.109247724,-7.696454241,33,1.0331816004,5.9894585529,-6.66327264
26,75,2001,2043,1429,449,10054,106,614,555,1022,159761,12.8288854,8.9733124019,2.819466248,-147,0.6656200942,3.8555729984,3.4850863422
26,75,2002,1989,1446,539,10317,99,543,638,1041,160802,12.409417182,9.021627574,3.3628335148,-140,0.6176632986,3.3877896077,3.9804968134
26,75,2003,2070,1520,619,10673,73,550,692,1037,161839,12.831599208,9.4222370994,3.8370820819,-205,0.4525153344,3.4093621083,4.2895974163
26,75,2004,2154,1607,-558,10515,83,547,-475,-49,161790,13.31153883,9.9311248374,-3.448393067,-121,0.512933019,3.3804139926,-2.935460048
26,75,2005,2124,1614,347,10792,81,510,428,783,162573,13.09643825,9.9518132463,2.1395781886,-155,0.4994404417,3.1446250035,2.6390186304
26,75,2006,2018,1536,-207,11128,92,482,-115,294,162867,12.401671583,9.4395280236,-1.272123894,-73,0.5653883972,2.9621435595,-0.706735497
26,75,2007,2079,1448,-898,11181,81,631,-817,-161,162706,12.771329318,8.895086509,-5.516427959,25,0.4975842591,3.8762428088,-5.0188437
26,75,2008,2164,1481,-3358,10015,81,683,-3277,-2526,160180,13.404111668,9.1735163494,-20.7999108,68,0.5017250671,4.2305953185,-20.29818574
26,77,2001,3140,1987,-512,11161,552,1153,40,967,239993,13.110127156,8.2961218657,-2.137702262,-226,2.3047102516,4.81400529,0.1670079892
26,77,2002,3131,1889,187,10935,519,1242,706,1716,241709,12.999738427,7.84302328,0.7764136333,-232,2.1548592283,5.1567151475,2.9312728616
26,77,2003,3102,1958,424,11042,451,1144,875,1673,243382,12.789352926,8.0727121303,1.7481256094,-346,1.8594449289,4.7166407952,3.6075705383
26,77,2004,3212,1901,-2920,10063,421,1311,-2499,-1434,241948,13.236354645,7.8338450127,-12.03304968,-246,1.7349020254,5.4025096326,-10.29814765
26,77,2005,3039,1890,-782,9851,439,1149,-343,585,242533,12.545383617,7.8021635523,-3.228196771,-221,1.8122485712,4.7432200644,-1.4159482
26,77,2006,3161,1894,-688,9505,444,1267,-244,909,243442,13.008899635,7.794639642,-2.831421369,-114,1.8272544884,5.2142599928,-1.004166881
26,77,2007,3191,1816,-703,9501,397,1375,-306,1117,244559,13.077842054,7.4426076996,-2.881141637,48,1.6270458462,5.635234354,-1.254095791
26,77,2008,3315,1858,-622,9509,397,1457,-225,1353,245912,13.517618779,7.576390857,-2.53633752,121,1.618852083,5.9412279217,-0.917485437
26,79,2001,228,169,138,194,1,59,139,186,16813,13.636363636,10.107655502,8.2535885167,-12,0.0598086124,3.528708134,8.3133971292
26,79,2002,193,143,36,194,0,50,36,70,16883,11.455365622,8.487654321,2.1367521368,-16,0,2.967711301,2.1367521368
26,79,2003,225,148,179,194,0,77,179,246,17129,13.230624485,8.7028107727,10.525696813,-10,0,4.5278137128,10.525696813
26,79,2004,240,153,-21,194,1,87,-20,55,17184,13.988867193,8.9179028357,-1.224025879,-12,0.0582869466,5.0709643575,-1.165738933
26,79,2005,216,137,-144,194,1,79,-143,-73,17111,12.596588424,7.989502843,-8.397725616,-9,0.058317539,4.607085581,-8.339408077
26,79,2006,206,155,56,194,1,51,57,99,17210,12.004312229,9.0323708517,3.2633081787,-9,0.0582733603,2.971941377,3.321581539
26,79,2007,231,167,-150,194,1,64,-149,-96,17114,13.459969701,9.730800606,-8.740240065,-11,0.0582682671,3.7291690945,-8.681971798
26,79,2008,237,148,-112,194,0,89,-112,-48,17066,13.867758923,8.6600351083,-6.553540082,-25,0,5.2077238151,-6.553540082
26,81,2001,9522,4177,-1399,12854,2290,5345,891,5688,582144,16.437079234,7.2104263767,-2.414983601,-548,3.9530467806,9.2266528569,1.5380631797
26,81,2002,9207,4094,-2412,12864,2147,5113,-265,4344,586488,15.756884973,7.0064827936,-4.127903395,-504,3.6743816702,8.7504021796,-0.453521725
26,81,2003,9195,3933,-3293,12761,1892,5262,-1401,3207,589695,15.635322054,6.6877348168,-5.59946879,-654,3.2171864412,8.9475872377,-2.382282349
26,81,2004,9479,4221,-3873,12659,1706,5258,-2167,2592,592287,16.039161341,7.1422407448,-6.55339929,-499,2.8866767853,8.8969205961,-3.666722505
26,81,2005,9443,4292,-3035,12764,1805,5151,-1230,3375,595662,15.897988887,7.2258994283,-5.109646963,-546,3.0388509944,8.6720894584,-2.070795969
26,81,2006,9276,4035,-3254,12884,1825,5241,-1429,3537,599199,15.526492203,6.7539236782,-5.446658649,-275,3.0547486277,8.7725685247,-2.391910021
26,81,2007,9513,3950,-3820,12874,1650,5563,-2170,3477,602676,15.830265211,6.5730629225,-6.356734269,84,2.7457098284,9.2572022881,-3.611024441
26,81,2008,9618,4012,-4900,12874,1651,5606,-3249,2537,605213,15.925304395,6.6429945136,-8.113328294,180,2.7336949008,9.2823098811,-5.379633393
26,83,2001,29,20,-22,149,1,9,-21,-16,2294,12.597741095,8.6880973067,-9.556907037,-4,0.4344048653,3.909643788,-9.122502172
26,83,2002,20,25,-41,125,1,-5,-40,-45,2249,8.8047545675,11.005943209,-18.04974686,0,0.4402377284,-2.201188642,-17.60950913
26,83,2003,21,19,-24,124,1,2,-23,-25,2224,9.3896713615,8.4954169461,-10.73105298,-4,0.4471272077,0.8942544154,-10.28392578
26,83,2004,16,23,-44,96,0,-7,-44,-53,2171,7.2810011377,10.466439135,-20.02275313,-2,0,-3.185437998,-20.02275313
26,83,2005,16,35,-15,96,1,-19,-14,-35,2136,7.429765498,16.252612027,-6.965405154,-2,0.4643603436,-8.822846529,-6.501044811
26,83,2006,36,23,4,96,0,13,4,17,2153,16.787129867,10.725110748,1.8652366519,0,0,6.0620191187,1.8652366519
26,83,2007,37,16,0,96,1,21,1,19,2172,17.10982659,7.3988439306,0,-3,0.4624277457,9.710982659,0.4624277457
26,83,2008,18,19,32,96,0,-1,32,30,2202,8.2304526749,8.6877000457,14.631915866,-1,0,-0.457247371,14.631915866
26,85,2001,99,139,237,713,2,-40,239,194,11566,8.6319644258,12.11962682,20.664399686,-5,0.1743831197,-3.487662394,20.838782806
26,85,2002,91,168,-11,716,2,-77,-9,-96,11470,7.9006772009,14.585865602,-0.955026914,-10,0.1736412572,-6.685188401,-0.781385657
26,85,2003,113,150,237,758,1,-37,238,206,11676,9.764106109,12.9612028,20.478700423,5,0.0864080187,-3.197096691,20.565108442
26,85,2004,115,139,142,766,0,-24,142,104,11780,9.8055934516,11.851978172,12.107776262,-14,0,-2.04638472,12.107776262
26,85,2005,110,162,41,787,1,-52,42,-15,11765,9.3438097261,13.760883415,3.4826927161,-5,0.0849437248,-4.417073689,3.5676364409
26,85,2006,129,156,-549,371,0,-27,-549,-579,11186,11.241340247,13.594178903,-47.84105268,-3,0,-2.352838656,-47.84105268
26,85,2007,115,149,-19,371,1,-34,-18,-68,11118,10.31205165,13.360832138,-1.703730273,-16,0.0896700143,-3.048780488,-1.614060258
26,85,2008,119,134,-59,371,0,-15,-59,-104,11014,10.753659859,12.109163203,-5.331646485,-30,0,-1.355503344,-5.331646485
26,87,2001,1093,583,464,1875,45,510,509,937,89241,12.312371511,6.5673491228,5.2268438987,-82,0.5069137402,5.7450223887,5.7337576389
26,87,2002,1078,582,567,2125,43,496,610,1036,90277,12.009937722,6.4840294567,6.3169152954,-70,0.4790605956,5.5259082655,6.795975891
26,87,2003,1020,665,322,2106,32,355,354,582,90859,11.262255984,7.3425492448,3.5553396343,-127,0.3533256779,3.9197067397,3.9086653123
26,87,2004,1050,638,290,2112,35,412,325,675,91534,11.513599754,6.9958825174,3.1799465988,-62,0.3837866585,4.517717237,3.5637332573
26,87,2005,1071,613,300,2110,34,458,334,706,92240,11.65562049,6.6712374982,3.2648796892,-86,0.3700196981,4.9843829922,3.6348993873
26,87,2006,931,658,-300,2099,34,273,-266,-34,92206,10.095095584,7.1348795854,-3.252984613,-41,0.3686715895,2.9602159982,-2.884313024
26,87,2007,990,653,-887,2109,32,337,-855,-483,91723,10.76502346,7.1005659793,-9.64502607,35,0.3479603543,3.6644574809,-9.297065716
26,87,2008,1057,647,-1330,2099,32,410,-1298,-848,90875,11.577344768,7.0866055488,-14.56751991,40,0.3504967196,4.4907392195,-14.21702319
26,89,2001,191,152,208,220,17,39,225,247,21510,8.9308676034,7.1072873074,9.7257615786,-17,0.7948939752,1.823580296,10.520655554
26,89,2002,169,200,74,220,16,-31,90,41,21551,7.8493300202,9.2891479529,3.4369847426,-18,0.7431318362,-1.439817933,4.1801165788
26,89,2003,202,176,255,220,7,26,262,270,21821,9.3147652864,8.115835101,11.758738357,-18,0.3227888961,1.1989301854,12.081527253
26,89,2004,176,174,79,220,11,2,90,76,21897,8.0516034585,7.9601079647,3.614072007,-16,0.5032252162,0.0914954938,4.1172972231
26,89,2005,207,200,-44,220,9,7,-35,-49,21848,9.4639387359,9.1439021602,-2.011658475,-21,0.4114755972,0.3200365756,-1.600182878
26,89,2006,186,182,-23,220,10,4,-13,-19,21829,8.51706848,8.333905717,-1.053185887,-10,0.4579069075,0.183162763,-0.59527898
26,89,2007,177,173,-12,220,6,4,-6,0,21829,8.1084795456,7.92523707,-0.549727427,2,0.2748637134,0.1832424756,-0.274863713
26,89,2008,209,183,-85,220,6,26,-79,-46,21783,9.5845180226,8.392185637,-3.898009722,7,0.2751536274,1.1923323856,-3.622856095
26,91,2001,1251,877,177,5039,57,374,234,511,99586,12.594318965,8.8291108975,1.7819300215,-97,0.5738418713,3.765208068,2.3557718928
26,91,2002,1189,866,308,5007,55,323,363,599,100185,11.903629656,8.6699270665,3.0835306426,-87,0.5506304719,3.2337025895,3.6341611145
26,91,2003,1250,867,36,4960,38,383,74,306,100491,12.457892324,8.6407941159,0.3587872989,-151,0.3787199266,3.8170982081,0.7375072256
26,91,2004,1241,871,111,4973,39,370,150,454,100945,12.321531405,8.6479080204,1.1020870152,-66,0.3872197621,3.6736233841,1.4893067773
26,91,2005,1220,826,-305,4879,40,394,-265,38,100983,12.083514916,8.1811338695,-3.020878729,-91,0.3961808169,3.9023810467,-2.624697912
26,91,2006,1260,915,-8,5062,42,345,34,330,101313,12.456993712,9.0461501958,-0.079092024,-49,0.4152331237,3.4108435164,0.3361411002
26,91,2007,1252,880,-395,5376,34,372,-361,32,101345,12.355791531,8.6845819065,-3.898193015,21,0.3355406646,3.6712096241,-3.56265235
26,91,2008,1269,855,-1064,5459,34,414,-1030,-544,100801,12.555281826,8.459232436,-10.52704481,72,0.3363905296,4.09604939,-10.19065428
26,93,2001,2017,916,3737,1422,164,1101,3901,4906,163333,12.537294878,5.693684734,23.228493287,-96,1.0193933366,6.8436101442,24.247886624
26,93,2002,2006,962,3649,1639,157,1044,3806,4769,168102,12.10493762,5.8050598157,22.019400486,-81,0.9473954169,6.2998778041,22.966795903
26,93,2003,1952,946,2504,1627,133,1006,2637,3542,171644,11.490937347,5.5688661529,14.740423728,-101,0.7829378418,5.9220711944,15.52336157
26,93,2004,2086,1041,3123,1627,130,1045,3253,4095,175739,12.009798983,5.9933848231,17.980154469,-203,0.7484534361,6.0164141596,18.728607905
26,93,2005,1997,1055,2752,1602,134,942,2886,3688,179427,11.245445792,5.940883981,15.496978877,-140,0.7545767331,5.3045618105,16.251555611
26,93,2006,1966,1046,1690,1591,134,920,1824,2648,182075,10.876841622,5.7869666005,9.3498791155,-96,0.7413513618,5.0898750214,10.091230477
26,93,2007,2006,1110,-401,1158,125,896,-276,580,182655,10.999917747,6.086694267,-2.198886848,-40,0.6854385436,4.9132234804,-1.513448304
26,93,2008,2101,1089,-1253,1092,125,1012,-1128,-80,182575,11.505078991,5.9633655505,-6.861429784,36,0.684500178,5.5417134408,-6.176929606
26,95,2001,66,70,82,1051,1,-4,83,75,7081,9.3703414496,9.9382409314,11.641939377,-4,0.1419748704,-0.567899482,11.783914247
26,95,2002,55,95,-33,1051,1,-40,-32,-78,7003,7.8102811701,13.490485657,-4.686168702,-6,0.1420051122,-5.680204487,-4.54416359
26,95,2003,57,91,-95,1036,1,-34,-94,-134,6869,8.2179930796,13.119953864,-13.69665513,-6,0.1441753172,-4.901960784,-13.55247982
26,95,2004,61,89,-4,1039,0,-28,-4,-37,6832,8.9044595285,12.991752427,-0.583898985,-5,0,-4.087292898,-0.583898985
26,95,2005,66,78,-69,1051,1,-12,-68,-85,6747,9.7208925547,11.488327565,-10.16275131,-5,0.1472862508,-1.76743501,-10.01546506
26,95,2006,54,63,-97,1061,0,-9,-97,-109,6638,8.0687336571,9.4135225999,-14.49383638,-3,0,-1.344788943,-14.49383638
26,95,2007,61,55,69,1098,1,6,70,68,6706,9.1426858513,8.2434052758,10.341726619,-8,0.1498800959,0.8992805755,10.491606715
26,95,2008,68,69,-82,1095,0,-1,-82,-92,6614,10.21021021,10.36036036,-12.31231231,-9,0,-0.15015015,-12.31231231
26,97,2001,116,144,-177,197,1,-28,-176,-214,11711,9.8155356236,12.184802843,-14.97715349,-10,0.0846166864,-2.369267219,-14.89253681
26,97,2002,104,139,-111,197,0,-35,-111,-156,11555,8.9400842431,11.94876644,-9.541820683,-10,0,-3.008682197,-9.541820683
26,97,2003,105,128,-109,197,-5,-23,-114,-151,11404,9.1467398406,11.150311425,-9.495187073,-14,-0.43555904,-2.003571584,-9.930746113
26,97,2004,99,143,-46,197,2,-44,-44,-98,11306,8.7186261559,12.593571114,-4.05107882,-10,0.1761338617,-3.874944958,-3.874944958
26,97,2005,112,134,-102,197,-1,-22,-103,-132,11174,9.9644128114,11.921708185,-9.074733096,-7,-0.088967972,-1.957295374,-9.163701068
26,97,2006,107,135,-155,197,1,-28,-154,-186,10988,9.6561682159,12.183015973,-13.98790723,-4,0.0902445628,-2.526847757,-13.89766267
26,97,2007,107,128,-85,197,-1,-21,-86,-116,10872,9.7895699909,11.710887466,-7.776761208,-9,-0.091491308,-1.921317475,-7.868252516
26,97,2008,105,119,-216,197,-1,-14,-217,-248,10624,9.7692593971,11.071827317,-20.09676219,-17,-0.093040566,-1.30256792,-20.18980275
26,99,2001,10264,7315,3926,8846,2123,2949,6049,9171,8e+05,12.903963908,9.1964629762,4.935791339,173,2.6690486532,3.7075009319,7.6048399922
26,99,2002,10062,7294,2420,8844,1943,2768,4363,7173,807173,12.521365155,9.0768075372,3.0114990732,42,2.4179102063,3.4445576176,5.4294092795
26,99,2003,10153,7394,2367,8832,1640,2759,4007,6560,813733,12.527561746,9.1232927758,2.9205888559,-206,2.0235596635,3.4042689706,4.9441485194
26,99,2004,10274,7263,2058,8850,1629,3011,3687,6900,820633,12.57245929,8.8878500899,2.5184077495,202,1.9934335394,3.6846092001,4.5118412889
26,99,2005,9948,7413,514,8849,1654,2535,2168,4595,825228,12.088505651,9.0080511052,0.6245970954,-108,2.0098902641,3.0804545463,2.6344873595
26,99,2006,10131,7279,-1477,8858,1679,2852,202,3054,828282,12.253932543,8.8043011533,-1.786502652,0,2.0308313829,3.4496313902,0.244328731
26,99,2007,10104,7321,-3291,8849,1495,2783,-1796,1082,829364,12.190781385,8.8330077713,-3.970690968,95,1.8037626852,3.3577736139,-2.166928283
26,99,2008,10153,7241,-3302,8840,1505,2912,-1797,1299,830663,12.232331161,8.7239544899,-3.978248547,184,1.8132235199,3.508376671,-2.165025027
26,101,2001,271,281,104,1150,6,-10,110,79,24708,10.985669984,11.39104526,4.2159028721,-21,0.2432251657,-0.405375276,4.4591280378
26,101,2002,233,308,255,1188,6,-75,261,169,24877,9.3980034285,12.423111828,10.285368559,-17,0.242008672,-3.0251084,10.527377231
26,101,2003,280,330,264,1197,6,-50,270,204,25081,11.209415909,13.211097322,10.568877857,-16,0.2402017695,-2.001681412,10.809079627
26,101,2004,261,293,-177,965,5,-32,-172,-224,24857,10.452961672,11.734550843,-7.0887901,-20,0.2002483079,-1.281589171,-6.888541792
26,101,2005,236,262,150,1303,6,-26,156,108,24965,9.4737264662,10.517442094,6.0214363133,-22,0.2408574525,-1.043715628,6.2622937658
26,101,2006,240,267,-4,1368,5,-27,1,-38,24927,9.6207808867,10.703118736,-0.160346348,-12,0.2004329351,-1.08233785,0.040086587
26,101,2007,239,265,-154,1366,5,-26,-149,-179,24748,9.6225465526,10.66935078,-6.200301963,-4,0.2013085053,-1.046804227,-5.998993457
26,101,2008,255,278,-83,1397,4,-23,-79,-108,24640,10.326395076,11.257795416,-3.361140358,-6,0.1619826679,-0.93140034,-3.19915769
26,103,2001,609,626,81,4101,21,-17,102,19,64624,9.4251290345,9.6882278745,1.2535885908,-66,0.3250044495,-0.26309884,1.5785930403
26,103,2002,632,640,193,4322,18,-8,211,138,64762,9.7692176897,9.8928786731,2.9833212249,-65,0.2782372127,-0.123660983,3.2615584375
26,103,2003,613,645,-6,4251,10,-32,4,-122,64640,9.4743512465,9.9689340196,-0.09273427,-94,0.1545571166,-0.494582773,0.0618228466
26,103,2004,633,619,470,4336,21,14,491,451,65091,9.7586544465,9.5428232265,7.2457623852,-54,0.32374683,0.21583122,7.5695092152
26,103,2005,602,629,40,4383,17,-27,57,-26,65065,9.250437936,9.6653246873,0.6146470389,-56,0.2612249915,-0.414886751,0.8758720305
26,103,2006,625,616,178,4472,20,9,198,175,65240,9.5928782472,9.4547408004,2.7320517248,-32,0.3069721039,0.1381374468,3.0390238287
26,103,2007,653,572,-34,4652,16,81,-18,77,65317,10.003293581,8.7624562452,-0.520845301,14,0.2451036712,1.2408373354,-0.27574163
26,103,2008,677,604,43,4628,16,73,59,175,65492,10.350969734,9.2348385814,0.6574471176,43,0.2446314856,1.1161311531,0.9020786032
26,105,2001,327,350,162,562,3,-23,165,112,28475,11.506386572,12.315704282,5.7004116964,-30,0.1055631796,-0.80931771,5.805974876
26,105,2002,295,366,243,562,1,-71,244,149,28624,10.332930524,12.819839227,8.5115326013,-24,0.0350268831,-2.486908702,8.5465594844
26,105,2003,291,271,118,563,-3,20,115,95,28719,10.149451546,9.4518947387,4.115585163,-40,-0.104633521,0.6975568073,4.0109516419
26,105,2004,333,308,94,559,5,25,99,105,28824,11.573953391,10.705037972,3.2671219783,-19,0.173783084,0.8689154198,3.4409050623
26,105,2005,301,334,-75,407,2,-33,-73,-128,28696,10.465924896,11.613351878,-2.607788595,-22,0.0695410292,-1.147426982,-2.538247566
26,105,2006,348,286,96,407,4,62,100,147,28843,12.096143485,9.9410834391,3.3368671684,-15,0.139036132,2.1550600462,3.4759033004
26,105,2007,333,316,-121,407,1,17,-120,-102,28741,11.565712698,10.975270909,-4.202556266,1,0.03473187,0.5904417894,-4.167824396
26,105,2008,326,313,22,407,1,13,23,41,28782,11.334596596,10.88260348,0.7649114267,5,0.0347687012,0.4519931158,0.7996801279
26,107,2001,481,367,108,3393,53,114,161,237,40888,11.798035296,9.0018273464,2.6490391101,-38,1.2999914152,2.7962079496,3.9490305253
26,107,2002,510,357,352,3400,52,153,404,530,41418,12.392778169,8.6749447185,8.5534468933,-27,1.263577382,3.7178334508,9.8170242753
26,107,2003,448,318,164,3508,38,130,202,279,41697,10.78024424,7.6520483667,3.9463394093,-53,0.9143957168,3.1281958732,4.860735126
26,107,2004,437,338,268,3302,40,99,308,373,42070,10.43370301,8.0700037007,6.3987011592,-34,0.9550300238,2.3636993088,7.3537311829
26,107,2005,451,318,96,3413,39,133,135,233,42303,10.690623778,7.5379564553,2.2756094959,-35,0.9244663577,3.1526673225,3.2000758536
26,107,2006,481,322,-372,3212,41,159,-331,-192,42111,11.396213898,7.6290662686,-8.813703888,-20,0.9714028479,3.7671476295,-7.84230104
26,107,2007,448,341,-516,3143,33,107,-483,-383,41728,10.687150372,8.1346390105,-12.30930712,-7,0.78722313,2.5525113611,-11.52208399
26,107,2008,469,341,-303,3143,33,128,-270,-166,41562,11.261856165,8.1882578941,-7.275783407,-24,0.7924120543,3.0735982711,-6.483371353
26,109,2001,276,303,-90,435,8,-27,-82,-131,25155,10.943478519,12.014036201,-3.568525604,-22,0.3172022759,-1.070557681,-3.251323328
26,109,2002,252,297,-113,435,7,-45,-106,-174,24981,10.052656774,11.847774055,-4.50773895,-23,0.2792404659,-1.795117281,-4.228498484
26,109,2003,259,267,-23,435,5,-8,-18,-62,24919,10.380761523,10.701402806,-0.921843687,-36,0.2004008016,-0.320641283,-0.721442886
26,109,2004,251,252,-22,435,7,-1,-15,-31,24888,10.078904572,10.11905957,-0.883409962,-15,0.2810849881,-0.040154998,-0.602324974
26,109,2005,218,263,-233,435,5,-45,-228,-296,24592,8.8116410671,10.630557801,-9.417946645,-23,0.2021018593,-1.818916734,-9.215844786
26,109,2006,223,262,-213,435,6,-39,-207,-256,24336,9.1154349248,10.709614127,-8.706671027,-10,0.2452583388,-1.594179202,-8.461412688
26,109,2007,250,255,-140,435,6,-5,-134,-138,24198,10.30205629,10.508097416,-5.769151523,1,0.247249351,-0.206041126,-5.521902172
26,109,2008,260,254,-10,435,5,6,-5,4,24202,10.743801653,10.495867769,-0.41322314,3,0.2066115702,0.2479338843,-0.20661157
26,111,2001,1054,637,36,1488,147,417,183,516,83516,12.659444138,7.6509164285,0.4323908814,-84,1.7655960989,5.008527709,2.1979869802
26,111,2002,1016,613,-558,1474,141,403,-417,-76,83440,12.170871367,7.3432521143,-6.684395889,-62,1.6890677783,4.827619253,-4.99532811
26,111,2003,996,627,-259,1320,113,369,-146,118,83558,11.928286566,7.5090719649,-3.101833555,-105,1.3533096205,4.4192146014,-1.748523934
26,111,2004,979,644,-484,1369,111,335,-373,-106,83452,11.723848871,7.7121130471,-5.796060116,-68,1.3292617209,4.0117358242,-4.466798395
26,111,2005,932,667,-594,1446,116,265,-478,-287,83165,11.187333825,8.006385903,-7.130124777,-74,1.3924149397,3.1809479225,-5.737709838
26,111,2006,887,631,-666,1474,117,256,-549,-329,82836,10.68668261,7.6023638412,-8.024048048,-36,1.4096300625,3.0843187692,-6.614417985
26,111,2007,917,654,-615,1412,103,263,-512,-243,82593,11.086327065,7.9067152676,-7.435213898,6,1.2452472057,3.1796117972,-6.189966693
26,111,2008,930,654,-366,1412,103,276,-263,12,82605,11.259216213,7.9177714016,-4.431046381,-1,1.2469884623,3.3414448117,-3.184057918
26,113,2001,178,143,28,206,0,35,28,50,14594,12.217722562,9.8153613838,1.9218889423,-13,0,2.4023611778,1.9218889423
26,113,2002,174,131,212,206,-1,43,211,244,14838,11.823865181,8.9018755096,14.406088611,-10,-0.067953248,2.9219896711,14.338135363
26,113,2003,172,136,151,206,-2,36,149,174,15012,11.524288107,9.1122278057,10.117252931,-11,-0.13400335,2.4120603015,9.9832495812
26,113,2004,173,134,61,206,1,39,62,89,15101,11.490054129,8.899810713,4.0514063693,-12,0.0664164979,2.5902434165,4.1178228672
26,113,2005,165,151,-37,206,-1,14,-38,-37,15064,10.93983093,10.011602851,-2.453174209,-13,-0.066302006,0.9282280789,-2.519476214
26,113,2006,174,131,-103,206,0,43,-103,-68,14996,11.576846307,8.7159015303,-6.852960745,-8,0,2.8609447771,-6.852960745
26,113,2007,176,142,-50,206,0,34,-50,-16,14980,11.742727515,9.4742460635,-3.336002135,0,0,2.2684814518,-3.336002135
26,113,2008,170,145,3,206,-1,25,2,21,15001,11.34051566,9.6727927688,0.2001267469,-6,-0.066708916,1.6677228912,0.1334178313
26,115,2001,1757,1203,704,1543,106,554,810,1226,147631,11.950917575,8.1826715096,4.7885292957,-138,0.7210001496,3.7682460651,5.5095294454
26,115,2002,1666,1203,510,1543,102,463,612,935,148566,11.249269912,8.1229722111,3.4436540546,-140,0.6887308109,3.1262977005,4.1323848655
26,115,2003,1718,1151,616,1543,85,567,701,1083,149649,11.52188857,7.7192629479,4.1312475898,-185,0.5700585148,3.8026256225,4.7013061047
26,115,2004,1773,1172,822,1543,91,601,913,1392,151041,11.792876384,7.7954039044,5.4674249227,-122,0.6052745352,3.99747248,6.0726994579
26,115,2005,1702,1223,770,1543,91,479,861,1201,152242,11.223840439,8.0650745343,5.0777656512,-139,0.600099577,3.1587659051,5.6778652282
26,115,2006,1782,1234,338,1543,96,548,434,908,153150,11.670246765,8.081416671,2.2135484885,-74,0.6287001624,3.5888300938,2.8422486509
26,115,2007,1802,1258,-467,1543,85,544,-382,181,153331,11.759293398,8.2093180328,-3.047497235,19,0.5546836509,3.5499753655,-2.492813584
26,115,2008,1855,1226,-1180,1543,85,629,-1095,-382,152949,12.113099125,8.0057463759,-7.705367637,84,0.5550476688,4.1073527491,-7.150319969
26,117,2001,867,531,207,2717,21,336,228,508,61997,14.042077644,8.6001652009,3.3526067732,-56,0.3401195277,5.4419124435,3.692726301
26,117,2002,826,546,108,2697,19,280,127,349,62346,13.285830324,8.7821590279,1.7371303572,-58,0.3056062665,4.5036712963,2.0427366237
26,117,2003,827,573,86,2694,14,254,100,267,62613,13.23634152,9.1710080907,1.3764514761,-87,0.2240734961,4.0653334294,1.6005249722
26,117,2004,833,553,176,2693,17,280,193,425,63038,13.258947402,8.8021583593,2.8014102554,-48,0.2705907633,4.4567890427,3.0720010187
26,117,2005,892,544,-280,2696,15,348,-265,29,63067,14.146941041,8.6277308592,-4.440743825,-54,0.2378969906,5.519210182,-4.202846834
26,117,2006,797,563,-143,2793,18,234,-125,80,63147,12.629343813,8.9213557925,-2.265992679,-29,0.2852298477,3.7079880203,-1.980762831
26,117,2007,852,527,-588,2864,14,325,-574,-262,62885,13.520375778,8.3629554399,-9.330963565,-13,0.2221657992,5.1574203377,-9.108797766
26,117,2008,863,548,-216,2943,14,315,-202,86,62971,13.714085939,8.7083651157,-3.432494279,-27,0.2224764811,5.0057208238,-3.210017798
26,119,2001,84,148,131,127,1,-64,132,59,10433,8.0742057961,14.225981641,12.591916182,-9,0.0961214976,-6.151775845,12.68803768
26,119,2002,92,175,133,127,1,-83,134,42,10475,8.8004591544,16.740003826,12.722402908,-9,0.0956571647,-7.939544672,12.818060073
26,119,2003,93,135,62,127,0,-42,62,11,10486,8.8736224417,12.881064835,5.9157482945,-9,0,-4.007442393,5.9157482945
26,119,2004,86,156,54,127,1,-70,55,-25,10461,8.2111996945,14.894734329,5.1558695756,-10,0.0954790662,-6.683534635,5.2513486418
26,119,2005,75,146,5,127,1,-71,6,-75,10386,7.1952798964,14.006811532,0.4796853264,-10,0.0959370653,-6.811531635,0.5756223917
26,119,2006,83,155,43,127,1,-72,44,-34,10352,8.0046291831,14.948403896,4.1469765648,-6,0.0964413155,-6.943774713,4.2434178802
26,119,2007,91,140,17,127,0,-49,17,-27,10325,8.8020505876,13.541616289,1.6443391208,5,0,-4.739565701,1.6443391208
26,119,2008,88,151,65,127,-1,-63,64,10,10335,8.5188770571,14.617618587,6.2923523717,9,-0.096805421,-6.09874153,6.1955469506
26,121,2001,2435,1588,-41,6051,116,847,75,753,171239,14.251225401,9.2940229717,-0.239959031,-169,0.678908479,4.9572024289,0.4389494477
26,121,2002,2327,1608,-97,6026,106,719,9,564,171803,13.566851872,9.374945342,-0.565528419,-164,0.6180001283,4.1919065304,0.052471709
26,121,2003,2312,1575,105,6036,90,737,195,676,172479,13.430850291,9.1494763014,0.6099650868,-256,0.5228272172,4.2813739899,1.132792304
26,121,2004,2426,1619,-199,6053,89,807,-110,581,173060,14.0418303,9.3708669644,-1.151823673,-116,0.5151372204,4.6709633355,-0.636686452
26,121,2005,2338,1624,230,6049,89,714,319,865,173925,13.476086863,9.360635186,1.3257057221,-168,0.5129904751,4.1154516766,1.8386961972
26,121,2006,2370,1642,-621,6184,90,728,-531,120,174045,13.621863954,9.437595195,-3.569273213,-77,0.5172859729,4.1842687588,-3.05198724
26,121,2007,2385,1535,-895,6206,79,850,-816,63,174108,13.700872892,8.8179622178,-5.14141771,29,0.4538234627,4.8829106743,-4.687594247
26,121,2008,2456,1534,-807,6291,79,922,-728,236,174344,14.096633109,8.8046560215,-4.631914869,42,0.4534340454,5.2919770872,-4.178480824
26,123,2001,647,413,349,681,41,234,390,584,48586,13.397109372,8.5517869715,7.2265705885,-40,0.8489667454,4.8453224003,8.0755373338
26,123,2002,581,445,-9,681,40,136,31,118,48704,11.943673553,9.1479083153,-0.185013876,-49,0.8222838935,2.7957652379,0.6372700175
26,123,2003,613,448,197,681,25,165,222,322,49026,12.544766193,9.1681162386,4.0315153996,-65,0.5116136294,3.376649954,4.543129029
26,123,2004,616,444,13,681,27,172,40,181,49207,12.541610253,9.0397320656,0.2646768398,-31,0.5497134364,3.5018781876,0.8143902762
26,123,2005,640,430,-46,681,25,210,-21,146,49353,12.987012987,8.7256493506,-0.933441558,-43,0.5073051948,4.2613636364,-0.426136364
26,123,2006,680,433,-497,681,26,247,-471,-246,49107,13.812715824,8.7954499289,-10.09547024,-22,0.5281332521,5.0172658948,-9.56733699
26,123,2007,629,392,-247,681,23,237,-224,-8,49099,12.809807955,7.9832189479,-5.030242551,-21,0.4684031526,4.8265890068,-4.561839399
26,123,2008,661,420,-443,681,22,241,-421,-202,48897,13.490346545,8.5717784399,-9.041185355,-22,0.4489979183,4.9185681048,-8.592187436
26,125,2001,16192,9071,-6437,13809,5176,7121,-1261,4842,1201330,13.505612186,7.566045463,-5.369048026,-1018,4.3172584408,5.9395667227,-1.051789585
26,125,2002,15496,8966,-11647,13812,4876,6530,-6771,-1046,1200284,12.904654953,7.4666453477,-9.699310547,-805,4.0606025781,5.4380096052,-5.638707969
26,125,2003,15441,9021,-6642,13972,4304,6420,-2338,2752,1203036,12.849724548,7.5071151574,-5.527353827,-1330,3.5817119651,5.3426093903,-1.945641862
26,125,2004,15478,9079,-6398,13927,3863,6399,-2535,2900,1205936,12.850294649,7.5376550661,-5.311809353,-964,3.2071771693,5.3126395824,-2.104632183
26,125,2005,14822,8978,-8883,13831,4093,5844,-4790,-59,1205877,12.291168511,7.4450216497,-7.366242739,-1113,3.3941271566,4.8461468613,-3.972115583
26,125,2006,14486,8981,-10314,13893,4111,5505,-6203,-1211,1204666,12.018868778,7.4514331418,-8.55740802,-513,3.4108497546,4.5674356359,-5.146558265
26,125,2007,14284,8980,-11792,14122,3729,5304,-8063,-2379,1202287,11.868948002,7.4617161199,-9.798280232,380,3.0985233197,4.407231882,-6.699756913
26,125,2008,14118,8954,-9428,14114,3730,5164,-5698,-113,1202174,11.743172378,7.4478230256,-7.842090182,421,3.102566438,4.2953493527,-4.739523744
26,127,2001,380,235,-38,765,62,145,24,139,27075,14.071207717,8.7019310881,-1.407120772,-30,2.2958286275,5.3692766288,0.8887078558
26,127,2002,367,210,243,765,59,157,302,440,27515,13.445686023,7.6937167979,8.9027294376,-19,2.1615680528,5.7519692251,11.06429749
26,127,2003,370,228,38,765,39,142,77,182,27697,13.402883431,8.2590741143,1.3765123524,-37,1.4127363617,5.1438093168,2.789248714
26,127,2004,404,230,23,765,43,174,66,219,27916,14.528977038,8.2714473235,0.8271447323,-21,1.5464010213,6.2575297143,2.3735457537
26,127,2005,358,270,-191,765,42,88,-149,-81,27835,12.842818963,9.6859249161,-6.851895033,-20,1.5066994314,3.1568940467,-5.345195602
26,127,2006,419,231,-163,765,44,188,-119,54,27889,15.03840356,8.2908621061,-5.850262006,-15,1.5792118297,6.7475414543,-4.271050176
26,127,2007,384,229,-392,765,34,155,-358,-221,27668,13.823640585,8.2437856616,-14.1116331,-18,1.2239681768,5.5798549238,-12.88766492
26,127,2008,406,220,-252,765,34,186,-218,-70,27598,14.692577715,7.9614953136,-9.119530996,-38,1.2304129121,6.7310824015,-7.889118083
26,129,2001,217,309,108,304,5,-92,113,2,21695,10.002765742,14.243569651,4.9783350235,-19,0.2304784733,-4.240803909,5.2088134968
26,129,2002,224,284,97,304,5,-60,102,24,21719,10.319251854,13.083337172,4.4686045976,-18,0.2303404432,-2.764085318,4.6989450408
26,129,2003,212,290,105,304,-1,-78,104,4,21723,9.7601399567,13.351134846,4.8340315823,-22,-0.046038396,-3.59099489,4.7879931863
26,129,2004,213,288,72,304,0,-75,72,-20,21703,9.8097913692,13.26394326,3.3159858149,-17,0,-3.454151891,3.3159858149
26,129,2005,216,323,51,304,0,-107,51,-74,21629,9.9695375242,14.90815102,2.3539185821,-18,0,-4.938613496,2.3539185821
26,129,2006,192,297,-114,304,0,-105,-114,-230,21399,8.9244213071,13.804964209,-5.298875151,-11,0,-4.880542902,-5.298875151
26,129,2007,208,312,-36,304,0,-104,-36,-153,21246,9.7549536874,14.632430531,-1.688357369,-13,0,-4.877476844,-1.688357369
26,129,2008,228,280,-147,304,-1,-52,-148,-230,21016,10.78983484,13.250674365,-6.956604041,-30,-0.047323837,-2.460839525,-7.003927878
26,131,2001,47,117,-14,177,1,-70,-13,-91,7710,6.0602153311,15.086067952,-1.805170524,-8,0.1289407517,-9.025852621,-1.676229772
26,131,2002,49,109,-10,177,1,-60,-9,-77,7633,6.3872775859,14.208433813,-1.303526038,-8,0.1303526038,-7.821156228,-1.173173434
26,131,2003,49,114,-57,177,-1,-65,-58,-131,7502,6.475057813,15.064420218,-7.532210109,-8,-0.132144037,-8.589362405,-7.664354146
26,131,2004,39,133,-27,177,0,-94,-27,-126,7376,5.2426401398,17.878747143,-3.629520097,-5,0,-12.636107,-3.629520097
26,131,2005,53,97,-99,177,0,-44,-99,-147,7229,7.2577884286,13.283122218,-13.55700103,-4,0,-6.02533379,-13.55700103
26,131,2006,58,97,-94,177,0,-39,-94,-136,7093,8.0994274543,13.545594191,-13.12665829,-3,0,-5.446166736,-13.12665829
26,131,2007,43,113,-64,177,0,-70,-64,-133,6960,6.119689746,16.081975379,-9.108375436,1,0,-9.962285633,-9.108375436
26,131,2008,47,109,-76,177,-1,-62,-77,-141,6819,6.8219754699,15.821177154,-11.03127948,-2,-0.145148414,-8.999201684,-11.1764279
26,133,2001,314,260,52,360,6,54,58,91,23322,13.490000644,11.170064228,2.2340128456,-21,0.257770713,2.3199364166,2.4917835585
26,133,2002,286,222,124,360,5,64,129,173,23495,12.217784138,9.4837345409,5.2972210949,-20,0.2135976248,2.7340495974,5.5108187197
26,133,2003,319,204,-24,360,0,115,-24,54,23549,13.561771958,8.6727319106,-1.020321401,-37,0,4.8890400476,-1.020321401
26,133,2004,309,214,-87,360,1,95,-86,-6,23543,13.12324811,9.0885925423,-3.694895099,-15,0.0424700586,4.0346555678,-3.65242504
26,133,2005,298,210,-231,360,1,88,-230,-161,23382,12.701118807,8.9504528503,-9.845498135,-19,0.042621204,3.7506659563,-9.802876931
26,133,2006,303,222,-219,360,1,81,-218,-149,23233,13.000107262,9.524831063,-9.39611713,-12,0.0429046444,3.4752761986,-9.353212485
26,133,2007,313,232,-218,360,1,81,-217,-141,23092,13.513221802,10.016189962,-9.411764706,-5,0.0431732326,3.4970318403,-9.368591473
26,133,2008,307,205,-241,360,0,102,-241,-162,22930,13.341445396,8.9087827561,-10.47325192,-23,0,4.4326626396,-10.47325192
26,135,2001,86,113,63,60,2,-27,65,30,9440,9.124668435,11.98938992,6.6843501326,-8,0.2122015915,-2.864721485,6.8965517241
26,135,2002,93,111,-60,60,2,-18,-58,-87,9353,9.897302187,11.812909062,-6.38535625,-11,0.2128452083,-1.915606875,-6.172511041
26,135,2003,81,94,45,60,1,-13,46,27,9380,8.6478407089,10.035765761,4.8043559494,-6,0.1067634655,-1.387925052,4.9111194149
26,135,2004,105,113,-105,60,0,-8,-105,-120,9260,11.266094421,12.124463519,-11.26609442,-7,0,-0.858369099,-11.26609442
26,135,2005,79,127,-157,60,1,-48,-156,-208,9052,8.628221931,13.870685889,-17.14722586,-4,0.1092179991,-5.242463958,-17.03800786
26,135,2006,82,110,-41,60,0,-28,-41,-75,8977,9.0964557102,12.202562538,-4.548227855,-6,0,-3.106106828,-4.548227855
26,135,2007,91,128,-3,60,1,-37,-2,-51,8926,10.165893984,14.29927945,-0.335139362,-12,0.1117131207,-4.133385466,-0.223426241
26,135,2008,90,124,-31,60,0,-34,-31,-90,8836,10.13399392,13.962391623,-3.490597906,-25,0,-3.828397703,-3.490597906
26,137,2001,266,190,238,231,8,76,246,303,23727,11.28289962,8.0592140145,10.095225976,-19,0.3393353269,3.2236856058,10.434561303
26,137,2002,304,202,233,231,7,102,240,327,24054,12.724723216,8.4552437161,9.7528306231,-15,0.2930034951,4.2694795002,10.045834118
26,137,2003,287,222,69,231,4,65,73,108,24162,11.904761905,9.2085614734,2.8621204579,-30,0.1659200265,2.6962004314,3.0280404845
26,137,2004,292,216,-23,231,6,76,-17,43,24205,12.074348213,8.9317096367,-0.951061674,-16,0.2481030455,3.1426385759,-0.702958629
26,137,2005,275,201,22,231,4,74,26,80,24285,11.342544855,8.2903691483,0.9074035884,-20,0.1649824706,3.0521757063,1.072386059
26,137,2006,260,231,-21,231,5,29,-16,1,24286,10.705976817,9.511848634,-0.864713512,-12,0.2058841696,1.1941281835,-0.658829343
26,137,2007,300,228,-194,231,4,72,-190,-127,24159,12.385179069,9.4127360925,-8.009082465,-9,0.1651357209,2.9724429766,-7.843946744
26,137,2008,280,230,-395,231,4,50,-391,-351,23808,11.674693018,9.5899264077,-16.46965622,-10,0.1667813288,2.0847666104,-16.30287489
26,139,2001,3659,1433,1596,9098,373,2226,1969,3976,243438,15.154276248,5.9349761855,6.6100641955,-219,1.5448332988,9.2193000621,8.1548974943
26,139,2002,3615,1499,586,9555,349,2116,935,2801,246239,14.764834779,6.1224031351,2.3934144344,-250,1.4254294157,8.6424316437,3.8188438501
26,139,2003,3431,1490,976,9899,301,1941,1277,2890,249129,13.852327966,6.0157297201,3.9405048368,-328,1.2152581515,7.8365982462,5.1557629883
26,139,2004,3613,1530,919,10331,280,2083,1199,3100,252229,14.412854687,6.1034231029,3.6660430271,-182,1.1169663195,8.3094315838,4.7830093466
26,139,2005,3503,1512,-46,10358,294,1991,248,2002,254231,13.833274099,5.9708565336,-0.181653043,-237,1.1609998815,7.8624175651,0.9793468388
26,139,2006,3593,1516,33,10153,297,2077,330,2281,256512,14.069698459,5.9364494472,0.1292235038,-126,1.1630115342,8.1332490117,1.292235038
26,139,2007,3608,1511,-443,10279,266,2097,-177,1949,258461,14.012385115,5.8682688219,-1.720478549,29,1.0330638694,8.1441162935,-0.68741468
26,139,2008,3801,1523,-751,10279,266,2278,-485,1903,260364,14.652339421,5.8709584157,-2.895003132,110,1.025393919,8.7813810052,-1.869609213
26,141,2001,121,185,-42,221,2,-64,-40,-121,14250,8.4553300024,12.927570665,-2.934907935,-17,0.1397575207,-4.472240662,-2.795150414
26,141,2002,131,181,7,221,1,-50,8,-55,14195,9.2107576024,12.726313939,0.4921778872,-13,0.0703111267,-3.515556337,0.5624890139
26,141,2003,134,172,-10,221,-2,-38,-12,-70,14125,9.4632768362,12.146892655,-0.706214689,-20,-0.141242938,-2.683615819,-0.847457627
26,141,2004,121,164,11,221,1,-43,12,-41,14084,8.5788223617,11.627494771,0.779892942,-10,0.0708993584,-3.04867241,0.8507923003
26,141,2005,128,167,-31,221,-1,-39,-32,-84,14000,9.115510611,11.89289275,-2.207662726,-13,-0.071214927,-2.777382139,-2.278877653
26,141,2006,112,182,-27,221,0,-70,-27,-103,13897,8.0295372262,13.047997993,-1.93569201,-6,0,-5.018460766,-1.93569201
26,141,2007,111,183,-11,221,-1,-72,-12,-81,13816,8.0106809079,13.206798254,-0.793851261,3,-0.072168296,-5.196117346,-0.866019558
26,141,2008,127,177,-124,221,-1,-50,-125,-166,13650,9.2477972766,12.888662346,-9.029345372,9,-0.072817301,-3.64086507,-9.102162674
26,143,2001,200,367,359,333,2,-167,361,179,25706,7.807467843,14.326703492,14.014404778,-15,0.0780746784,-6.519235649,14.092479457
26,143,2002,215,403,241,333,2,-188,243,40,25746,8.3573038949,15.665085905,9.3679545985,-15,0.0777423618,-7.30778201,9.4456969603
26,143,2003,215,356,390,333,1,-141,391,252,25998,8.3101422387,13.760049474,15.074211503,2,0.0386518244,-5.449907236,15.112863327
26,143,2004,184,371,52,333,2,-187,54,-157,25841,7.0989023708,14.313547715,2.0062115396,-24,0.0771619823,-7.214645344,2.0833735219
26,143,2005,210,375,90,333,2,-165,92,-91,25750,8.1409548177,14.537419317,3.4889806362,-18,0.077532903,-6.3964645,3.5665135392
26,143,2006,193,347,59,333,2,-154,61,-107,25643,7.5107504913,13.503784562,2.2960325336,-14,0.0778316113,-5.993034071,2.3738641449
26,143,2007,194,367,-49,333,1,-173,-48,-237,25406,7.600540657,14.378342377,-1.919724187,-16,0.0391780446,-6.77780172,-1.880546142
26,143,2008,229,367,-201,333,0,-138,-201,-364,25042,9.078655249,14.549635268,-7.968601332,-25,0,-5.470980019,-7.968601332
26,145,2001,2753,2091,-1211,5879,157,662,-1054,-575,209351,13.132129833,9.9743129244,-5.776610689,-183,0.7489082397,3.1578169086,-5.02770245
26,145,2002,2802,2079,-1010,6073,152,723,-858,-309,209042,13.394105542,9.9380247757,-4.827996644,-174,0.726589594,3.4560807662,-4.10140705
26,145,2003,2639,2025,-1389,6204,125,614,-1264,-866,208176,12.65046091,9.7071554919,-6.658389619,-216,0.5992071291,2.9433054183,-6.05918249
26,145,2004,2655,2009,-997,6341,123,646,-874,-392,207784,12.765650543,9.6595826522,-4.793730166,-164,0.5914030195,3.1060678911,-4.202327147
26,145,2005,2629,2133,-1761,6495,126,496,-1635,-1327,206457,12.693094117,10.298352891,-8.502296972,-188,0.608341521,2.3947412255,-7.893955451
26,145,2006,2632,2097,-2177,6666,129,535,-2048,-1595,204862,12.797852761,10.196465517,-10.585458,-82,0.6272503823,2.6013872445,-9.95820762
26,145,2007,2552,2099,-3282,6829,111,453,-3171,-2590,202272,12.536413073,10.311101505,-16.122456,128,0.54527502,2.2253115682,-15.57718098
26,145,2008,2569,1992,-2288,6830,111,577,-2177,-1527,200745,12.74884186,9.8854390758,-11.35435974,73,0.5508452497,2.8634027845,-10.80351449
26,147,2001,2086,1495,564,1677,97,591,661,1099,165824,12.621426778,9.0455575421,3.4125046514,-153,0.5869023957,3.5758692357,3.9994070471
26,147,2002,2002,1467,435,1677,86,535,521,897,166721,12.040475725,8.8228660783,2.6161872829,-159,0.5172232329,3.2176096468,3.1334105159
26,147,2003,2105,1488,1147,1677,61,617,1208,1638,168359,12.564163782,8.8814611436,6.8461262982,-187,0.3640921571,3.6827026382,7.2102184553
26,147,2004,2118,1480,589,1677,79,638,668,1189,169548,12.535993631,8.7598066924,3.486166312,-117,0.4675842761,3.776186939,3.9537505882
26,147,2005,2023,1438,-532,1677,70,585,-462,-23,169525,11.932533702,8.4819493147,-3.13796734,-146,0.4128904395,3.4505843874,-2.725076901
26,147,2006,1966,1499,202,2095,77,467,279,662,170187,11.574510173,8.8251224567,1.1892426526,-84,0.4533251696,2.7493877167,1.6425678222
26,147,2007,2108,1464,-1077,2122,68,644,-1009,-347,169840,12.399015372,8.6110808848,-6.334791061,18,0.3999682378,3.7879344876,-5.934822823
26,147,2008,2083,1456,-1707,2116,69,627,-1638,-946,168894,12.298735881,8.5967160073,-10.07870482,65,0.4073993163,3.702019874,-9.671305508
26,149,2001,989,632,-490,996,130,357,-360,-56,62461,15.826785514,10.113780025,-7.841380083,-53,2.0803661444,5.713005489,-5.761013938
26,149,2002,863,535,-656,996,123,328,-533,-244,62217,13.843661271,8.5821075089,-10.52310752,-39,1.9730826609,5.2615537625,-8.550024864
26,149,2003,945,563,-215,996,110,382,-105,196,62413,15.164888069,9.0347428388,-3.450212629,-81,1.7652250662,6.1301452299,-1.684987563
26,149,2004,946,617,-448,996,107,329,-341,-64,62349,15.16487392,9.8908321444,-7.181673907,-52,1.7152658662,5.2740417755,-5.466408041
26,149,2005,983,596,-420,996,107,387,-313,21,62370,15.763436205,9.5574852268,-6.735140596,-53,1.7158572471,6.2059509778,-5.019283349
26,149,2006,970,569,-553,996,110,401,-443,-70,62300,15.561081255,9.1280981792,-8.87142055,-28,1.764658699,6.4329830753,-7.106761851
26,149,2007,913,566,-443,996,99,347,-344,-9,62291,14.655954282,9.0857285037,-7.111268069,-12,1.5891998619,5.5702257787,-5.522068207
26,149,2008,960,554,-544,996,99,406,-445,-59,62232,15.418838287,8.8979545947,-8.737341696,-20,1.5900676983,6.5208836922,-7.147273998
26,151,2001,547,464,-5,756,5,83,0,40,44571,12.278063343,10.415029966,-0.112230926,-43,0.1122309264,1.8630333775,0
26,151,2002,549,435,-181,756,4,114,-177,-104,44467,12.331813383,9.7711089647,-4.065679822,-41,0.0898492778,2.5607044183,-3.975830544
26,151,2003,501,473,-240,756,0,28,-240,-261,44206,11.299944741,10.668410903,-5.413147181,-49,0,0.6315338378,-5.413147181
26,151,2004,556,443,-1,756,3,113,2,83,44289,12.565681677,10.011865077,-0.022600147,-32,0.0678004407,2.5538165998,0.0452002938
26,151,2005,542,486,-292,756,1,56,-291,-268,44021,12.27494055,11.00668101,-6.613067603,-33,0.0226474918,1.2682595403,-6.590420111
26,151,2006,504,426,-165,756,2,78,-163,-108,43913,11.463142812,9.6890849956,-3.752814611,-23,0.045488662,1.7740578161,-3.707325949
26,151,2007,526,467,-447,756,2,59,-445,-399,43514,12.032896016,10.683198554,-10.22567399,-13,0.0457524563,1.3496974619,-10.17992153
26,151,2008,552,452,-557,756,1,100,-556,-490,43024,12.757401373,10.446277936,-12.87295754,-34,0.0231112344,2.3111234371,-12.84984631
26,153,2001,94,107,-75,393,1,-13,-74,-97,8825,10.593339719,12.058376064,-8.452132755,-10,0.1126951034,-1.465036344,-8.339437651
26,153,2002,88,110,-66,395,1,-22,-65,-94,8731,10.025062657,12.531328321,-7.518796992,-7,0.1139211666,-2.506265664,-7.404875826
26,153,2003,65,124,42,396,1,-59,43,-26,8705,7.4558384951,14.223445744,4.8176187199,-10,0.1147052076,-6.767607249,4.9323239275
26,153,2004,78,108,105,398,0,-30,105,67,8772,8.926017051,12.359100532,12.015792184,-8,0,-3.433083481,12.015792184
26,153,2005,74,119,-53,389,1,-45,-52,-106,8666,8.4872118362,13.648354169,-6.078678748,-9,0.1146920518,-5.161142333,-5.963986696
26,153,2006,67,113,41,445,0,-46,41,-9,8657,7.7353807077,13.046239104,4.7335911794,-4,0,-5.310858396,4.7335911794
26,153,2007,72,110,-121,445,1,-38,-120,-152,8505,8.3906304627,12.819018762,-14.10092064,6,0.1165365342,-4.4283883,-13.9843841
26,153,2008,76,117,-248,182,0,-41,-248,-285,8220,9.0881913303,13.99103139,-29.65620329,4,0,-4.90284006,-29.65620329
26,155,2001,908,607,-12,721,9,301,-3,226,71933,12.642717906,8.4516847675,-0.167084378,-72,0.1253132832,4.1910331384,-0.041771094
26,155,2002,922,644,-166,721,8,278,-158,56,71989,12.812495657,8.9492919776,-2.306805075,-64,0.1111713289,3.8632036798,-2.195633746
26,155,2003,846,634,56,721,1,212,57,163,72152,11.738506046,8.7969418833,0.7770169487,-106,0.0138753027,2.9415641629,0.7908922513
26,155,2004,923,619,229,721,8,304,237,488,72640,12.749323167,8.5501961434,3.1631581855,-53,0.1105033427,4.1991270236,3.2736615283
26,155,2005,864,606,-579,721,5,258,-574,-379,72261,11.925383538,8.3643315091,-7.991663274,-63,0.0690126362,3.5610520286,-7.922650637
26,155,2006,854,602,-344,721,7,252,-337,-117,72144,11.827845296,8.3376614383,-4.764377965,-32,0.0969495516,3.4901838579,-4.667428413
26,155,2007,873,575,-792,721,5,298,-787,-482,71662,12.141357106,7.9968846919,-11.01483944,7,0.0695381278,4.1444724142,-10.94530131
26,155,2008,889,606,-1082,721,5,283,-1077,-782,70880,12.473516578,8.5027570821,-15.18149037,12,0.0701547614,3.9707594954,-15.11133561
26,157,2001,697,535,-210,1460,6,162,-204,-94,58178,11.97080292,9.1884929154,-3.606698154,-52,0.1030485187,2.7823100043,-3.503649635
26,157,2002,675,567,-200,1455,5,108,-195,-137,58041,11.616000826,9.7574406939,-3.441778023,-50,0.0860444506,1.8585601322,-3.355733572
26,157,2003,705,503,5,1457,3,202,8,127,58168,12.133311534,8.6568165977,0.0860518548,-83,0.0516311129,3.4764949358,0.1376829678
26,157,2004,699,554,-305,1387,3,145,-302,-202,57966,12.037818382,9.540702981,-5.252553085,-45,0.0516644566,2.4971154012,-5.200888629
26,157,2005,620,520,-519,1194,4,100,-515,-464,57502,10.738906017,9.0068244016,-8.989503585,-49,0.0692832646,1.7320816157,-8.920220321
26,157,2006,631,511,-620,1188,4,120,-616,-519,56983,11.023278159,8.9269336594,-10.83111325,-23,0.06987815,2.0963444993,-10.7612351
26,157,2007,678,549,-445,1282,3,129,-442,-300,56683,11.929688737,9.6598807031,-7.829957947,13,0.0527862334,2.2698080341,-7.777171714
26,157,2008,684,540,-654,1317,2,144,-652,-496,56187,12.120138212,9.5685301674,-11.5885532,12,0.0354390006,2.5516080447,-11.5531142
26,159,2001,1068,650,-31,1916,67,418,36,378,76729,13.953488372,8.4922916122,-0.405016985,-76,0.8753592893,5.4611967599,0.4703423047
26,159,2002,1072,683,143,1916,62,389,205,522,77251,13.923886219,8.8712819847,1.8573840759,-72,0.8052993895,5.0526042343,2.6626834654
26,159,2003,980,722,159,1916,48,258,207,368,77619,12.655775812,9.3239491186,2.0533350552,-97,0.6198747336,3.3318266934,2.6732097889
26,159,2004,1027,647,15,1916,48,380,63,392,78011,13.197969543,8.3145923023,0.1927648911,-51,0.6168476515,4.8833772409,0.8096125426
26,159,2005,1067,737,-396,1916,49,330,-347,-87,77924,13.685189342,9.4526565556,-5.079039343,-70,0.6284669895,4.2325327861,-4.450572354
26,159,2006,1019,663,-300,1916,50,356,-250,70,77994,13.070973204,8.5044702985,-3.848176606,-36,0.6413627676,4.5665029054,-3.206813838
26,159,2007,1073,682,-642,1916,42,391,-600,-213,77781,13.776279891,8.7562189055,-8.242657679,-4,0.5392392874,5.0200609854,-7.703418392
26,159,2008,1066,680,-391,1916,42,386,-349,20,77801,13.70338471,8.7413711098,-5.026288388,-17,0.5399082156,4.9620136005,-4.486380173
26,161,2001,4110,1869,641,21412,2206,2241,2847,4751,329239,12.574056143,5.7179831948,1.9610632573,-337,6.7489946109,6.8560729479,8.7100578682
26,161,2002,4207,1783,242,21691,2073,2424,2315,4397,333636,12.693192533,5.3795964548,0.7301527437,-342,6.2545728833,7.3135960777,6.984725627
26,161,2003,4213,1879,-206,21292,1827,2334,1621,3457,337093,12.562450707,5.6028589788,-0.614257025,-498,5.4478038075,6.9595917278,4.8335467827
26,161,2004,4268,1877,-190,21449,1653,2391,1463,3632,340725,12.593351018,5.5383598547,-0.560622468,-222,4.8774154714,7.0549911628,4.3167930034
26,161,2005,4239,1842,-540,21726,1743,2397,1203,3300,344025,12.381161008,5.3800657174,-1.577217963,-300,5.0909090909,7.0010952903,3.5136911281
26,161,2006,4228,1860,-1778,21698,1735,2368,-43,2160,346185,12.251343794,5.3896640153,-5.152055172,-165,5.0274554121,6.8616797786,-0.124599759
26,161,2007,4245,1841,-2227,21637,1582,2404,-645,1784,347969,12.230715374,5.3042984698,-6.416443613,25,4.5580663657,6.9264169046,-1.858377248
26,161,2008,4253,1883,-4674,21547,1583,2370,-3091,-593,347376,12.232776535,5.4160165098,-13.44368623,128,4.5531354939,6.8167600256,-8.890550734
26,163,2001,30885,20440,-27463,32300,6416,10445,-21047,-647,2058087,15.00429579,9.9299920983,-13.34184799,9955,3.1169681655,5.0743036921,-10.22487983
26,163,2002,29857,20105,-29398,32379,6020,9752,-23378,-5691,2052396,14.527246555,9.7823053884,-14.30391514,7935,2.929096167,4.7449411663,-11.37481897
26,163,2003,29001,19786,-30230,32709,5279,9215,-24951,-7564,2044832,14.156400376,9.6582372277,-14.75631817,8172,2.5768641628,4.4981631484,-12.17945401
26,163,2004,28548,19116,-30675,32517,4785,9432,-25890,-9131,2035701,13.992289733,9.3693642473,-15.0348006,7327,2.3452818541,4.6229254855,-12.68951875
26,163,2005,28025,19241,-32878,31976,5044,8784,-27834,-11518,2024183,13.805813171,9.4785959402,-16.19652187,7532,2.4848000583,4.3272172308,-13.71172181
26,163,2006,27287,18348,-36278,31968,5089,8939,-31189,-14979,2009204,13.530563767,9.0980607613,-17.98885155,7271,2.5234374981,4.4325030055,-15.46541406
26,163,2007,27480,18117,-41633,31850,4605,9363,-37028,-27550,1981654,13.771474705,9.0792506273,-20.8641851,115,2.3077744184,4.6922240781,-18.55641068
26,163,2008,27389,18230,-45140,31935,4610,9159,-40530,-31725,1949929,13.93281027,9.2736182856,-22.9627608,-354,2.3451113712,4.6591919845,-20.61764943
26,165,2001,388,316,109,371,12,72,121,167,30692,12.676217391,10.323929627,3.5611023082,-26,0.3920479605,2.3522877632,3.9531502687
26,165,2002,386,296,-9,371,12,90,3,61,30753,12.564081699,9.6346325983,-0.29294491,-32,0.3905932134,2.9294491008,0.0976483034
26,165,2003,389,321,277,371,10,68,287,334,31087,12.580853816,10.381630013,8.9586028461,-21,0.3234152652,2.1992238034,9.2820181113
26,165,2004,387,301,79,371,10,86,89,153,31240,12.418374059,9.6587353795,2.5350169269,-22,0.3208882186,2.7596386799,2.8559051454
26,165,2005,444,303,212,371,10,141,222,336,31576,14.136525726,9.6472236373,6.7498726439,-27,0.3183902191,4.4893020886,7.068262863
26,165,2006,426,296,-26,371,10,130,-16,98,31674,13.470355731,9.3596837945,-0.822134387,-16,0.3162055336,4.1106719368,-0.505928854
26,165,2007,432,295,-66,371,8,137,-58,65,31739,13.62496649,9.304085913,-2.081592103,-14,0.2523141943,4.3208805765,-1.829277908
26,165,2008,432,299,-193,371,7,133,-186,-66,31673,13.625181354,9.430391724,-6.087175929,-13,0.2207784016,4.1947896297,-5.866397527
27,0,2001,67847,38004,7441,137629,13581,29843,21022,48552,4982339,13.684174646,7.6650901774,1.5007877068,-2313,2.7391745526,6.0190844691,4.2399622595
27,0,2002,66742,38075,-5144,139541,12682,28667,7538,34304,5016643,13.349759005,7.6157752859,-1.028904743,-1901,2.5366582318,5.7339837195,1.5077534893
27,0,2003,69063,37859,-9347,142202,10659,31204,1312,30065,5046708,13.725646656,7.5241338596,-1.857631717,-2451,2.1183798518,6.2015127963,0.2607481345
27,0,2004,71061,37816,-7504,142951,10083,33245,2579,31306,5078014,14.037126155,7.4700322636,-1.482312304,-4518,1.991758391,6.5670938916,0.5094460865
27,0,2005,70815,37711,-12513,141703,10445,33104,-2068,26876,5104890,13.908606032,7.4067279825,-2.457648624,-4160,2.0514776531,6.5018780497,-0.40617097
27,0,2006,72041,36741,-5269,143225,10562,35300,5293,38244,5143134,14.059490883,7.1703579149,-1.028295796,-2349,2.0612754225,6.8891329685,1.0329796261
27,0,2007,73141,37951,-5028,143092,9456,35190,4428,39226,5182360,14.16707036,7.3509315874,-0.973900135,-392,1.83158307,6.8161387726,0.8576829351
27,0,2008,73657,37959,-7136,143590,9403,35698,2267,38033,5220393,14.161059097,7.2978758604,-1.371944523,68,1.8077906877,6.8631832362,0.435846165
27,1,2001,153,197,42,174,2,-44,44,-16,15334,9.9726241689,12.840568374,2.7375831052,-16,0.1303611002,-2.867944205,2.8679442054
27,1,2002,127,176,265,174,1,-49,266,213,15547,8.2251222435,11.398594605,17.16265665,-4,0.0647647421,-3.173472362,17.227421392
27,1,2003,153,194,153,174,-1,-41,152,99,15646,9.8098932453,12.438688167,9.8098932453,-12,-0.064116949,-2.628794922,9.745776296
27,1,2004,162,154,167,174,0,8,167,156,15802,10.302721954,9.7939455609,10.620707199,-19,0,0.5087763928,10.620707199
27,1,2005,160,184,90,174,-1,-24,89,56,15858,10.10739103,11.623499684,5.6854074542,-9,-0.063171194,-1.516108654,5.6222362603
27,1,2006,146,164,69,174,0,-18,69,41,15899,9.1948231886,10.328431527,4.3454986302,-10,0,-1.133608338,4.3454986302
27,1,2007,164,206,12,174,0,-42,12,-39,15860,10.327781101,12.972700652,0.7556913001,-9,0,-2.64491955,0.7556913001
27,1,2008,165,185,-80,174,-1,-20,-81,-124,15736,10.444360046,11.710343081,-5.063932143,-23,-0.063299152,-1.265983036,-5.127231295
27,3,2001,4450,1455,1993,3067,454,2995,2447,5162,304897,14.71969727,4.8128448379,6.5924396989,-280,1.5017399013,9.9068524326,8.0941796002
27,3,2002,4281,1470,1040,3115,417,2811,1457,3979,308876,13.949782737,4.7900445279,3.3888750401,-289,1.3588085497,9.1597382094,4.7476835899
27,3,2003,4268,1433,370,3172,351,2835,721,3094,311970,13.748981229,4.6162816544,1.1919219903,-462,1.1307151854,9.1326995745,2.3226371757
27,3,2004,4461,1410,1834,3193,341,3051,2175,4971,316941,14.186427014,4.483941289,5.8323037759,-255,1.0844141699,9.7024857253,6.9167179458
27,3,2005,4344,1464,314,3229,350,2880,664,3272,320213,13.635635969,4.5954353265,0.9856329867,-272,1.0986354947,9.0402006422,2.0842684814
27,3,2006,4431,1391,-79,3200,357,3040,278,3154,323367,13.769849902,4.3226949253,-0.245501725,-164,1.1094191864,9.4471549768,0.8639174617
27,3,2007,4468,1523,-1168,3190,323,2945,-845,1953,325320,13.775518856,4.695639037,-3.601120417,-147,0.9958577866,9.0798798188,-2.605262631
27,3,2008,4459,1522,-1280,3190,324,2937,-956,1770,327090,13.669318373,4.6657776552,-3.923912877,-211,0.993240447,9.0035407183,-2.93067243
27,5,2001,369,357,210,483,10,12,220,207,30275,12.230084683,11.832358351,6.960210795,-25,0.3314386093,0.3977263311,7.2916494042
27,5,2002,360,322,329,483,9,38,338,359,30634,11.820913166,10.573150109,10.803001199,-17,0.2955228291,1.2477630564,11.098524028
27,5,2003,412,301,350,483,3,111,353,439,31073,13.353428298,9.7557813538,11.343931807,-25,0.0972337012,3.5976469444,11.441165508
27,5,2004,435,332,275,483,6,103,281,354,31427,13.92,10.624,8.8,-30,0.192,3.296,8.992
27,5,2005,434,328,22,483,4,106,26,100,31527,13.787845093,10.420306891,0.6989230232,-32,0.1270769133,3.3675382025,0.8259999365
27,5,2006,397,313,147,483,6,84,153,223,31750,12.548003224,9.8930100985,4.6462379696,-14,0.1896423661,2.6549931255,4.8358803357
27,5,2007,449,333,-22,483,3,116,-19,102,31852,14.11905286,10.471368825,-0.691802145,5,0.0943366561,3.6476840351,-0.597465489
27,5,2008,450,327,11,483,3,123,14,148,32000,14.095094907,10.242435632,0.3445467644,11,0.0939672994,3.8526592746,0.4385140638
27,7,2001,587,330,382,1997,25,257,407,627,40426,14.633842318,8.2268619508,9.5232159551,-37,0.6232471175,6.4069803677,10.146463073
27,7,2002,575,351,415,2163,24,224,439,629,41055,14.113719763,8.6155054553,10.186423829,-34,0.5890943901,5.4982143076,10.775518219
27,7,2003,632,325,301,2122,16,307,317,582,41637,15.285638272,7.8604943646,7.2800270885,-42,0.3869781841,7.4251439075,7.6670052726
27,7,2004,634,340,158,2164,17,294,175,440,42077,15.146809375,8.1228946174,3.7747569104,-29,0.4061447309,7.0239147574,4.1809016413
27,7,2005,667,334,283,2015,17,333,300,599,42676,15.739855816,7.8817269005,6.6782296792,-34,0.4011657404,7.8581289158,7.0793954196
27,7,2006,658,338,110,1945,17,320,127,425,43101,15.342108024,7.8809004745,2.5647900952,-22,0.3963766511,7.4612075498,2.9611667463
27,7,2007,716,356,-22,1846,10,360,-12,328,43429,16.549173697,8.2283601063,-0.508494164,-20,0.2311337109,8.3208135907,-0.277360453
27,7,2008,700,338,47,1833,9,362,56,406,43835,16.043270994,7.7466079941,1.0771910524,-12,0.2062706271,8.2966629996,1.2834616795
27,9,2001,563,314,737,769,34,249,771,1194,35690,16.043085516,8.9476533782,21.001339298,174,0.9688541874,7.0954321375,21.970193486
27,9,2002,564,318,638,769,33,246,671,1067,36757,15.570002899,8.7788314216,17.612875619,150,0.9110108079,6.7911714771,18.523886427
27,9,2003,597,314,472,769,20,283,492,926,37683,16.039763568,8.4363245567,12.681354111,151,0.5373455132,7.6034390113,13.218699624
27,9,2004,544,301,196,769,23,243,219,473,38156,14.346180725,7.9378683791,5.1688445259,11,0.6065480821,6.4083123459,5.775392608
27,9,2005,601,312,171,769,23,289,194,485,38641,15.651653059,8.1253173952,4.453298957,2,0.5989817311,7.5263356642,5.052280688
27,9,2006,623,321,3,769,26,302,29,330,38971,16.05421842,8.2719167139,0.0773076328,-1,0.6699994846,7.7823017059,0.7473071175
27,9,2007,597,312,223,769,18,285,241,505,39476,15.220467322,7.9544150828,5.6853671906,-21,0.4589085625,7.2660522391,6.1442757531
27,9,2008,606,313,110,769,18,293,128,402,39878,15.273332157,7.8887012627,2.7723870252,-19,0.4536633314,7.3846308945,3.2260503566
27,11,2001,61,99,-62,173,1,-38,-61,-103,5679,10.644795393,17.275979408,-10.81930024,-4,0.1745048425,-6.631184015,-10.64479539
27,11,2002,54,73,18,173,1,-19,19,-4,5675,9.5120662322,12.858904351,3.1706887441,-4,0.1761493747,-3.346838119,3.3468381187
27,11,2003,57,94,-47,173,1,-37,-46,-85,5590,10.119840213,16.688859299,-8.344429649,-2,0.1775410564,-6.569019086,-8.166888593
27,11,2004,39,90,-97,173,0,-51,-97,-156,5434,7.0754716981,16.328011611,-17.59796807,-8,0,-9.252539913,-17.59796807
27,11,2005,56,79,21,173,1,-23,22,-5,5429,10.310227377,14.54478505,3.8663352665,-4,0.1841112032,-4.234557673,4.0504464697
27,11,2006,58,84,-21,173,0,-26,-21,-50,5379,10.732790526,15.544041451,-3.886010363,-3,0,-4.811250925,-3.886010363
27,11,2007,57,76,13,173,1,-19,14,-9,5370,10.605637734,14.140850312,2.4188296586,-4,0.1860638199,-3.535212578,2.6048934785
27,11,2008,56,83,29,173,0,-27,29,-5,5365,10.433162552,15.463437354,5.4028877503,-7,0,-5.030274802,5.4028877503
27,13,2001,644,428,302,4226,88,216,390,553,56501,11.454081406,7.6123398163,5.3713238891,-53,1.5651539809,3.8417415895,6.93647787
27,13,2002,659,437,203,4255,86,222,289,461,56962,11.616121555,7.702951623,3.5782589919,-50,1.5159126764,3.913169932,5.0941716683
27,13,2003,690,449,431,4288,62,241,493,673,57635,12.042200058,7.8361562694,7.52201192,-61,1.0820527588,4.2060437882,8.6040646788
27,13,2004,693,422,-19,4280,67,271,48,279,57914,11.99491125,7.3042605302,-0.328864811,-40,1.1596811742,4.6906507196,0.8308163636
27,13,2005,699,458,242,4018,63,241,305,494,58408,12.01836282,7.8746926635,4.1608638091,-52,1.0832000825,4.143670157,5.2440638916
27,13,2006,760,410,533,3960,66,350,599,920,59328,12.910239859,6.9647346606,9.0541550588,-29,1.1211524088,5.9455051981,10.175307468
27,13,2007,787,450,185,4136,61,337,246,582,59910,13.200489777,7.5479293514,3.1030376222,-1,1.0231637565,5.6525604254,4.1262013788
27,13,2008,783,441,68,4161,61,342,129,491,60401,13.016266177,7.3310004904,1.1304037037,20,1.0140386166,5.6852656864,2.1444423203
27,15,2001,294,251,-3,1275,6,43,3,20,26896,10.935059139,9.3357137544,-0.111582236,-26,0.2231644722,1.5993453842,0.1115822361
27,15,2002,268,262,-46,1309,5,6,-41,-59,26837,9.9752479854,9.751921538,-1.71216943,-24,0.1861053729,0.2233264474,-1.526064057
27,15,2003,288,264,-210,1312,4,24,-206,-204,26633,10.772395736,9.8746960913,-7.854871891,-22,0.1496166074,0.8976996447,-7.705255283
27,15,2004,292,310,-89,1270,7,-18,-82,-123,26510,10.989217771,11.666635305,-3.349453362,-23,0.263440152,-0.677417534,-3.08601321
27,15,2005,278,285,-401,1011,5,-7,-396,-421,26089,10.570543166,10.836707922,-15.24743816,-18,0.1901176828,-0.266164756,-15.05732048
27,15,2006,307,274,-46,927,6,33,-40,-20,26069,11.77192377,10.506537827,-1.763871314,-13,0.2300701714,1.2653859427,-1.533801143
27,15,2007,326,272,-161,902,4,54,-157,-102,25967,12.52978707,10.454300869,-6.188023676,1,0.1537397187,2.0754862019,-6.034283957
27,15,2008,303,267,-150,878,3,36,-147,-105,25862,11.692295819,10.303112157,-5.788265257,6,0.1157653051,1.3891836617,-5.672499952
27,17,2001,387,327,243,1572,15,60,258,291,32014,12.143652823,10.260915951,7.6250843309,-27,0.470684218,1.8827368718,8.0957685489
27,17,2002,356,335,432,1558,12,21,444,443,32457,11.043725086,10.392269392,13.401374261,-22,0.3722603961,0.6514556933,13.773634657
27,17,2003,397,325,393,1599,1,72,394,448,32905,12.147731098,9.9446161378,12.025335822,-18,0.0305988189,2.2031149598,12.055934641
27,17,2004,410,325,394,1667,11,85,405,457,33362,12.374183228,9.8088037787,11.891288273,-33,0.3319902817,2.5653794498,12.223278555
27,17,2005,393,331,255,1663,7,62,262,291,33653,11.728717451,9.8783854361,7.6102365142,-33,0.2089084533,1.8503320152,7.8191449675
27,17,2006,435,327,-78,1597,9,108,-69,24,33677,12.921431754,9.7133521461,-2.316946383,-15,0.2673399673,3.2080796079,-2.049606416
27,17,2007,428,350,-146,1414,5,78,-141,-54,33623,12.719167905,10.401188707,-4.338781575,9,0.1485884101,2.3179791976,-4.190193165
27,17,2008,436,332,178,1414,5,104,183,310,33933,12.907809817,9.8288827047,5.269702173,23,0.1480253419,3.0789271123,5.417727515
27,19,2001,1193,288,1221,1097,151,905,1372,2232,73093,16.574739153,4.0012781861,16.96375231,-45,2.0978923823,12.573460967,19.061644692
27,19,2002,1171,271,1550,1109,142,900,1692,2560,75653,15.744961209,3.6437954634,20.840896562,-32,1.9092950399,12.101165746,22.750191602
27,19,2003,1176,313,1711,1120,117,863,1828,2690,78343,15.273123977,4.0650406504,22.221356399,-1,1.5195199875,11.208083327,23.740876386
27,19,2004,1224,325,1714,1081,112,899,1826,2620,80963,15.366652857,4.0801978582,21.518335781,-105,1.4060989542,11.286454999,22.924434736
27,19,2005,1287,338,1920,1047,117,949,2037,2919,83882,15.614668325,4.1008219843,23.294610088,-67,1.4195153023,11.513846341,24.714125391
27,19,2006,1280,354,1393,1044,119,926,1512,2389,86271,15.045282775,4.1609610174,16.373499145,-49,1.398741133,10.884321757,17.772240278
27,19,2007,1297,369,810,992,108,928,918,1825,88096,14.876668177,4.2324522415,9.2907488229,-21,1.2387665097,10.644215935,10.529515333
27,19,2008,1336,346,859,987,108,990,967,1947,90043,14.999522845,3.8846069642,9.644154284,-10,1.2125362779,11.11491588,10.856690562
27,21,2001,334,301,321,443,3,33,324,336,27613,12.169794134,10.967389324,11.696119512,-21,0.1093095281,1.2024048096,11.80542904
27,21,2002,328,297,262,433,2,31,264,274,27887,11.81981982,10.702702703,9.4414414414,-21,0.0720720721,1.1171171171,9.5135135135
27,21,2003,298,273,122,420,0,25,122,127,28014,10.661705515,9.767267133,4.3648593048,-20,0,0.8944383821,4.3648593048
27,21,2004,337,313,331,412,3,24,334,327,28341,11.959897081,11.108153669,11.746961228,-31,0.1064679265,0.8517434123,11.853429154
27,21,2005,395,302,257,412,1,93,258,331,28672,13.856488871,10.594075036,9.0154876958,-20,0.0350797187,3.2624138354,9.0505674144
27,21,2006,397,272,-2,412,2,125,0,108,28780,13.820232542,9.468773933,-0.069623338,-17,0.0696233377,4.3514586089,0
27,21,2007,365,274,-196,412,0,91,-196,-137,28643,12.712676105,9.5432143914,-6.826532922,-32,0,3.1694617139,-6.826532922
27,21,2008,384,282,43,412,-1,102,42,89,28732,13.385620915,9.8300653595,1.4989106754,-55,-0.034858388,3.5555555556,1.4640522876
27,23,2001,137,140,-109,297,2,-3,-107,-120,12946,10.533599877,10.764262648,-8.380747347,-10,0.1537751807,-0.230662771,-8.226972167
27,23,2002,105,160,-27,297,2,-55,-25,-92,12854,8.1395348837,12.403100775,-2.093023256,-12,0.1550387597,-4.263565891,-1.937984496
27,23,2003,149,165,-138,297,0,-16,-138,-165,12689,11.666601417,12.919390831,-10.8053087,-11,0,-1.252789414,-10.8053087
27,23,2004,165,175,-74,297,1,-10,-73,-92,12597,13.050699992,13.841651507,-5.853041209,-9,0.0790951515,-0.790951515,-5.773946057
27,23,2005,139,140,40,297,1,-1,41,27,12624,11.022560565,11.101859561,3.1719598747,-13,0.0792989969,-0.079298997,3.2512588716
27,23,2006,153,142,-71,297,1,11,-70,-64,12560,12.150571792,11.277001271,-5.638500635,-5,0.0794155019,0.873570521,-5.559085133
27,23,2007,176,143,-155,297,1,33,-154,-114,12446,14.076621611,11.437255059,-12.39702471,7,0.0799808046,2.639366552,-12.31704391
27,23,2008,160,142,-59,297,0,18,-59,-32,12414,12.872083669,11.423974256,-4.746580853,9,0,1.4481094127,-4.746580853
27,25,2001,644,303,1225,821,6,341,1231,1555,43094,15.218649936,7.1603275318,28.948518899,-17,0.141788664,8.0583224038,29.090307563
27,25,2002,735,311,1218,1065,4,424,1222,1634,44728,16.738402678,7.0825077999,27.737924438,-12,0.0910933479,9.6558948783,27.829017786
27,25,2003,707,334,1222,1454,1,373,1223,1612,46340,15.52685905,7.3351781087,26.837088769,16,0.0219616111,8.1916809417,26.85905038
27,25,2004,704,339,1088,1530,4,365,1092,1394,47734,14.966940919,7.207092289,23.130726875,-63,0.085039437,7.7598486298,23.215766312
27,25,2005,705,296,511,1536,2,409,513,882,48616,14.634146341,6.144265698,10.607161391,-40,0.0415153088,8.4898806435,10.6486767
27,25,2006,703,305,352,1503,3,398,355,728,49344,14.35279706,6.2270314414,7.1866067783,-25,0.0612494896,8.1257656186,7.2478562679
27,25,2007,727,345,181,1501,3,382,184,546,49890,14.652236129,6.9532619868,3.6479432453,-20,0.0604631477,7.6989741419,3.708406393
27,25,2008,744,338,-33,1501,2,406,-31,367,50257,14.858158507,6.7500773862,-0.659031224,-8,0.0399412863,8.1080811208,-0.619089938
27,27,2001,461,382,11,4071,39,79,50,79,51370,8.9810151859,7.4419691996,0.2142975424,-50,0.7597821958,1.5390459863,0.9740797382
27,27,2002,504,385,13,4151,36,119,49,115,51485,9.8002041709,7.486267075,0.2527830441,-53,0.7000145836,2.3139370959,0.9527976277
27,27,2003,619,401,61,4115,24,218,85,230,51715,11.996124031,7.7713178295,1.1821705426,-73,0.4651162791,4.2248062016,1.6472868217
27,27,2004,708,383,600,4203,34,325,634,906,52621,13.571538108,7.3416653887,11.501303481,-53,0.6517405306,6.2298727189,12.153044012
27,27,2005,661,356,415,4215,29,305,444,697,53318,12.478879355,6.7208487903,7.8346973258,-52,0.5474848734,5.7580305648,8.3821821992
27,27,2006,740,406,408,4122,32,334,440,748,54066,13.782313939,7.5616479178,7.5988974149,-26,0.5959919541,6.220666021,8.194889369
27,27,2007,767,431,157,3997,30,336,187,529,54595,14.117300595,7.9329290178,2.8897212431,6,0.5521760337,6.1843715777,3.4418972769
27,27,2008,786,406,732,4039,30,380,762,1172,55767,14.244033272,7.3576049727,13.265435567,30,0.5436653921,6.8864282996,13.809100959
27,29,2001,108,109,-38,180,0,-1,-38,-46,8330,12.929486412,13.049203879,-4.549263738,-7,0,-0.119717467,-4.549263738
27,29,2002,99,108,34,180,-1,-9,33,17,8347,11.872638964,12.951969779,4.0774719674,-7,-0.119925646,-1.079330815,3.9575463213
27,29,2003,119,105,-77,180,-1,14,-78,-70,8277,14.316650626,12.632338787,-9.263715111,-6,-0.120307988,1.6843118383,-9.384023099
27,29,2004,119,101,-12,180,0,18,-12,1,8278,14.376321353,12.201751737,-1.449713078,-5,0,2.1745696164,-1.449713078
27,29,2005,122,98,-55,180,-1,24,-56,-39,8239,14.772658473,11.866561724,-6.659805049,-7,-0.121087365,2.9060967488,-6.780892414
27,29,2006,109,88,-70,180,0,21,-70,-54,8185,13.273258646,10.716025329,-8.524111057,-5,0,2.5572333171,-8.524111057
27,29,2007,134,91,-2,180,0,43,-2,43,8228,16.328520076,11.088771096,-0.243709255,2,0,5.2397489795,-0.243709255
27,29,2008,124,97,-10,180,-1,27,-11,21,8249,15.051283607,11.773987983,-1.213813194,5,-0.121381319,3.2772956242,-1.335194514
27,31,2001,40,64,26,57,7,-24,33,4,5194,7.7041602465,12.326656394,5.0077041602,-5,1.3482280431,-4.622496148,6.3559322034
27,31,2002,36,42,40,57,7,-6,47,38,5232,6.9058123921,8.0567811241,7.6731248801,-3,1.342796854,-1.150968732,9.0159217341
27,31,2003,38,42,37,57,7,-4,44,34,5266,7.2394741856,8.0015240998,7.048961707,-6,1.33358735,-0.762049914,8.382549057
27,31,2004,46,40,33,57,6,6,39,41,5307,8.70140925,7.5664428261,6.2423153315,-4,1.1349664239,1.1349664239,7.3772817554
27,31,2005,44,46,4,57,7,-2,11,6,5313,8.286252354,8.6629001883,0.7532956685,-3,1.31826742,-0.376647834,2.0715630885
27,31,2006,44,34,34,57,6,10,40,46,5359,8.2458770615,6.371814093,6.371814093,-4,1.1244377811,1.8740629685,7.4962518741
27,31,2007,49,37,15,57,4,12,19,26,5385,9.121370067,6.8875651526,2.792256143,-5,0.7446016381,2.2338049144,3.5368577811
27,31,2008,51,32,39,57,3,19,42,52,5437,9.4252448716,5.9138791351,7.2075401959,-9,0.5544261689,3.5113657365,7.7619663648
27,33,2001,148,159,-61,406,2,-11,-59,-80,12055,12.236461348,13.145928069,-5.043406366,-10,0.1653575858,-0.909466722,-4.87804878
27,33,2002,138,143,-83,406,2,-5,-81,-94,11961,11.492338441,11.908727515,-6.912058628,-8,0.1665556296,-0.416389074,-6.745502998
27,33,2003,140,157,-38,406,1,-17,-37,-70,11891,11.739057521,13.164514506,-3.186315613,-16,0.0838504109,-1.425456985,-3.102465202
27,33,2004,155,152,2,406,2,3,4,-1,11890,13.035616669,12.783314411,0.1682015054,-8,0.1682015054,0.2523022581,0.3364030108
27,33,2005,132,150,-216,406,2,-18,-214,-239,11651,11.21447687,12.743723716,-18.35096215,-7,0.1699163162,-1.529246846,-18.18104583
27,33,2006,152,147,-208,406,2,5,-206,-207,11444,13.163022299,12.730028145,-18.01255683,-6,0.1731976618,0.4329941546,-17.83935917
27,33,2007,129,158,-78,406,2,-29,-76,-111,11333,11.327216051,13.873644466,-6.849014357,-6,0.1756157527,-2.546428415,-6.673398604
27,33,2008,138,141,-37,406,1,-3,-36,-50,11283,12.203749558,12.469048461,-3.272019809,-11,0.0884329678,-0.265298903,-3.183586841
27,35,2001,680,525,692,1068,17,155,709,824,56136,12.203000502,9.4214342115,12.41834757,-40,0.3050750126,2.781566291,12.723422583
27,35,2002,712,533,890,1072,12,179,902,1052,57188,12.565740708,9.4066570188,15.707175885,-29,0.2117821468,3.1590836892,15.918958032
27,35,2003,753,518,763,1045,0,235,763,972,58160,13.056143149,8.9815168013,13.229531505,-26,0,4.0746263481,13.229531505
27,35,2004,751,534,613,1041,15,217,628,784,58944,12.826205766,9.1200983741,10.469326411,-61,0.2561825386,3.7061073917,10.725508949
27,35,2005,769,530,579,1041,9,239,588,771,59715,12.961511558,8.9331614121,9.7590574672,-56,0.1516951938,4.0283501462,9.910752661
27,35,2006,780,554,757,1041,13,226,770,965,60680,12.957348727,9.2030399934,12.57527306,-31,0.2159558121,3.7543087338,12.791228872
27,35,2007,813,549,536,1041,10,264,546,824,61504,13.307798075,8.9864466706,8.7736528514,14,0.1636875532,4.3213514044,8.9373404046
27,35,2008,842,569,345,1041,10,273,355,668,62172,13.616223034,9.2014618843,5.5790937611,40,0.1617128626,4.4147611501,5.7408066238
27,37,2001,5286,1646,1598,2321,758,3640,2356,5659,363509,14.655670755,4.5636084113,4.4305262706,-337,2.1015888067,10.092062343,6.5321150772
27,37,2002,5142,1733,805,2337,678,3409,1483,4519,368028,14.058072251,4.737969508,2.2008456168,-373,1.8536314636,9.3201027426,4.0544770804
27,37,2003,5416,1769,119,2338,548,3647,667,3731,371759,14.642052375,4.7824576534,0.3217142231,-583,1.481507515,9.8595947212,1.8032217381
27,37,2004,5498,1779,729,2325,579,3719,1308,4778,376537,14.694719737,4.7548029122,1.9484268257,-249,1.5475159563,9.9399168244,3.495942782
27,37,2005,5464,1908,728,2321,565,3556,1293,4490,381027,14.425183879,5.0371981773,1.9219498287,-359,1.49162315,9.3879857015,3.4135729787
27,37,2006,5578,1881,-60,2335,598,3697,538,4049,385076,14.562010591,4.9105668559,-0.156636901,-186,1.561147783,9.6514437354,1.4045108817
27,37,2007,5591,1879,108,2328,542,3712,650,4342,389418,14.437813592,4.8522002753,0.2788917668,-20,1.3996234961,9.5856133166,1.6785152629
27,37,2008,5608,1869,-973,2335,545,3739,-428,3337,392755,14.339538695,4.7789939054,-2.487940647,26,1.3935536,9.56054479,-1.094387047
27,39,2001,242,121,118,192,21,121,139,244,18098,13.462394304,6.7311971518,6.5643079662,-16,1.1682242991,6.7311971518,7.7325322652
27,39,2002,297,133,221,192,20,164,241,392,18490,16.234831092,7.2701432164,12.08046354,-13,1.093254619,8.9646878758,13.173718159
27,39,2003,281,116,80,192,14,165,94,236,18726,15.101031814,6.233877902,4.2992261393,-23,0.7523645744,8.8671539123,5.0515907137
27,39,2004,292,122,176,192,15,170,191,342,19068,15.452188178,6.4560512251,9.3136476689,-19,0.79377679,8.996136953,10.107424459
27,39,2005,286,114,30,192,15,172,45,200,19268,14.920701169,5.9474123539,1.5651085142,-17,0.7825542571,8.9732888147,2.3476627713
27,39,2006,293,128,-2,192,15,165,13,168,19436,15.140553948,6.6143034312,-0.103348491,-10,0.7751136833,8.5262505167,0.6717651922
27,39,2007,283,122,-128,192,7,161,-121,40,19476,14.545641447,6.2705592105,-6.578947368,0,0.3597861842,8.2750822368,-6.219161184
27,39,2008,301,124,89,192,6,177,95,275,19751,15.346572514,6.3221760522,4.5376908762,3,0.3059117445,9.0243964616,4.8436026206
27,41,2001,359,330,322,676,3,29,325,326,33244,10.852150781,9.9755146459,9.7336839878,-28,0.0906864968,0.8766361355,9.8243704846
27,41,2002,359,345,415,676,2,14,417,407,33651,10.733238658,10.314672248,12.407504298,-24,0.0597952014,0.41856641,12.467299499
27,41,2003,362,344,508,676,1,18,509,509,34160,10.676733863,10.145846544,14.982819896,-18,0.02949374,0.5308873192,15.012313636
27,41,2004,381,320,411,676,4,61,415,442,34602,11.081702103,9.3074663331,11.954277072,-34,0.1163433292,1.7742357698,12.070620401
27,41,2005,440,324,469,676,2,116,471,554,35156,12.615040569,9.2892571461,13.446486424,-33,0.0573410935,3.3257834227,13.503827518
27,41,2006,429,333,266,676,3,96,269,346,35502,12.14299867,9.425684282,7.5292252823,-19,0.0849160746,2.7173143876,7.614141357
27,41,2007,439,340,402,676,3,99,405,503,36005,12.278518187,9.5095585048,11.243654467,-1,0.0839078692,2.7689596823,11.327562337
27,41,2008,472,373,154,676,2,99,156,253,36258,13.063393438,10.323402018,4.2622088759,-2,0.055353362,2.7399914202,4.3175622379
27,43,2001,144,214,-164,450,8,-70,-156,-238,15908,8.9848380857,13.352467711,-10.23273226,-12,0.4991576714,-4.367629625,-9.733574593
27,43,2002,149,218,-74,450,8,-69,-66,-149,15759,9.4104272587,13.768276123,-4.673635014,-14,0.5052578394,-4.357848865,-4.168377175
27,43,2003,177,233,-134,450,6,-56,-128,-197,15562,11.302321126,14.878196737,-8.556559497,-13,0.3831295297,-3.575875611,-8.173429967
27,43,2004,175,196,-63,450,7,-21,-56,-91,15471,11.278316631,12.631714626,-4.060193987,-14,0.4511326652,-1.353397996,-3.609061322
27,43,2005,170,228,-257,450,7,-58,-250,-318,15153,11.102403344,14.890282132,-16.78422153,-10,0.4571577847,-3.787878788,-16.32706374
27,43,2006,159,169,-140,450,7,-10,-133,-153,15000,10.546214307,11.209498226,-9.285974862,-10,0.4642987431,-0.663283919,-8.821676118
27,43,2007,168,225,-126,450,2,-57,-124,-182,14818,11.268361392,15.091555436,-8.451271044,-1,0.1341471594,-3.823194044,-8.317123885
27,43,2008,179,203,-165,450,1,-24,-164,-194,14624,12.159500034,13.789824061,-11.20847768,-6,0.0679301678,-1.630324027,-11.14054752
27,45,2001,238,253,68,520,2,-15,70,35,21192,11.239934827,11.948334081,3.2114099506,-20,0.0944532338,-0.708399254,3.3058631845
27,45,2002,248,242,49,520,2,6,51,39,21231,11.691770973,11.408905547,2.310067652,-18,0.0942884756,0.2828654268,2.4043561276
27,45,2003,274,259,7,520,2,15,9,-7,21224,12.907784713,12.201154163,0.3297609233,-31,0.0942174067,0.70663055,0.42397833
27,45,2004,275,236,-88,520,1,39,-87,-66,21158,12.977207305,11.13680336,-4.152706338,-18,0.0471898447,1.8404039451,-4.105516493
27,45,2005,269,256,-62,520,2,13,-60,-69,21089,12.734632045,12.11920373,-2.935119653,-22,0.0946812791,0.6154283144,-2.840438374
27,45,2006,278,245,-171,520,1,33,-170,-146,20943,13.228016749,11.657784545,-8.136657785,-9,0.0475827941,1.570232204,-8.08907499
27,45,2007,298,245,-14,520,1,53,-13,46,20989,14.213488505,11.685586187,-0.667747782,6,0.0476962702,2.527902318,-0.620051512
27,45,2008,296,241,-206,520,0,55,-206,-139,20850,14.14947776,11.520351825,-9.847271684,12,0,2.6291259351,-9.847271684
27,47,2001,390,378,-137,590,47,12,-90,-108,32436,12.003693444,11.63434903,-4.216682056,-30,1.4465989535,0.3693444137,-2.770083102
27,47,2002,350,381,-462,590,47,-31,-415,-461,31975,10.867708932,11.830277437,-14.34537579,-15,1.4593780565,-0.962568505,-12.88599773
27,47,2003,359,387,-44,590,31,-28,-13,-81,31894,11.241760478,12.118555168,-1.377820226,-40,0.9707369773,-0.876794689,-0.407083249
27,47,2004,404,344,-177,590,29,60,-148,-117,31777,12.690235743,10.805547266,-5.559831006,-29,0.9109327637,1.8846884767,-4.648898243
27,47,2005,374,378,-286,590,31,-4,-255,-287,31490,11.822909258,11.949357485,-9.041048256,-28,0.979973762,-0.126448227,-8.061074494
27,47,2006,360,357,-192,590,31,3,-161,-172,31318,11.463507833,11.367978601,-6.113870844,-14,0.9871353968,0.0955292319,-5.126735448
27,47,2007,396,365,-212,590,26,31,-186,-156,31162,12.676056338,11.683738796,-6.786171575,-1,0.8322663252,0.9923175416,-5.95390525
27,47,2008,396,360,-298,590,25,36,-273,-235,30927,12.755882685,11.596256986,-9.599123838,2,0.805295624,1.1596256986,-8.793828214
27,49,2001,507,459,372,1129,23,48,395,404,44560,11.429730826,10.347626133,8.3863113756,-39,0.518508499,1.0821046936,8.9048198747
27,49,2002,533,439,265,1131,21,94,286,339,44899,11.916073285,9.8145519176,5.924501727,-41,0.4694888161,2.1015213673,6.3939905432
27,49,2003,527,433,12,1084,13,94,25,56,44955,11.730140005,9.637856968,0.2670999622,-63,0.2893582923,2.0922830369,0.5564582545
27,49,2004,592,422,148,1131,15,170,163,300,45255,13.124930717,9.3559472342,3.2812326793,-33,0.3325573661,3.768983483,3.6137900454
27,49,2005,565,454,-84,1153,14,111,-70,2,45257,12.484532438,10.031818985,-1.856107477,-39,0.3093512462,2.4527134524,-1.546756231
27,49,2006,581,386,-20,1128,15,195,-5,169,45426,12.81386809,8.5131722594,-0.441097008,-21,0.3308227562,4.3006958305,-0.110274252
27,49,2007,597,430,123,1112,12,167,135,307,45733,13.097993616,9.4340657532,2.6985815992,5,0.2632762536,3.6639278623,2.9618578528
27,49,2008,617,435,-47,1112,11,182,-36,164,45897,13.467205064,9.4947069737,-1.025864891,18,0.2400960384,3.9724980901,-0.785768853
27,51,2001,63,84,2,199,1,-21,3,-24,6247,10.065505672,13.420674229,0.3195398626,-6,0.1597699313,-3.355168557,0.4793097939
27,51,2002,68,76,27,199,0,-8,27,13,6260,10.87391061,12.153194211,4.317582154,-6,0,-1.279283601,4.317582154
27,51,2003,58,94,-39,199,-1,-36,-40,-85,6175,9.3285082429,15.118616807,-6.272617612,-9,-0.160836349,-5.790108565,-6.433453961
27,51,2004,72,92,-58,199,0,-20,-58,-84,6091,11.739768466,15.000815262,-9.457035708,-6,0,-3.261046796,-9.457035708
27,51,2005,61,88,1,199,-1,-27,0,-33,6058,10.041978764,14.486789036,0.1646226027,-6,-0.164622603,-4.444810272,0
27,51,2006,74,79,-30,199,0,-5,-30,-38,6020,12.253684385,13.081636032,-4.967709886,-3,0,-0.827951648,-4.967709886
27,51,2007,75,88,1,199,0,-13,1,-10,6010,12.46882793,14.630091438,0.1662510391,2,0,-2.161263508,0.1662510391
27,51,2008,70,84,5,199,-1,-14,4,-5,6005,11.65210154,13.982521848,0.8322929671,5,-0.166458593,-2.330420308,0.6658343737
27,53,2001,16709,8046,-7953,27812,6884,8663,-1069,6630,1124857,14.898238318,7.1740514399,-7.091129891,-964,6.1379778912,7.7241868784,-0.953152
27,53,2002,16072,8008,-15721,28210,6472,8064,-9249,-1831,1123026,14.299676629,7.1249259859,-13.9873828,-646,5.7583068158,7.1747506432,-8.229075979
27,53,2003,16272,7861,-14371,29277,5693,8411,-8678,-969,1122057,14.495677888,7.0028591371,-12.8021993,-702,5.0715274224,7.492818751,-7.730671873
27,53,2004,16713,7654,-12739,29454,5149,9059,-7590,378,1122435,14.892456734,6.8202515313,-11.35134364,-1091,4.5881206081,8.0722052028,-6.763223037
27,53,2005,16617,7765,-14403,29481,5435,8852,-8968,-1066,1121369,14.81145412,6.9212818945,-12.83801972,-950,4.8444516544,7.8901722254,-7.993568066
27,53,2006,16467,7496,-10412,29477,5436,8971,-4976,3480,1124849,14.66197849,6.6743299181,-9.270694118,-515,4.8401357304,7.987648572,-4.430558387
27,53,2007,16509,7568,-6702,29331,4932,8941,-1770,7106,1131955,14.630424264,6.7068296582,-5.93937267,-65,4.370782753,7.9235946055,-1.568589917
27,53,2008,16307,7616,-4619,29464,4935,8691,316,9033,1140988,14.348798012,6.7014438989,-4.064334213,26,4.3423878205,7.6473541131,0.2780536072
27,55,2001,206,202,162,375,9,4,171,157,19894,10.395902198,10.194040019,8.1754182332,-18,0.4541899018,0.2018621786,8.629608135
27,55,2002,202,157,-94,375,8,45,-86,-58,19836,10.168638309,7.9033475963,-4.731940599,-17,0.4027183489,2.2652907123,-4.32922225
27,55,2003,197,182,-56,375,3,15,-53,-64,19772,9.9474853565,9.1900626136,-2.827711573,-26,0.1514845486,0.7574227429,-2.676227025
27,55,2004,226,193,-136,375,2,33,-134,-117,19655,11.464225023,9.7902452634,-6.898825678,-16,0.1014533188,1.6739797601,-6.797372359
27,55,2005,235,198,-22,375,3,37,-19,1,19656,11.955941085,10.073516319,-1.119279591,-17,0.1526290351,1.8824247666,-0.966650556
27,55,2006,203,181,-104,375,3,22,-101,-87,19569,10.350541746,9.2288081581,-5.302740599,-8,0.1529636711,1.1217335883,-5.149776928
27,55,2007,248,177,-137,375,2,71,-135,-70,19499,12.69581243,9.0611241937,-7.013412512,-6,0.1023855841,3.6346882359,-6.911026927
27,55,2008,218,175,-289,375,1,43,-288,-254,19245,11.253355358,9.0336568243,-14.91843898,-9,0.0516208961,2.219698534,-14.86681809
27,57,2001,171,166,-39,169,2,5,-37,-53,18367,9.2967624433,9.0249272841,-2.120314241,-21,0.1087340637,0.2718351592,-2.011580178
27,57,2002,189,187,107,169,1,2,108,95,18462,10.263650927,10.155040865,5.8106383556,-15,0.0543050314,0.1086100627,5.864943387
27,57,2003,199,167,12,169,-1,32,11,21,18483,10.772770334,9.0404655569,0.6496142915,-22,-0.054134524,1.7323047774,0.5954797672
27,57,2004,215,164,168,169,0,51,168,199,18682,11.570025562,8.8255078703,9.0407641598,-20,0,2.7445176914,9.0407641598
27,57,2005,230,179,-44,169,-1,51,-45,-7,18675,12.313622614,9.5832106433,-2.355649544,-13,-0.05353749,2.730411971,-2.409187033
27,57,2006,209,161,-91,169,0,48,-91,-53,18622,11.207335711,8.6334021503,-4.879749041,-10,0,2.5739335603,-4.879749041
27,57,2007,249,178,92,169,0,71,92,144,18766,13.319781748,9.5217716915,4.9213651439,-19,0,3.7980100567,4.9213651439
27,57,2008,242,189,26,169,-1,53,25,44,18810,12.880562061,10.059612519,1.3838620396,-34,-0.053225463,2.8209495423,1.3306365765
27,59,2001,378,204,939,471,12,174,951,1110,32624,11.7870841,6.3612834825,29.280613677,-15,0.374193146,5.4258006174,29.654806823
27,59,2002,418,250,955,470,11,168,966,1130,33754,12.594534334,7.5326162283,28.774593992,-4,0.331435114,5.0619181054,29.106029106
27,59,2003,476,244,1202,470,7,232,1209,1478,35232,13.799901429,7.073899052,34.847650248,37,0.2029397269,6.7260023773,35.050589975
27,59,2004,461,273,855,470,10,188,865,1005,36237,12.900698205,7.6396759434,23.926457625,-48,0.2798416096,5.2610222614,24.206299235
27,59,2005,474,261,776,470,8,213,784,968,37205,12.908145203,7.1076495738,21.132322105,-29,0.2178589908,5.8004956292,21.350181095
27,59,2006,486,251,656,475,9,235,665,879,38084,12.910252494,6.6676406912,17.426184436,-21,0.2390787499,6.2426118025,17.665263186
27,59,2007,532,251,443,476,5,281,448,728,38812,13.836870578,6.5282979609,11.522055764,-1,0.1300457761,7.3085726176,11.65210154
27,59,2008,530,258,19,476,4,272,23,293,39105,13.604219875,6.6224315618,0.4876984483,-2,0.1026733575,6.9817883132,0.5903718059
27,61,2001,455,481,-130,710,22,-26,-108,-174,43836,10.359037406,10.950982401,-2.959724973,-40,0.5008765339,-0.591944995,-2.458848439
27,61,2002,455,483,51,710,19,-28,70,2,43838,10.379359901,11.018089742,1.1634007802,-40,0.4334238201,-0.63872984,1.5968246002
27,61,2003,463,458,254,710,15,5,269,232,44070,10.533739819,10.419984529,5.7787687127,-42,0.3412658689,0.1137552896,6.1200345816
27,61,2004,502,510,-39,710,16,-8,-23,-62,44008,11.398987261,11.580644429,-0.885578692,-31,0.363314335,-0.181657168,-0.522264357
27,61,2005,486,448,13,710,16,38,29,27,44035,11.040059971,10.176845405,0.2953102461,-40,0.3634587645,0.8632145656,0.6587690106
27,61,2006,458,488,105,710,16,-30,121,69,44104,10.392675206,11.073418124,2.382600211,-22,0.3630628893,-0.680742917,2.7456631003
27,61,2007,548,465,254,710,13,83,267,357,44461,12.375091741,10.500762152,5.7359001863,7,0.2935696946,1.8743295884,6.0294698809
27,61,2008,540,481,-46,710,12,59,-34,51,44512,12.138513931,10.812268891,-1.034021557,26,0.269744754,1.3262450406,-0.764276803
27,63,2001,115,119,-153,313,3,-4,-150,-162,11072,10.311127051,10.669774948,-13.71828208,-8,0.2689859231,-0.358647897,-13.44929615
27,63,2002,111,146,99,313,3,-35,102,59,11131,9.9986488312,13.15137594,8.9177138225,-8,0.2702337522,-3.152727109,9.1879475747
27,63,2003,106,127,-70,313,-1,-21,-71,-103,11028,9.5672187373,11.462611129,-6.317974638,-11,-0.090256781,-1.895392391,-6.408231418
27,63,2004,102,132,-12,313,0,-30,-12,-49,10979,9.269777798,11.996183033,-1.090562094,-7,0,-2.726405235,-1.090562094
27,63,2005,113,130,-31,313,0,-17,-31,-57,10922,10.319163509,11.871604036,-2.830920963,-9,0,-1.552440528,-2.830920963
27,63,2006,116,94,-50,313,0,22,-50,-32,10890,10.636346965,8.6191087475,-4.584632312,-4,0,2.0172382175,-4.584632312
27,63,2007,105,112,-29,313,0,-7,-29,-34,10856,9.6569484043,10.300744965,-2.667157178,2,0,-0.64379656,-2.667157178
27,63,2008,111,131,-103,313,-1,-20,-104,-122,10734,10.282538212,12.1352478,-9.541454377,2,-0.092635479,-1.852709588,-9.634089856
27,65,2001,191,123,124,122,2,68,126,182,15227,12.618921776,8.1263213531,8.1923890063,-12,0.1321353066,4.4926004228,8.3245243129
27,65,2002,179,135,102,122,2,44,104,136,15363,11.703170971,8.8264138607,6.6688460281,-12,0.1307616868,2.8767571102,6.7996077149
27,65,2003,171,130,322,122,1,41,323,369,15732,10.998552822,8.3614729056,20.710725197,5,0.0643190224,2.6370799164,20.775044219
27,65,2004,182,105,91,122,0,77,91,155,15887,11.51206553,6.6415762674,5.7560327651,-13,0,4.8704892628,5.7560327651
27,65,2005,186,138,89,122,1,48,90,127,16014,11.661076455,8.6517664023,5.5797623899,-11,0.0626939594,3.009310053,5.6424563493
27,65,2006,167,116,-17,122,0,51,-17,25,16039,10.420241475,7.2380120426,-1.060743144,-9,0,3.1822294325,-1.060743144
27,65,2007,206,122,-27,122,1,84,-26,43,16082,12.826499798,7.5962765792,-1.681143177,-15,0.0622645621,5.2302232185,-1.618878615
27,65,2008,184,131,-22,122,0,53,-22,9,16091,11.438162434,8.1434743418,-1.367606378,-22,0,3.2946880925,-1.367606378
27,67,2001,523,387,-142,857,80,136,-62,38,41181,12.705893786,9.4018755163,-3.449783781,-36,1.9435401584,3.3040182693,-1.506243623
27,67,2002,537,339,-539,862,76,198,-463,-288,40893,13.085751882,8.2608377805,-13.13448839,-23,1.851987231,4.8249141019,-11.28250116
27,67,2003,581,381,-35,861,47,200,12,150,41043,14.18180043,9.2999414177,-0.854325327,-62,1.1472368678,4.8818590119,0.2929115407
27,67,2004,572,381,-235,864,45,191,-190,-30,41013,13.941698352,9.2863410354,-5.727795652,-31,1.0968119333,4.655357317,-4.630983718
27,67,2005,591,382,-347,848,46,209,-301,-127,40886,14.432410652,9.3285632303,-8.47385194,-35,1.1233348393,5.1038474218,-7.3505171
27,67,2006,581,347,-411,826,49,234,-362,-147,40739,14.235834609,8.5022970904,-10.0704441,-19,1.2006125574,5.7335375191,-8.869831547
27,67,2007,621,359,-396,799,34,262,-362,-109,40630,15.263798252,8.8239993118,-9.733436567,-9,0.8356990992,6.4397989406,-8.897737468
27,67,2008,618,351,-239,799,34,267,-205,49,40679,15.201269232,8.6337305833,-5.878808004,-13,0.836315783,6.5675386489,-5.042492221
27,69,2001,53,79,-68,147,1,-26,-67,-96,5159,10.178605723,15.171884002,-13.05934319,-3,0.1920491646,-4.993278279,-12.86729403
27,69,2002,45,68,-116,147,1,-23,-115,-139,5020,8.8417329797,13.360840947,-22.79202279,-1,0.1964829551,-4.519107967,-22.59553984
27,69,2003,37,77,-85,147,1,-40,-84,-126,4894,7.4641920516,15.533588864,-17.14746823,-2,0.2017349203,-8.069396813,-16.94573331
27,69,2004,41,68,-62,147,0,-27,-62,-95,4799,8.4597131951,14.030743836,-12.79273703,-6,0,-5.571030641,-12.79273703
27,69,2005,47,84,-36,147,1,-37,-35,-77,4722,9.8729125092,17.645205336,-7.562230858,-5,0.2100619683,-7.772292826,-7.35216889
27,69,2006,32,57,-104,147,0,-25,-104,-130,4592,6.8713764226,12.239639253,-22.33197337,-1,0,-5.36826283,-22.33197337
27,69,2007,47,68,-80,147,1,-21,-79,-98,4494,10.345586617,14.968082765,-17.60950913,2,0.2201188642,-4.622496148,-17.38939027
27,69,2008,39,65,-5,147,0,-26,-5,-32,4462,8.7092451987,14.515408665,-1.116569897,-1,0,-5.806163466,-1.116569897
27,71,2001,142,152,-190,288,13,-10,-177,-196,14100,10.001408649,10.705733202,-13.3821665,-9,0.9156219186,-0.704324553,-12.46654458
27,71,2002,127,147,-135,288,12,-20,-123,-153,13947,9.0562270475,10.482404535,-9.626698043,-10,0.8557064927,-1.426177488,-8.77099155
27,71,2003,130,175,-21,288,6,-45,-15,-80,13867,9.3478104552,12.583590997,-1.51003092,-20,0.4314374056,-3.235780542,-1.078593514
27,71,2004,126,143,-59,288,9,-17,-50,-78,13789,9.1119467747,10.341336419,-4.266705236,-11,0.650853341,-1.229389644,-3.615851895
27,71,2005,119,159,-60,288,7,-40,-53,-104,13685,8.6627356774,11.574579603,-4.367765888,-11,0.5095726869,-2.911843925,-3.858193201
27,71,2006,111,147,-151,288,8,-36,-143,-186,13499,8.1665685697,10.815185403,-11.10947616,-7,0.5885815185,-2.648616833,-10.52089464
27,71,2007,134,164,-73,288,7,-30,-66,-97,13402,9.9624549273,12.192855284,-5.427307535,-1,0.5204267499,-2.230400357,-4.906880785
27,71,2008,137,160,-133,288,6,-23,-127,-151,13251,10.280268638,12.006153153,-9.980114809,-1,0.4502307433,-1.725884516,-9.529884066
27,73,2001,76,111,-124,213,0,-35,-124,-163,7885,9.5399485345,13.933345886,-15.56517919,-4,0,-4.393397351,-15.56517919
27,73,2002,69,109,7,213,-1,-40,6,-43,7842,8.7747186367,13.861512049,0.8901888472,-9,-0.127169835,-5.086793413,0.7630190119
27,73,2003,60,113,-64,213,-1,-53,-65,-123,7719,7.711586659,14.523488208,-8.225692436,-5,-0.128526444,-6.811901549,-8.354218881
27,73,2004,62,110,-83,213,0,-48,-83,-138,7581,8.1045751634,14.379084967,-10.8496732,-7,0,-6.274509804,-10.8496732
27,73,2005,75,98,-90,213,-1,-23,-91,-121,7460,9.9727411741,13.031048468,-11.96728941,-7,-0.132969882,-3.058307293,-12.10025929
27,73,2006,64,99,-146,213,0,-35,-146,-184,7276,8.6862106406,13.436482085,-19.81541802,-3,0,-4.750271444,-19.81541802
27,73,2007,79,103,0,213,0,-24,0,-20,7256,10.872557115,14.175612442,0,4,0,-3.303055326,0
27,73,2008,78,105,-71,213,-1,-27,-72,-91,7165,10.817557728,14.562096942,-9.846751266,8,-0.138686638,-3.744539214,-9.985437903
27,75,2001,98,113,73,270,0,-15,73,48,11112,8.8383838384,10.191197691,6.5836940837,-10,0,-1.352813853,6.5836940837
27,75,2002,100,141,12,270,-1,-41,11,-41,11071,9.0159130866,12.712437452,1.0819095704,-11,-0.090159131,-3.696524366,0.9917504395
27,75,2003,101,141,73,270,-1,-40,72,21,11092,9.1142895817,12.723909218,6.5875558363,-11,-0.090240491,-3.609619636,6.4973153454
27,75,2004,83,137,-25,270,0,-54,-25,-87,11005,7.5123319908,12.399873286,-2.2627506,-8,0,-4.887541295,-2.2627506
27,75,2005,87,141,-43,270,-1,-54,-44,-104,10901,7.943029307,12.873185429,-3.92586506,-6,-0.091299187,-4.930156122,-4.017164247
27,75,2006,114,166,-25,270,0,-52,-25,-82,10819,10.497237569,15.285451197,-2.302025783,-5,0,-4.788213628,-2.302025783
27,75,2007,105,148,-57,270,0,-43,-57,-113,10706,9.756097561,13.7514518,-5.296167247,-13,0,-3.995354239,-5.296167247
27,75,2008,100,133,-41,270,-1,-33,-42,-97,10609,9.3830635703,12.479474548,-3.847056064,-22,-0.093830636,-3.096410978,-3.9408867
27,77,2001,35,43,-56,47,9,-8,-47,-58,4446,7.8212290503,9.6089385475,-12.51396648,-3,2.0111731844,-1.787709497,-10.5027933
27,77,2002,26,57,-125,47,8,-31,-117,-149,4297,5.947615235,13.039002631,-28.59430401,-1,1.8300354569,-7.091387396,-26.76426856
27,77,2003,47,34,9,47,4,13,13,21,4318,10.911201393,7.8932095183,2.0893789901,-5,0.9286128845,3.0179918746,3.0179918746
27,77,2004,44,44,5,47,5,0,10,6,4324,10.182828049,10.182828049,1.157139551,-4,1.157139551,0,2.3142791021
27,77,2005,39,46,-45,47,5,-7,-40,-50,4274,9.0718771807,10.700162829,-10.46755059,-3,1.163061177,-1.628285648,-9.304489416
27,77,2006,44,57,-69,47,5,-13,-64,-77,4197,10.388383898,13.457679141,-16.29087475,0,1.1804981702,-3.069295243,-15.11037658
27,77,2007,37,34,-142,47,5,3,-137,-140,4057,8.9653501333,8.2384298522,-34.40755997,-6,1.2115338018,0.7269202811,-33.19602617
27,77,2008,43,53,-64,47,4,-10,-60,-72,3985,10.693857249,13.180800796,-15.9164387,-2,0.9947774186,-2.486943546,-14.92166128
27,79,2001,340,227,108,293,26,113,134,225,25707,13.284104007,8.8690929692,4.2196565668,-22,1.0158432476,4.4150110375,5.2354998144
27,79,2002,327,228,182,293,25,99,207,283,25990,12.650637368,8.8206278894,7.0410275258,-23,0.9671741107,3.8300094783,8.0082016365
27,79,2003,322,219,384,293,12,103,396,489,26479,12.273914121,8.3477863119,14.637214355,-10,0.4574129486,3.9261278088,15.094627304
27,79,2004,341,191,308,293,13,150,321,445,26924,12.770818119,7.1531561897,11.534932494,-26,0.4868640339,5.6176619291,12.021796528
27,79,2005,352,217,100,293,12,135,112,220,27144,13.020640675,8.0269290523,3.6990456462,-27,0.4438854775,4.9937116224,4.1429311238
27,79,2006,394,181,232,293,13,213,245,443,27587,14.397690523,6.6141674736,8.477827922,-15,0.4750507025,7.7835230491,8.9528786245
27,79,2007,377,197,234,293,9,180,243,430,28017,13.560175527,7.0858211639,8.4166606719,7,0.3237177181,6.474354363,8.74037839
27,79,2008,389,225,-163,293,8,164,-155,25,28042,13.878235431,8.0272569971,-5.815301736,16,0.2854135821,5.8509784334,-5.529888154
27,81,2001,59,93,-52,201,2,-34,-50,-88,6312,9.2825676526,14.631843927,-8.181246067,-4,0.3146633103,-5.349276274,-7.866582756
27,81,2002,64,107,-61,201,2,-43,-59,-107,6205,10.226092514,17.096748422,-9.746744428,-5,0.3195653911,-6.870655908,-9.427179037
27,81,2003,67,96,-15,201,1,-29,-14,-49,6156,10.840546881,15.53272389,-2.426988108,-6,0.1617992072,-4.692177008,-2.265188901
27,81,2004,80,110,-66,201,0,-30,-66,-102,6054,13.104013104,18.018018018,-10.81081081,-6,0,-4.914004914,-10.81081081
27,81,2005,61,111,-31,201,1,-50,-30,-86,5968,10.148061887,18.4661454,-5.157211778,-6,0.1663616703,-8.318083514,-4.990850108
27,81,2006,69,88,-40,201,0,-19,-40,-61,5907,11.621052632,14.821052632,-6.736842105,-2,0,-3.2,-6.736842105
27,81,2007,76,80,-42,201,1,-4,-41,-45,5862,12.915285921,13.595037811,-7.137394851,0,0.1699379726,-0.679751891,-6.967456878
27,81,2008,71,91,-12,201,0,-20,-12,-25,5837,12.137789555,15.556885204,-2.05145739,7,0,-3.419095649,-2.05145739
27,83,2001,363,235,-244,1284,65,128,-179,-69,25368,14.289932093,9.2510579667,-9.605353804,-18,2.5588032674,5.0388741266,-7.046550536
27,83,2002,327,229,-551,1208,61,98,-490,-400,24968,12.992689129,9.0988556898,-21.89287985,-8,2.423712651,3.8938334393,-19.4691672
27,83,2003,321,214,-381,1116,42,107,-339,-240,24728,12.918544752,8.6123631681,-15.33322601,-8,1.6902768835,4.306181584,-13.64294913
27,83,2004,298,258,-264,1147,42,40,-222,-206,24522,12.101522843,10.47715736,-10.72081218,-24,1.7055837563,1.6243654822,-9.015228426
27,83,2005,320,232,-13,1216,43,88,30,96,24618,13.024013024,9.4424094424,-0.529100529,-22,1.7501017501,3.5816035816,1.221001221
27,83,2006,321,206,-60,1216,44,115,-16,87,24705,13.016239888,8.3531009874,-2.432942035,-12,1.7841574924,4.6631389007,-0.648784543
27,83,2007,387,227,-220,1227,35,160,-185,-21,24684,15.671505801,9.192330276,-8.908866347,4,1.4173196461,6.4791755249,-7.491546701
27,83,2008,334,226,14,1307,34,108,48,160,24844,13.487320304,9.1261508642,0.5653367792,4,1.3729607495,4.3611694395,1.9382975287
27,85,2001,526,289,75,477,31,237,106,305,35170,15.021060898,8.253016349,2.1417862497,-38,0.8852716499,6.7680445492,3.0270578996
27,85,2002,485,275,76,477,30,210,106,280,35450,13.735485698,7.7881619938,2.1523647692,-36,0.849617672,5.9473237043,3.0019824412
27,85,2003,512,315,-46,477,22,197,-24,123,35573,14.417864635,8.8703659378,-1.295355026,-50,0.6195176211,5.5474986976,-0.675837405
27,85,2004,538,291,159,477,22,247,181,402,35975,15.038855034,8.1343992844,4.4445686812,-26,0.6149717672,6.90445575,5.0595404484
27,85,2005,544,304,102,477,23,240,125,333,36308,15.051948591,8.4113830361,2.8222403608,-32,0.6363875323,6.6405655548,3.4586278931
27,85,2006,512,297,295,477,24,215,319,516,36824,14.002078434,8.1222994038,8.0676037849,-18,0.6563474266,5.8797790297,8.7239512115
27,85,2007,574,301,-8,477,20,273,12,283,37107,15.527992317,8.1427276785,-0.216418011,-2,0.5410450285,7.3852646386,0.3246270171
27,85,2008,561,291,-241,477,19,270,-222,58,37165,15.106635071,7.8360620422,-6.489659629,10,0.5116329168,7.2705730289,-5.978026713
27,87,2001,79,57,-17,75,3,22,-14,2,5174,15.271602552,11.018751208,-3.28629422,-6,0.5799342741,4.2528513435,-2.706359946
27,87,2002,85,64,-55,75,3,21,-52,-34,5140,16.482451037,12.410316075,-10.66511538,-3,0.581733566,4.0721349622,-10.08338181
27,87,2003,79,47,-80,75,1,32,-79,-52,5088,15.447790379,9.1904575675,-15.64333203,-5,0.1955416504,6.2573328119,-15.44779038
27,87,2004,84,51,-65,75,0,33,-65,-37,5051,16.569681428,10.060163724,-12.8217773,-5,0,6.5095177039,-12.8217773
27,87,2005,97,47,-24,75,1,50,-23,24,5075,19.15860162,9.2830337744,-4.740272566,-3,0.1975113569,9.8755678452,-4.542761209
27,87,2006,85,56,-49,75,0,29,-49,-22,5053,16.785150079,11.058451817,-9.67614534,-2,0,5.7266982622,-9.67614534
27,87,2007,90,39,-4,75,1,51,-3,45,5098,17.732243129,7.6839720225,-0.788099695,-3,0.1970249237,10.048271106,-0.591074771
27,87,2008,104,33,-34,75,0,71,-34,30,5128,20.340309016,6.4541365148,-6.649716409,-7,0,13.886172501,-6.649716409
27,89,2001,88,99,-184,123,7,-11,-177,-195,9927,8.7784926929,9.8758042795,-18.35503018,-7,0.6982891915,-1.097311587,-17.65674098
27,89,2002,109,97,-65,123,7,12,-58,-57,9870,11.01176946,9.7994645653,-6.566651513,-11,0.7071778552,1.2123048947,-5.859473658
27,89,2003,108,96,2,123,3,12,5,4,9874,10.940032415,9.7244732577,0.2025931929,-13,0.3038897893,1.2155591572,0.5064829822
27,89,2004,121,89,-79,123,2,32,-77,-52,9822,12.286758733,9.0373679935,-8.021933387,-7,0.2030869212,3.2493907392,-7.818846466
27,89,2005,104,79,-104,123,3,25,-101,-83,9739,10.6334032,8.0772966617,-10.6334032,-7,0.3067327846,2.5561065385,-10.32667042
27,89,2006,97,77,-78,123,2,20,-76,-60,9679,9.9907302503,7.9307858688,-8.033783088,-4,0.2059944382,2.0599443815,-7.82778865
27,89,2007,100,99,-112,123,2,1,-110,-109,9570,10.390150138,10.286248636,-11.63696815,0,0.2078030028,0.1039015014,-11.42916515
27,89,2008,116,86,-89,123,1,30,-88,-68,9502,12.16442953,9.0184563758,-9.333053691,-10,0.1048657718,3.1459731544,-9.228187919
27,91,2001,232,228,-350,480,6,4,-344,-350,21421,10.742730135,10.55751065,-16.20670495,-10,0.2778292276,0.1852194851,-15.92887572
27,91,2002,235,276,-172,480,6,-41,-166,-223,21198,11.027945283,12.951969779,-8.071517398,-16,0.2815645604,-1.924024496,-7.789952838
27,91,2003,202,247,-148,480,4,-45,-144,-210,20988,9.5766367989,11.710045987,-7.016545773,-21,0.1896363723,-2.133409188,-6.826909401
27,91,2004,248,213,-165,480,5,35,-160,-146,20842,11.857518527,10.184078413,-7.889074827,-21,0.2390628735,1.6734401148,-7.650011953
27,91,2005,233,233,-118,480,5,0,-113,-132,20710,11.214863304,11.214863304,-5.679630343,-19,0.2406623027,0,-5.43896804
27,91,2006,235,254,-191,480,5,-19,-186,-213,20497,11.405829107,12.328002524,-9.270269614,-8,0.242677215,-0.922173417,-9.027592399
27,91,2007,233,253,-41,480,4,-20,-37,-55,20442,11.382789028,12.359852463,-2.002980043,2,0.1954126872,-0.977063436,-1.807567356
27,91,2008,245,257,-6,480,3,-12,-3,-7,20435,11.987181055,12.574308291,-0.293563618,8,0.1467818088,-0.587127235,-0.146781809
27,93,2001,294,236,47,515,6,58,53,90,22784,12.929328467,10.378644619,2.0669334623,-21,0.2638638463,2.5506838471,2.3307973086
27,93,2002,304,227,55,515,5,77,60,115,22899,13.309108421,9.9380513539,2.4078979051,-22,0.2188998096,3.3710570672,2.6267977147
27,93,2003,282,236,59,515,1,46,60,78,22977,12.29400994,10.288604063,2.5721510158,-28,0.0435957799,2.0054058767,2.6157467957
27,93,2004,296,236,45,515,2,60,47,92,23069,12.856708509,10.250618946,1.954567172,-15,0.0868696521,2.6060895626,2.041436824
27,93,2005,342,234,-98,515,2,108,-96,-8,23061,14.827660958,10.145241708,-4.248861912,-20,0.0867114676,4.6824192499,-4.162150444
27,93,2006,297,216,35,515,2,81,37,108,23169,12.848799481,9.3445814406,1.514168289,-10,0.0865239022,3.5042180402,1.6006921912
27,93,2007,340,223,-127,515,2,117,-125,-14,23155,14.679215957,9.6278387013,-5.483118902,-6,0.0863483292,5.0513772559,-5.396770572
27,93,2008,336,237,-107,515,1,99,-106,-12,23143,14.51466586,10.238023241,-4.622229902,-5,0.0431984103,4.2766426196,-4.579031492
27,95,2001,261,249,466,515,4,12,470,462,22911,11.507936508,10.978835979,20.546737213,-20,0.176366843,0.5291005291,20.723104056
27,95,2002,280,256,708,515,3,24,711,729,23640,12.02981676,10.998689609,30.418250951,-6,0.1288908939,1.0311271509,30.547141844
27,95,2003,329,245,560,515,1,84,561,649,24289,13.72864028,10.223455528,23.36789835,4,0.0417283899,3.5051847524,23.40962674
27,95,2004,317,249,462,515,2,68,464,502,24791,12.917685412,10.146699267,18.826405868,-30,0.0814995925,2.7709861451,18.90790546
27,95,2005,387,231,570,515,1,156,571,708,25499,15.390733744,9.1867170412,22.668522569,-19,0.0397693378,6.2040167031,22.708291907
27,95,2006,378,248,338,515,2,130,340,455,25954,14.693020815,9.6398655083,13.138203798,-15,0.0777408509,5.0531553068,13.215944649
27,95,2007,378,262,206,515,2,116,208,301,26255,14.480262024,10.036583731,7.8913597273,-23,0.076615143,4.443678293,7.9679748702
27,95,2008,389,246,0,515,1,143,1,122,26377,14.781881745,9.3479252166,0,-22,0.037999696,5.4339565283,0.037999696
27,97,2001,420,289,145,557,2,131,147,248,32041,13.159131497,9.0547357208,4.5430334931,-30,0.0626625309,4.1043957765,4.6056960241
27,97,2002,411,318,172,557,-1,93,171,239,32280,12.779652058,9.8879059716,5.348175557,-25,-0.031094044,2.891746086,5.317081513
27,97,2003,394,319,-8,557,-7,75,-15,14,32294,12.203053861,9.8801375166,-0.247777743,-46,-0.216805525,2.322916344,-0.464583269
27,97,2004,431,289,-108,557,7,142,-101,18,32312,13.342414017,8.9465374733,-3.343342724,-23,0.2166981395,4.395876544,-3.126644584
27,97,2005,449,315,33,557,1,134,34,135,32447,13.866798437,9.7283775228,1.0191633595,-33,0.0308837382,4.1384209145,1.0500470977
27,97,2006,430,280,-98,557,5,150,-93,42,32489,13.243809289,8.6238758162,-3.018356536,-15,0.1539977824,4.619933473,-2.864358753
27,97,2007,453,305,32,557,1,148,33,181,32670,13.904449117,9.361715189,0.9822127411,0,0.0306941482,4.5427339278,1.0129068893
27,97,2008,460,309,66,557,1,151,67,223,32893,14.032304806,9.4260482284,2.0133306896,5,0.0305050104,4.6062565776,2.0438357
27,99,2001,530,389,-209,856,105,141,-104,-1,38670,13.705537813,10.059347565,-5.404636609,-38,2.7152480573,3.6461902484,-2.689388552
27,99,2002,525,404,-371,856,97,121,-274,-187,38483,13.609321737,10.472697108,-9.617254028,-34,2.5144842067,3.136624629,-7.102769821
27,99,2003,527,385,-230,856,80,142,-150,-54,38429,13.703973372,10.011441648,-5.980861244,-46,2.0802995631,3.6925317246,-3.900561681
27,99,2004,534,392,-121,856,77,142,-44,70,38499,13.883111481,10.191347754,-3.145798669,-28,2.0018718802,3.6917637271,-1.143926789
27,99,2005,536,416,-517,856,81,120,-436,-347,38152,13.985466595,10.854391984,-13.48971312,-31,2.1134753624,3.1310746109,-11.37623775
27,99,2006,528,400,-284,856,81,128,-203,-93,38059,13.856267468,10.497172324,-7.45299235,-18,2.1256773957,3.3590951437,-5.327314955
27,99,2007,572,379,-367,856,71,193,-296,-107,37952,15.050453224,9.9722408599,-9.656497086,-4,1.8681506624,5.078212364,-7.788346424
27,99,2008,543,386,-317,856,70,157,-247,-93,37859,14.325097941,10.183218794,-8.362902481,-3,1.8466977088,4.1418791468,-6.516204772
27,101,2001,91,105,-64,161,5,-14,-59,-80,9063,9.9967043832,11.534658904,-7.030649237,-7,0.5492694716,-1.53795452,-6.481379765
27,101,2002,92,98,-75,161,4,-6,-71,-85,8978,10.198991187,10.864142786,-8.314394989,-8,0.4434343994,-0.665151599,-7.87096059
27,101,2003,102,95,-69,161,-1,7,-70,-72,8906,11.406844106,10.624021472,-7.716394543,-9,-0.111831805,0.7828226348,-7.828226348
27,101,2004,88,108,-67,161,0,-20,-67,-93,8813,9.9328404538,12.190304193,-7.562503527,-6,0,-2.257463739,-7.562503527
27,101,2005,101,105,-103,161,-1,-4,-104,-114,8699,11.534947465,11.991777067,-11.76336227,-6,-0.114207401,-0.456829603,-11.87756967
27,101,2006,83,81,-95,161,0,2,-95,-99,8600,9.5959304006,9.364703162,-10.98329383,-6,0,0.2312272386,-10.98329383
27,101,2007,88,97,-115,161,0,-9,-115,-131,8469,10.311090281,11.365633605,-13.47472025,-7,0,-1.054543324,-13.47472025
27,101,2008,90,85,-68,161,-1,5,-69,-80,8389,10.677423182,10.084233005,-8.067386404,-16,-0.118638035,0.5931901768,-8.186024439
27,103,2001,388,176,51,2445,38,212,89,271,30171,12.918046978,5.8597326497,1.697990711,-30,1.2651695494,7.058314328,2.9631602604
27,103,2002,389,190,34,2571,37,199,71,238,30409,12.842522285,6.2726972598,1.1224826675,-32,1.2215252559,6.5698250248,2.3440079234
27,103,2003,360,187,-21,2618,28,173,7,134,30543,11.812573829,6.1359758498,-0.689066807,-46,0.9187557422,5.6765979787,0.2296889356
27,103,2004,388,189,15,2618,30,199,45,224,30767,12.656989072,6.1653890067,0.4893165878,-20,0.9786331757,6.4916000652,1.4679497635
27,103,2005,409,198,-74,2673,29,211,-45,146,30913,13.261997406,6.420233463,-2.399481193,-20,0.9403372244,6.8417639429,-1.459143969
27,103,2006,379,200,332,2814,30,179,362,523,31436,12.157372211,6.4154998476,10.649729747,-18,0.9623249771,5.7418723636,11.612054724
27,103,2007,430,213,101,2849,29,217,130,319,31755,13.609533003,6.7414663481,3.1966577519,-28,0.9178522258,6.8680666551,4.1145099777
27,103,2008,403,218,80,2849,28,185,108,272,32027,12.63679408,6.8357843906,2.5085447305,-21,0.8779906557,5.8010096893,3.3865353862
27,105,2001,315,202,-208,389,80,113,-128,-34,20741,15.174872338,9.7311879757,-10.02023316,-19,3.853935832,5.4436843627,-6.166297331
27,105,2002,299,175,-471,389,79,124,-392,-272,20469,14.511041009,8.4930842029,-22.85852948,-4,3.8340208687,6.0179568066,-19.02450861
27,105,2003,303,187,-265,389,60,116,-205,-102,20367,14.839847194,9.1585855618,-12.97874425,-13,2.9385836027,5.6812616319,-10.04016064
27,105,2004,341,200,-312,389,58,141,-254,-135,20232,16.798443311,9.8524594202,-15.3698367,-22,2.8572132319,6.9459838912,-12.51262346
27,105,2005,326,169,-227,389,59,157,-168,-30,20202,16.12504328,8.3593015779,-11.22817431,-19,2.9183360538,7.7657417025,-8.309838255
27,105,2006,341,186,-347,389,59,155,-288,-140,20062,16.938207828,9.2390224518,-17.23624081,-7,2.9306576594,7.6991853765,-14.30558315
27,105,2007,317,170,-167,389,54,147,-113,40,20102,15.785280351,8.4652923016,-8.31590479,6,2.6889752017,7.319988049,-5.626929589
27,105,2008,319,180,60,389,53,139,113,263,20365,15.765932735,8.8961375936,2.9653791979,11,2.6194182914,6.8697951417,5.5847974893
27,107,2001,62,90,-109,185,6,-28,-103,-136,7286,8.4307859668,12.238237694,-14.82186565,-5,0.8158825129,-3.807451727,-14.00598314
27,107,2002,81,110,-21,185,6,-29,-15,-49,7237,11.154720099,15.14838532,-2.89196447,-5,0.8262755629,-3.993665221,-2.065688907
27,107,2003,64,110,-111,185,0,-46,-111,-162,7075,8.9435438793,15.371716042,-15.51145892,-5,0,-6.428172163,-15.51145892
27,107,2004,78,105,-72,185,1,-27,-71,-105,6970,11.107155571,14.951940192,-10.25275899,-7,0.1423994304,-3.844784621,-10.11035956
27,107,2005,74,111,-69,185,1,-37,-68,-111,6859,10.702147661,16.053221491,-9.979029576,-6,0.144623617,-5.35107383,-9.834405958
27,107,2006,81,83,-139,185,1,-2,-138,-143,6716,11.933701657,12.228360958,-20.47882136,-3,0.1473296501,-0.2946593,-20.33149171
27,107,2007,66,107,-30,185,1,-41,-29,-68,6648,9.8772822508,16.01316971,-4.48967375,2,0.1496557917,-6.135887459,-4.340017959
27,107,2008,76,102,-21,185,0,-26,-21,-43,6605,11.469101336,15.392741266,-3.16909379,4,0,-3.923639931,-3.16909379
27,109,2001,1879,766,217,3089,657,1113,874,1853,126736,14.935279132,6.088570418,1.7248300009,-134,5.2221811548,8.8467087144,6.9470111558
27,109,2002,1954,773,705,3064,612,1181,1317,2381,129117,15.274395844,6.0425322353,5.5109770063,-117,4.7839970608,9.2318636092,10.294974067
27,109,2003,2035,828,425,3094,543,1207,968,2006,131123,15.639409776,6.3633569013,3.2662158008,-169,4.1730710114,9.2760528743,7.4392868122
27,109,2004,2123,800,302,3073,497,1323,799,2031,133154,16.066475705,6.0542536808,2.2854807645,-91,3.7612050992,10.012222025,6.0466858637
27,109,2005,2161,809,6,3150,520,1352,526,1748,134902,16.123496583,6.0360521682,0.0447667652,-130,3.8797863133,10.087444415,3.9245530785
27,109,2006,2222,824,333,3162,517,1398,850,2178,137080,16.339316572,6.0592245075,2.4486914575,-70,3.8017221728,10.280092065,6.2504136303
27,109,2007,2202,845,212,3120,475,1357,687,2052,139132,15.944274688,6.1184886971,1.5350527855,8,3.4393871374,9.8257859905,4.974439923
27,109,2008,2257,855,290,3123,474,1402,764,2228,141360,16.093150607,6.0964305577,2.0677951599,62,3.3797755373,9.9967200491,5.4475706972
27,111,2001,547,627,-10,1382,85,-80,75,-59,57093,9.5759114184,10.976410346,-0.175062366,-54,1.4880301107,-1.400498928,1.3129677448
27,111,2002,582,662,147,1382,83,-80,230,102,57195,10.184796304,11.584768305,2.572448551,-48,1.4524709506,-1.399972001,4.0249195016
27,111,2003,586,667,229,1378,56,-81,285,137,57332,10.233394745,11.647908353,3.9990569909,-67,0.977935334,-1.414513608,4.976992325
27,111,2004,614,664,-10,1362,59,-50,49,-42,57290,10.713475598,11.585908464,-0.174486573,-41,1.0294707822,-0.872432866,0.854984209
27,111,2005,600,623,-247,1360,57,-23,-190,-268,57022,10.497585555,10.899993002,-4.321506054,-55,0.9972706278,-0.402407446,-3.324235426
27,111,2006,613,631,87,1333,58,-18,145,101,57123,10.740724517,11.056112839,1.524376889,-26,1.0162512594,-0.315388322,2.5406281484
27,111,2007,627,618,-323,1324,39,9,-284,-254,56869,11.000771984,10.842866166,-5.667064355,21,0.6842585445,0.157905818,-4.982805811
27,111,2008,657,662,-158,1324,38,-5,-120,-83,56786,11.561303946,11.649289517,-2.780344024,42,0.6686903348,-0.08798557,-2.111653689
27,113,2001,158,146,-185,441,7,12,-178,-174,13369,11.741973841,10.850178359,-13.74851367,-8,0.5202140309,0.8917954816,-13.22829964
27,113,2002,169,135,193,441,6,34,199,225,13594,12.535697066,10.013722509,14.315914401,-8,0.4450543337,2.5219745577,14.760968735
27,113,2003,175,148,-31,441,6,27,-25,-16,13578,12.880906816,10.893566907,-2.281760636,-18,0.4416310908,1.9873399087,-1.840129545
27,113,2004,186,160,4,441,7,26,11,29,13607,13.684016921,11.771197351,0.2942799338,-8,0.5149898841,1.9128195696,0.8092698179
27,113,2005,190,138,-61,441,7,52,-54,-15,13592,13.971101879,10.147431891,-4.485459024,-13,0.5147248061,3.8236699879,-3.970734218
27,113,2006,187,138,79,441,7,49,86,129,13721,13.69311317,10.105078168,5.7847911251,-6,0.5125764288,3.5880350016,6.2973675539
27,113,2007,202,130,-67,441,7,72,-60,15,13736,14.713916305,9.4693520778,-4.880358379,3,0.5098881888,5.2445642277,-4.37047019
27,113,2008,205,140,-70,441,6,65,-64,11,13747,14.918313139,10.18811629,-5.094058145,10,0.4366335553,4.730196849,-4.65742459
27,115,2001,313,238,340,1351,6,75,346,404,27067,11.650846827,8.8591103666,12.655871952,-17,0.2233389168,2.7917364601,12.879210869
27,115,2002,286,244,319,1399,6,42,325,349,27416,10.498687664,8.9569223427,11.710074702,-18,0.2202521888,1.5417653213,11.930326891
27,115,2003,326,251,105,1417,-1,75,104,151,27567,11.85821072,9.1300947566,3.8193623484,-28,-0.03637488,2.7281159631,3.7829874689
27,115,2004,311,236,176,1415,0,75,176,226,27793,11.235549133,8.5260115607,6.3583815029,-25,0,2.7095375723,6.3583815029
27,115,2005,325,249,81,1423,0,76,81,140,27933,11.664214191,8.9365825647,2.9070810753,-17,0,2.7276316262,2.9070810753
27,115,2006,343,251,-65,1418,0,92,-65,12,27945,12.276745768,8.98385769,-2.326497011,-15,0,3.2928880776,-2.326497011
27,115,2007,356,259,90,1422,0,97,90,162,28107,12.702490544,9.2414186827,3.2113037893,-25,0,3.4610718618,3.2113037893
27,115,2008,345,243,130,1755,-1,102,129,190,28297,12.233174952,8.6164101837,4.6096021559,-41,-0.035458478,3.6167647685,4.5741436778
27,117,2001,131,137,-23,231,1,-6,-22,-38,9811,13.326551373,13.936927772,-2.339776195,-10,0.1017293998,-0.610376399,-2.238046796
27,117,2002,102,137,-120,231,0,-35,-120,-160,9651,10.481964855,14.078717501,-12.33172336,-5,0,-3.596752646,-12.33172336
27,117,2003,103,127,-73,231,0,-24,-73,-105,9546,10.730843361,13.231234047,-7.605355003,-8,0,-2.500390686,-7.605355003
27,117,2004,127,119,-96,231,1,8,-95,-96,9450,13.37123605,12.528953464,-10.10739103,-9,0.1052853232,0.8422825858,-10.00210571
27,117,2005,122,133,-162,231,1,-11,-161,-181,9269,13.034884342,14.210160799,-17.30861691,-9,0.1068433143,-1.175276457,-17.2017736
27,117,2006,143,136,10,231,1,7,11,15,9284,15.415296718,14.660701773,1.0779927774,-3,0.1077992777,0.7545949442,1.1857920552
27,117,2007,135,123,1,231,0,12,1,16,9300,14.528626776,13.237193285,0.1076194576,3,0,1.2914334912,0.1076194576
27,117,2008,135,135,88,231,-1,0,87,95,9395,14.442364269,14.442364269,9.4142818936,8,-0.106980476,0,9.3073014175
27,119,2001,301,370,-280,1492,19,-69,-261,-353,31028,9.646044641,11.857264177,-8.973064782,-23,0.6088865388,-2.211219536,-8.364178244
27,119,2002,313,377,-141,1456,15,-64,-126,-215,30813,10.122734108,12.192558335,-4.560081499,-25,0.4851150531,-2.069824227,-4.074966446
27,119,2003,363,396,16,1471,0,-33,16,-62,30751,11.792606068,12.864661166,0.5197842895,-45,0,-1.072055097,0.5197842895
27,119,2004,404,367,-10,1436,14,37,4,21,30772,13.133299742,11.930497538,-0.325081677,-20,0.4551143475,1.2028022041,0.1300326707
27,119,2005,361,317,-61,1364,8,44,-53,-39,30733,11.738883018,10.308105032,-1.983578571,-30,0.2601414519,1.4307779855,-1.723437119
27,119,2006,386,331,-103,1381,12,55,-91,-50,30683,12.570014329,10.778950111,-3.354174808,-14,0.3907776475,1.7910642178,-2.96339716
27,119,2007,408,370,32,1509,8,38,40,72,30755,13.281682346,12.044662912,1.0417005762,-6,0.260425144,1.2370194342,1.3021257202
27,119,2008,424,357,-143,1503,8,67,-135,-61,30694,13.80006184,11.619391691,-4.654266139,7,0.2603785253,2.1806701492,-4.393887614
27,121,2001,97,140,-39,309,3,-43,-36,-92,11154,8.6607142857,12.5,-3.482142857,-13,0.2678571429,-3.839285714,-3.214285714
27,121,2002,108,147,86,309,3,-39,89,38,11192,9.6661594916,13.156717086,7.6971270026,-12,0.2685044303,-3.490557594,7.9656314329
27,121,2003,132,140,-38,309,1,-8,-37,-59,11133,11.825307951,12.541993281,-3.404255319,-14,0.0895856663,-0.71668533,-3.314669653
27,121,2004,130,166,38,309,0,-36,38,-5,11128,11.679619065,14.913975113,3.4140424958,-7,0,-3.234356049,3.4140424958
27,121,2005,106,132,-28,309,1,-26,-27,-64,11064,9.5529920692,11.896178803,-2.523431867,-11,0.0901225667,-2.343186734,-2.433309301
27,121,2006,120,148,33,309,0,-28,33,-1,11063,10.846477155,13.377321824,2.9827812175,-6,0,-2.530844669,2.9827812175
27,121,2007,124,149,-32,309,1,-25,-31,-54,11009,11.235955056,13.501268576,-2.899601305,2,0.0906125408,-2.265313519,-2.808988764
27,121,2008,129,140,30,309,0,-11,30,21,11030,11.70652026,12.704750669,2.722446572,2,0,-0.99823041,2.722446572
27,123,2001,7651,4126,-4142,17485,2426,3525,-1716,1397,512982,14.935089653,8.0541340879,-8.085366794,-412,4.7356590638,6.8809555646,-3.34970773
27,123,2002,7258,4001,-7696,17926,2268,3257,-5428,-2419,510563,14.182082859,7.8179269109,-15.03793189,-248,4.4316566443,6.3641559482,-10.60627525
27,123,2003,7454,3739,-10715,17942,1992,3715,-8723,-4982,505581,14.671148971,7.3591931852,-21.08953062,26,3.9207041522,7.3119557858,-17.16882647
27,123,2004,7402,3912,-9508,18205,1811,3490,-7697,-4831,500750,14.71086551,7.7747778812,-18.8963671,-624,3.5992133801,6.9360876292,-15.29715372
27,123,2005,7238,3836,-8633,18328,1912,3402,-6721,-3703,497047,14.507961038,7.688938732,-17.30412098,-384,3.8324428716,6.8190223061,-13.47167811
27,123,2006,7500,3735,-5975,18989,1917,3765,-4058,-510,496537,15.096861463,7.5182370086,-12.0271663,-217,3.85875779,7.5786244545,-8.168408509
27,123,2007,7365,3915,-3139,18929,1741,3450,-1398,2091,498628,14.80156557,7.868041983,-6.308501605,39,3.498917265,6.9335235865,-2.80958434
27,123,2008,7275,3926,-2402,18895,1742,3349,-660,2800,501428,14.549185246,7.8515603126,-4.803730991,111,3.4838049069,6.697624933,-1.319926084
27,125,2001,49,41,2,163,2,8,4,7,4291,11.428571429,9.5626822157,0.4664723032,-5,0.4664723032,1.8658892128,0.9329446064
27,125,2002,39,47,-28,163,2,-8,-26,-38,4253,9.1292134831,11.001872659,-6.554307116,-4,0.468164794,-1.872659176,-6.086142322
27,125,2003,51,44,14,163,1,7,15,18,4271,11.966213046,10.323791647,3.2848427968,-4,0.2346316283,1.6424213984,3.5194744252
27,125,2004,53,46,21,163,0,7,21,25,4296,12.373059414,10.738881756,4.9025329754,-3,0,1.6341776585,4.9025329754
27,125,2005,55,45,-76,163,1,10,-75,-68,4228,12.904739559,10.558423275,-17.83200375,-3,0.2346316283,2.3463162834,-17.59737213
27,125,2006,39,48,-115,163,0,-9,-115,-125,4103,9.362621534,11.523226503,-27.60773016,-1,0,-2.160604969,-27.60773016
27,125,2007,45,38,-5,163,1,7,-4,-5,4098,10.97427143,9.2671625412,-1.219363492,-8,0.2438726985,1.7071088892,-0.975490794
27,125,2008,53,37,-38,163,0,16,-38,-29,4069,12.979062079,9.060854659,-9.305742623,-7,0,3.9182074201,-9.305742623
27,127,2001,185,216,-124,500,2,-31,-122,-167,16590,11.095450865,12.954688578,-7.43695085,-14,0.1199508202,-1.859237713,-7.31700003
27,127,2002,191,191,-234,500,1,0,-233,-241,16349,11.597194815,11.597194815,-14.20808161,-8,0.0607182975,0,-14.14736331
27,127,2003,231,214,-194,500,-2,17,-196,-188,16161,14.211011996,13.165179945,-11.9347893,-9,-0.123039065,1.0458320517,-12.05782836
27,127,2004,208,201,-109,500,1,7,-108,-115,16046,12.916446735,12.481758624,-6.768714876,-14,0.0620983016,0.4346881113,-6.706616574
27,127,2005,173,231,-212,500,-1,-58,-213,-287,15759,10.878792643,14.526017922,-13.33123723,-16,-0.062883194,-3.647225279,-13.39412042
27,127,2006,212,195,-106,500,0,17,-106,-96,15663,13.493730507,12.41168608,-6.746865254,-7,0,1.0820444275,-6.746865254
27,127,2007,220,193,-173,500,0,27,-173,-146,15517,14.111610006,12.379730597,-11.09685696,0,0,1.7318794099,-11.09685696
27,127,2008,200,194,-28,500,-1,6,-29,-24,15493,12.899064818,12.512092873,-1.805869074,-1,-0.064495324,0.3869719445,-1.870364399
27,129,2001,205,258,-195,369,14,-53,-181,-247,16889,12.049963262,15.165319618,-11.46216018,-13,0.8229243204,-3.115356356,-10.63923586
27,129,2002,189,191,-13,369,13,-2,0,-17,16872,11.196350819,11.314830722,-0.770119369,-15,0.7701193685,-0.118479903,0
27,129,2003,204,194,-134,369,3,10,-131,-137,16735,12.140327908,11.545213795,-7.974529116,-16,0.1785342339,0.5951141131,-7.795994882
27,129,2004,194,223,-119,369,4,-29,-115,-158,16577,11.647454371,13.388568684,-7.144572526,-14,0.2401536984,-1.741114313,-6.904418828
27,129,2005,206,220,-38,369,3,-14,-35,-66,16511,12.451644101,13.29787234,-2.296905222,-17,0.1813346228,-0.84622824,-2.1155706
27,129,2006,218,185,-239,369,4,33,-235,-209,16302,13.287416573,11.276018651,-14.56739707,-7,0.2438058087,2.0113979216,-14.32359126
27,129,2007,197,194,-193,369,2,3,-191,-179,16123,12.151117965,11.966075559,-11.90439476,9,0.1233616037,0.1850424056,-11.78103315
27,129,2008,204,188,-286,369,1,16,-285,-262,15861,12.756378189,11.755877939,-17.88394197,7,0.0625312656,1.0005002501,-17.82141071
27,131,2001,712,458,515,6803,170,254,685,890,57701,12.435377952,7.9991616599,8.9946905128,-49,2.9691211401,4.4362162917,11.963811653
27,131,2002,714,439,284,6861,160,275,444,668,58369,12.302920651,7.5644007926,4.8935986904,-51,2.7569570087,4.7385198587,7.6505556991
27,131,2003,704,440,482,6965,136,264,618,830,59199,11.976047904,7.4850299401,8.1995100708,-52,2.3135547088,4.4910179641,10.51306478
27,131,2004,739,446,323,6929,120,293,443,689,59888,12.41109441,7.4903222014,5.4246055405,-47,2.0153333277,4.9207722086,7.4399388682
27,131,2005,795,434,169,6946,133,361,302,607,60495,13.207844961,7.2103203941,2.8077054069,-56,2.2096143143,5.9975245674,5.0173197212
27,131,2006,822,403,287,6904,133,419,420,808,61303,13.497758584,6.6175142449,4.7127210627,-31,2.1839439071,6.880244339,6.8966649699
27,131,2007,850,450,-68,6935,114,400,46,450,61753,13.814848524,7.3137433364,-1.105187882,4,1.8528149785,6.5011051879,0.7476270966
27,131,2008,845,442,90,6859,114,403,204,637,62390,13.613333011,7.1208203443,1.4499407941,30,1.8365916725,6.4925126668,3.2865324666
27,133,2001,129,152,7,232,2,-23,9,-24,9679,13.311319781,15.684655866,0.7223196781,-10,0.2063770509,-2.373336085,0.9286967289
27,133,2002,118,132,-1,232,0,-14,-1,-24,9655,12.206475639,13.654701562,-0.103444709,-9,0,-1.448225923,-0.103444709
27,133,2003,123,128,-65,232,-2,-5,-67,-79,9576,12.791846498,13.311840258,-6.759918881,-7,-0.207997504,-0.51999376,-6.967916385
27,133,2004,137,135,-143,232,2,2,-141,-151,9425,14.420293669,14.209778433,-15.05183938,-12,0.210515236,0.210515236,-14.84132414
27,133,2005,128,114,-11,232,0,14,-11,-5,9420,13.584505174,12.09869992,-1.167418413,-8,0,1.4858052534,-1.167418413
27,133,2006,129,107,-29,232,2,22,-27,-9,9411,13.70081249,11.364239817,-3.080027614,-4,0.2124156975,2.3365726727,-2.867611917
27,133,2007,137,135,70,232,0,2,70,65,9476,14.507333086,14.295547202,7.4125059565,-7,0,0.2117858845,7.4125059565
27,133,2008,143,127,-8,232,0,16,-8,0,9476,15.090755593,13.402279443,-0.844238075,-8,0,1.6884761503,-0.844238075
27,135,2001,203,146,-194,241,6,57,-188,-142,16166,12.50230954,8.9918088317,-11.94801995,-11,0.3695263903,3.5105007083,-11.57849356
27,135,2002,208,133,-137,241,6,75,-131,-68,16098,12.893627573,8.2444830151,-8.492437392,-12,0.3719315646,4.6491445574,-8.120505827
27,135,2003,226,143,-7,241,4,83,-3,55,16153,14.0150693,8.8679420793,-0.434095067,-25,0.2480543239,5.1471272209,-0.186040743
27,135,2004,219,140,-87,241,3,79,-84,-17,16136,13.564991173,8.6716838552,-5.38883211,-12,0.1858217969,4.8933073183,-5.203010313
27,135,2005,208,142,2,241,4,66,6,58,16194,12.867305908,8.784410764,0.1237240953,-14,0.2474481905,4.0828951438,0.3711722858
27,135,2006,210,125,-299,241,3,85,-296,-218,15976,13.055641902,7.7712154181,-18.58874728,-7,0.18650917,5.2844264843,-18.40223811
27,135,2007,211,125,-180,241,4,86,-176,-90,15886,13.244617413,7.8463373297,-11.29872575,0,0.2510827946,5.3982800829,-11.04764296
27,135,2008,221,128,-115,241,3,93,-112,-21,15865,13.920821391,8.0627381815,-7.243866335,-2,0.1889704261,5.85808321,-7.054895909
27,137,2001,1968,2218,701,10342,86,-250,787,356,200827,9.8081724803,11.05412935,3.4936630634,-181,0.4286091633,-1.24595687,3.9222722266
27,137,2002,1997,2171,-854,10379,68,-174,-786,-1136,199691,9.9720861484,10.840960956,-4.264477502,-176,0.3395602695,-0.868874807,-3.924917232
27,137,2003,2022,2250,-359,10969,31,-228,-328,-833,198858,10.146807544,11.29095795,-1.801535068,-277,0.1555643095,-1.144150406,-1.645970759
27,137,2004,2188,2165,-1073,10954,87,23,-986,-1119,197739,11.033870655,10.917883897,-5.411034375,-156,0.4387325169,0.1159867573,-4.972301858
27,137,2005,2071,2081,-1062,11003,64,-10,-998,-1187,196552,10.504931637,10.555655594,-5.386884306,-179,0.3246333292,-0.050723958,-5.062250977
27,137,2006,2162,2037,-450,11302,80,125,-370,-334,196218,11.008987448,10.372482623,-2.291417369,-89,0.4073630878,0.6365048247,-1.884054281
27,137,2007,2187,2102,52,11259,56,85,108,202,196420,11.140032294,10.707063504,0.2648750248,9,0.2852500267,0.4329687906,0.5501250516
27,137,2008,2265,2039,127,11222,58,226,185,444,196864,11.518393832,10.369097141,0.645843716,33,0.2949522482,1.1492966914,0.9407959642
27,139,2001,1708,410,4654,906,156,1298,4810,6115,97192,18.144251045,4.3554700986,49.439897168,7,1.657203257,13.788780946,51.097100425
27,139,2002,1836,413,4359,928,152,1423,4511,5968,103160,18.327743172,4.1227439706,43.513416387,34,1.5173295001,14.204999201,45.030745887
27,139,2003,2016,397,2982,981,113,1619,3095,4779,107939,19.100043108,3.7612684096,28.252147097,65,1.0705877337,15.338774698,29.322734831
27,139,2004,2141,471,4127,1003,111,1670,4238,5706,113645,19.324499964,4.2512094736,37.249981948,-202,1.0018773919,15.07329049,38.25185934
27,139,2005,2105,465,3171,1029,116,1640,3287,4837,118482,18.136623486,4.006427516,27.321250867,-90,0.9994528857,14.13019597,28.320703753
27,139,2006,2159,455,2302,1059,115,1704,2417,4050,122532,17.915971686,3.7757142739,19.102624744,-71,0.9543014099,14.140257412,20.056926154
27,139,2007,2183,493,1651,1065,101,1690,1752,3406,125938,17.571537811,3.9682859098,13.289330704,-36,0.8129754095,13.603251902,14.102306113
27,139,2008,2302,486,1115,1065,101,1816,1216,2999,128937,18.063756744,3.8136341344,8.7493869544,-33,0.7925453654,14.250122609,9.5419323198
27,141,2001,1160,315,1929,1660,22,845,1951,2984,68259,17.373852352,4.7178995612,28.891518265,188,0.3295040963,12.655952791,29.221022361
27,141,2002,1152,390,2738,1658,21,762,2759,3721,71980,16.429096043,5.5619335563,39.047625839,200,0.29948873,10.867162487,39.347114569
27,141,2003,1234,386,1844,1630,18,848,1862,2935,74915,16.801116444,5.2554545764,25.106368495,225,0.2450730113,11.545661867,25.351441506
27,141,2004,1230,455,2494,1749,18,775,2512,3243,78158,16.070763623,5.9448759742,32.585759736,-44,0.2351819067,10.125887648,32.820941642
27,141,2005,1292,387,2099,1754,19,905,2118,3036,81194,16.215673478,4.8571715448,26.344193986,13,0.2384657864,11.358501933,26.582659772
27,141,2006,1388,413,2019,1781,18,975,2037,3014,84208,16.783352076,4.9938936651,24.413247724,2,0.2176515399,11.78945841,24.630899264
27,141,2007,1358,428,916,1771,17,930,933,1845,86053,15.951979608,5.0275753108,10.759950899,-18,0.1996934119,10.924404297,10.959644311
27,141,2008,1428,453,634,1773,16,975,650,1607,87660,16.440911158,5.2154991279,7.2993961304,-18,0.1842118897,11.22541203,7.4836080201
27,143,2001,178,169,-10,324,27,9,17,10,15363,11.590050788,11.004036984,-0.651126449,-16,1.7580414116,0.5860138039,1.1069149629
27,143,2002,188,147,-130,324,25,41,-105,-76,15287,12.267536705,9.5921696574,-8.482871126,-12,1.6313213703,2.6753670473,-6.851549755
27,143,2003,186,141,-179,324,14,45,-165,-134,15153,12.220762155,9.2641261498,-11.760841,-14,0.9198423127,2.9566360053,-10.84099869
27,143,2004,212,139,-160,324,14,73,-146,-88,15065,14.03137203,9.19981468,-10.58971474,-15,0.9266000397,4.8315573499,-9.6631147
27,143,2005,205,139,-189,324,14,66,-175,-117,14948,13.66074701,9.2626528504,-12.59454236,-8,0.9329290641,4.3980941592,-11.6616133
27,143,2006,212,155,-64,324,15,57,-49,0,14948,14.182499331,10.369280171,-4.281509232,-8,1.0034787263,3.8132191598,-3.278030506
27,143,2007,205,138,-43,324,13,67,-30,22,14970,13.704124607,9.2252155893,-2.874523698,-15,0.8690420483,4.478909018,-2.00548165
27,143,2008,216,136,-86,324,12,80,-74,-16,14954,14.436572651,9.0896938912,-5.747894666,-22,0.8020318139,5.3468787595,-4.945862853
27,145,2001,1736,796,73,7356,152,940,225,2429,135955,12.884025219,5.9076521165,0.5417821665,1264,1.128094374,6.9763731024,1.6698765405
27,145,2002,1755,774,207,7502,145,981,352,2357,138312,12.79774818,5.6441350946,1.5094779904,1024,1.0573638097,7.1536130851,2.5668418001
27,145,2003,1771,766,-202,7561,117,1005,-85,1911,140223,12.716534726,5.5002064373,-1.450446084,991,0.8401098605,7.2163282891,-0.610336223
27,145,2004,1859,786,-262,7401,119,1073,-143,964,141187,13.212039373,5.5861554316,-1.862051811,34,0.8457410895,7.6258839416,-1.016310721
27,145,2005,1863,777,310,7238,121,1086,431,1506,142693,13.125264196,5.4741440045,2.1840214175,-11,0.8524728759,7.6511201916,3.0364942934
27,145,2006,1981,790,279,7139,122,1191,401,1593,144286,13.805888236,5.5056293318,1.9443931437,1,0.8502364284,8.300258904,2.7946295722
27,145,2007,1979,818,487,7353,105,1161,592,1781,146067,13.631682814,5.6345207385,3.3545374079,28,0.723257552,7.9971620751,4.0777949599
27,145,2008,2067,836,-390,7313,105,1231,-285,1009,147076,14.102332309,5.7037009241,-2.660817417,63,0.7163739199,8.3986313847,-1.944443497
27,147,2001,488,271,84,639,98,217,182,368,34169,14.359276151,7.9741062233,2.4716786818,-31,2.8836251287,6.3851699279,5.3553038105
27,147,2002,445,286,-56,650,95,159,39,167,34336,12.991752427,8.3497554923,-1.634917159,-31,2.773520181,4.6419969345,1.1386030217
27,147,2003,510,304,88,663,77,206,165,327,34663,14.782822939,8.811721909,2.5507616052,-44,2.2319164046,5.9711010304,4.7826780098
27,147,2004,532,279,96,648,76,253,172,399,35062,15.259949803,8.0028684116,2.7536751524,-26,2.179992829,7.2570813912,4.9336679814
27,147,2005,506,246,117,607,76,260,193,420,35482,14.345656611,6.9743706056,3.3170787027,-33,2.1546836017,7.3712860059,5.4717623044
27,147,2006,551,223,76,602,75,328,151,460,35942,15.428987455,6.2443996416,2.1281362007,-19,2.1001344086,9.1845878136,4.2282706093
27,147,2007,535,292,-24,584,69,243,45,287,36229,14.8258996,8.0918928656,-0.665087085,-1,1.9121253689,6.734006734,1.2470382841
27,147,2008,565,279,-48,574,68,286,20,317,36546,15.527310203,7.667468224,-1.319134318,11,1.8687736173,7.8598419787,0.5496392992
27,149,2001,106,90,-64,1000,15,16,-49,-40,9982,10.597880424,8.9982003599,-6.398720256,-7,1.49970006,1.599680064,-4.899020196
27,149,2002,96,80,-81,1032,15,16,-66,-57,9925,9.6448485457,8.0373737881,-8.13784096,-7,1.5070075853,1.6074747576,-6.630833375
27,149,2003,94,94,-11,1076,12,0,1,-12,9913,9.4767617703,9.4767617703,-1.10898276,-13,1.2097993749,0,0.1008166146
27,149,2004,113,79,-127,985,11,34,-116,-93,9820,11.452896164,8.0068920083,-12.87183905,-11,1.1148836974,3.4460041555,-11.75695535
27,149,2005,101,61,-105,967,12,40,-93,-61,9759,10.317176567,6.2311660453,-10.72577762,-8,1.2258031564,4.0860105215,-9.499974462
27,149,2006,116,69,-145,878,11,47,-134,-90,9669,11.941527692,7.1031500926,-14.92690961,-3,1.1323862467,4.8383775993,-13.79452337
27,149,2007,114,89,-97,874,8,25,-89,-63,9606,11.828793774,9.2347600519,-10.06485084,1,0.8300907912,2.5940337224,-9.234760052
27,149,2008,106,74,13,889,7,32,20,55,9661,11.00326984,7.6815280012,1.3494576218,3,0.7266310271,3.3217418384,2.076088649
27,151,2001,110,129,-382,1386,1,-19,-381,-402,11521,9.3840641529,11.004947961,-32.58829551,-2,0.0853096741,-1.620883808,-32.50298584
27,151,2002,114,123,-65,1359,0,-9,-65,-84,11437,9.9311786741,10.715219096,-5.662514156,-10,0,-0.784040422,-5.662514156
27,151,2003,126,129,166,1673,0,-3,166,163,11600,10.938924339,11.199374919,14.411598732,0,0,-0.26045058,14.411598732
27,151,2004,132,110,-203,1673,1,22,-202,-193,11407,11.474768549,9.5623071239,-17.64680315,-13,0.0869300648,1.9124614248,-17.55987308
27,151,2005,102,131,-994,860,1,-29,-993,-1023,10384,9.3616630719,12.023312377,-91.23032445,-1,0.0917810105,-2.661649305,-91.13854344
27,151,2006,107,104,854,1903,1,3,855,849,11233,9.8996160429,9.6220567146,79.011888791,-9,0.0925197761,0.2775593283,79.104408567
27,151,2007,126,121,-119,1840,1,5,-118,-116,11117,11.275167785,10.827740492,-10.64876957,-3,0.0894854586,0.4474272931,-10.55928412
27,151,2008,123,121,-75,1840,0,2,-75,-82,11035,11.105092091,10.924521488,-6.771397616,-9,0,0.1805706031,-6.771397616
27,153,2001,260,223,11,302,33,37,44,58,24470,10.637862608,9.1240129291,0.450063418,-23,1.3501902541,1.5138496788,1.8002536721
27,153,2002,280,250,-248,302,32,30,-216,-210,24260,11.49189411,10.260619741,-10.17853478,-24,1.3133593269,1.231274369,-8.865175457
27,153,2003,294,220,-195,302,17,74,-178,-127,24133,12.150517637,9.092224082,-8.0590168,-23,0.7025809518,3.0582935549,-7.356435848
27,153,2004,303,219,-42,302,20,84,-22,46,24179,12.543467462,9.0660705415,-1.73869846,-16,0.8279516476,3.47739692,-0.910746812
27,153,2005,306,230,-219,302,18,76,-201,-147,24032,12.694198419,9.5413909689,-9.085063575,-22,0.7467175541,3.1528074506,-8.338346021
27,153,2006,322,237,-224,302,19,85,-205,-129,23903,13.434859706,9.8883905288,-9.345989361,-9,0.792740169,3.546469177,-8.553249192
27,153,2007,313,218,-38,302,15,95,-23,63,23966,13.077356953,9.1081911049,-1.587666339,-9,0.6267103971,3.9691658485,-0.960955942
27,153,2008,330,225,-167,302,14,105,-153,-49,23917,13.783597519,9.3979073993,-6.975335714,-1,0.5847586826,4.3856901197,-6.390577032
27,155,2001,33,60,-123,108,0,-27,-123,-150,3970,8.1582200247,14.833127318,-30.407911,0,0,-6.674907293,-30.407911
27,155,2002,31,51,-29,108,-1,-20,-30,-52,3918,7.860040568,12.931034483,-7.352941176,-2,-0.253549696,-5.070993915,-7.606490872
27,155,2003,40,61,-27,108,-1,-21,-28,-53,3865,10.278812797,15.675189516,-6.938198638,-4,-0.25697032,-5.396376718,-7.195168958
27,155,2004,33,58,12,108,0,-25,12,-16,3849,8.5558724397,15.037593985,3.1112263417,-3,0,-6.481721545,3.1112263417
27,155,2005,29,47,-19,108,0,-18,-19,-41,3808,7.574768186,12.276348439,-4.962779156,-4,0,-4.701580253,-4.962779156
27,155,2006,41,46,-26,108,0,-5,-26,-33,3775,10.813662139,12.132401424,-6.857444283,-2,0,-1.318739285,-6.857444283
27,155,2007,43,47,-69,108,0,-4,-69,-69,3706,11.495789333,12.565165085,-18.44673172,4,0,-1.069375752,-18.44673172
27,155,2008,35,50,-32,108,-1,-15,-33,-46,3660,9.5031224545,13.575889221,-8.688569101,2,-0.271517784,-4.072766766,-8.960086886
27,157,2001,264,181,35,359,42,83,77,138,21791,12.153577019,8.3325660621,1.6112696805,-22,1.9335236166,3.8210109566,3.5447932971
27,157,2002,268,195,-88,359,40,73,-48,7,21798,12.296680355,8.9472114524,-4.037715938,-18,1.8353254261,3.3494689027,-2.202390511
27,157,2003,253,194,13,359,22,59,35,63,21861,11.589821114,8.8870565061,0.595524405,-31,1.0078105316,2.7027646075,1.6033349367
27,157,2004,252,196,-119,359,24,56,-95,-56,21805,11.542160949,8.9772362937,-5.450464893,-17,1.0992534237,2.5649246553,-4.351211469
27,157,2005,281,188,-142,359,23,93,-119,-46,21759,12.900560095,8.630979708,-6.519144248,-20,1.0559177302,4.2695803875,-5.463226517
27,157,2006,277,178,-25,359,24,99,-1,86,21845,12.705256398,8.1643885882,-1.14668379,-12,1.1008164389,4.5408678103,-0.045867352
27,157,2007,247,196,-227,359,19,51,-208,-148,21697,11.345367691,9.0028018924,-10.42671444,9,0.8727205916,2.3425657985,-9.553993845
27,157,2008,273,189,12,359,18,84,30,116,21813,12.548839347,8.6876580097,0.5515973339,2,0.8273960009,3.8611813376,1.3789933349
27,159,2001,156,184,-28,445,1,-28,-27,-69,13650,11.399758851,13.445869414,-2.046110563,-14,0.0730753773,-2.046110563,-1.973035186
27,159,2002,155,203,50,445,1,-48,51,-13,13637,11.360721223,14.878880053,3.6647487815,-16,0.0732949756,-3.51815883,3.7380437571
27,159,2003,178,204,-143,445,1,-26,-142,-174,13463,13.136531365,15.055350554,-10.55350554,-6,0.073800738,-1.918819188,-10.4797048
27,159,2004,168,184,-34,445,0,-16,-34,-61,13402,12.506979341,13.698120231,-2.53117439,-11,0,-1.19114089,-2.53117439
27,159,2005,186,216,88,445,1,-30,89,49,13451,13.85320076,16.087587979,6.55420251,-10,0.074479574,-2.234387219,6.6286820839
27,159,2006,187,182,-160,445,0,5,-160,-160,13291,13.985490988,13.611547379,-11.9661955,-5,0,0.3739436093,-11.9661955
27,159,2007,193,207,76,445,1,-14,77,60,13351,14.488401772,15.539373921,5.7052773816,-3,0.0750694392,-1.050972149,5.7803468208
27,159,2008,190,191,-42,445,0,-1,-42,-40,13311,14.252494186,14.327507314,-3.150551346,3,0,-0.075013127,-3.150551346
27,161,2001,255,183,-85,1443,8,72,-77,-23,19494,13.073235754,9.3819691882,-4.357745251,-18,0.4101407295,3.6912665658,-3.947604522
27,161,2002,221,170,-35,1496,7,51,-28,6,19500,11.335077191,8.7192901472,-1.795147971,-17,0.3590295943,2.6157870442,-1.436118377
27,161,2003,257,163,-161,1432,2,94,-159,-85,19415,13.208274444,8.3772324297,-8.274444302,-20,0.102788128,4.8310420146,-8.171656174
27,161,2004,257,187,-224,1428,6,70,-218,-166,19249,13.294020277,9.6730809021,-11.587006,-18,0.3103662322,3.6209393751,-11.27663977
27,161,2005,258,158,-43,1465,4,100,-39,43,19292,13.38833969,8.1990607405,-2.231389948,-18,0.207571158,5.1892789497,-2.02381879
27,161,2006,262,158,-23,1477,6,104,-17,77,19369,13.553710458,8.17361165,-1.189829544,-10,0.3103903158,5.3800988076,-0.879439228
27,161,2007,290,163,-25,1471,4,127,-21,109,19478,14.930367853,8.3918964141,-1.287100677,3,0.2059361083,6.5384714392,-1.081164569
27,161,2008,283,158,-175,1478,4,125,-171,-35,19443,14.542277948,8.1190103029,-8.992574703,11,0.2055445646,6.4232676447,-8.787030138
27,163,2001,2806,978,2206,3241,237,1828,2443,4104,206633,13.715838714,4.7805025882,10.78301504,-167,1.1584653511,8.935336126,11.941480392
27,163,2002,2801,1055,775,3223,217,1746,992,2537,209170,13.472726267,5.0745184619,3.7277268322,-201,1.043763513,8.3982078051,4.7714903452
27,163,2003,2966,1042,1288,3313,162,1924,1450,3115,212285,14.075049531,4.9447746497,6.112159068,-259,0.7687653486,9.1302748811,6.8809244166
27,163,2004,2868,1105,-252,3405,180,1763,-72,1553,213838,13.460902134,5.1862959756,-1.182757091,-138,0.8448264938,8.2746061583,-0.337930598
27,163,2005,2884,1091,1773,3391,178,1793,1951,3539,217377,13.376158065,5.0601208214,8.223276092,-205,0.8255742495,8.3160372436,9.0488503415
27,163,2006,2930,1106,2349,3405,189,1824,2538,4249,221626,13.348428143,5.0386899406,10.701521402,-113,0.8610419519,8.3097382022,11.562563354
27,163,2007,2983,1095,2098,3428,164,1888,2262,4166,225792,13.334286953,4.894751664,9.3782547864,16,0.7330952264,8.4395352891,10.111350013
27,163,2008,3136,1130,1217,3438,165,2006,1382,3381,229173,13.785675821,4.9674150759,5.3498620773,-7,0.7253305199,8.8182607453,6.0751925972
27,165,2001,193,126,-106,170,35,67,-71,-11,11811,16.333093556,10.663055896,-8.970507341,-7,2.9619599712,5.6700376592,-6.00854737
27,165,2002,134,123,-127,170,35,11,-92,-88,11723,11.387779383,10.452961672,-10.79289539,-7,2.9744199881,0.9348177105,-7.818475397
27,165,2003,155,123,-245,170,23,32,-222,-192,11531,13.331039821,10.578825148,-21.07164359,-2,1.978154296,2.7522146727,-19.09348929
27,165,2004,158,119,-241,170,22,39,-219,-193,11338,13.817832,10.407101316,-21.07656653,-13,1.924001924,3.4107306835,-19.15256461
27,165,2005,128,118,-190,170,23,10,-167,-166,11172,11.372723234,10.484229231,-16.88138605,-9,2.0435362061,0.8884940027,-14.83784984
27,165,2006,165,114,-136,170,22,51,-114,-68,11104,14.814149758,10.235230742,-12.21045071,-5,1.9752199677,4.578919016,-10.23523074
27,165,2007,153,111,-191,170,18,42,-173,-126,10978,13.857440449,10.053437189,-17.29915768,5,1.6302871117,3.8040032606,-15.66887057
27,165,2008,150,104,-183,170,17,46,-166,-118,10860,13.737521751,9.5246817474,-16.75977654,2,1.5569191318,4.2128400037,-15.2028574
27,167,2001,87,83,-161,147,2,4,-159,-158,6961,12.357954545,11.789772727,-22.86931818,-3,0.2840909091,0.5681818182,-22.58522727
27,167,2002,64,69,-26,147,0,-5,-26,-39,6922,9.2199092415,9.940214651,-3.745588129,-8,0,-0.720305409,-3.745588129
27,167,2003,66,76,-32,147,-2,-10,-34,-55,6867,9.5728479223,11.023279426,-4.641380811,-11,-0.290086301,-1.450431503,-4.931467111
27,167,2004,89,75,-144,147,2,14,-142,-136,6731,13.090160318,11.031033976,-21.17958523,-8,0.294160906,2.0591263421,-20.88542433
27,167,2005,73,79,-82,147,0,-6,-82,-91,6640,10.919153392,11.816618054,-12.26535039,-3,0,-0.897464662,-12.26535039
27,167,2006,71,70,-167,147,2,1,-165,-167,6473,10.828948372,10.676427972,-25.47090673,-3,0.3050407992,0.1525203996,-25.16586593
27,167,2007,77,55,-73,147,0,22,-73,-64,6409,11.954665425,8.5390467319,-11.33364384,-13,0,3.4156186927,-11.33364384
27,167,2008,80,69,-118,147,0,11,-118,-123,6286,12.60338716,10.870421426,-18.58999606,-16,0,1.7329657345,-18.58999606
27,169,2001,529,404,-368,3879,67,125,-301,-215,49822,10.594938864,8.0914088865,-7.370392253,-39,1.3418920678,2.5035299773,-6.028500185
27,169,2002,510,439,-416,3988,62,71,-354,-319,49503,10.269317896,8.8396677574,-8.376541656,-36,1.2484268814,1.4296501384,-7.128114775
27,169,2003,499,407,-110,4007,49,92,-61,-34,49469,10.083660025,8.2245483571,-2.222850907,-65,0.9901790405,1.8591116679,-1.232671867
27,169,2004,546,375,-339,4216,46,171,-293,-164,49305,11.055540932,7.5930912993,-6.864154535,-42,0.9314191994,3.4624496325,-5.932735335
27,169,2005,531,367,89,4250,49,164,138,256,49561,10.74181215,7.4241903182,1.8004167257,-46,0.9912406692,3.3176218316,2.7916573949
27,169,2006,543,427,-79,4251,48,116,-31,61,49622,10.949457064,8.6103465312,-1.593014932,-24,0.9679078068,2.3391105331,-0.625107125
27,169,2007,569,397,12,4436,43,172,55,226,49848,11.440635367,7.982306223,0.2412787775,-1,0.8645822861,3.4583291445,1.1058610636
27,169,2008,589,396,-219,4522,42,193,-177,31,49879,11.812247435,7.9416807886,-4.391990133,15,0.8422994776,3.8705666469,-3.549690655
27,171,2001,1432,524,2093,894,46,908,2139,2990,93742,15.523540061,5.6804015307,22.68908474,-57,0.4986612031,9.8431385303,23.187745943
27,171,2002,1580,562,3271,894,42,1018,3313,4334,98076,16.473949264,5.859721194,34.105245597,3,0.437915107,10.61422807,34.543160704
27,171,2003,1813,570,2827,894,27,1243,2854,4162,102238,18.101580519,5.6910650279,28.225685673,65,0.2695767645,12.410515491,28.495262438
27,171,2004,1918,611,2766,894,30,1307,2796,3948,106186,18.404790235,5.8630484013,26.5420489,-155,0.2878747169,12.541741834,26.829923617
27,171,2005,1974,576,2108,894,29,1398,2137,3438,109624,18.293869608,5.3380288216,19.535702701,-97,0.2687549233,12.955840786,19.804457625
27,171,2006,2077,578,2608,894,31,1499,2639,4074,113698,18.600943928,5.1763820851,23.356409131,-64,0.2776260288,13.424561843,23.63403516
27,171,2007,2186,628,1647,894,22,1558,1669,3234,116932,18.956770585,5.4459523913,14.282617179,7,0.1907817717,13.510818194,14.473398951
27,171,2008,2259,640,1102,894,22,1619,1124,2769,119701,19.092856871,5.4092201848,9.3140010058,26,0.1859419439,13.683636686,9.4999429496
27,173,2001,136,135,-116,337,5,1,-111,-117,10928,12.378828562,12.287807764,-10.5584126,-7,0.4551039913,0.0910207983,-10.10330861
27,173,2002,123,123,-178,337,4,0,-174,-181,10747,11.349480969,11.349480969,-16.42445213,-7,0.369088812,0,-16.05536332
27,173,2003,111,143,-91,337,0,-32,-91,-131,10616,10.391798905,13.387632823,-8.519402706,-8,0,-2.995833918,-8.519402706
27,173,2004,135,146,-152,337,1,-11,-151,-173,10443,12.821121611,13.865805594,-14.43563322,-11,0.0949712712,-1.044683983,-14.34066195
27,173,2005,103,119,-127,337,0,-16,-127,-152,10291,9.935371853,11.478730587,-12.25040995,-9,0,-1.543358734,-12.25040995
27,173,2006,139,127,-69,337,1,12,-68,-60,10231,13.546437969,12.37696131,-6.72449079,-4,0.0974563883,1.1694766592,-6.627034402
27,173,2007,124,139,-108,337,0,-15,-108,-117,10114,12.189727206,13.664290981,-10.61685918,6,0,-1.474563775,-10.61685918
27,173,2008,122,139,-147,337,-1,-17,-148,-156,9958,12.156237545,13.850139498,-14.64726983,9,-0.099641291,-1.693901953,-14.74691112
28,0,2001,43400,28666,-9340,96699,1738,14734,-7602,4768,2853061,15.2244537,10.055856907,-3.27641469,-2364,0.6096797357,5.168596793,-2.666734955
28,0,2002,41742,28324,-7206,96194,877,13418,-6329,4952,2858013,14.617916,9.9189749599,-2.523518343,-2137,0.3071226183,4.6989410398,-2.216395725
28,0,2003,41729,28363,-1200,96663,-1057,13366,-2257,8698,2866711,14.578519419,9.9089493223,-0.419234185,-2411,-0.369275445,4.6695700963,-0.788509629
28,0,2004,42725,28369,3660,97285,2560,14356,6220,17885,2884596,14.857492393,9.8652358499,1.2727541757,-2691,0.8902324289,4.9922565427,2.1629866046
28,0,2005,42766,28603,553,96693,1326,14163,1879,13613,2898209,14.790746013,9.8924310953,0.1912566652,-2429,0.4586009731,4.8983149181,0.6498576383
28,0,2006,43448,28808,-16819,97801,2062,14640,-14757,-1496,2896713,14.995197519,9.9424979318,-5.80473732,-1379,0.7116575512,5.0526995877,-5.093079769
28,0,2007,47314,27264,3833,99941,1168,20050,5001,24317,2921030,16.265414268,9.3727069071,1.3176931329,-734,0.4015302842,6.8927073609,1.7192234171
28,0,2008,45832,27834,-753,99852,1442,17998,689,17588,2938618,15.643260483,9.5002293653,-0.257012025,-1099,0.492179735,6.1430311172,0.2351677097
28,1,2001,467,434,-485,480,8,33,-477,-468,33746,13.743378458,12.772218952,-14.27310182,-24,0.2354326074,0.9711595056,-14.03766922
28,1,2002,451,396,-430,477,7,55,-423,-385,33361,13.441220737,11.802047476,-12.81535458,-17,0.2086220514,1.6391732606,-12.60673253
28,1,2003,468,424,-471,459,2,44,-469,-444,32917,14.122333203,12.794592474,-14.21286098,-19,0.0603518513,1.3277407284,-14.15250913
28,1,2004,382,400,-825,458,9,-18,-816,-879,32038,11.761989069,12.316218921,-25.40220152,-45,0.2771149257,-0.554229851,-25.1250866
28,1,2005,413,367,-323,466,6,46,-317,-295,31743,12.950565215,11.50812938,-10.12840815,-24,0.1881438046,1.4424358351,-9.940264342
28,1,2006,460,418,389,478,8,42,397,419,32162,14.396369611,13.081918473,12.174321258,-20,0.2503716454,1.3144511384,12.424692904
28,1,2007,450,402,-549,478,5,48,-544,-490,31672,14.099069461,12.595168719,-17.20086474,6,0.1566563273,1.5039007426,-17.04420842
28,1,2008,431,393,-412,478,6,38,-406,-365,31307,13.68710205,12.480350593,-13.08372632,3,0.1905397037,1.2067514568,-12.89318662
28,3,2001,458,468,68,512,24,-10,92,46,34653,13.225527,13.514293965,1.9636153624,-36,0.6930407161,-0.288766965,2.6566560785
28,3,2002,486,410,27,531,23,76,50,90,34743,14.006570984,11.816243011,0.7781428324,-36,0.6628624128,2.1903279728,1.4410052453
28,3,2003,441,411,-43,530,13,30,-30,-51,34692,12.702527544,11.838410024,-1.238568445,-51,0.3744509253,0.86411752,-0.86411752
28,3,2004,425,395,225,548,16,30,241,241,34933,12.208258528,11.346499102,6.4631956912,-30,0.4596050269,0.8617594255,6.9228007181
28,3,2005,484,431,61,553,14,53,75,95,35028,13.836280213,12.321150355,1.7438287046,-33,0.4002229814,1.5151298581,2.1440516859
28,3,2006,483,424,248,548,15,59,263,305,35333,13.729196572,12.052131152,7.0493597305,-17,0.4263725643,1.6770654198,7.4757322949
28,3,2007,518,400,106,544,11,118,117,243,35576,14.610275141,11.282065746,2.9897474228,8,0.310256808,3.3282093951,3.3000042308
28,3,2008,490,402,-21,544,12,88,-9,97,35673,13.754579012,11.284368903,-0.589481958,18,0.3368468329,2.4702101082,-0.252635125
28,5,2001,182,154,-85,79,0,28,-85,-67,13511,13.437188527,11.369928753,-6.275610026,-10,0,2.0672597733,-6.275610026
28,5,2002,159,142,-96,95,0,17,-96,-90,13421,11.807515224,10.545076489,-7.129065795,-11,0,1.2624387346,-7.129065795
28,5,2003,152,156,11,98,-2,-4,9,-12,13409,11.330600075,11.628773761,0.819977637,-17,-0.149086843,-0.298173686,0.6708907939
28,5,2004,151,143,-96,98,2,8,-94,-97,13312,11.301972232,10.703192246,-7.185359829,-11,0.1496949964,0.5987799858,-7.035664833
28,5,2005,171,143,17,98,0,28,17,37,13349,12.827725892,10.727279547,1.2752709951,-8,0,2.1004463448,1.2752709951
28,5,2006,157,139,98,98,1,18,99,110,13459,11.712921516,10.370038794,7.311250373,-7,0.0746045956,1.3428827216,7.3858549687
28,5,2007,194,149,-155,98,0,45,-155,-126,13333,14.481934906,11.122723201,-11.57061809,-16,0,3.359211705,-11.57061809
28,5,2008,180,152,-88,98,1,28,-87,-85,13248,13.543508521,11.436740529,-6.621270833,-26,0.075241714,2.1067679922,-6.546029119
28,7,2001,303,261,-50,379,9,42,-41,-17,19628,15.4304484,13.291574364,-2.546278614,-18,0.4583301505,2.1388740356,-2.087948463
28,7,2002,249,251,-27,374,8,-2,-19,-43,19585,12.699869941,12.801876929,-1.377094331,-22,0.4080279499,-0.102006987,-0.969066381
28,7,2003,266,260,-73,374,7,6,-66,-83,19502,13.610663392,13.303655947,-3.735257247,-23,0.3581753524,0.3070074449,-3.377081894
28,7,2004,268,307,-88,370,8,-39,-80,-133,19369,13.789200175,15.795837514,-4.527797072,-14,0.4116179157,-2.006637339,-4.116179157
28,7,2005,290,275,-68,364,8,15,-60,-62,19307,14.996380184,14.220705347,-3.516392595,-17,0.4136932465,0.7756748371,-3.102699348
28,7,2006,304,253,74,355,8,51,82,123,19430,15.695588197,13.062446756,3.8206366007,-10,0.4130417947,2.633141441,4.2336783953
28,7,2007,330,265,62,355,8,65,70,131,19561,16.92698315,13.592880408,3.1802210767,-4,0.4103511067,3.3341027417,3.5905721833
28,7,2008,317,263,44,355,8,54,52,110,19671,16.160277325,13.407422512,2.2430668842,4,0.4078303426,2.7528548124,2.6508972268
28,9,2001,137,100,-143,118,1,37,-142,-109,7915,17.19053893,12.547838635,-17.94340925,-4,0.1254783863,4.6427002949,-17.81793086
28,9,2002,115,96,-101,116,1,19,-100,-87,7828,14.609667789,12.195896589,-12.83109954,-6,0.1270405895,2.4137711999,-12.70405895
28,9,2003,119,85,-46,119,1,34,-45,-20,7808,15.221284216,10.872345869,-5.883857764,-9,0.1279099514,4.3489383474,-5.755947813
28,9,2004,101,88,-23,114,0,13,-23,-15,7793,12.947887956,11.28132812,-2.94852894,-5,0,1.6665598359,-2.94852894
28,9,2005,121,76,23,113,1,45,24,62,7855,15.465235174,9.7137014315,2.9396728016,-7,0.1278118609,5.7515337423,3.0674846626
28,9,2006,116,81,61,109,0,35,61,93,7948,14.680756818,10.251218123,7.7200531545,-3,0,4.4295386952,7.7200531545
28,9,2007,119,74,22,109,1,45,23,67,8015,14.909478168,9.2714402055,2.7563741151,-1,0.1252897325,5.6380379628,2.8816638476
28,9,2008,113,64,55,109,0,49,55,101,8116,14.010290745,7.9350319261,6.8191680615,-3,0,6.0752588184,6.8191680615
28,11,2001,656,461,-577,2249,6,195,-571,-407,40064,16.291053579,11.448438567,-14.32917365,-31,0.1490035388,4.8426150121,-14.18017011
28,11,2002,638,426,-1067,1908,5,212,-1062,-854,39210,16.096071852,10.74753387,-26.91929258,-4,0.1261447637,5.3485379822,-26.79314782
28,11,2003,588,391,-558,2061,4,197,-554,-380,38830,15.069195284,10.020502307,-14.30035879,-23,0.1025115325,5.048692978,-14.19784726
28,11,2004,631,420,-729,2172,7,211,-722,-556,38274,16.367503631,10.894376427,-18.9095248,-45,0.1815729404,5.4731272048,-18.72795186
28,11,2005,587,398,-858,2124,6,189,-852,-692,37582,15.476692681,10.493566758,-22.62180974,-29,0.1581944737,4.9831259228,-22.46361527
28,11,2006,608,420,-99,2182,6,188,-93,77,37659,16.161401364,11.164125942,-2.631543972,-18,0.1594875135,4.9972754216,-2.472056459
28,11,2007,664,457,-374,2087,5,207,-369,-166,37493,17.670853736,12.16201831,-9.953161593,-4,0.1330636577,5.5088354269,-9.820097935
28,11,2008,628,399,-546,2087,5,229,-541,-298,37195,16.816623822,10.684447301,-14.62082262,14,0.1338903171,6.132176521,-14.48693231
28,13,2001,210,186,-136,249,24,24,-112,-99,14952,13.99860014,12.398760124,-9.065760091,-11,1.599840016,1.599840016,-7.465920075
28,13,2002,213,190,-167,250,23,23,-144,-133,14819,14.3092271,12.764099291,-11.21897148,-12,1.5451278089,1.5451278089,-9.673843673
28,13,2003,191,162,-110,251,9,29,-101,-85,14734,12.925929686,10.963353974,-7.444252699,-13,0.6090752208,1.9625757114,-6.835177478
28,13,2004,199,174,-126,250,16,25,-110,-98,14636,13.551242765,11.848825332,-8.580183861,-13,1.089547157,1.7024174328,-7.490636704
28,13,2005,208,188,-137,247,12,20,-125,-117,14519,14.268564569,12.896587206,-9.398044932,-12,0.8231864174,1.3719773624,-8.574858515
28,13,2006,197,171,16,249,15,26,31,49,14568,13.545570186,11.757829958,1.1001478324,-8,1.0313885928,1.7877402276,2.1315364252
28,13,2007,207,153,-82,249,11,54,-71,-21,14547,14.219474498,10.510046368,-5.632835308,-4,0.7556242487,3.7094281298,-4.87721106
28,13,2008,207,144,-108,249,12,63,-96,-39,14508,14.24883841,9.9122354156,-7.434176562,-6,0.826019618,4.3366029943,-6.608156944
28,15,2001,118,108,-118,259,4,10,-114,-116,10657,11.01259916,10.079328045,-11.01259916,-12,0.3733084461,0.9332711153,-10.63929071
28,15,2002,105,87,-189,292,4,18,-185,-172,10485,9.9328351149,8.2300633809,-17.87910321,-5,0.3783937187,1.702771734,-17.50070949
28,15,2003,108,99,-53,342,4,9,-49,-51,10434,10.325541374,9.4650795927,-5.067163822,-11,0.3824274583,0.8604617812,-4.684736364
28,15,2004,108,102,-56,357,3,6,-53,-55,10379,10.378129054,9.8015663287,-5.381252102,-8,0.2882813626,0.5765627252,-5.092970739
28,15,2005,96,119,-98,357,4,-23,-94,-126,10253,9.305932532,11.535478868,-9.499806126,-9,0.3877471888,-2.229546336,-9.112058938
28,15,2006,112,113,-60,389,3,-1,-57,-62,10191,10.95675993,11.054588143,-5.869692819,-4,0.293484641,-0.097828214,-5.576208178
28,15,2007,139,78,55,388,4,61,59,112,10303,13.564945838,7.6119839953,5.3674246121,-8,0.3903581536,5.9529618425,5.7577827657
28,15,2008,134,89,26,388,3,45,29,64,10367,12.965650701,8.6115142719,2.5157232704,-10,0.290275762,4.3541364296,2.8059990324
28,17,2001,315,221,-66,208,27,94,-39,37,19443,16.216633633,11.377384231,-3.397770856,-18,1.3899971685,4.8392494015,-2.007773688
28,17,2002,295,216,-245,215,27,79,-218,-154,19289,15.232882371,11.153568109,-12.6510379,-15,1.3941960136,4.0793142621,-11.25684189
28,17,2003,290,172,-174,212,22,118,-152,-53,19236,15.055158988,8.9292667099,-9.033095393,-19,1.1421155094,6.1258922777,-7.890979883
28,17,2004,322,178,-198,202,20,144,-178,-50,19186,16.761230545,9.2655249597,-10.30659518,-16,1.0410702202,7.4957055853,-9.26552496
28,17,2005,257,177,-248,207,22,80,-226,-160,19026,13.451271852,9.2641055166,-12.98021564,-14,1.1514707422,4.1871663352,-11.8287449
28,17,2006,298,194,-225,204,21,104,-204,-108,18918,15.707358212,10.225595615,-11.85958254,-8,1.1068943707,5.4817625975,-10.75268817
28,17,2007,299,158,-135,204,21,141,-114,19,18937,15.797120592,8.3476423194,-7.132479197,-8,1.109496764,7.4494782724,-6.022982433
28,17,2008,299,185,-242,204,20,114,-222,-111,18826,15.835606281,9.7979503747,-12.81677833,-3,1.0592378783,6.0376559066,-11.75754045
28,19,2001,103,91,-146,316,2,12,-144,-138,9610,10.641595206,9.4017977064,-15.08420291,-6,0.2066329166,1.2397974997,-14.87757
28,19,2002,115,105,-34,305,2,10,-32,-30,9580,11.985409067,10.943199583,-3.543512246,-8,0.2084418968,1.0422094841,-3.335070349
28,19,2003,100,74,-85,304,1,26,-84,-67,9513,10.47504321,7.7515319751,-8.903786728,-9,0.1047504321,2.7235112345,-8.799036296
28,19,2004,97,84,-184,306,2,13,-182,-181,9332,10.294507827,8.9148315203,-19.52772619,-12,0.2122578933,1.3796763067,-19.31546829
28,19,2005,93,94,-58,301,2,-1,-56,-64,9268,10,10.107526882,-6.23655914,-7,0.2150537634,-0.107526882,-6.021505376
28,19,2006,102,98,-90,302,2,4,-88,-89,9179,11.058708733,10.625033881,-9.757684176,-5,0.2168374261,0.4336748523,-9.54084675
28,19,2007,132,76,-199,302,2,56,-197,-140,9039,14.491162586,8.3433966407,-21.84652541,1,0.2195630695,6.1477659458,-21.62696234
28,19,2008,106,82,25,302,2,24,27,51,9090,11.693970986,9.0462794418,2.7580120249,0,0.220640962,2.6476915439,2.9786529869
28,21,2001,169,117,-188,1761,0,52,-188,-145,11678,14.382366708,9.9570231054,-15.99931918,-9,0,4.4253436024,-15.99931918
28,21,2002,172,115,-184,1649,0,57,-184,-135,11543,14.814176823,9.9048275268,-15.84772404,-8,0,4.9093492959,-15.84772404
28,21,2003,156,103,-349,1594,-1,53,-350,-290,11253,13.686611686,9.0366731005,-30.61940691,7,-0.08773469,4.6499385857,-30.7071416
28,21,2004,146,92,-44,1528,2,54,-42,4,11257,12.972012439,8.1741448245,-3.909373612,-8,0.1776988005,4.7978676144,-3.731674811
28,21,2005,154,110,-18,1633,0,44,-18,16,11273,13.67066134,9.7647581003,-1.597869507,-10,0,3.9059032401,-1.597869507
28,21,2006,141,113,-238,1446,1,28,-237,-213,11060,12.627054135,10.119554023,-21.31375095,-4,0.0895535754,2.5075001119,-21.22419738
28,21,2007,163,94,-356,1236,0,69,-356,-279,10781,14.926056499,8.6076644842,-32.59923996,8,0,6.318392015,-32.59923996
28,21,2008,153,120,40,1236,1,33,41,67,10848,14.147672107,11.096213417,3.6987378057,-7,0.0924684451,3.0514586897,3.7912062509
28,23,2001,247,206,-168,181,0,41,-168,-140,17812,13.812772621,11.51996421,-9.394922268,-13,0,2.2928084107,-9.394922268
28,23,2002,226,183,-135,181,-1,43,-136,-107,17705,12.726300082,10.304924402,-7.601993412,-14,-0.056311062,2.4213756793,-7.658304474
28,23,2003,247,182,-172,181,-3,65,-175,-127,17578,14.001077006,10.316583057,-9.749737834,-17,-0.170053567,3.6844939489,-9.919791401
28,23,2004,238,193,-89,181,3,45,-86,-54,17524,13.560480884,10.996524415,-5.070936129,-13,0.1709304313,2.5639564697,-4.900005698
28,23,2005,212,194,-189,181,0,18,-189,-184,17340,12.161541992,11.128958238,-10.84212942,-13,0,1.032583754,-10.84212942
28,23,2006,239,189,75,180,2,50,77,119,17459,13.736026897,10.862381103,4.3104686916,-8,0.1149458318,2.8736457944,4.4254145234
28,23,2007,249,180,-159,166,0,69,-159,-105,17354,14.305001005,10.340964582,-9.134518714,-15,0,3.9640364232,-9.134518714
28,23,2008,235,187,-14,166,1,48,-13,24,17378,13.532189335,10.768167684,-0.806172982,-11,0.0575837844,2.7640216515,-0.748589197
28,25,2001,333,238,-259,422,5,95,-254,-175,21796,15.216944273,10.875773985,-11.8354011,-16,0.2284826467,4.3411702881,-11.60691845
28,25,2002,325,228,-36,433,2,97,-34,42,21838,14.896640235,10.450566072,-1.65008938,-21,0.0916716322,4.4460741624,-1.558417748
28,25,2003,296,227,-551,334,-5,69,-556,-475,21363,13.703386496,10.509015995,-25.50866878,12,-0.231476123,3.1943705007,-25.7401449
28,25,2004,291,235,-17,329,9,56,-8,34,21397,13.610851263,10.991580917,-0.795135641,-14,0.4209541628,2.6192703461,-0.374181478
28,25,2005,321,203,-394,343,4,118,-390,-288,21109,15.103750059,9.5515927163,-18.53855926,-16,0.1882087235,5.5521573425,-18.35035054
28,25,2006,304,204,-162,345,7,100,-155,-64,21045,14.423305024,9.6787967927,-7.686103335,-9,0.3321155762,4.7445082317,-7.353987759
28,25,2007,312,213,-191,345,4,99,-187,-82,20963,14.854313464,10.140925538,-9.093505999,6,0.1904399162,4.7133879261,-8.903066083
28,25,2008,320,226,-215,345,5,94,-210,-103,20860,15.302584702,10.807450446,-10.2814241,13,0.239102886,4.4951342563,-10.04232121
28,27,2001,597,350,-518,747,12,247,-506,-282,30268,19.632345687,11.509750403,-17.0344306,-23,0.3946200138,8.1225952843,-16.63981058
28,27,2002,539,355,-613,775,11,184,-602,-431,29837,17.935279927,11.812661176,-20.39763747,-13,0.366026121,6.1226187505,-20.03161135
28,27,2003,510,342,-737,794,7,168,-730,-556,29281,17.253628337,11.570080179,-24.93318448,6,0.2368145066,5.6835481579,-24.69636997
28,27,2004,546,337,-654,779,13,209,-641,-469,28812,18.797445475,11.60208631,-22.5156215,-37,0.4475582256,7.1953591655,-22.06806328
28,27,2005,475,344,-684,685,10,131,-674,-563,28249,16.648849477,12.057272042,-23.97434325,-20,0.3505020943,4.5915774347,-23.62384115
28,27,2006,513,303,-489,660,12,210,-477,-278,27971,18.249733191,10.779082177,-17.3959445,-11,0.4268943436,7.4706510139,-16.96905016
28,27,2007,527,320,-554,764,8,207,-546,-329,27642,18.952403215,11.508100624,-19.92339921,10,0.2877025156,7.4443025911,-19.63569669
28,27,2008,527,327,-588,764,9,200,-579,-370,27272,19.19364825,11.909531267,-21.41530393,9,0.3277852642,7.2841169829,-21.08751867
28,29,2001,454,314,-46,1266,3,140,-43,69,28831,15.765804872,10.904102929,-1.597416353,-28,0.1041793273,4.8617019429,-1.493237025
28,29,2002,425,271,-258,1286,-5,154,-263,-129,28702,14.77412963,9.4206803052,-8.968765752,-20,-0.17381329,5.3534493247,-9.142579042
28,29,2003,395,263,181,1293,-23,132,158,255,28957,13.701243518,9.1226001145,6.2782913335,-35,-0.797793926,4.5786434035,5.4804974072
28,29,2004,438,280,-115,1270,15,158,-100,37,28994,15.116218875,9.6633362668,-3.968870252,-21,0.5176787286,5.4528826077,-3.451191524
28,29,2005,443,320,-176,1236,1,123,-175,-80,28914,15.300131243,11.052013539,-6.078607446,-28,0.0345375423,4.2481177039,-6.044069904
28,29,2006,518,264,48,1253,9,254,57,297,29211,17.823655914,9.0838709677,1.6516129032,-14,0.3096774194,8.7397849462,1.9612903226
28,29,2007,508,302,-118,1268,1,206,-117,92,29303,17.363366032,10.322316027,-4.033222818,3,0.0341798544,7.0410500051,-3.999042964
28,29,2008,472,304,-153,1268,5,168,-148,28,29331,16.099873793,10.36941024,-5.218815022,8,0.1705495105,5.7304635536,-5.048265511
28,31,2001,317,195,-103,286,5,122,-98,7,19468,16.286059236,10.018238331,-5.291684862,-17,0.2568779059,6.2678209047,-5.034806956
28,31,2002,293,262,216,286,4,31,220,234,19702,14.9604289,13.377584886,11.028848609,-17,0.2042379372,1.5828440133,11.233086546
28,31,2003,284,214,244,290,4,70,248,307,20009,14.303341643,10.777870112,12.288786482,-11,0.2014555161,3.5254715318,12.490241998
28,31,2004,276,231,38,288,5,45,43,73,20082,13.768676262,11.523783393,1.8956873114,-15,0.249432541,2.2448928687,2.1451198523
28,31,2005,310,222,-117,265,5,88,-112,-41,20041,15.452483613,11.065972136,-5.832066396,-17,0.2492336067,4.3865114772,-5.582832789
28,31,2006,309,229,125,271,5,80,130,199,20240,15.342220898,11.370124873,6.2064000397,-11,0.2482560016,3.9720960254,6.4546560413
28,31,2007,335,236,4,271,5,99,9,112,20352,16.505715412,11.627906977,0.1970831691,4,0.2463539614,4.8778084352,0.4434371305
28,31,2008,315,230,76,271,5,85,81,174,20526,15.411712902,11.252996722,3.7183815255,8,0.2446303635,4.1587161799,3.963011889
28,33,2001,1782,804,3521,593,127,978,3648,4578,113246,16.060275602,7.2460502717,31.73301369,-48,1.1445875429,8.8142253305,32.877601233
28,33,2002,1795,822,3972,651,116,973,4088,5048,118294,15.504880366,7.1002850479,34.309406582,-13,1.0019866978,8.4045953183,35.31139328
28,33,2003,1823,837,4281,651,94,986,4375,5509,123803,15.060079224,6.9145838238,35.365989665,148,0.7765482431,8.1454954006,36.142537908
28,33,2004,1917,878,5360,626,97,1039,5457,6245,130048,15.103348027,6.9174436973,42.229496831,-251,0.7642278344,8.1859043297,42.993724665
28,33,2005,2034,968,4853,650,101,1066,4954,5918,135966,15.292428218,7.277812446,36.486801447,-102,0.75935853,8.0146157721,37.246159977
28,33,2006,2058,886,6462,656,102,1172,6564,7646,143612,14.722188441,6.3381238867,46.226813269,-90,0.7296711472,8.3840645544,46.956484416
28,33,2007,2280,919,4028,656,89,1361,4117,5524,149136,15.576536817,6.2784374274,27.518548376,46,0.608031481,9.2980993892,28.126579857
28,33,2008,2322,983,4138,656,90,1339,4228,5612,154748,15.282147135,6.4695739164,27.234076161,45,0.5923312843,8.8125732187,27.826407445
28,35,2001,1088,709,-9,5455,113,379,104,408,73227,14.899415253,9.7092696822,-0.123248839,-75,1.5474576503,5.1901455706,1.4242088109
28,35,2002,1079,745,-64,5448,86,334,22,283,73510,14.706583888,10.154221498,-0.872308961,-73,1.1721651662,4.5523623899,0.2998562053
28,35,2003,1080,700,414,5404,32,380,446,730,74240,14.61928934,9.475465313,5.6040609137,-96,0.4331641286,5.1438240271,6.0372250423
28,35,2004,1113,727,39,5353,121,386,160,494,74734,14.94220468,9.7600923651,0.5235812961,-52,1.6244445339,5.1821123149,2.14802583
28,35,2005,1126,694,390,5397,92,432,482,851,75585,14.981472735,9.2336963391,5.1889648015,-63,1.2240634916,5.7477763955,6.4130282932
28,35,2006,1165,723,1090,5231,112,442,1202,1601,77186,15.251585707,9.4651471811,14.269723966,-43,1.4662468662,5.7864385256,15.735970832
28,35,2007,1303,677,718,5728,81,626,799,1425,78611,16.726894613,8.6907963568,9.2171222809,0,1.0398146306,8.0360982561,10.256936911
28,35,2008,1287,689,123,5728,89,598,212,814,79425,16.287428181,8.7195322585,1.5566073553,4,1.1263256473,7.5678959224,2.6829330026
28,37,2001,113,101,-113,94,1,12,-112,-109,8342,13.457988448,12.028821533,-13.45798845,-9,0.1190972429,1.4291669148,-13.3388912
28,37,2002,97,101,-131,94,1,-4,-130,-139,8203,11.725596857,12.209126624,-15.83559988,-5,0.1208824418,-0.483529767,-15.71471744
28,37,2003,99,85,26,93,1,14,27,31,8234,12.045993794,10.342519925,3.1635943299,-10,0.121676705,1.7034738699,3.2852710349
28,37,2004,117,79,35,93,0,38,35,66,8300,14.152655135,9.5560662876,4.233700254,-7,0,4.5965888472,4.233700254
28,37,2005,97,106,-93,93,1,-9,-92,-107,8193,11.762565937,12.853938034,-11.27751167,-6,0.1212635664,-1.091372097,-11.15624811
28,37,2006,119,75,3,94,0,44,3,43,8236,14.486578611,9.1301966036,0.3652078641,-4,0,5.3563820074,0.3652078641
28,37,2007,117,52,14,94,1,65,15,67,8303,14.148376564,6.288167362,1.6929681359,-13,0.1209262954,7.8602092025,1.8138944313
28,37,2008,125,77,-22,94,0,48,-22,13,8316,15.043023046,9.2665021963,-2.647572056,-13,0,5.7765208496,-2.647572056
28,39,2001,340,217,145,400,14,123,159,265,19460,17.591514681,11.227525547,7.502263614,-17,0.7243564869,6.3639891347,8.2266201009
28,39,2002,364,199,224,601,12,165,236,391,19851,18.518989596,10.124392664,11.39630129,-10,0.6105161405,8.3945969322,12.00681743
28,39,2003,337,206,269,643,6,131,275,393,20244,16.810076069,10.275595461,13.418131937,-13,0.2992891882,6.5344806086,13.717421125
28,39,2004,319,238,111,673,15,81,126,191,20435,15.683768038,11.701369257,5.4573612921,-16,0.7374812557,3.9823987807,6.1948425478
28,39,2005,331,219,295,666,12,112,307,403,20838,16.039541589,10.612264677,14.295059724,-16,0.5814939549,5.4272769123,14.876553679
28,39,2006,340,195,540,707,15,145,555,687,21525,16.051743267,9.2061468735,25.493945188,-13,0.7081651441,6.8455963931,26.202110332
28,39,2007,417,224,204,706,11,193,215,411,21936,19.189618278,10.308092313,9.3877269276,3,0.5062009618,8.8815259658,9.8939278894
28,39,2008,387,202,278,706,12,185,290,470,22406,17.455234315,9.111000857,12.53890217,-5,0.5412475757,8.3442334581,13.080149745
28,41,2001,151,109,-124,2157,0,42,-124,-92,13213,11.388490836,8.2208311336,-9.35213817,-10,0,3.1676597028,-9.35213817
28,41,2002,152,116,1,2296,-1,36,0,22,13235,11.494252874,8.7719298246,0.0756200847,-14,-0.075620085,2.722323049,0
28,41,2003,148,129,57,2427,-5,19,52,56,13291,11.158863002,9.7263062656,4.2976702104,-15,-0.376988615,1.4325567368,3.9206815954
28,41,2004,144,121,-192,2441,3,23,-189,-180,13111,10.908264525,9.1659722748,-14.5443527,-14,0.2272555109,1.7422922506,-14.31709719
28,41,2005,149,120,8,2450,0,29,8,25,13136,11.353678516,9.1439021602,0.6095934773,-12,0,2.2097763554,0.6095934773
28,41,2006,158,130,-163,2265,2,28,-161,-138,12998,12.091528277,9.9487257978,-12.47417158,-5,0.15305732,2.1428024795,-12.32111426
28,41,2007,148,112,642,2842,0,36,642,689,13687,11.092373993,8.3942289676,48.116919618,11,0,2.6981450253,48.116919618
28,41,2008,160,99,76,2842,1,61,77,131,13818,11.634248318,7.1986911471,5.5262679513,-7,0.072714052,4.4355571714,5.5989820033
28,43,2001,339,316,-168,520,14,23,-154,-149,23042,14.664849783,13.669889473,-7.267536175,-18,0.6056280146,0.9949603097,-6.661908161
28,43,2002,265,301,-62,516,12,-36,-50,-107,22935,11.527502882,13.093503273,-2.697000674,-21,0.5220001305,-1.566000392,-2.175000544
28,43,2003,278,311,-130,502,5,-33,-125,-180,22755,12.168964763,13.613482162,-5.69052309,-22,0.2188662727,-1.4445174,-5.471656818
28,43,2004,297,321,-50,520,16,-24,-34,-76,22679,13.073909407,14.130386935,-2.20099485,-18,0.7043183519,-1.056477528,-1.496676498
28,43,2005,322,295,26,515,12,27,38,44,22723,14.184397163,12.995022246,1.1453239945,-21,0.5286110744,1.1893749174,1.6739350689
28,43,2006,338,265,170,489,14,73,184,245,22968,14.795036222,11.599658576,7.4412904073,-12,0.6128121512,3.1953776455,8.0541025585
28,43,2007,344,255,-22,489,10,89,-12,77,23045,14.95229609,11.083824137,-0.956251494,0,0.4346597701,3.8684719536,-0.521591724
28,43,2008,344,289,-126,489,11,55,-115,-50,22995,14.943527368,12.554300608,-5.473501303,10,0.4778453519,2.3892267593,-4.995655951
28,45,2001,551,464,508,451,13,87,521,574,43848,12.648929088,10.651729758,11.66180758,-34,0.2984320837,1.9971993297,11.960239664
28,45,2002,530,459,534,455,6,71,540,587,44435,12.006841634,10.398377944,12.097459307,-24,0.1359265091,1.6084636906,12.233385816
28,45,2003,521,408,339,471,-9,113,330,400,44835,11.672454352,9.1408087823,7.5949367089,-43,-0.201635488,2.5316455696,7.393301221
28,45,2004,535,456,560,481,20,79,580,610,45445,11.85201595,10.101905184,12.405848471,-49,0.4430660168,1.7501107665,12.848914488
28,45,2005,547,457,586,465,11,90,597,643,46088,11.951973605,9.9854697213,12.804125288,-44,0.2403504747,1.9665038838,13.044475763
28,45,2006,415,434,-7227,344,17,-19,-7210,-7235,38853,9.7714884449,10.218857795,-170.1651735,-6,0.4002778399,-0.44736935,-169.7648956
28,45,2007,508,309,762,344,7,199,769,888,39741,12.92719546,7.8631956638,19.39079319,-80,0.1781306461,5.0639997964,19.568923836
28,45,2008,469,346,393,344,10,123,403,399,40140,11.74246692,8.662886043,9.8396364592,-127,0.250372429,3.0795808766,10.090008888
28,47,2001,2940,1747,-776,7200,110,1193,-666,360,190232,15.469450466,9.1922210763,-4.083093048,-167,0.578788963,6.2772293899,-3.504304085
28,47,2002,2914,1781,401,6976,-292,1133,109,1063,191295,15.27545888,9.3361675583,2.1020792762,-179,-1.530691144,5.9392913215,0.5713881324
28,47,2003,2918,1800,-81,6616,-1119,1118,-1200,-362,190933,15.26837385,9.4184622791,-0.423830803,-280,-5.85514405,5.8499115711,-6.278974853
28,47,2004,2949,1808,1966,7314,688,1141,2654,3611,194544,15.300523767,9.3805856121,10.200349178,-184,3.5696033745,5.9199381545,13.769952552
28,47,2005,2978,1825,167,7161,67,1153,234,1212,195756,15.260056367,9.3517806815,0.8557519857,-175,0.3433256469,5.9082756854,1.1990776326
28,47,2006,2522,1806,-23935,6952,419,716,-23516,-22801,172955,13.680090911,9.7962903195,-129.8306804,-1,2.2727827485,3.8838005918,-127.5578976
28,47,2007,2902,1504,2197,6879,50,1398,2247,3411,176366,16.615090418,8.6109910369,12.57868837,-234,0.2862696488,8.0040993814,12.864958019
28,47,2008,2824,1549,1034,6879,174,1275,1208,2094,178460,15.917661051,8.7310400027,5.8282087558,-389,0.9807624019,7.1866210481,6.8089711577
28,49,2001,3920,2074,-2930,10004,126,1846,-2804,-1170,249426,15.67931011,8.2956349921,-11.71948434,-212,0.503977825,7.3836751183,-11.21550652
28,49,2002,3852,2062,-2472,9735,111,1790,-2361,-778,248648,15.467581122,8.2798941523,-9.926235861,-207,0.4457169015,7.1876869702,-9.480518959
28,49,2003,3872,2113,-1740,9629,57,1759,-1683,-219,248429,15.579075274,8.5017009437,-7.000927422,-295,0.2293407259,7.0773743303,-6.771586696
28,49,2004,3930,2054,-811,9482,112,1876,-699,1009,249438,15.78734883,8.2511996176,-3.257898194,-168,0.449919356,7.5361492125,-2.807978838
28,49,2005,3914,2053,-2268,9646,92,1861,-2176,-518,248920,15.707583705,8.2390570634,-9.101890609,-203,0.3692124938,7.4685266415,-8.732678115
28,49,2006,4065,2087,160,9734,105,1978,265,2124,251044,16.261170804,8.3486010993,0.6400460833,-119,0.4200302422,7.912569705,1.0600763255
28,49,2007,4146,1947,-4127,9953,88,2199,-4039,-1889,249155,16.577402194,7.7849016092,-16.50143243,-49,0.3518599597,8.7925005848,-16.14957247
28,49,2008,4045,1983,-3545,9953,93,2062,-3452,-1505,247650,16.284055112,7.9830114431,-14.27119292,-115,0.3743923672,8.301043669,-13.89680056
28,51,2001,412,282,-313,887,-1,130,-314,-201,21387,19.173938336,13.12390925,-14.56660849,-17,-0.046538685,6.0500290867,-14.61314718
28,51,2002,346,249,-288,872,-1,97,-289,-203,21184,16.2551972,11.698104343,-13.53033755,-11,-0.046980339,4.5570928566,-13.57731789
28,51,2003,345,239,-461,911,-3,106,-464,-365,20819,16.427398043,11.380139514,-21.95081304,-7,-0.14284694,5.0472585292,-22.09365998
28,51,2004,403,286,-159,954,1,117,-158,-57,20762,19.383853202,13.756282918,-7.64772372,-16,0.0480988913,5.6275702845,-7.599624829
28,51,2005,388,269,-267,931,-1,119,-268,-165,20597,18.762542615,13.008051452,-12.91133731,-16,-0.048357069,5.7544911627,-12.95969438
28,51,2006,402,243,-140,996,1,159,-139,9,20606,19.513142247,11.795257627,-6.795621678,-11,0.0485401548,7.7178846201,-6.747081523
28,51,2007,421,206,-342,1021,-1,215,-343,-123,20483,20.492102509,10.027014529,-16.64679111,5,-0.048674828,10.46508798,-16.69546594
28,51,2008,396,238,-55,1021,0,158,-55,112,20595,19.280393398,11.587711184,-2.677832416,9,0,7.6926822143,-2.677832416
28,53,2001,209,116,-191,97,9,93,-182,-97,11036,18.855158104,10.465063828,-17.23126889,-8,0.8119446073,8.3900942758,-16.41932428
28,53,2002,219,140,-446,95,9,79,-437,-355,10681,20.168531565,12.893125201,-41.07381314,3,0.828843763,7.2754063637,-40.24496938
28,53,2003,210,140,-293,93,9,70,-284,-208,10473,19.854401059,13.236267373,-27.70161672,6,0.8509029025,6.6181336863,-26.85071381
28,53,2004,188,108,-188,94,8,80,-180,-111,10362,18.046556275,10.367170626,-18.04655628,-11,0.7679385649,7.6793856491,-17.27861771
28,53,2005,182,105,-285,92,9,77,-276,-207,10155,17.741385193,10.235414534,-27.78183945,-8,0.8773212458,7.5059706585,-26.9045182
28,53,2006,217,129,-155,91,8,88,-147,-65,10090,21.437391949,12.74388738,-15.31242282,-6,0.7903185972,8.693504569,-14.52210422
28,53,2007,244,95,-252,91,9,149,-243,-86,10004,24.285856475,9.4555588733,-25.08211406,8,0.895789788,14.830297601,-24.18632428
28,53,2008,217,130,-4,91,8,87,4,85,10089,21.599562037,12.939829791,-0.398148609,-6,0.7962972179,8.6597322451,0.398148609
28,55,2001,21,14,-99,213,1,7,-98,-92,2175,9.4552003602,6.3034669068,-44.57451598,-1,0.4502476362,3.1517334534,-44.12426835
28,55,2002,19,11,-132,213,1,8,-131,-122,2053,8.9877010407,5.2034058657,-62.44087039,1,0.4730368969,3.784295175,-61.96783349
28,55,2003,17,16,-34,247,1,1,-33,-33,2020,8.3476552909,7.8566167444,-16.69531058,-1,0.4910385465,0.4910385465,-16.20427204
28,55,2004,20,11,-126,261,0,9,-126,-122,1898,10.209290454,5.6151097499,-64.31852986,-5,0,4.5941807044,-64.31852986
28,55,2005,12,12,-81,260,1,0,-80,-81,1817,6.4602960969,6.4602960969,-43.60699865,-1,0.5383580081,0,-43.06864065
28,55,2006,23,16,-66,283,0,7,-66,-58,1759,12.863534676,8.9485458613,-36.91275168,1,0,3.9149888143,-36.91275168
28,55,2007,18,10,-105,279,1,8,-104,-98,1661,10.526315789,5.8479532164,-61.40350877,-2,0.5847953216,4.6783625731,-60.81871345
28,55,2008,14,4,-8,279,0,10,-8,-3,1658,8.4362759867,2.4103645676,-4.820729135,-5,0,6.0259114191,-4.820729135
28,57,2001,275,299,22,783,1,-24,23,-23,22825,12.042125545,13.093074683,0.9633700436,-22,0.0437895474,-1.050949138,1.007159591
28,57,2002,267,284,-19,797,1,-17,-18,-58,22767,11.712581155,12.458326022,-0.833479558,-23,0.0438673451,-0.745744868,-0.789612213
28,57,2003,262,269,198,899,0,-7,198,164,22931,11.466584971,11.772944111,8.6655871154,-27,0,-0.30635914,8.6655871154
28,57,2004,294,306,-13,892,3,-12,-10,-37,22894,12.831423895,13.355155483,-0.567375887,-15,0.1309328969,-0.523731588,-0.43644299
28,57,2005,296,288,131,900,2,8,133,121,23015,12.89507504,12.546559498,5.7069419939,-20,0.0871288854,0.3485155416,5.7940708793
28,57,2006,275,276,-22,907,4,-1,-18,-29,22986,11.95626182,11.999739136,-0.956500946,-10,0.1739092628,-0.043477316,-0.782591683
28,57,2007,303,240,-26,907,3,63,-23,46,23032,13.16876005,10.43070103,-1.129992612,6,0.1303837629,2.7380590204,-0.999608849
28,57,2008,306,250,71,907,4,56,75,143,23175,13.244746467,10.820871297,3.0731274482,12,0.1731339407,2.4238751704,3.246261389
28,59,2001,1900,1157,-28,2261,115,743,87,696,132531,14.374011787,8.7530166512,-0.211827542,-134,0.8700059766,5.6209951355,0.6581784344
28,59,2002,1856,1140,-712,2048,-25,716,-737,-131,132400,14.011195368,8.6060143962,-5.37498443,-110,-0.188728386,5.4051809716,-5.563712816
28,59,2003,1829,1220,208,2156,-316,609,-108,299,132699,13.798618629,9.2041086537,1.569225082,-202,-2.384015028,4.5945099755,-0.814789946
28,59,2004,1848,1149,401,2078,290,699,691,1295,133994,13.85863146,8.6166491059,3.0072030387,-95,2.17478524,5.2419823542,5.1819882787
28,59,2005,1838,1220,-332,1742,85,618,-247,249,134243,13.70429881,9.0964333779,-2.475422854,-122,0.6337678993,4.6078654324,-1.841654954
28,59,2006,1726,1253,-6928,1200,209,473,-6719,-6282,127961,13.165321658,9.5574438224,-52.8443502,-36,1.5941785785,3.6078778356,-51.25017162
28,59,2007,2003,1094,1418,1252,75,909,1493,2240,130201,15.517388307,8.475298456,10.985350284,-162,0.5810305157,7.0420898506,11.5663808
28,59,2008,1902,1104,-146,1252,118,798,-28,493,130694,14.580578394,8.4631748405,-1.119224209,-277,0.9045784703,6.1174035532,-0.214645739
28,61,2001,304,207,103,162,5,97,108,188,18319,16.680384088,11.358024691,5.6515775034,-17,0.2743484225,5.3223593964,5.9259259259
28,61,2002,250,187,-153,164,5,63,-148,-97,18222,13.6832599,10.235078405,-8.374155059,-12,0.273665198,3.4481814948,-8.100489861
28,61,2003,212,172,-187,164,2,40,-185,-159,18063,11.685269395,9.4805015847,-10.30728951,-14,0.1102383905,2.2047678104,-10.19705112
28,61,2004,274,156,-145,164,5,118,-140,-38,18025,15.185103081,8.6455331412,-8.035912215,-16,0.2771004212,6.5395699401,-7.758811793
28,61,2005,229,157,-254,164,3,72,-251,-194,17831,12.773315484,8.7572512271,-14.16778224,-15,0.1673360107,4.016064257,-14.00044623
28,61,2006,247,194,81,163,4,53,85,129,17960,13.802352547,10.840714146,4.5262775558,-9,0.2235198793,2.9616384007,4.7497974351
28,61,2007,290,186,-2,163,2,104,0,97,18057,16.103506677,10.328456007,-0.111058667,-7,0.1110586667,5.7750506705,0
28,61,2008,272,185,106,163,3,87,109,196,18253,14.982098595,10.190030295,5.8386119526,0,0.1652437345,4.7920683007,6.0038556871
28,63,2001,154,90,-138,637,0,64,-138,-82,9622,15.937079582,9.3138776777,-14.28127911,-8,0,6.6232019042,-14.28127911
28,63,2002,128,88,-98,632,0,40,-98,-66,9556,13.348628637,9.1771821879,-10.2200438,-8,0,4.1714464491,-10.2200438
28,63,2003,130,99,-248,627,-1,31,-249,-220,9336,13.762439128,10.48062672,-26.25449926,-2,-0.105864916,3.2818124074,-26.36036418
28,63,2004,133,86,-81,662,0,47,-81,-41,9295,14.277279802,9.2319252858,-8.695185444,-7,0,5.0453545167,-8.695185444
28,63,2005,135,93,-239,644,0,42,-239,-201,9094,14.682690739,10.114742509,-25.99380064,-4,0,4.5679482299,-25.99380064
28,63,2006,119,72,-169,663,0,47,-169,-126,8968,13.176835345,7.9725390322,-18.71332078,-4,0,5.2042963127,-18.71332078
28,63,2007,136,54,-68,689,0,82,-68,-2,8966,15.166722427,6.0220809635,-7.583361213,-16,0,9.1446414631,-7.583361213
28,63,2008,132,73,-135,689,0,59,-135,-94,8872,14.799865456,8.1847740778,-15.13622603,-18,0,6.615091378,-15.13622603
28,65,2001,196,148,-262,96,-1,48,-263,-226,13644,14.247292288,10.758159482,-19.04484989,-11,-0.072690267,3.4891328051,-19.11754016
28,65,2002,162,136,-238,99,-1,26,-239,-222,13422,11.970738196,10.049508609,-17.58664007,-9,-0.073893446,1.9212295869,-17.66053351
28,65,2003,159,151,-184,104,-3,8,-187,-192,13230,11.931562359,11.331232178,-13.80759418,-13,-0.225123818,0.6003301816,-14.03271799
28,65,2004,162,135,-319,105,1,27,-318,-308,12922,12.38910982,10.324258183,-24.39583971,-17,0.0764759865,2.0648516366,-24.31936372
28,65,2005,151,148,-73,105,-1,3,-74,-82,12840,11.722692338,11.489791165,-5.667261859,-11,-0.077633724,0.2329011723,-5.744895583
28,65,2006,194,154,78,105,0,40,78,111,12951,15.0440076,11.942150363,6.0486216122,-7,0,3.101857237,6.0486216122
28,65,2007,197,138,-212,105,-1,59,-213,-156,12795,15.303348093,10.720111862,-16.46857764,-2,-0.07768197,4.5832362309,-16.54625961
28,65,2008,179,158,-162,105,0,21,-162,-142,12653,14.067903175,12.41747878,-12.73184533,-1,0,1.6504243948,-12.73184533
28,67,2001,1078,715,-619,1724,158,363,-461,-151,64837,16.606970922,11.014827653,-9.53591373,-53,2.4340458309,5.5921432698,-7.101867899
28,67,2002,979,687,-343,1690,146,292,-197,39,64876,15.094863275,10.592616006,-5.288598676,-56,2.2511236345,4.502247269,-3.037475041
28,67,2003,952,693,-300,1792,121,259,-179,3,64879,14.673808331,10.6816693,-4.624099264,-77,1.8650533698,3.9921390313,-2.759045894
28,67,2004,1023,733,-23,1791,121,290,98,344,65223,15.726122581,11.268081966,-0.353568738,-44,1.8600790149,4.4580406143,1.5065102766
28,67,2005,1061,723,89,1815,123,338,212,488,65711,16.206638459,11.043731957,1.3594635465,-62,1.878809171,5.1629065025,3.2382727176
28,67,2006,1090,726,-62,1800,125,364,63,396,66107,16.537953845,11.015187607,-0.940690953,-31,1.8965543401,5.5227662383,0.9558633874
28,67,2007,1200,717,7,1841,112,483,119,588,66695,18.072016988,10.79803015,0.1054200991,-14,1.6867215855,7.2739868375,1.7921416846
28,67,2008,1152,697,-53,1841,113,455,60,503,67198,17.207770384,10.411298574,-0.791676936,-12,1.6879149769,6.7964718096,0.8962380408
28,69,2001,152,100,120,620,2,52,122,166,10592,14.463792939,9.5156532496,11.4187839,-8,0.190313065,4.9481396898,11.609096965
28,69,2002,117,123,-144,576,2,-6,-142,-157,10435,11.128549008,11.699243829,-13.6966757,-9,0.190231607,-0.570694821,-13.5064441
28,69,2003,137,109,-58,597,2,28,-56,-45,10390,13.157262905,10.468187275,-5.570228091,-17,0.1920768307,2.6890756303,-5.378151261
28,69,2004,142,108,-69,644,1,34,-68,-41,10349,13.694006461,10.415159844,-6.6541299,-7,0.0964366652,3.2788466175,-6.557693235
28,69,2005,109,91,-158,650,2,18,-156,-145,10204,10.606724079,8.8551549652,-15.37488445,-7,0.1946187904,1.751569114,-15.18026565
28,69,2006,131,90,-117,625,1,41,-116,-80,10124,12.888626525,8.8547815821,-11.51121606,-5,0.098386462,4.0338449429,-11.41282959
28,69,2007,148,73,-117,621,2,75,-115,-42,10082,14.649114125,7.2255765614,-11.5807186,-2,0.1979610017,7.4235375631,-11.3827576
28,69,2008,135,91,-164,621,1,44,-163,-115,9967,13.467005836,9.0777594893,-16.3599182,4,0.0997555988,4.3892463465,-16.2601626
28,71,2001,415,299,211,4881,61,116,272,355,39117,10.65755852,7.6785783074,5.4186622838,-33,1.5665326982,2.9789802129,6.985194982
28,71,2002,453,328,270,5008,56,125,326,412,39529,11.519975587,8.3411743763,6.8662106147,-39,1.4241029423,3.1788012105,8.290313557
28,71,2003,492,304,892,5372,43,188,935,1120,40649,12.272693258,7.5831275412,22.250492654,-3,1.0726134351,4.6895657163,23.323106089
28,71,2004,477,285,86,4981,55,192,141,308,40957,11.690316888,6.9847805308,2.1076881602,-25,1.3479401024,4.7055363576,3.4556282626
28,71,2005,498,342,148,4513,51,156,199,318,41275,12.112073159,8.3179297597,3.5995719428,-37,1.2403930343,3.7941433992,4.8399649771
28,71,2006,516,335,1230,5090,54,181,1284,1441,42716,12.287030753,7.9770451596,29.288852377,-24,1.2858520556,4.3099855937,30.574704433
28,71,2007,546,336,193,5007,46,210,239,437,43153,12.717045732,7.8258742969,4.4952194622,-12,1.0713994573,4.8911714356,5.5666189195
28,71,2008,551,330,496,5007,47,221,543,769,43922,12.655756532,7.579672696,11.392477749,5,1.0795291415,5.0760838358,12.472006891
28,73,2001,590,278,332,475,8,312,340,617,39952,14.882641543,7.0124988964,8.3746389698,-35,0.2017985294,7.8701426463,8.5764374992
28,73,2002,627,314,685,475,-1,313,684,976,40928,15.504451039,7.7645895153,16.93867458,-21,-0.024727992,7.7398615232,16.913946588
28,73,2003,625,311,423,468,-24,314,399,681,41609,15.144722973,7.5360141512,10.249948508,-32,-0.581557362,7.6087088215,9.6683911458
28,73,2004,671,303,927,477,19,368,946,1256,42865,15.886544972,7.1738049577,21.947581504,-58,0.4498425551,8.7127400147,22.397424059
28,73,2005,697,325,946,483,4,372,950,1285,44150,16.020226398,7.4699764408,21.743377579,-37,0.0919381716,8.5502499569,21.83531575
28,73,2006,740,353,1396,481,13,387,1409,1766,45916,16.432394022,7.8386960673,30.999489263,-30,0.2886771923,8.5936979548,31.288166456
28,73,2007,817,311,1218,481,3,506,1221,1732,47648,17.463981873,6.647856013,26.035654739,5,0.0641272284,10.81612586,26.099781967
28,73,2008,828,317,955,481,7,511,962,1473,49121,17.112918393,6.5516849404,19.737725925,0,0.1446744309,10.561233453,19.882400355
28,75,2001,1154,976,-687,3477,1,178,-686,-570,77511,14.833667541,12.545632166,-8.830788215,-62,0.0128541313,2.2880353746,-8.817934084
28,75,2002,1169,955,31,3383,-66,214,-35,100,77611,15.072007839,12.31288921,0.3996854089,-79,-0.850943129,2.7591186292,-0.45125772
28,75,2003,1151,971,202,3595,-206,180,-4,75,77686,14.823209721,12.505070929,2.6014668667,-101,-2.652981062,2.3181387921,-0.051514195
28,75,2004,1239,926,-718,3475,103,313,-615,-373,77313,15.987199917,11.948464184,-9.2645759,-71,1.3290408325,4.0387357338,-7.935535068
28,75,2005,1143,942,-329,3605,-4,201,-333,-201,77112,14.803302574,12.200097135,-4.260968107,-69,-0.051805083,2.6032054395,-4.312773191
28,75,2006,1170,910,-555,3762,55,260,-500,-276,76836,15.199937641,11.822173721,-7.21022683,-36,0.7145269831,3.3777639203,-6.495699847
28,75,2007,1282,899,681,4521,-9,383,672,1081,77917,16.568337932,11.618514665,8.8011217876,26,-0.116314385,4.9498232668,8.6848074028
28,75,2008,1256,913,-134,4521,13,343,-121,263,78180,16.092557833,11.697854539,-1.71688117,41,0.1665630986,4.3947032935,-1.550318071
28,77,2001,187,145,9,93,1,42,10,39,13320,14.059621819,10.901845795,0.6766662907,-13,0.0751851434,3.1577760235,0.7518514342
28,77,2002,182,147,-102,93,0,35,-102,-78,13242,13.703787365,11.068443641,-7.680144567,-11,0,2.6353437241,-7.680144567
28,77,2003,174,145,58,93,-4,29,54,68,13310,13.106357337,10.921964447,4.3687857788,-15,-0.301295571,2.1843928894,4.0674902079
28,77,2004,181,130,-70,92,3,51,-67,-26,13284,13.612092953,9.7766413477,-5.264345341,-10,0.2256148003,3.8354516056,-5.038730541
28,77,2005,174,143,-57,91,0,31,-57,-38,13246,13.117225782,10.780248775,-4.297022239,-12,0,2.3369770072,-4.297022239
28,77,2006,165,147,-9,93,2,18,-7,6,13252,12.453770096,11.095176994,-0.679296551,-5,0.150954789,1.3585931014,-0.528341762
28,77,2007,213,114,-18,93,0,99,-18,78,13330,16.025882176,8.5772327139,-1.354299902,-3,0,7.448649462,-1.354299902
28,77,2008,203,127,-35,93,1,76,-34,40,13370,15.205992509,9.5131086142,-2.621722846,-2,0.074906367,5.6928838951,-2.546816479
28,79,2001,376,234,377,1086,12,142,389,519,21449,17.744637674,11.043205361,17.79183086,-12,0.5663182236,6.7014323132,18.358149083
28,79,2002,346,250,137,1201,12,96,149,228,21677,16.04600473,11.593934054,6.3534758614,-17,0.5565088346,4.4520706766,6.909984696
28,79,2003,368,254,163,1455,10,114,173,269,21946,16.871833666,11.645233019,7.4731219769,-18,0.4584737409,5.2266006464,7.9315957179
28,79,2004,361,251,148,1495,12,110,160,251,22197,16.355934123,11.372131482,6.7054799175,-19,0.5436875609,4.9838026414,7.2491674784
28,79,2005,364,260,108,1641,10,104,118,201,22398,16.324700078,11.660500056,4.843592331,-21,0.4484807714,4.6642000224,5.2920731024
28,79,2006,411,286,116,1729,11,125,127,239,22637,18.252470301,12.701232375,5.1515487954,-13,0.4885089375,5.5512379261,5.6400577329
28,79,2007,449,270,33,1738,10,179,43,217,22854,19.740168385,11.870479875,1.4508364292,-5,0.4396474028,7.8696885098,1.890483832
28,79,2008,407,266,-170,1738,11,141,-159,-10,22844,17.812595737,11.641647337,-7.440150554,8,0.4814215064,6.1709484004,-6.958729047
28,81,2001,1284,783,143,1354,44,501,187,612,76573,16.835590754,10.26656352,1.8749918051,-76,0.5769205554,6.5690272333,2.4519123605
28,81,2002,1164,747,-198,1358,40,417,-158,188,76761,15.182542685,9.7434358981,-2.582597467,-71,0.521736862,5.4391067865,-2.060860605
28,81,2003,1165,740,236,1355,23,425,259,579,77340,15.119953797,9.6040908236,3.0629262626,-105,0.2985055256,5.515862973,3.3614317882
28,81,2004,1218,701,-116,1355,38,517,-78,384,77724,15.70964247,9.0414280555,-1.496156426,-55,0.4901202084,6.6682144147,-1.006036217
28,81,2005,1261,743,4,1356,32,518,36,484,78208,16.173716748,9.5297950389,0.0513044147,-70,0.410435318,6.6439217095,0.4617397327
28,81,2006,1226,799,694,1352,35,427,729,1114,79322,15.565289151,10.144099537,8.8110201232,-42,0.4443598045,5.4211896147,9.2553799276
28,81,2007,1308,1012,614,1352,27,296,641,887,80209,16.398066833,12.687189324,7.697563483,-50,0.3384922053,3.7108775097,8.0360556882
28,81,2008,1326,851,426,1352,28,475,454,930,81139,16.4365223,10.548627811,5.280511689,1,0.3470758857,5.8878944889,5.6275875747
28,83,2001,567,426,-930,2815,15,141,-915,-788,37043,15.145444347,11.379116916,-24.84173411,-14,0.4006731309,3.7663274301,-24.44106098
28,83,2002,591,413,-791,2804,15,178,-776,-607,36436,16.086228718,11.24130704,-21.52996094,-9,0.4082799167,4.8449216783,-21.12168102
28,83,2003,602,407,-1568,1959,12,195,-1556,-1298,35138,16.821750915,11.372844888,-43.81479308,63,0.335317294,5.4489060273,-43.47947579
28,83,2004,589,377,463,2897,14,212,477,653,35791,16.608157453,10.630348659,13.05530883,-36,0.3947609581,5.9778087947,13.450069788
28,83,2005,554,401,-624,2799,12,153,-612,-488,35303,15.585000141,11.280839452,-17.55422399,-29,0.3375812305,4.3041606887,-17.21664275
28,83,2006,599,364,-347,2839,14,235,-333,-113,35190,16.994595208,10.327266537,-9.844949144,-15,0.3972025591,6.6673286709,-9.447746585
28,83,2007,625,356,-304,2993,11,269,-293,-17,35173,17.765018547,10.118954564,-8.640905021,7,0.3126643264,7.6460639825,-8.328240695
28,83,2008,597,365,-250,2993,12,232,-238,12,35185,16.97035163,10.375508116,-7.106512408,18,0.3411125956,6.5948435146,-6.765399812
28,85,2001,475,371,-57,645,5,104,-52,17,33166,14.325567368,11.189022092,-1.719068084,-35,0.150795446,3.1365452763,-1.568272638
28,85,2002,433,372,99,650,4,61,103,131,33297,13.029806058,11.194198276,2.979101154,-33,0.1203677234,1.8356077818,3.0994688774
28,85,2003,453,384,30,651,4,69,34,55,33352,13.593602305,11.523053609,0.9002385632,-48,0.1200318084,2.0705486954,1.0202703716
28,85,2004,452,352,-1,653,5,100,4,82,33434,13.53577097,10.541131375,-0.029946396,-22,0.1497319798,2.9946395951,0.1197855838
28,85,2005,461,339,136,643,5,122,141,237,33671,13.739661724,10.103569034,4.0533492288,-26,0.1490201922,3.6360926906,4.2023694211
28,85,2006,491,423,518,649,5,68,523,570,34241,14.459889268,12.457297679,15.255035929,-21,0.1472493816,2.0025915891,15.40228531
28,85,2007,565,362,115,649,5,203,120,308,34549,16.426806222,10.524785579,3.343509231,-15,0.1453699666,5.9020206425,3.4888791976
28,85,2008,535,381,236,649,5,154,241,382,34931,15.400115141,10.967184801,6.7933218192,-13,0.1439263097,4.4329303397,6.937248129
28,87,2001,933,482,-956,1838,10,451,-946,-535,60967,15.236508831,7.8713796961,-15.61211409,-40,0.1633066327,7.3651291347,-15.44880745
28,87,2002,913,516,-592,1881,-52,397,-644,-287,60680,15.010645556,8.4835630965,-9.733080142,-40,-0.854932715,6.5270824599,-10.58801286
28,87,2003,874,551,-554,1817,-185,323,-739,-465,60215,14.458827909,9.1153480293,-9.164977873,-49,-3.060507052,5.3434798792,-12.22548492
28,87,2004,925,552,-705,1838,105,373,-600,-285,59930,15.398060677,9.1888967498,-11.73581922,-58,1.7478879687,6.2091639269,-9.98793125
28,87,2005,838,557,-699,1846,5,281,-694,-463,59467,14.037203615,9.3302176772,-11.70883691,-50,0.0837541982,4.7069859377,-11.62508271
28,87,2006,914,544,-358,1880,60,370,-298,45,59512,15.364055842,9.144470873,-6.0178687,-27,1.0085813463,6.2195849688,-5.009287353
28,87,2007,925,527,-462,1723,3,398,-459,-46,59466,15.54909311,8.8587806149,-7.76614164,15,0.0504294912,6.6903124947,-7.715712148
28,87,2008,927,550,-605,1723,24,377,-581,-182,59284,15.612631579,9.2631578947,-10.18947368,22,0.4042105263,6.3494736842,-9.785263158
28,89,2001,1273,819,1052,2080,50,454,1102,1461,76527,16.794970744,10.805248263,13.879268832,-95,0.6596610661,5.9897224806,14.538929898
28,89,2002,1203,933,1220,2152,45,270,1265,1454,77981,15.572009216,12.077044554,15.792062547,-81,0.5824941103,3.494964662,16.374556657
28,89,2003,1244,987,1551,2209,32,257,1583,1784,79765,15.772190737,12.513787988,19.664523982,-56,0.4057155174,3.2584027487,20.070239499
28,89,2004,1207,962,2015,2226,43,245,2058,2199,81964,14.926203711,11.896444051,24.918227405,-104,0.5317537362,3.0297596597,25.449981141
28,89,2005,1217,1002,2227,2223,41,215,2268,2443,84407,14.629953538,12.045368484,26.771492628,-40,0.4928743591,2.5845850539,27.264366987
28,89,2006,1368,1049,2409,2225,43,319,2452,2712,87119,15.950934552,12.231381831,28.089036065,-59,0.5013817147,3.7195527209,28.590417779
28,89,2007,1483,1033,1793,2226,36,450,1829,2202,89321,16.810247109,11.709362956,20.324189526,-77,0.4080707323,5.1008841533,20.732260258
28,89,2008,1476,1034,1675,2226,37,442,1712,2048,91369,16.337373402,11.445016326,18.540040954,-106,0.4095412032,4.8923570757,18.949582157
28,91,2001,358,345,-319,881,4,13,-315,-319,25268,14.079244912,13.567987415,-12.54547242,-17,0.157309999,0.5112574968,-12.38816242
28,91,2002,361,303,-167,907,4,58,-163,-124,25144,14.321986829,12.020947393,-6.625406649,-19,0.1586923748,2.3010394351,-6.466714274
28,91,2003,401,320,-50,943,4,81,-46,2,25146,15.947504474,12.726188109,-1.988466892,-33,0.1590773514,3.2213163651,-1.829389541
28,91,2004,387,367,-11,955,2,20,-9,-5,25141,15.391651918,14.59621771,-0.437488814,-16,0.0795434208,0.7954342076,-0.357945393
28,91,2005,382,318,-115,968,4,64,-111,-68,25073,15.214880312,12.665790417,-4.580395906,-21,0.1593181185,2.5490898952,-4.421077787
28,91,2006,399,365,367,1004,3,34,370,390,25463,15.790723445,14.445148013,14.524299509,-14,0.1187272439,1.3455754314,14.643026753
28,91,2007,455,305,98,999,3,150,101,248,25711,17.782467659,11.920115684,3.8300699574,-3,0.1172470395,5.8623519756,3.9473169969
28,91,2008,425,338,34,999,2,87,36,119,25830,16.491725034,13.11577191,1.3193380028,-4,0.0776081178,3.3759531247,1.3969461206
28,93,2001,560,352,-186,1509,6,208,-180,-7,35044,15.978315144,10.043512376,-5.307083244,-35,0.1711962337,5.9348027677,-5.13588701
28,93,2002,520,329,50,1611,6,191,56,214,35258,14.793320247,9.3596199255,1.4224346391,-33,0.1706921567,5.4337003215,1.5931267958
28,93,2003,485,373,266,1721,4,112,270,351,35609,13.687612006,10.526761398,7.5070201928,-31,0.1128875217,3.1608506075,7.6199077145
28,93,2004,486,372,-170,1731,6,114,-164,-79,35530,13.663391389,10.458398347,-4.779375589,-29,0.1686838443,3.2049930418,-4.610691744
28,93,2005,509,359,104,1735,5,150,109,236,35766,14.278500898,10.070691203,2.9174147217,-23,0.1402603232,4.2078096948,3.0576750449
28,93,2006,498,411,215,1725,6,87,221,288,36054,13.868003342,11.445279866,5.9871901977,-20,0.1670843776,2.4227234754,6.1542745753
28,93,2007,556,370,493,1724,4,186,497,657,36711,15.282072425,10.169724455,13.550470693,-26,0.1099429671,5.1123479695,13.66041366
28,93,2008,558,368,217,1724,5,190,222,391,37102,15.11928793,9.9711432945,5.879723084,-21,0.1354774904,5.1481446358,6.0152005744
28,95,2001,508,382,-99,421,2,126,-97,-7,37995,13.368948774,10.053028409,-2.605366001,-36,0.0526336566,3.3159203653,-2.552732345
28,95,2002,512,398,-434,428,1,114,-433,-346,37649,13.537094813,10.522976046,-11.47480302,-27,0.0264396383,3.0141187669,-11.44836339
28,95,2003,474,392,-130,430,-3,82,-133,-99,37550,12.606550619,10.425670554,-3.457492786,-48,-0.079788295,2.1808800649,-3.537281081
28,95,2004,487,385,-131,418,4,102,-127,-52,37498,12.978360516,10.260100203,-3.49109903,-27,0.1065984437,2.7182603134,-3.384500586
28,95,2005,551,436,-357,413,2,115,-355,-272,37226,14.747604518,11.669610835,-9.555163,-32,0.0535303249,3.0779936834,-9.501632675
28,95,2006,534,392,-206,410,4,142,-202,-76,37150,14.359470797,10.541034742,-5.539421319,-16,0.107561579,3.8184360546,-5.43185974
28,95,2007,552,374,-247,410,1,178,-246,-76,37074,14.873895236,10.077602932,-6.655529209,-8,0.0269454624,4.7962923044,-6.628583746
28,95,2008,549,392,31,410,2,157,33,176,37250,14.773155374,10.548409666,0.8341854583,-14,0.0538184167,4.224745708,0.8880038749
28,97,2001,161,132,-64,150,-1,29,-65,-46,12078,13.304685563,10.908189406,-5.288819106,-10,-0.082637799,2.3964961573,-5.371456904
28,97,2002,160,135,-203,148,-2,25,-205,-186,11892,13.350020859,11.2640801,-16.93783897,-6,-0.166875261,2.0859407593,-17.10471423
28,97,2003,146,139,-155,149,-4,7,-159,-160,11732,12.360311548,11.767693871,-13.12224856,-8,-0.338638673,0.5926176769,-13.46088723
28,97,2004,155,134,-128,149,2,21,-126,-118,11614,13.278505954,11.479482567,-10.96547588,-13,0.1713355607,1.7990233873,-10.79414032
28,97,2005,177,154,-25,148,-1,23,-26,-12,11602,15.248104755,13.266712612,-2.153687112,-9,-0.086147484,1.9813921433,-2.239834597
28,97,2006,162,126,-47,147,1,36,-46,-16,11586,13.972744523,10.867690185,-4.053820942,-6,0.0862515094,3.1050543385,-3.967569432
28,97,2007,183,131,-164,147,-1,52,-165,-115,11471,15.873704298,11.363143514,-14.22561478,-2,-0.086741554,4.5105607841,-14.31235633
28,97,2008,156,140,-217,147,0,16,-217,-205,11266,13.72212693,12.314729296,-19.08783041,-4,0,1.4073976338,-19.08783041
28,99,2001,475,326,-350,607,5,149,-345,-222,28493,16.606069081,11.397007412,-12.2360509,-26,0.1748007272,5.2090616697,-12.06125017
28,99,2002,476,335,40,600,3,141,43,156,28649,16.660249904,11.725175878,1.4000210003,-28,0.105001575,4.9350740261,1.5050225753
28,99,2003,488,294,219,624,-3,194,216,384,29033,16.920356437,10.193821296,7.5933566797,-26,-0.104018585,6.7265351409,7.4893380951
28,99,2004,530,323,213,632,8,207,221,401,29434,18.129885234,11.048967794,7.2861614244,-27,0.273658645,7.0809174406,7.5598200694
28,99,2005,510,335,125,637,4,175,129,280,29714,17.244877257,11.327517414,4.2266856022,-24,0.1352539393,5.9173598431,4.3619395415
28,99,2006,537,327,59,623,6,210,65,260,29974,17.993566546,10.956976277,1.97694679,-15,0.2010454363,7.0365902694,2.1779922262
28,99,2007,550,296,-45,623,3,254,-42,206,30180,18.286398245,9.8414070552,-1.496159856,-6,0.0997439904,8.4449911893,-1.396415866
28,99,2008,552,303,99,623,4,249,103,350,30530,18.184813046,9.981881074,3.2614066875,-2,0.1317740076,8.2029319717,3.3931806951
28,101,2001,347,255,-68,740,1,92,-67,5,21856,15.878463404,11.668611435,-3.111629716,-20,0.0457592605,4.2098519688,-3.065870456
28,101,2002,322,217,-233,732,-6,105,-239,-150,21706,14.783526927,9.9628116248,-10.69739681,-16,-0.275469446,4.8207153023,-10.97286626
28,101,2003,324,239,58,726,-23,85,35,92,21798,14.895182052,10.987495403,2.6664214785,-28,-1.057374035,3.9076866495,1.6090474439
28,101,2004,345,251,-12,709,10,94,-2,77,21875,15.799235225,11.494516063,-0.549538617,-15,0.4579488471,4.3047191629,-0.091589769
28,101,2005,375,198,-25,692,-1,177,-26,134,22009,17.090511348,9.0237899918,-1.139367423,-17,-0.045574697,8.0667213563,-1.18494212
28,101,2006,356,234,-24,719,5,122,-19,91,22100,16.141830465,10.610079576,-1.08821329,-12,0.226711102,5.5317508898,-0.861502188
28,101,2007,355,213,97,741,-2,142,95,234,22334,15.978755007,9.5872530045,4.3660260161,-3,-0.090021155,6.391502003,4.2760048611
28,101,2008,376,222,-131,741,2,154,-129,21,22355,16.827407192,9.935330842,-5.862740272,-4,0.0895074851,6.8920763499,-5.773232787
28,103,2001,209,118,-194,176,9,91,-185,-104,12438,16.733386709,9.4475580464,-15.53242594,-10,0.7205764612,7.2858286629,-14.81184948
28,103,2002,208,105,-236,172,9,103,-227,-132,12306,16.812156482,8.4869059166,-19.07533139,-8,0.7274490786,8.3252505658,-18.34788231
28,103,2003,185,120,-243,173,6,65,-237,-174,12132,15.140355185,9.8207709305,-19.88706113,-2,0.4910385465,5.319584254,-19.39602259
28,103,2004,186,125,-147,191,7,61,-140,-90,12042,15.388433855,10.341689418,-12.16182676,-11,0.5791346074,5.0467444362,-11.58269215
28,103,2005,204,100,-196,190,7,104,-189,-92,11950,17.005668556,8.3361120373,-16.33877959,-7,0.5835278426,8.6695565188,-15.75525175
28,103,2006,196,103,-182,189,7,93,-175,-86,11864,16.46090535,8.6503737297,-15.2851264,-4,0.5878894768,7.8105316201,-14.69723692
28,103,2007,211,79,-131,189,6,132,-125,-4,11860,17.787894116,6.6599224414,-11.04366886,-11,0.5058168943,11.127971674,-10.53785196
28,103,2008,206,121,-122,189,6,85,-116,-32,11828,17.392772712,10.216143195,-10.30057413,-1,0.506585613,7.1766295171,-9.793988517
28,105,2001,587,281,-624,4336,124,306,-500,-221,42817,13.674218159,6.5459204473,-14.53613651,-27,2.8885912294,7.1282977113,-11.64754528
28,105,2002,535,255,-827,4149,116,280,-711,-450,42367,12.561044328,5.9870398197,-19.41679189,-19,2.7235161533,6.5740045079,-16.69327573
28,105,2003,540,302,-462,3883,103,238,-359,-159,42208,12.769731008,7.1415903045,-10.92521431,-38,2.4357079515,5.6281407035,-8.489506355
28,105,2004,573,269,-489,3696,101,304,-388,-126,42082,13.595918852,6.3827263021,-11.60279986,-42,2.3964883142,7.2131925495,-9.206311543
28,105,2005,592,281,-69,3802,102,311,33,303,42385,14.017308535,6.6534859768,-1.633774137,-41,2.4151443759,7.3638225579,0.7813702393
28,105,2006,594,259,414,3951,104,335,518,830,43215,13.878504673,6.0514018692,9.6728971963,-23,2.4299065421,7.8271028037,12.102803738
28,105,2007,610,283,314,4116,93,327,407,743,43958,13.995159052,6.4928360846,7.204065479,9,2.1336881833,7.502322967,9.3377536623
28,105,2008,647,289,-482,4116,94,358,-388,-14,43944,14.720939228,6.5755045391,-10.96675844,16,2.138745421,8.1454346886,-8.828013014
28,107,2001,568,333,-130,597,6,235,-124,78,34490,16.487184697,9.665902296,-3.773475371,-33,0.1741604017,6.8212824011,-3.599314969
28,107,2002,590,349,63,596,4,241,67,275,34765,17.038480976,10.078694679,1.8193632229,-33,0.1155151253,6.959786297,1.9348783481
28,107,2003,525,338,-61,594,0,187,-61,72,34837,15.085773397,9.7123645872,-1.752823195,-54,0,5.3734088101,-1.752823195
28,107,2004,563,351,-105,594,9,212,-96,93,34930,16.13943555,10.062063726,-3.010019063,-23,0.258001634,6.0773718234,-2.752017429
28,107,2005,567,349,-168,588,5,218,-163,23,34953,16.227122476,9.9881230056,-4.808036289,-32,0.1430963181,6.2389994705,-4.664939971
28,107,2006,537,437,69,586,7,100,76,158,35111,15.328842201,12.474309203,1.9696277689,-18,0.1998173099,2.8545329984,2.1694450788
28,107,2007,638,375,29,586,4,263,33,293,35404,18.095440686,10.636034886,0.8225200312,-3,0.1134510388,7.4594058002,0.93597107
28,107,2008,602,366,1,586,5,236,6,256,35660,16.942474389,10.30057413,0.0281436452,14,0.1407182258,6.6419002589,0.168861871
28,109,2001,668,482,428,788,8,186,436,585,49350,13.616674311,9.8252051164,8.7244559955,-37,0.1630739438,3.7914691943,8.8875299394
28,109,2002,674,487,544,767,2,187,546,700,50050,13.561368209,9.7987927565,10.945674044,-33,0.0402414487,3.7625754527,10.985915493
28,109,2003,638,489,339,750,-11,149,328,425,50475,12.693359861,9.7289231534,6.7445908978,-52,-0.218851032,2.9644367073,6.5257398657
28,109,2004,681,518,663,762,16,163,679,789,51264,13.38719665,10.182919038,13.033350043,-53,0.3145303178,3.2042776123,13.347880361
28,109,2005,655,508,402,673,6,147,408,509,51773,12.71387948,9.8605355358,7.8030222153,-46,0.1164630181,2.8533439444,7.9194852335
28,109,2006,732,516,4285,839,12,216,4297,4464,56237,13.554300528,9.5546708638,79.344505138,-49,0.222201648,3.9996296639,79.566706786
28,109,2007,824,548,548,919,6,276,554,770,57007,14.552647381,9.6782169475,9.6782169475,-60,0.105965879,4.8744304334,9.7841828265
28,109,2008,782,550,310,919,9,232,319,459,57466,13.662610397,9.6092528369,5.4161243263,-92,0.1572423191,4.0533575603,5.5733666454
28,111,2001,176,142,-27,124,-1,34,-28,-7,12169,14.458821113,11.665639762,-2.218114603,-13,-0.082152393,2.7931813514,-2.300266995
28,111,2002,146,118,31,108,-1,28,30,47,12216,11.974574534,9.6780807874,2.5425466475,-11,-0.082017634,2.2964937462,2.4605290137
28,111,2003,188,117,-66,108,-2,71,-68,-13,12203,15.39784594,9.5827019943,-5.405626766,-16,-0.163806872,5.8151439453,-5.569433638
28,111,2004,154,114,-66,107,1,40,-65,-34,12169,12.637452815,9.3549975382,-5.416051206,-9,0.0820613819,3.2824552765,-5.333989824
28,111,2005,163,118,-199,109,-1,45,-200,-165,12004,13.486120879,9.7629586729,-16.46465064,-10,-0.082736938,3.7231622058,-16.54738758
28,111,2006,167,113,-71,108,0,54,-71,-23,11981,13.925370023,9.422555764,-5.920366896,-6,0,4.5028142589,-5.920366896
28,111,2007,205,137,162,108,-1,68,161,229,12210,16.948451904,11.326526394,13.393410773,0,-0.082675375,5.6219255095,13.310735397
28,111,2008,182,107,-48,108,0,75,-48,25,12235,14.890570669,8.7543464921,-3.927183473,-2,0,6.1362241767,-3.927183473
28,113,2001,641,460,-441,836,4,181,-437,-282,38700,16.50317963,11.843155429,-11.35398162,-26,0.1029839602,4.6600242012,-11.25099766
28,113,2002,613,439,-182,847,3,174,-179,-38,38662,15.847573744,11.34924123,-4.7051524,-33,0.0775574571,4.4983325147,-4.627594943
28,113,2003,636,447,-297,890,-3,189,-300,-152,38510,16.482662105,11.584512517,-7.69709221,-41,-0.077748406,4.8981495879,-7.774840616
28,113,2004,659,447,-173,897,4,212,-169,12,38522,17.109772562,11.605566518,-4.491639838,-31,0.1038529442,5.5042060442,-4.387786894
28,113,2005,625,475,18,880,1,150,19,132,38654,16.196745102,12.309526278,0.4664662589,-37,0.0259147922,3.8872188245,0.4923810511
28,113,2006,664,498,1121,904,3,166,1124,1266,39920,16.90126505,12.675948787,28.533611627,-24,0.0763611373,4.2253162624,28.609972765
28,113,2007,737,468,-353,941,1,269,-352,-72,39848,18.478587905,11.734028683,-8.850666934,11,0.0250727109,6.7445592217,-8.825594223
28,113,2008,668,463,-92,941,2,205,-90,113,39961,16.73996667,11.60270145,-2.305504392,-2,0.0501196607,5.1372652207,-2.255384731
28,115,2001,391,260,171,264,22,131,193,297,27074,14.521550203,9.6562737925,6.3508569943,-27,0.8170693209,4.8652764108,7.1679263152
28,115,2002,368,260,11,268,21,108,32,112,27186,13.564319941,9.5834869149,0.4054552156,-28,0.7740508662,3.9808330262,1.1795060818
28,115,2003,403,242,329,262,17,161,346,493,27679,14.69060421,8.8216531486,11.993073909,-14,0.6197029071,5.8689510617,12.612776816
28,115,2004,379,251,121,328,15,128,136,243,27922,13.63284833,9.0286145933,4.3524397043,-21,0.539558641,4.6042337368,4.8919983454
28,115,2005,474,245,-4,266,17,229,13,220,28142,16.909246575,8.7400114155,-0.142694064,-22,0.6064497717,8.1692351598,0.4637557078
28,115,2006,401,219,287,269,16,182,303,470,28612,14.131162561,7.717517708,10.113824576,-15,0.5638369102,6.4136448532,10.677661486
28,115,2007,491,227,-66,269,13,264,-53,207,28819,17.098779405,7.9051383399,-2.298410266,-4,0.4527171737,9.1936410649,-1.845693093
28,115,2008,458,231,-50,269,12,227,-38,185,29004,15.841447175,7.9899002127,-1.72941563,-4,0.4150597513,7.8515469623,-1.314355879
28,117,2001,327,243,-197,799,0,84,-197,-138,25454,12.811973514,9.5208243545,-7.718528386,-25,0,3.2911491596,-7.718528386
28,117,2002,295,224,-12,822,-1,71,-13,31,25485,11.582481007,8.7948330356,-0.47115177,-27,-0.039262647,2.7876479711,-0.510414417
28,117,2003,330,228,60,804,-4,102,56,127,25612,12.916609586,8.9242029865,2.3484744701,-31,-0.156564965,3.9924065992,2.1919095055
28,117,2004,314,277,-106,698,3,37,-103,-86,25526,12.280495913,10.833431108,-4.145645117,-20,0.1173295788,1.447064805,-4.028315538
28,117,2005,305,262,45,754,0,43,45,64,25590,11.93364113,10.251193364,1.7607011503,-24,0,1.6824477659,1.7607011503
28,117,2006,303,270,-120,711,2,33,-118,-96,25494,11.862814188,10.570824524,-4.698144233,-11,0.0783024039,1.2919896641,-4.619841829
28,117,2007,369,233,-107,842,0,136,-107,26,25520,14.466617007,9.1347473243,-4.194926883,-3,0,5.3318696828,-4.194926883
28,117,2008,329,228,90,842,1,101,91,187,25707,12.844788881,8.9015558202,3.5137720343,-5,0.0390419115,3.9432330607,3.5528139458
28,119,2001,169,121,-135,149,1,48,-134,-94,9961,16.886490807,12.090327738,-13.48920863,-8,0.0999200639,4.7961630695,-13.38928857
28,119,2002,165,100,-168,154,1,65,-167,-108,9853,16.654890481,10.093873019,-16.95770667,-6,0.1009387302,6.5610174624,-16.85676794
28,119,2003,146,105,-331,150,-1,41,-332,-284,9569,15.034496962,10.812480692,-34.08505818,7,-0.102976007,4.2220162702,-34.18803419
28,119,2004,128,122,-35,171,0,6,-35,-35,9534,13.401036486,12.772862901,-3.664345914,-6,0,0.6281735853,-3.664345914
28,119,2005,121,120,-241,161,0,1,-241,-247,9287,12.857977791,12.751713512,-25.6096913,-7,0,0.1062642793,-25.6096913
28,119,2006,140,103,-221,176,0,37,-221,-186,9101,15.227322167,11.202958451,-24.03741571,-2,0,4.0243637155,-24.03741571
28,119,2007,145,101,-270,177,0,44,-270,-217,8884,16.124548235,11.231581874,-30.02502085,9,0,4.8929663609,-30.02502085
28,119,2008,119,128,-151,177,0,-9,-151,-160,8724,13.516583371,14.538845979,-17.15129487,0,0,-1.022262608,-17.15129487
28,121,2001,1726,830,1865,5181,100,896,1965,2773,118947,14.681802136,7.0601945381,15.864172065,-88,0.850625848,7.6216075978,16.714797913
28,121,2002,1682,822,1499,5198,85,860,1584,2367,121314,14.001440101,6.8425587174,12.478096736,-77,0.7075638576,7.1588813832,13.185660594
28,121,2003,1841,850,2011,5214,45,991,2056,3027,124341,14.988500132,6.9202743685,16.372555006,-20,0.3663674666,8.0682257638,16.738922473
28,121,2004,1907,819,2621,5307,86,1088,2707,3629,127970,15.116265244,6.4919880624,20.775947145,-166,0.6816983802,8.6242771817,21.457645525
28,121,2005,1942,822,2236,5357,72,1120,2308,3306,131276,14.981909075,6.3414671779,17.250025073,-122,0.5554569791,8.6404418969,17.805482052
28,121,2006,1980,837,2860,5466,81,1143,2941,4007,135283,14.855998109,6.2800355644,21.458663936,-77,0.6077453772,8.5759625449,22.066409313
28,121,2007,2197,880,1574,5496,69,1317,1643,2909,138192,16.067282201,6.4356888198,11.511107048,-51,0.5046165097,9.6315933815,12.015723558
28,121,2008,2191,902,1455,5496,74,1289,1529,2709,140901,15.70085957,6.4637952224,10.426631983,-109,0.5302891868,9.2370643477,10.95692117
28,123,2001,457,276,-201,325,94,181,-107,50,28451,16.07683107,9.7094209526,-7.070991346,-24,3.3068317737,6.3674101175,-3.764159572
28,123,2002,418,307,-460,321,90,111,-370,-271,28180,14.762232699,10.842118274,-16.24551924,-12,3.1784711554,3.920114425,-13.06704808
28,123,2003,459,261,19,320,69,198,88,245,28425,16.217648618,9.2218001943,0.6713187881,-41,2.4379471778,6.9958484233,3.1092659659
28,123,2004,471,253,-221,318,69,218,-152,43,28468,16.557397219,8.8938885276,-7.768969821,-23,2.4256059621,7.6635086918,-5.343363858
28,123,2005,499,256,-214,314,68,243,-146,72,28540,17.506314903,8.9811956217,-7.507718215,-25,2.385630087,8.5251192815,-5.122088128
28,123,2006,495,238,-221,314,70,257,-151,92,28632,17.316168754,8.3257538655,-7.731057161,-14,2.4487511369,8.9904148884,-5.282306024
28,123,2007,556,249,-163,314,64,307,-99,202,28834,19.350572512,8.665993805,-5.672919639,-6,2.2274040302,10.684578707,-3.445515609
28,123,2008,510,274,-280,314,65,236,-215,16,28850,17.682546287,9.5000346717,-9.708064628,-5,2.2536578601,8.182511615,-7.454406768
28,125,2001,113,72,-215,101,1,41,-214,-175,6363,17.518021859,11.161925432,-33.33074955,-2,0.1550267421,6.3560964266,-33.17572281
28,125,2002,115,63,-123,94,1,52,-122,-76,6287,18.181818182,9.9604743083,-19.44664032,-6,0.1581027668,8.2213438735,-19.28853755
28,125,2003,86,58,-129,97,1,28,-128,-99,6188,13.78757515,9.2985971944,-20.68136273,1,0.1603206413,4.4889779559,-20.52104208
28,125,2004,103,71,-190,101,0,32,-190,-168,6020,16.874180865,11.631716907,-31.12712975,-10,0,5.2424639581,-31.12712975
28,125,2005,91,57,-137,99,1,34,-136,-105,5915,15.249266862,9.551738584,-22.95768747,-3,0.1675743611,5.6975282782,-22.79011311
28,125,2006,120,53,-210,95,0,67,-210,-145,5770,20.53915276,9.0714591356,-35.94351733,-2,0,11.467693624,-35.94351733
28,125,2007,95,49,-264,95,1,46,-263,-211,5559,16.771118369,8.6503663165,-46.60605526,6,0.1765380881,8.1207520523,-46.42951717
28,125,2008,92,45,-44,95,0,47,-44,-3,5556,16.554206028,8.0971659919,-7.91722897,-6,0,8.457040036,-7.91722897
28,127,2001,405,326,-297,943,17,79,-280,-223,27433,14.703479824,11.835393636,-10.78255187,-22,0.6171831037,2.8680861878,-10.16536877
28,127,2002,362,299,237,1036,13,63,250,286,27719,13.127357122,10.842761822,8.5944299391,-27,0.471424427,2.2845953003,9.0658543661
28,127,2003,409,319,-297,962,6,90,-291,-226,27493,14.815619793,11.555458958,-10.75853075,-25,0.2173440556,3.2601608346,-10.5411867
28,127,2004,408,305,-83,988,19,103,-64,20,27513,14.834745301,11.089699306,-3.017852598,-19,0.6908337272,3.745045995,-2.327018871
28,127,2005,408,286,188,992,16,122,204,300,27813,14.748942631,10.338719589,6.7960814084,-26,0.5783899071,4.4102230416,7.3744713155
28,127,2006,399,274,-71,996,19,125,-52,61,27874,14.330094995,9.8407168639,-2.549966779,-12,0.682385476,4.4893781313,-1.867581303
28,127,2007,441,271,-245,997,14,170,-231,-51,27823,15.835682353,9.7312243029,-8.797601307,10,0.5027200747,6.1044580498,-8.294881232
28,127,2008,426,317,74,997,15,109,89,211,28034,15.253235942,11.350412661,2.6496231448,13,0.5370857726,3.9028232809,3.1867089174
28,129,2001,187,164,-80,131,5,23,-75,-65,16122,11.575721935,10.151970039,-4.952180507,-13,0.3095112817,1.4237518958,-4.642669225
28,129,2002,224,176,-214,131,5,48,-209,-175,15947,13.969877452,10.976332284,-13.34622221,-14,0.3118276217,2.9935451682,-13.03439459
28,129,2003,198,147,-122,131,4,51,-118,-87,15860,12.450089603,9.2432483416,-7.671267331,-20,0.2515169617,3.2068412614,-7.419750369
28,129,2004,219,162,-64,131,3,57,-61,-15,15845,13.814855701,10.219208327,-4.037218104,-11,0.1892445986,3.5956473742,-3.847973506
28,129,2005,202,214,148,131,4,-12,152,126,15971,12.698013578,13.452351018,9.3034950968,-14,0.2514458134,-0.75433744,9.5549409102
28,129,2006,205,224,29,131,3,-19,32,6,15977,12.833354201,14.022787029,1.8154501064,-7,0.1878051834,-1.189432828,2.0032552898
28,129,2007,222,206,-39,131,3,16,-36,-16,15961,13.901934999,12.899993738,-2.442231824,4,0.1878639865,1.0019412612,-2.254367838
28,129,2008,217,166,-202,131,2,51,-200,-152,15809,13.660686182,10.450110167,-12.71639912,-3,0.1259049418,3.2105760151,-12.59049418
28,131,2001,202,141,323,902,1,61,324,379,14067,14.555935867,10.160331472,23.27508557,-6,0.0720590885,4.3956043956,23.347144659
28,131,2002,202,152,-91,873,0,50,-91,-51,14016,14.385927429,10.825054303,-6.480789089,-10,0,3.5608731261,-6.480789089
28,131,2003,196,152,97,919,-4,44,93,123,14139,13.922926656,10.797371692,6.8904279879,-14,-0.28414136,3.1255549636,6.6062866276
28,131,2004,210,147,102,948,4,63,106,158,14297,14.770009847,10.339006893,7.1740047827,-11,0.2813335209,4.431002954,7.4553383036
28,131,2005,173,154,387,999,1,19,388,398,14695,11.934326711,10.623620309,26.697019868,-9,0.0689845475,1.3107064018,26.766004415
28,131,2006,188,160,676,1020,3,28,679,695,15390,12.497922553,10.636529832,44.939338541,-12,0.1994349344,1.8613927206,45.138773475
28,131,2007,235,152,73,853,1,83,74,159,15549,15.19118265,9.8257862245,4.718963121,2,0.0646433304,5.3653964252,4.7836064514
28,131,2008,233,138,380,853,2,95,382,476,16025,14.758978907,8.7413694812,24.070437702,-1,0.1266865142,6.0176094255,24.197124216
28,133,2001,508,326,-445,5623,15,182,-430,-278,33954,14.900419441,9.5620801924,-13.05253278,-30,0.439973015,5.3383392485,-12.61255976
28,133,2002,497,314,-607,5682,14,183,-593,-429,33525,14.730508751,9.3065990901,-17.99078232,-19,0.4149439085,5.4239096608,-17.57583841
28,133,2003,441,320,-422,6008,9,121,-413,-320,33205,13.217443429,9.5908886558,-12.64798441,-28,0.2697437434,3.626554773,-12.37824067
28,133,2004,470,325,-1226,5243,16,145,-1210,-1121,32084,14.397524851,9.9557352693,-37.55609674,-56,0.4901285056,4.4417895817,-37.06596823
28,133,2005,478,328,-831,4945,13,150,-818,-691,31393,15.060573121,10.334451849,-26.18271185,-23,0.4095971769,4.7261212723,-25.77311467
28,133,2006,522,350,-500,4794,15,172,-485,-324,31069,16.714162211,11.206813743,-16.00973392,-11,0.4802920175,5.5073484679,-15.5294419
28,133,2007,530,356,-260,4808,11,174,-249,-69,31000,17.07776829,11.471104738,-8.377773123,6,0.3544442475,5.6066635519,-8.023328876
28,133,2008,508,326,-497,4808,12,182,-485,-303,30697,16.467575409,10.56777477,-16.11099405,0,0.3889978443,5.8998006386,-15.72199621
28,135,2001,208,158,-278,105,5,50,-273,-233,14633,14.102172955,10.712227533,-18.84809655,-10,0.3389945422,3.3899454219,-18.509102
28,135,2002,208,159,-292,108,5,49,-287,-246,14387,14.33494142,10.957960028,-20.12405238,-8,0.344589938,3.3769813921,-19.77946244
28,135,2003,183,136,-246,103,5,47,-241,-203,14184,12.810192153,9.5201428021,-17.2202583,-9,0.3500052501,3.2900493507,-16.87025305
28,135,2004,212,156,-213,103,3,56,-210,-168,14016,15.035460993,11.063829787,-15.10638298,-14,0.2127659574,3.9716312057,-14.89361702
28,135,2005,172,134,-224,104,4,38,-220,-192,13824,12.356321839,9.6264367816,-16.09195402,-10,0.2873563218,2.7298850575,-15.8045977
28,135,2006,198,136,-361,104,4,62,-357,-300,13524,14.480035103,9.9458826971,-26.40046804,-5,0.2925259617,4.534152406,-26.10794208
28,135,2007,253,119,-388,104,5,134,-383,-243,13281,18.877075173,8.8789404962,-28.94982279,6,0.3730647267,9.9981346764,-28.57675807
28,135,2008,225,149,-339,104,4,76,-335,-254,13027,17.105063099,11.327352896,-25.7716284,5,0.3040900106,5.7777102022,-25.46753839
28,137,2001,399,259,-52,1172,1,140,-51,63,25505,15.663336408,10.167428897,-2.041337076,-26,0.0392564822,5.4959075117,-2.002080594
28,137,2002,373,251,-98,1118,-1,122,-99,-4,25501,14.625730306,9.841979375,-3.842685174,-27,-0.039211073,4.7837509313,-3.881896248
28,137,2003,407,248,101,1098,-5,159,96,225,25726,15.890057977,9.68239405,3.9432330607,-30,-0.195209557,6.2076639272,3.7480235032
28,137,2004,413,273,228,1218,5,140,233,349,26075,15.945638115,10.540337059,8.8029188626,-24,0.1930464663,5.405301056,8.9959653289
28,137,2005,375,229,110,1244,1,146,111,236,26311,14.316802199,8.7427938762,4.1995953117,-21,0.0381781392,5.5740083228,4.2377734509
28,137,2006,388,257,228,1209,3,131,231,348,26659,14.649801775,9.7036058146,8.6086464036,-14,0.1132716632,4.94619596,8.7219180668
28,137,2007,432,243,41,1220,1,189,42,221,26880,16.137768729,9.0774949103,1.5315937914,-10,0.0373559461,7.0602738191,1.5689497376
28,137,2008,430,256,129,1220,2,174,131,296,27176,15.909427261,9.4716590203,4.7728281782,-9,0.0739973361,6.4377682403,4.8468255143
28,139,2001,341,273,-97,374,34,68,-63,-14,20847,16.351779035,13.091013714,-4.651385825,-19,1.6303826604,3.2607653208,-3.021003165
28,139,2002,315,274,-45,383,33,41,-12,10,20857,15.106464608,13.140226357,-2.158066373,-19,1.5825820065,1.9662382505,-0.575484366
28,139,2003,329,254,-47,434,29,75,-18,28,20885,15.763499593,12.169996646,-2.251928513,-29,1.389487806,3.5935029467,-0.862440707
28,139,2004,326,251,-98,417,27,75,-71,-13,20872,15.614148526,12.021936442,-4.69382379,-17,1.2931963503,3.5922120842,-3.40062744
28,139,2005,331,261,69,399,29,70,98,149,21021,15.802162652,12.460315566,3.294106414,-19,1.3844795073,3.3418470866,4.6785859213
28,139,2006,355,242,-94,395,29,113,-65,38,21059,16.872623574,11.501901141,-4.467680608,-10,1.3783269962,5.3707224335,-3.089353612
28,139,2007,313,216,-22,442,25,97,3,97,21156,14.828852304,10.233329385,-1.042283549,-3,1.1844131233,4.5955229184,0.1421295748
28,139,2008,336,227,-81,442,25,109,-56,54,21210,15.861775952,10.716140301,-3.823820989,1,1.1801916631,5.1456356512,-2.643629325
28,141,2001,233,274,-155,258,15,-41,-140,-197,18961,12.224874734,14.376032949,-8.132427398,-16,0.7870091031,-2.151158215,-7.345418295
28,141,2002,216,272,118,257,15,-56,133,60,19021,11.373808646,14.322573851,6.2134695382,-17,0.7898478227,-2.948765205,7.0033173609
28,141,2003,224,247,-126,259,8,-23,-118,-158,18863,11.825572801,13.039805723,-6.651884701,-17,0.4223418858,-1.214232922,-6.229542815
28,141,2004,232,250,24,257,7,-18,31,1,18864,12.298884088,13.253107854,1.272298354,-12,0.3710870199,-0.954223765,1.6433853739
28,141,2005,219,254,49,260,8,-35,57,3,18867,11.608491691,13.463730089,2.5973337574,-19,0.424054491,-1.855238398,3.0213882484
28,141,2006,222,225,109,273,7,-3,116,104,18971,11.734235425,11.892806174,5.7614038797,-9,0.3699984143,-0.158570749,6.131402294
28,141,2007,251,260,80,273,5,-9,85,83,19054,13.201840894,13.675213675,4.2077580539,7,0.2629848784,-0.473372781,4.4707429323
28,141,2008,243,257,-102,273,4,-14,-98,-107,18947,12.789137128,13.525959843,-5.368279782,5,0.2105207758,-0.736822715,-5.157759006
28,143,2001,175,91,57,114,7,84,64,137,9358,18.838473545,9.7960062436,6.1359599548,-11,0.7535389418,9.0424673018,6.8894988966
28,143,2002,196,118,277,114,6,78,283,360,9718,20.549381422,12.371566366,29.041727826,-1,0.6290626966,8.1778150556,29.670790522
28,143,2003,217,102,154,124,5,115,159,269,9987,22.024866785,10.35270236,15.630550622,-5,0.5074854098,11.672164425,16.138036031
28,143,2004,194,96,-64,117,6,98,-58,32,10019,19.394181745,9.5971208637,-6.398080576,-8,0.599820054,9.7970608817,-5.798260522
28,143,2005,205,104,42,108,6,101,48,140,10159,20.319159481,10.308256517,4.1629497472,-9,0.5947071067,10.010902964,4.757656854
28,143,2006,230,123,133,114,6,107,139,239,10398,22.376805954,11.966726662,12.939631269,-7,0.583742764,10.410079292,13.523374033
28,143,2007,247,65,-118,114,6,182,-112,66,10464,23.679417122,6.2314255584,-11.31243409,-4,0.5752085131,17.447991564,-10.73722558
28,143,2008,219,96,-143,114,6,123,-137,-16,10448,20.944912012,9.181331293,-13.67635807,-2,0.5738332058,11.763580719,-13.10252487
28,145,2001,415,293,54,243,32,122,86,184,25695,16.209038003,11.44397141,2.1091278366,-24,1.2498535328,4.7650665938,3.3589813694
28,145,2002,339,258,-12,243,31,81,19,73,25768,13.174513728,10.026621068,-0.466354468,-27,1.204749043,3.1478926607,0.7383945747
28,145,2003,346,253,150,244,24,93,174,240,26008,13.36526576,9.7728677379,5.7941903585,-27,0.9270704574,3.5923980222,6.7212608158
28,145,2004,349,277,53,239,29,72,82,135,26143,13.384211233,10.6229986,2.032559299,-19,1.1121550881,2.7612126325,3.1447143871
28,145,2005,374,246,328,235,26,128,354,458,26601,14.181707872,9.3280752313,12.437433642,-24,0.9858941301,4.8536326407,13.423327772
28,145,2006,391,282,104,246,29,109,133,227,26828,14.636246233,10.556065058,3.8930169009,-15,1.0855527897,4.080181175,4.9785696906
28,145,2007,446,255,-162,246,23,191,-139,55,26883,16.607398857,9.4952616782,-6.03228389,3,0.8564353671,7.1121371786,-5.175848523
28,145,2008,386,244,152,246,24,142,176,329,27212,14.271189574,9.0211664664,5.6197430446,11,0.8873278492,5.2500231075,6.5070708938
28,147,2001,213,175,-33,177,1,38,-32,-8,15093,14.10876333,11.591706962,-2.185864741,-14,0.0662383255,2.5170563688,-2.119626416
28,147,2002,206,159,-185,181,0,47,-185,-148,14945,13.715959784,10.586590319,-12.31773087,-10,0,3.1293694653,-12.31773087
28,147,2003,228,173,-8,184,0,55,-8,25,14970,15.243189036,11.566103961,-0.534848738,-22,0,3.6770850744,-0.534848738
28,147,2004,227,156,-34,182,1,71,-33,26,14996,15.150503904,10.41180004,-2.26923847,-12,0.0667423079,4.7387038644,-2.202496162
28,147,2005,193,174,-64,183,1,19,-63,-57,14939,12.894604977,11.625187907,-4.275931184,-13,0.0668114248,1.2694170703,-4.209119759
28,147,2006,226,169,425,180,1,57,426,473,15412,14.892425291,11.136371125,28.005667029,-10,0.0658956871,3.7560541663,28.071562716
28,147,2007,252,144,-169,180,1,108,-168,-66,15346,16.385980883,9.3634176474,-10.98901099,-6,0.0650237337,7.0225632356,-10.92398726
28,147,2008,224,168,23,180,1,56,24,70,15416,14.563422404,10.922566803,1.4953514076,-10,0.0650152786,3.6408556011,1.5603666862
28,149,2001,804,520,-605,603,18,284,-587,-338,49244,16.271021796,10.523546435,-12.24374153,-35,0.3642766074,5.7474753607,-11.87946492
28,149,2002,720,515,-412,599,15,205,-397,-227,49017,14.654847803,10.48228697,-8.385829576,-35,0.3053093292,4.1725608329,-8.080520247
28,149,2003,771,561,-418,593,10,210,-408,-240,48777,15.767838518,11.473096509,-8.548581713,-42,0.2045115242,4.2947420087,-8.344070188
28,149,2004,765,506,-135,598,19,259,-116,107,48884,15.666437984,10.362375974,-2.764665527,-36,0.3891010741,5.3040620104,-2.375564453
28,149,2005,765,509,-535,601,16,256,-519,-306,48578,15.698426053,10.44509655,-10.97863783,-43,0.3283330939,5.2533295028,-10.65030473
28,149,2006,747,499,241,584,18,248,259,484,49062,15.301106104,10.221220811,4.9365014338,-23,0.3687013519,5.0798852929,5.3052027857
28,149,2007,823,494,-645,584,15,329,-630,-291,48771,16.82458884,10.098841904,-13.18573487,10,0.3066449971,6.7257469361,-12.87908988
28,149,2008,794,491,-1018,584,16,303,-1002,-684,48087,16.395135146,10.138553346,-21.02046295,15,0.3303805571,6.2565818002,-20.69008239
28,151,2001,1109,677,-1467,857,26,432,-1441,-1040,61651,17.837898699,10.889321388,-23.59621045,-31,0.4182014122,6.948577311,-23.17800904
28,151,2002,1015,663,-1673,844,25,352,-1648,-1304,60347,16.639617043,10.86903064,-27.42667913,-8,0.4098427843,5.7705864031,-27.01683634
28,151,2003,993,659,-1576,805,20,334,-1556,-1203,59144,16.620498615,11.030119423,-26.37855571,19,0.334753245,5.5903791917,-26.04380246
28,151,2004,944,626,-1205,831,21,318,-1184,-937,58207,16.088486677,10.668848156,-20.53668056,-71,0.357900657,5.4196385203,-20.1787799
28,151,2005,935,645,-895,811,22,290,-873,-633,57574,16.151181973,11.141724463,-15.46022232,-50,0.3800278111,5.0094575103,-15.08019451
28,151,2006,943,622,-1432,810,24,321,-1408,-1105,56469,16.537621774,10.908166218,-25.11333444,-18,0.4208938734,5.6294555562,-24.69244057
28,151,2007,1014,572,-1323,811,18,442,-1305,-830,55639,18.089699219,10.204445713,-23.6022407,33,0.321118921,7.8852535055,-23.28112178
28,151,2008,928,601,-930,811,19,327,-911,-560,55079,16.763308586,10.856409979,-16.79943641,24,0.3432142922,5.9068986073,-16.45622211
28,153,2001,312,202,-145,206,2,110,-143,-53,21129,14.747937888,9.5483444022,-6.854009596,-20,0.0945380634,5.1995934863,-6.759471532
28,153,2002,312,208,-81,203,2,104,-79,4,21133,14.765037149,9.8433580995,-3.833230798,-21,0.094647674,4.9216790497,-3.738583124
28,153,2003,282,197,-192,208,0,85,-192,-128,21005,13.384593479,9.350230196,-9.112914709,-21,0,4.0343632825,-9.112914709
28,153,2004,312,197,-168,207,3,115,-165,-67,20938,14.877333524,9.3937009751,-8.010871898,-17,0.1430512839,5.4836325489,-7.867820614
28,153,2005,244,198,-85,208,1,46,-84,-52,20886,11.667941852,9.4682478959,-4.064651875,-14,0.0478194338,2.1996939556,-4.016832441
28,153,2006,358,219,-51,206,3,139,-48,80,20966,17.107904043,10.46544968,-2.437159514,-11,0.1433623244,6.642454363,-2.29379719
28,153,2007,348,168,-28,206,1,180,-27,119,21085,16.551330527,7.9902974959,-1.331716249,-34,0.0475612946,8.5610330313,-1.284154955
28,153,2008,309,195,-412,206,2,114,-410,-330,20755,14.770554493,9.3212237094,-19.69407266,-34,0.0956022945,5.4493307839,-19.59847036
28,155,2001,137,143,-13,229,1,-6,-12,-27,10260,13.33528009,13.919306955,-1.265391541,-9,0.0973378109,-0.584026865,-1.16805373
28,155,2002,158,151,-106,196,0,7,-106,-105,10155,15.478814597,14.79304433,-10.38452119,-6,0,0.685770267,-10.38452119
28,155,2003,131,152,-178,199,-3,-21,-181,-202,9953,13.029639944,15.118360851,-17.70439626,0,-0.298388701,-2.088720907,-18.00278496
28,155,2004,136,120,-34,200,2,16,-32,-24,9929,13.680716226,12.071220199,-3.420179056,-8,0.2011870033,1.6094960266,-3.218992053
28,155,2005,138,165,-78,198,0,-27,-78,-113,9816,13.978222335,16.713091922,-7.900734363,-8,0,-2.734869587,-7.900734363
28,155,2006,138,134,-14,198,2,4,-12,-13,9803,14.067995311,13.660227331,-1.42718793,-5,0.20388399,0.40776798,-1.22330394
28,155,2007,140,151,-23,198,-1,-11,-24,-32,9771,14.304689895,15.428629815,-2.350056197,3,-0.102176356,-1.12393992,-2.452232553
28,155,2008,136,135,115,198,0,1,115,116,9887,13.836605962,13.734866212,11.700071218,0,0,0.1017397497,11.700071218
28,157,2001,147,138,-20,1044,0,9,-20,-23,10268,14.300306435,13.42477747,-1.945619923,-12,0,0.8755289654,-1.945619923
28,157,2002,130,146,30,1076,-1,-16,29,5,10273,12.657611606,14.215471496,2.9209872937,-8,-0.097366243,-1.55785989,2.8236210506
28,157,2003,130,163,67,1174,-1,-33,66,25,10298,12.639152205,15.84755238,6.5140245977,-8,-0.097224248,-3.208400175,6.41680035
28,157,2004,164,116,-124,1195,0,48,-124,-87,10211,15.992978692,11.31210688,-12.09225218,-11,0,4.6808718124,-12.09225218
28,157,2005,133,128,-54,1172,0,5,-54,-56,10155,13.060983993,12.569969557,-5.302955907,-7,0,0.4910144358,-5.302955907
28,157,2006,123,128,208,1163,0,-5,208,195,10350,11.997073884,12.484759815,20.287734699,-8,0,-0.48768593,20.287734699
28,157,2007,160,104,-141,1171,0,56,-141,-82,10268,15.520419051,10.088272383,-13.67736929,3,0,5.432146668,-13.67736929
28,157,2008,153,131,-8,1171,0,22,-8,15,10283,14.889786385,12.748771349,-0.778550922,1,0,2.1410150358,-0.778550922
28,159,2001,303,242,-169,530,15,61,-154,-109,20059,15.064508912,12.031719989,-8.402316852,-16,0.7457677679,3.0327889229,-7.656549084
28,159,2002,238,199,-223,511,14,39,-209,-184,19875,11.919667451,9.9664446336,-11.16842791,-14,0.7011569089,1.9532228176,-10.467271
28,159,2003,253,207,-79,554,12,46,-67,-46,19829,12.744307878,10.427160991,-3.979447915,-25,0.6044731009,2.317146887,-3.374974814
28,159,2004,270,216,-109,581,12,54,-97,-59,19770,13.636707998,10.909366398,-5.505189525,-16,0.606075911,2.7273415995,-4.899113614
28,159,2005,290,212,-218,576,13,78,-205,-144,19626,14.722306833,10.762513961,-11.06711341,-17,0.6599654787,3.9597928724,-10.40714793
28,159,2006,264,224,-81,607,13,40,-68,-38,19588,13.464578977,11.424491253,-4.131177641,-10,0.6630285102,2.0400877238,-3.46814913
28,159,2007,295,181,-23,606,10,114,-13,102,19690,15.021131422,9.2163552116,-1.17113906,1,0.5091908957,5.8047762106,-0.661948164
28,159,2008,285,222,-201,606,10,63,-191,-115,19575,14.516745193,11.307780466,-10.23812556,13,0.5093594805,3.2089647269,-9.728766077
28,161,2001,186,139,203,104,2,47,205,243,13406,14.001279687,10.463321917,15.28096654,-9,0.1505513945,3.5379577703,15.431517934
28,161,2002,176,143,-53,105,2,33,-51,-30,13376,13.143155851,10.678814129,-3.95788216,-12,0.1493540438,2.4643417221,-3.808528116
28,161,2003,176,160,36,104,2,16,38,37,13413,13.139721527,11.945201389,2.6876703124,-17,0.1493150174,1.1945201389,2.8369853298
28,161,2004,214,185,-51,108,1,29,-50,-31,13382,15.973129315,13.808546371,-3.806680351,-10,0.0746407912,2.1645829446,-3.73203956
28,161,2005,201,154,77,113,2,47,79,113,13495,14.957026454,11.459612308,5.729806154,-13,0.1488261339,3.4974141459,5.8786322878
28,161,2006,226,166,2,142,1,60,3,56,13551,16.712267988,12.275382681,0.1478961769,-7,0.0739480884,4.4368853065,0.2218442653
28,161,2007,210,145,74,142,2,65,76,142,13693,15.416238438,10.644545588,5.4323887829,1,0.1468213185,4.7716928498,5.5792101013
28,161,2008,217,153,-120,142,1,64,-119,-48,13645,15.875338357,11.193210915,-8.778988953,7,0.0731582413,4.6821274417,-8.705830712
28,163,2001,430,329,-458,2490,12,101,-446,-362,27767,15.38571633,11.771862029,-16.38757693,-17,0.4293688278,3.6138543008,-15.9582081
28,163,2002,417,282,-219,2476,11,135,-208,-95,27672,15.043561392,10.173343675,-7.900575407,-22,0.3968325547,4.8702177168,-7.503742853
28,163,2003,432,283,6,2486,8,149,14,123,27795,15.576829466,10.204265599,0.2163448537,-40,0.2884598049,5.3725638668,0.5048046586
28,163,2004,405,298,-117,2591,10,107,-107,-20,27775,14.576210185,10.725211445,-4.210905165,-20,0.3599064243,3.8509987403,-3.85099874
28,163,2005,447,257,-129,2909,10,190,-119,46,27821,16.080293546,9.2452694438,-4.640621627,-25,0.3597381107,6.8350241025,-4.280883517
28,163,2006,445,296,790,3919,10,149,800,932,28753,15.731608159,10.464170821,27.928023474,-17,0.3535192845,5.2674373387,28.281542758
28,163,2007,489,255,-311,3852,7,234,-304,-60,28693,17.024684051,8.877902726,-10.8275598,10,0.2437071337,8.1467813251,-10.58385266
28,163,2008,460,247,-465,3763,7,213,-458,-229,28464,16.096016236,8.6428608919,-16.27097293,16,0.2449393775,7.4531553441,-16.02603356
29,0,2001,75674,54839,2387,166124,7903,20835,10290,36126,5641994,13.455712739,9.7510086806,0.4244362173,5001,1.4052448368,3.7047040584,1.8296810541
29,0,2002,75213,55533,3731,167908,6726,19680,10457,33647,5675641,13.291292748,9.8135343647,0.6593250268,3510,1.188587545,3.4777583833,1.8479125718
29,0,2003,75872,55122,5355,168833,4007,20750,9362,28998,5704639,13.333942574,9.6872836169,0.9411016249,-1114,0.7042005996,3.6466589574,1.6453022245
29,0,2004,77938,55371,4621,168423,7181,22567,11802,38011,5742650,13.616848496,9.6740809112,0.8073527278,3642,1.2546201987,3.9427675845,2.0619729265
29,0,2005,78118,54572,7804,169435,6254,23546,14058,42480,5785130,13.552999797,9.4679114279,1.353946727,4876,1.0850311161,4.0850883691,2.4389778431
29,0,2006,79736,54339,11302,169128,6909,25397,18211,47847,5832977,13.726160381,9.3541916941,1.9455837341,4239,1.1893503821,4.3719686865,3.1349341162
29,0,2007,82765,52570,4501,168872,5567,30195,10068,45422,5878399,14.134120534,8.9775958009,0.7686543409,5159,0.9506995591,5.1565247329,1.7193539
29,0,2008,82985,53170,-2384,168872,5902,29815,3518,33206,5911605,14.077179278,9.0195049976,-0.40441038,-127,1.0011871073,5.0576742807,0.5967767271
29,1,2001,290,238,-102,2790,29,52,-73,-45,24915,11.629072682,9.5438596491,-4.090225564,-24,1.1629072682,2.0852130326,-2.927318296
29,1,2002,296,244,-3,2790,27,52,24,51,24966,11.868246426,9.7832842164,-0.120286281,-25,1.0825765321,2.0849622101,0.9622902508
29,1,2003,267,215,-245,2790,23,52,-222,-191,24775,10.735610462,8.6447799602,-9.851028327,-21,0.9247904143,2.090830502,-8.926237912
29,1,2004,288,214,-103,2790,22,74,-81,-25,24750,11.630489652,8.6420999495,-4.159515396,-18,0.8884401817,2.9883897022,-3.271075215
29,1,2005,278,232,-251,2790,23,46,-228,-202,24548,11.278348006,9.4121465374,-10.18296888,-20,0.9331007343,1.8662014686,-9.249868149
29,1,2006,269,220,12,2790,22,49,34,72,24620,10.942076147,8.9489098601,0.488122356,-11,0.894890986,1.993166287,1.383013342
29,1,2007,319,206,-145,2790,20,113,-125,-4,24616,12.957998213,8.3678609148,-5.889999188,8,0.812413681,4.5901372979,-5.077585507
29,1,2008,301,218,215,2790,19,83,234,327,24943,12.147137755,8.797594786,8.6765269679,10,0.7667628483,3.349542969,9.4432898162
29,3,2001,171,159,63,264,1,12,64,59,16589,10.326398744,9.6017391829,3.8044626951,-17,0.0603882967,0.724659561,3.8648509919
29,3,2002,178,181,-54,264,-1,-3,-55,-76,16513,10.754637182,10.935895112,-3.262642741,-18,-0.06041931,-0.18125793,-3.323062051
29,3,2003,190,158,88,264,-6,32,82,99,16612,11.471698113,9.5396226415,5.3132075472,-15,-0.362264151,1.9320754717,4.9509433962
29,3,2004,174,161,-39,264,4,13,-35,-33,16579,10.484769968,9.7014250851,-2.350034648,-11,0.2410291947,0.7833448826,-2.109005453
29,3,2005,192,177,-74,264,0,15,-74,-74,16505,11.606819006,10.700036271,-4.473461492,-15,0,0.9067827349,-4.473461492
29,3,2006,186,187,293,264,2,-1,295,285,16790,11.172848776,11.232917856,17.600240276,-9,0.1201381589,-0.060069079,17.720378435
29,3,2007,212,172,0,264,0,40,0,43,16833,12.610415489,10.231091812,0,3,0,2.3793236772,0
29,3,2008,199,153,41,264,2,46,43,90,16923,11.790496504,9.0650551013,2.4291977722,1,0.1184974523,2.725441403,2.5476952246
29,5,2001,58,87,11,297,1,-29,12,-21,6384,9.0702947846,13.605442177,1.7202283212,-4,0.1563843928,-4.535147392,1.8766127141
29,5,2002,61,102,-87,297,0,-41,-87,-132,6252,9.6549540994,16.144349478,-13.77018044,-4,0,-6.489395378,-13.77018044
29,5,2003,69,90,50,297,0,-21,50,26,6278,11.013567438,14.365522745,7.9808459697,-3,0,-3.351955307,7.9808459697
29,5,2004,53,76,13,297,1,-23,14,-13,6265,8.4509288049,12.118313003,2.0728693295,-4,0.1594514869,-3.667384198,2.2323208164
29,5,2005,66,90,-52,297,1,-24,-51,-80,6185,10.602409639,14.457831325,-8.353413655,-5,0.1606425703,-3.855421687,-8.192771084
29,5,2006,60,66,-99,297,1,-6,-98,-105,6080,9.7839380351,10.762331839,-16.14349776,-1,0.1630656339,-0.978393804,-15.98043212
29,5,2007,56,62,24,297,0,-6,24,19,6099,9.19615732,10.18145989,3.94121028,1,0,-0.98530257,3.94121028
29,5,2008,64,75,-57,297,0,-11,-57,-68,6031,10.552349547,12.366034625,-9.398186315,0,0,-1.813685078,-9.398186315
29,7,2001,410,284,-192,1944,1,126,-191,-85,25723,15.912751548,11.022491316,-7.451825115,-20,0.0388115891,4.8902602317,-7.413013526
29,7,2002,348,284,40,2143,1,64,41,82,25805,13.507219376,11.023133054,1.5525539512,-23,0.0388138488,2.484086322,1.5913678
29,7,2003,388,334,-81,2236,1,54,-80,-57,25748,15.052470273,12.957538844,-3.142397145,-31,0.0387950265,2.0949314298,-3.103602118
29,7,2004,399,311,-257,2205,0,88,-257,-195,25553,15.555252334,12.12451999,-10.01929787,-26,0,3.4307323444,-10.01929787
29,7,2005,381,291,190,2463,1,90,191,258,25811,14.835293201,11.330893233,7.398177712,-23,0.0389377774,3.5043999688,7.4371154894
29,7,2006,398,289,81,2513,0,109,81,177,25988,15.367092029,11.158516574,3.1274735033,-13,0,4.2085754551,3.1274735033
29,7,2007,398,299,-261,2495,1,99,-260,-159,25829,15.361753865,11.540614084,-10.07391397,2,0.0385973715,3.8211397804,-10.03531659
29,7,2008,398,292,111,2495,0,106,111,220,26049,15.343690967,11.257180308,4.2792705964,3,0,4.0865106596,4.2792705964
29,9,2001,489,360,-140,355,78,129,-62,30,34072,14.358281704,10.570514138,-4.110755498,-37,2.2902780632,3.7877675661,-1.820477435
29,9,2002,475,382,11,355,76,93,87,144,34216,13.911668229,11.187910028,0.3221649485,-36,2.2258669166,2.7237582006,2.548031865
29,9,2003,504,397,293,355,62,107,355,435,34651,14.636908824,11.529469848,8.5091553284,-27,1.8005721173,3.1074389766,10.309727446
29,9,2004,491,415,199,355,63,76,262,308,34959,14.10716851,11.923574199,5.7175693148,-30,1.8100847579,2.1835943112,7.5276540727
29,9,2005,531,386,215,355,64,145,279,390,35349,15.104966718,10.980258292,6.1159469762,-34,1.8205609603,4.1247084258,7.9365079365
29,9,2006,522,394,371,355,64,128,435,545,35894,14.654071277,11.060735792,10.415058322,-18,1.7966677428,3.5933354856,12.211726064
29,9,2007,579,373,-43,355,53,206,10,209,36103,16.0840035,10.361542842,-1.194494215,-7,1.4722835674,5.7224606581,0.2777893523
29,9,2008,556,398,-15,355,55,158,40,198,36301,15.358267499,10.993867742,-0.414341749,0,1.5192530799,4.3643997569,1.1049113309
29,11,2001,171,137,116,172,2,34,118,142,12683,13.558515699,10.862670473,9.1975895972,-10,0.158579131,2.6958452268,9.3561687282
29,11,2002,178,136,58,172,2,42,60,91,12774,13.984365793,10.684683977,4.5567034607,-11,0.1571277055,3.2996818164,4.7138311663
29,11,2003,169,131,102,172,0,38,102,130,12904,13.163018927,10.20328686,7.9445439676,-10,0,2.9597320664,7.9445439676
29,11,2004,160,138,-8,172,3,22,-5,9,12913,12.394933571,10.690630205,-0.619746679,-8,0.2324050045,1.704303366,-0.387341674
29,11,2005,159,152,28,172,2,7,30,25,12938,12.301264941,11.759699818,2.1662604928,-12,0.1547328923,0.5415651232,2.3209933852
29,11,2006,164,127,-70,172,2,37,-68,-37,12901,12.693989705,9.8301017841,-5.418166338,-6,0.1548047525,2.8638879214,-5.263361585
29,11,2007,188,137,-243,172,0,51,-243,-184,12717,14.677180108,10.695604653,-18.97103599,8,0,3.9815754548,-18.97103599
29,11,2008,165,130,-226,172,2,35,-224,-186,12531,13.070342205,10.297845374,-17.90240811,3,0.1584283904,2.7724968314,-17.74397972
29,13,2001,206,217,89,279,9,-11,98,72,16774,12.30732465,12.964511889,5.3172422034,-15,0.5376986498,-0.657187239,5.8549408531
29,13,2002,213,229,193,279,9,-16,202,177,16951,12.631578947,13.580429948,11.445515196,-9,0.5337286879,-0.948851001,11.979243884
29,13,2003,220,207,57,279,5,13,62,55,17006,12.957563978,12.191889743,3.3571870307,-20,0.2944900904,0.7656742351,3.6516771211
29,13,2004,230,201,-73,279,6,29,-67,-51,16955,13.544948618,11.83710727,-4.299048909,-13,0.3533464857,1.7078413474,-3.945702423
29,13,2005,216,199,-19,279,6,17,-13,-10,16945,12.743362832,11.740412979,-1.120943953,-14,0.3539823009,1.0029498525,-0.766961652
29,13,2006,232,209,44,279,6,23,50,63,17008,13.66594999,12.311135982,2.5918181015,-10,0.3534297411,1.3548140076,2.9452478426
29,13,2007,215,194,-33,279,5,21,-28,-6,17002,12.643340194,11.408409291,-1.940605704,1,0.2940311673,1.2349309027,-1.646574537
29,13,2008,229,197,32,279,5,32,37,73,17075,13.440150248,11.56205065,1.878099598,4,0.2934530622,1.878099598,2.1715526602
29,15,2001,150,257,251,248,1,-107,252,133,17366,8.6707708315,14.855920691,14.509089858,-12,0.0578051389,-6.18514986,14.566894997
29,15,2002,148,231,215,248,1,-83,216,125,17491,8.4918380813,13.254152681,12.336116132,-8,0.0573772843,-4.7623146,12.393493416
29,15,2003,158,259,422,248,1,-101,423,331,17822,8.9485458613,14.668818849,23.900546541,9,0.0566363662,-5.720272987,23.957182907
29,15,2004,172,256,381,248,0,-84,381,271,18093,9.5781706808,14.255881943,21.216761799,-26,0,-4.677711263,21.216761799
29,15,2005,172,261,372,248,1,-89,373,273,18366,9.435256041,14.317452481,20.406483996,-11,0.0548561398,-4.88219644,20.461340135
29,15,2006,141,254,29,248,0,-113,29,-94,18272,7.6969266881,13.865385665,1.5830558437,-10,0,-6.168458977,1.5830558437
29,15,2007,178,267,267,248,1,-89,268,165,18437,9.6978942494,14.546841374,14.546841374,-14,0.054482552,-4.848947125,14.601323926
29,15,2008,178,256,25,248,0,-78,25,-88,18349,9.6775947371,13.918338498,1.359212744,-35,0,-4.240743761,1.359212744
29,17,2001,130,130,194,164,0,0,194,187,12240,10.702671551,10.702671551,15.971679085,-7,0,0,15.971679085
29,17,2002,159,126,-10,164,0,33,-10,9,12249,12.985422026,10.290334436,-0.816693209,-14,0,2.6950875903,-0.816693209
29,17,2003,144,98,-63,164,-1,46,-64,-36,12213,11.773362767,8.0124274385,-5.15084621,-18,-0.081759464,3.7609353283,-5.232605674
29,17,2004,135,144,-20,164,2,-9,-18,-35,12178,11.069656841,11.807633963,-1.639949162,-8,0.1639949162,-0.737977123,-1.475954245
29,17,2005,146,139,-26,164,1,7,-25,-27,12151,12.002137367,11.426692425,-2.137366928,-9,0.0822064203,0.5754449422,-2.055160508
29,17,2006,143,133,-44,164,1,10,-43,-39,12112,11.787495363,10.963194988,-3.62692165,-6,0.0824300375,0.8243003751,-3.544491613
29,17,2007,150,116,-20,164,0,34,-20,2,12114,12.383389747,9.5764880707,-1.651118633,-12,0,2.8069016759,-1.651118633
29,17,2008,158,120,-142,164,2,38,-140,-124,11990,13.109857285,9.9568536343,-11.7822768,-22,0.1659475606,3.1530036508,-11.61632924
29,19,2001,1763,848,591,8969,449,915,1040,1820,137659,12.892233216,6.2011422387,4.321786631,-135,3.2833878127,6.6910909769,7.6051744437
29,19,2002,1766,877,848,8973,419,889,1267,2046,139705,12.734168818,6.3238199622,6.1147084697,-110,3.0213005293,6.4103488557,9.136008999
29,19,2003,1818,843,602,8971,354,975,956,1761,141466,12.931632352,5.996350975,4.2820916809,-170,2.518040623,6.9352813768,6.8001323038
29,19,2004,1920,891,580,8965,338,1029,918,1841,143307,13.484424436,6.257615715,4.0734198818,-106,2.3738205518,7.2268087213,6.4472404336
29,19,2005,1991,847,1498,8966,351,1144,1849,2866,146173,13.755699876,5.8518723228,10.349592373,-127,2.4250379992,7.9038275529,12.774630372
29,19,2006,1974,858,1949,8975,355,1116,2304,3340,149513,13.352001786,5.8034536637,13.182903485,-80,2.4011958632,7.548548122,15.584099349
29,19,2007,2105,874,988,8972,322,1231,1310,2536,152049,13.960644909,5.7964862947,6.5525497244,-5,2.1355475823,8.1641586141,8.6880973067
29,19,2008,2198,884,645,8972,325,1314,970,2316,154365,14.346602962,5.769971346,4.2099904051,32,2.1213129948,8.576631616,6.3313034
29,21,2001,1090,952,-450,4649,31,138,-419,83,86177,12.654480441,11.052353559,-5.224326787,364,0.3598980676,1.6021268815,-4.86442872
29,21,2002,1139,926,-370,4774,24,213,-346,147,86324,13.205720547,10.736169645,-4.289830204,280,0.2782592565,2.4695509012,-4.011570947
29,21,2003,1114,932,-464,4590,5,182,-459,-20,86304,12.906365132,10.797784832,-5.375721204,257,0.0579280302,2.1085802998,-5.317793174
29,21,2004,1120,928,-217,4709,38,192,-179,330,86634,12.952618858,10.732169911,-2.509569904,317,0.4394638541,2.220448947,-2.07010605
29,21,2005,1129,931,-54,4713,28,198,-26,463,87097,12.997104719,10.717718772,-0.621650713,291,0.3223374067,2.2793859472,-0.299313306
29,21,2006,1177,948,-190,4675,34,229,-156,375,87472,13.484639312,10.861034892,-2.176789693,302,0.3895307873,2.62360442,-1.787258906
29,21,2007,1387,901,668,4604,24,486,692,1541,89013,15.718049693,10.210499476,7.570048446,363,0.2719777885,5.5075502167,7.8420262345
29,21,2008,1312,871,-109,4604,28,441,-81,395,89408,14.706788999,9.763424709,-1.221829269,35,0.3138643994,4.9433642901,-0.90796487
29,23,2001,557,508,-152,960,19,49,-133,-124,40678,13.672066765,12.469317624,-3.730976927,-40,0.4663721159,1.2027491409,-3.264604811
29,23,2002,559,542,102,964,18,17,120,100,40778,13.725201336,13.307798075,2.5044195639,-37,0.4419563936,0.4174032607,2.9463759576
29,23,2003,517,579,5,965,13,-62,18,-99,40679,12.693813914,14.216089471,0.1227641578,-55,0.3191868102,-1.522275556,0.441950968
29,23,2004,581,552,203,966,14,29,217,211,40890,14.245608013,13.534553568,4.9773811129,-35,0.343267663,0.7110544447,5.3206487759
29,23,2005,598,514,306,963,13,84,319,365,41255,14.559620184,12.514456145,7.4502404285,-38,0.3165134823,2.0451640392,7.7667539108
29,23,2006,580,543,105,959,15,37,120,138,41393,14.035427355,13.140063885,2.5408963314,-19,0.3629851902,0.8953634692,2.9038815216
29,23,2007,594,511,-257,962,12,83,-245,-163,41230,14.37856287,12.369437082,-6.221028043,-1,0.2904760176,2.0091257882,-5.930552025
29,23,2008,563,512,85,962,14,51,99,153,41383,13.629816131,12.395143621,2.0577875153,3,0.3389297084,1.2346725092,2.3967172237
29,25,2001,108,117,28,119,0,-9,28,10,8987,12.024048096,13.026052104,3.1173458027,-9,0,-1.002004008,3.1173458027
29,25,2002,131,110,0,119,0,21,0,13,9000,14.566075499,12.231055762,0,-8,0,2.3350197365,0
29,25,2003,117,101,74,119,-1,16,73,83,9083,12.940330697,11.170712824,8.1844826633,-6,-0.110601117,1.7696178731,8.0738815462
29,25,2004,122,84,26,119,0,38,26,58,9141,13.388937665,9.2186128183,2.853380158,-6,0,4.1703248464,2.853380158
29,25,2005,121,101,7,119,0,20,7,19,9160,13.22332113,11.037648216,0.7649855199,-8,0,2.185672914,0.7649855199
29,25,2006,134,109,36,119,0,25,36,56,9216,14.584240313,11.863299956,3.9181541141,-5,0,2.720940357,3.9181541141
29,25,2007,121,98,33,119,0,23,33,57,9273,13.088863649,10.600897831,3.569690086,1,0,2.4879658175,3.569690086
29,25,2008,133,99,-67,119,0,34,-67,-25,9248,14.362075482,10.690567464,-7.235030506,8,0,3.6715080179,-7.235030506
29,27,2001,513,333,392,4056,26,180,418,566,41491,12.449039022,8.0809551543,9.5127159775,-32,0.6309454475,4.3680838672,10.143661425
29,27,2002,489,361,356,4213,23,128,379,478,41969,11.718188354,8.6508507069,8.5310328301,-29,0.5511622334,3.0673376468,9.0821950635
29,27,2003,489,318,-174,3707,14,171,-160,-38,41931,11.656734207,7.5804529201,-4.147794994,-49,0.3337306317,4.0762812872,-3.814064362
29,27,2004,501,379,-461,3161,28,122,-433,-353,41578,11.998706726,9.0768659665,-11.04072615,-42,0.6705864039,2.9218407597,-10.37013975
29,27,2005,539,319,721,3603,23,220,744,925,42503,12.820970255,7.5879211713,17.150129042,-39,0.5470914951,5.2330490836,17.697220537
29,27,2006,496,334,250,3546,26,162,276,416,42919,11.612933436,7.8199995317,5.8532930627,-22,0.6087424785,3.7929339046,6.4620355412
29,27,2007,529,317,27,3375,20,212,47,261,43180,12.288179886,7.3636163022,0.6271849847,2,0.4645814702,4.9245635838,1.0917664549
29,27,2008,542,318,17,3375,22,224,39,284,43464,12.510964406,7.3403813305,0.3924103227,21,0.5078251235,5.1705830756,0.9002354462
29,29,2001,364,393,187,622,15,-29,202,131,37359,9.7604140132,10.538029415,5.0142786276,-42,0.4022148632,-0.777615402,5.4164934908
29,29,2002,362,350,442,622,14,12,456,444,37803,9.6325270749,9.3132167851,11.76126234,-24,0.3725286714,0.3193102898,12.133791011
29,29,2003,369,422,284,622,5,-53,289,213,38016,9.7337079096,11.131774357,7.4915258708,-23,0.1318930611,-1.398066448,7.6234189319
29,29,2004,424,439,442,622,12,-15,454,390,38406,11.096281176,11.488838293,11.567349716,-49,0.3140456936,-0.392557117,11.88139541
29,29,2005,387,407,719,622,9,-20,728,686,39092,9.9873545124,10.503496864,18.555317557,-22,0.2322640584,-0.516142352,18.787581615
29,29,2006,452,393,821,622,11,59,832,867,39959,11.435655463,9.9429482233,20.771400741,-24,0.2783013498,1.4927072396,21.049702091
29,29,2007,461,402,433,622,7,59,440,448,40407,11.472513252,10.004230645,10.775701167,-51,0.1742030212,1.4682826071,10.949904188
29,29,2008,462,417,302,622,9,45,311,257,40664,11.397417079,10.287279052,7.4502596489,-99,0.2220276054,1.1101380272,7.6722872544
29,31,2001,875,645,230,3405,39,230,269,426,69220,12.679873056,9.346877853,3.3329952034,-73,0.5651600562,3.3329952034,3.8981552596
29,31,2002,859,720,174,3405,33,139,207,275,69495,12.385106153,10.380997008,2.5087409437,-71,0.4757956962,2.0041091446,2.9845366399
29,31,2003,848,629,158,3402,21,219,179,293,69788,12.176647545,9.0319708794,2.2687621605,-105,0.3015443378,3.1446766655,2.5703064983
29,31,2004,933,691,588,3404,43,242,631,812,70600,13.291734336,9.8441462233,8.3767843405,-61,0.6125879705,3.4475881129,8.989372311
29,31,2005,902,765,405,3393,36,137,441,524,71124,12.72896616,10.795630945,5.7153340295,-54,0.5080296915,1.9333352149,6.223363721
29,31,2006,947,712,751,3386,41,235,792,988,72112,13.222932782,9.9416347846,10.486190622,-39,0.5724817783,3.2812979977,11.058672401
29,31,2007,953,659,220,3396,34,294,254,530,72642,13.167166365,9.1051024497,3.0396396645,-18,0.4697624936,4.0620639153,3.5094021581
29,31,2008,981,691,280,3396,37,290,317,601,73243,13.448949515,9.4732152038,3.8386400247,-6,0.5072488604,3.9757343113,4.3458888851
29,33,2001,103,136,-53,194,1,-33,-52,-96,10179,10.071379681,13.298132395,-5.182360419,-11,0.0977803853,-3.226752713,-5.084580033
29,33,2002,123,135,15,194,1,-12,16,-6,10173,12.087264151,13.266509434,1.4740566038,-10,0.0982704403,-1.179245283,1.572327044
29,33,2003,133,143,-51,194,1,-10,-50,-72,10101,13.12025254,14.106737694,-5.031074282,-12,0.0986485153,-0.986485153,-4.932425767
29,33,2004,101,137,0,194,0,-36,0,-43,10058,10.02033831,13.591944045,0,-7,0,-3.571605734,0
29,33,2005,110,123,39,194,1,-13,40,17,10075,10.927333234,12.218745343,3.8742363284,-10,0.099339393,-1.291412109,3.9735757215
29,33,2006,109,124,-120,194,0,-15,-120,-139,9936,10.894008295,12.393183749,-11.99340363,-4,0,-1.499175454,-11.99340363
29,33,2007,106,120,-70,194,1,-14,-69,-81,9855,10.711939771,12.126724269,-7.07392249,2,0.1010560356,-1.414784498,-6.972866454
29,33,2008,116,129,-95,194,0,-13,-95,-99,9756,11.830095355,13.155881903,-9.688440161,9,0,-1.325786548,-9.688440161
29,35,2001,78,85,-61,85,-1,-7,-62,-75,5870,13.203554803,14.388489209,-10.32585696,-6,-0.169276344,-1.184934405,-10.49513331
29,35,2002,75,68,8,85,-1,7,7,10,5880,12.765957447,11.574468085,1.3617021277,-4,-0.170212766,1.1914893617,1.1914893617
29,35,2003,81,65,23,85,-2,16,21,30,5910,13.740458015,11.026293469,3.9016115352,-7,-0.339270568,2.7141645462,3.5623409669
29,35,2004,77,72,-35,85,1,5,-34,-34,5876,13.066349907,12.217885627,-5.939249958,-5,0.1696928559,0.8484642797,-5.769557102
29,35,2005,75,71,4,85,0,4,4,3,5879,12.760527435,12.079965972,0.6805614632,-5,0,0.6805614632,0.6805614632
29,35,2006,88,95,15,85,0,-7,15,6,5885,14.960897654,16.150969058,2.5501530092,-2,0,-1.190071404,2.5501530092
29,35,2007,89,64,5,85,-1,25,4,28,5913,15.087302933,10.849296491,0.8476012884,-1,-0.169520258,4.2380064418,0.6780810307
29,35,2008,79,69,-33,85,1,10,-32,-23,5890,13.38642718,11.691942726,-5.591798695,-1,0.1694484453,1.6944844531,-5.42235025
29,37,2001,1143,756,1598,966,50,387,1648,1972,84568,13.675193223,9.0450096911,19.118949056,-63,0.5982149267,4.6301835323,19.717163983
29,37,2002,1136,723,1801,966,28,413,1829,2199,86767,13.260571395,8.4396066186,21.023141798,-43,0.3268450696,4.8209647766,21.349986868
29,37,2003,1224,728,1015,966,-17,496,998,1427,88194,13.991689577,8.3218545847,11.602585719,-67,-0.194329022,5.6698349918,11.408256697
29,37,2004,1223,737,2338,966,73,486,2411,2772,90966,13.652601027,8.2272828756,26.099575798,-125,0.8149140433,5.4253181514,26.914489841
29,37,2005,1224,749,1358,966,44,475,1402,1790,92756,13.324479376,8.1536234093,14.78320506,-87,0.4789845527,5.1708559672,15.262189613
29,37,2006,1277,768,1254,966,60,509,1314,1774,94530,13.636897579,8.2013604861,13.391283919,-49,0.640731288,5.435537093,14.032015207
29,37,2007,1370,772,1720,966,39,598,1759,2397,96927,14.3113075,8.0644740072,17.967480949,40,0.4074021843,6.2468334926,18.374883133
29,37,2008,1407,785,798,966,47,622,845,1502,98429,14.404471836,8.0366100862,8.1697004443,35,0.4811728332,6.3678617498,8.6508732775
29,39,2001,141,193,185,350,5,-52,190,128,13861,10.219612959,13.988548235,13.408712039,-10,0.3623976227,-3.768935276,13.771109662
29,39,2002,154,202,11,350,3,-48,14,-47,13814,11.129177958,14.598012647,0.7949412827,-13,0.216802168,-3.468834688,1.0117434508
29,39,2003,153,192,54,350,3,-39,57,4,13818,11.074116966,13.896931094,3.9085118703,-14,0.2171395483,-2.822814129,4.1256514186
29,39,2004,163,175,59,350,4,-12,63,41,13859,11.778733244,12.64587925,4.2634678614,-10,0.2890486686,-0.867146006,4.55251653
29,39,2005,164,201,206,350,4,-37,210,160,14019,11.765549896,14.419972738,14.778678528,-13,0.2869646316,-2.654422842,15.065643159
29,39,2006,183,220,-122,350,4,-37,-118,-161,13858,13.129102845,15.783620906,-8.75273523,-6,0.2869749256,-2.654518061,-8.465760304
29,39,2007,160,174,-131,350,4,-14,-127,-151,13707,11.608924361,12.624705242,-9.50480682,-10,0.290223109,-1.015780882,-9.214583711
29,39,2008,173,190,-35,350,4,-17,-31,-55,13652,12.646661062,13.889396542,-2.558573047,-7,0.2924083483,-1.24273548,-2.266164699
29,41,2001,83,123,-109,196,0,-40,-109,-153,8256,9.9609960996,14.761476148,-13.08130813,-4,0,-4.800480048,-13.08130813
29,41,2002,72,125,44,196,-1,-53,43,-18,8238,8.7304474354,15.157026798,5.3352734328,-8,-0.121256214,-6.426579362,5.2140172184
29,41,2003,69,135,-32,196,-1,-66,-33,-109,8129,8.4316001711,16.49660903,-3.910307326,-10,-0.122197104,-8.065008859,-4.03250443
29,41,2004,99,100,-31,196,0,-1,-31,-40,8089,12.208657048,12.331976816,-3.822912813,-8,0,-0.123319768,-3.822912813
29,41,2005,78,119,-56,196,0,-41,-56,-103,7986,9.7045101089,14.805598756,-6.967340591,-6,0,-5.101088647,-6.967340591
29,41,2006,104,121,-31,196,0,-17,-31,-52,7934,13.065326633,15.201005025,-3.894472362,-4,0,-2.135678392,-3.894472362
29,41,2007,94,97,-112,196,0,-3,-112,-112,7822,11.931962427,12.312769739,-14.2168063,3,0,-0.380807312,-14.2168063
29,41,2008,100,104,-83,196,0,-4,-83,-82,7740,12.851818532,13.365891274,-10.66700938,5,0,-0.514072741,-10.66700938
29,43,2001,863,417,1555,603,9,446,1564,1978,56930,15.426967698,7.4542821902,27.797143419,-32,0.1608837883,7.9726855079,27.958027207
29,43,2002,800,403,1552,603,5,397,1557,1933,58863,13.817761005,6.960697106,26.806456349,-21,0.0863610063,6.8570638985,26.892817355
29,43,2003,806,480,1709,603,-6,326,1703,2058,60921,13.457556936,8.0144259667,28.534695786,29,-0.100180325,5.4431309691,28.434515461
29,43,2004,949,463,2213,603,11,486,2224,2601,63522,15.251962746,7.4411577992,35.566484254,-109,0.1767877663,7.8108049468,35.74327202
29,43,2005,1035,488,2379,603,5,547,2384,2887,66409,15.931532891,7.5116792759,36.61943647,-44,0.076963927,8.4198536146,36.696400397
29,43,2006,1033,495,2777,603,8,538,2785,3279,69688,15.18034931,7.2742235317,40.809128783,-44,0.1175632086,7.9061257779,40.926691992
29,43,2007,1066,467,2660,603,2,599,2662,3266,72954,14.946509443,6.5478610788,37.296168029,5,0.0280422316,8.3986483644,37.324210261
29,43,2008,1150,530,1937,603,5,620,1942,2525,75479,15.495206592,7.1412691248,26.099317537,-37,0.0673704634,8.3539374667,26.166688001
29,45,2001,91,78,38,122,0,13,38,44,7433,12.279044663,10.524895426,5.1275131561,-7,0,1.7541492376,5.1275131561
29,45,2002,76,77,-59,122,-1,-1,-60,-66,7367,10.27027027,10.405405405,-7.972972973,-5,-0.135135135,-0.135135135,-8.108108108
29,45,2003,76,99,-62,122,-1,-23,-63,-92,7275,10.381095479,13.522742795,-8.468788417,-6,-0.136593362,-3.141647316,-8.605381778
29,45,2004,84,90,-32,122,0,-6,-32,-43,7232,11.580616254,12.40780313,-4.411663335,-5,0,-0.827186875,-4.411663335
29,45,2005,88,82,-19,122,0,6,-19,-19,7213,12.184146764,11.353409484,-2.630668051,-6,0,0.8307372793,-2.630668051
29,45,2006,93,85,-34,122,0,8,-34,-29,7184,12.9193582,11.808015559,-4.723206224,-3,0,1.1113426408,-4.723206224
29,45,2007,92,64,-2,122,0,28,-2,28,7212,12.781328147,8.8913587108,-0.27785496,2,0,3.889969436,-0.27785496
29,45,2008,95,82,-47,122,0,13,-47,-32,7180,13.201778766,11.395219566,-6.531406337,2,0,1.8065591996,-6.531406337
29,47,2001,2805,1441,1922,2920,263,1364,2185,3399,188205,15.039770945,7.7263137012,10.305326116,-150,1.4101460815,7.3134572439,11.715472198
29,47,2002,2789,1366,1457,2920,251,1423,1708,2985,191190,14.702355065,7.200938336,7.6806494551,-146,1.3231592404,7.5014167293,9.0038086954
29,47,2003,2918,1465,1001,2920,205,1453,1206,2435,193625,15.165728987,7.6140483089,5.2024999026,-224,1.065447033,7.5516806777,6.2679469355
29,47,2004,2923,1412,1825,2920,213,1511,2038,3370,196995,14.965951564,7.229532538,9.3441196047,-179,1.0905739593,7.7364190262,10.434693564
29,47,2005,2949,1430,2409,2920,217,1519,2626,3964,200959,14.820808435,7.1867602788,12.106926931,-181,1.090578308,7.6340481563,13.197505239
29,47,2006,3152,1462,3837,2920,218,1690,4055,5633,206592,15.468002778,7.174562202,18.829545259,-112,1.0698047606,8.2934405755,19.89935002
29,47,2007,3234,1416,2872,2920,199,1818,3071,4933,211525,15.469354272,6.7732237627,13.73778153,44,0.9518866729,8.6961305089,14.689668203
29,47,2008,3306,1455,2060,2920,202,1851,2262,4182,215707,15.476368811,6.811287544,9.6434723991,69,0.9456220508,8.6650812673,10.58909445
29,49,2001,240,208,357,513,1,32,358,365,19396,12.491217113,10.825721498,18.580685456,-25,0.052046738,1.6654956151,18.632732194
29,49,2002,240,212,176,517,1,28,177,188,19584,12.314007183,10.877373012,9.0302719343,-17,0.0513083633,1.4366341714,9.0815802976
29,49,2003,262,239,515,544,-2,23,513,534,20118,13.19832754,12.039695733,25.943277417,-2,-0.100750592,1.158631807,25.842526825
29,49,2004,262,240,412,563,2,22,414,411,20529,12.891480306,11.808989593,20.272098802,-25,0.0984082466,1.0824907127,20.370507048
29,49,2005,232,281,72,566,0,-49,72,11,20540,11.298059364,13.684287419,3.5062942852,-12,0,-2.386228055,3.5062942852
29,49,2006,293,247,-94,561,2,46,-92,-55,20485,14.283973187,12.041438147,-4.582571603,-9,0.0975015235,2.2425350396,-4.485070079
29,49,2007,261,223,458,571,0,38,458,490,20975,12.590448625,10.757356488,22.093584178,-6,0,1.833092137,22.093584178
29,49,2008,286,229,65,571,2,57,67,119,21094,13.596710167,10.886876322,3.0901614015,-5,0.0950818893,2.7098338444,3.1852432908
29,51,2001,876,613,-171,5680,98,263,-73,124,71600,12.245240292,8.5688724873,-2.390338002,-66,1.3699013112,3.6763678045,-1.020436691
29,51,2002,934,575,51,5714,87,359,138,422,72022,13.006363928,8.0071298269,0.710197602,-75,1.2115135564,4.9992341006,1.9217111585
29,51,2003,926,552,179,5778,57,374,236,512,72534,12.81164393,7.6371786712,2.4765488807,-98,0.7886217106,5.1744652591,3.2651705913
29,51,2004,999,609,-814,5051,92,390,-722,-406,72128,13.81150544,8.4196264396,-11.25381925,-74,1.2719304309,5.3918790007,-9.981888817
29,51,2005,991,603,-11,4728,81,388,70,399,72527,13.701565794,8.3370778749,-0.152085998,-59,1.1199059832,5.3644879195,0.9678199855
29,51,2006,956,594,110,4767,90,362,200,525,73052,13.133762425,8.1605176571,1.5112069735,-37,1.2364420693,4.9732447674,2.7476490428
29,51,2007,1043,541,-122,4730,76,502,-46,454,73506,14.233272834,7.3827426684,-1.664869881,-2,1.0371320569,6.8505301655,-0.627737824
29,51,2008,1021,560,259,4730,80,461,339,807,74313,13.81419168,7.5768338306,3.5042856466,7,1.0824048329,6.2373578498,4.5866904796
29,53,2001,173,170,-29,2071,2,3,-27,-39,16663,10.370148359,10.190319197,-1.738348569,-15,0.1198861082,0.1798291623,-1.618462461
29,53,2002,188,174,280,2120,1,14,281,285,16948,11.186813841,10.353753236,16.661212103,-10,0.0595043289,0.8330606052,16.720716432
29,53,2003,197,181,-31,2043,-1,16,-32,-38,16910,11.636836198,10.691712446,-1.83117727,-22,-0.059070235,0.9451237521,-1.890247504
29,53,2004,192,182,213,2085,2,10,215,208,17118,11.284824262,10.697072999,12.519101916,-17,0.1175502527,0.5877512637,12.636652169
29,53,2005,175,175,181,2121,1,0,182,165,17283,10.174122845,10.174122845,10.522949914,-17,0.0581378448,0,10.581087759
29,53,2006,203,180,107,2097,1,23,108,123,17406,11.703998386,10.377929603,6.1691025974,-8,0.0576551645,1.3260687826,6.2267577618
29,53,2007,211,169,103,2115,1,42,104,149,17555,12.070592946,9.6679156775,5.8922799691,3,0.0572066016,2.402677269,5.9494865708
29,53,2008,217,179,-67,2115,2,38,-65,-20,17535,12.368196067,10.202336848,-3.818751781,7,0.1139925905,2.1658592192,-3.704759191
29,55,2001,308,261,-86,380,14,47,-72,-47,22784,13.504329716,11.443604078,-3.770689466,-22,0.6138331689,2.0607256385,-3.156856297
29,55,2002,307,258,391,380,14,49,405,444,23228,13.344344953,11.214465792,16.995566374,-10,0.6085369034,2.129879162,17.604103277
29,55,2003,301,252,159,380,9,49,168,193,23421,12.904885421,10.80409012,6.8168663851,-24,0.3858603614,2.1007953011,7.2027267466
29,55,2004,317,278,49,380,8,39,57,81,23502,13.51149756,11.849199753,2.088528014,-15,0.3409841655,1.662297807,2.4295121795
29,55,2005,315,265,63,380,9,50,72,104,23606,13.373524667,11.250742974,2.6747049333,-18,0.3821007048,2.1227816931,3.0568056381
29,55,2006,322,255,146,380,8,67,154,208,23814,13.580767609,10.754955715,6.1577393505,-13,0.3374103754,2.8258118937,6.4951497259
29,55,2007,370,250,103,380,8,120,111,213,24027,15.467904099,10.451286553,4.30593006,-18,0.3344411697,5.0166175456,4.6403712297
29,55,2008,349,269,-125,380,7,80,-118,-57,23970,14.542575578,11.209033898,-5.208658875,-19,0.291684897,3.3335416797,-4.916973978
29,57,2001,92,124,-18,120,3,-32,-15,-54,7853,11.675126904,15.736040609,-2.284263959,-7,0.3807106599,-4.060913706,-1.903553299
29,57,2002,80,120,-36,120,3,-40,-33,-79,7774,10.238689448,15.358034172,-4.607410251,-6,0.3839508543,-5.119344724,-4.223459397
29,57,2003,77,129,-6,120,2,-52,-4,-67,7707,9.9476777986,16.665590078,-0.775143725,-11,0.2583812415,-6.71791228,-0.516762483
29,57,2004,89,127,-18,120,1,-38,-17,-60,7647,11.59307021,16.542920412,-2.344665885,-5,0.1302592158,-4.949850202,-2.214406669
29,57,2005,77,134,16,120,2,-57,18,-45,7602,10.099022887,17.574922946,2.0984982622,-6,0.2623122828,-7.475900059,2.360810545
29,57,2006,101,122,-4,120,1,-21,-3,-28,7574,13.310490248,16.078017923,-0.527148129,-4,0.1317870322,-2.767527675,-0.395361096
29,57,2007,86,95,-64,120,2,-9,-62,-79,7495,11.414161524,12.608666799,-8.494259739,-8,0.2654456168,-1.194505276,-8.228814122
29,57,2008,81,110,-41,120,1,-29,-40,-77,7418,10.863005432,14.752229598,-5.498558305,-8,0.1341111782,-3.889224167,-5.364447127
29,59,2001,207,170,19,144,3,37,22,44,15734,13.174643585,10.819755601,1.2092668024,-15,0.1909368635,2.3548879837,1.400203666
29,59,2002,214,180,75,144,2,34,77,98,15832,13.558892479,11.404675917,4.7519482988,-13,0.1267186213,2.1542165621,4.8786669201
29,59,2003,206,173,88,144,-2,33,86,106,15938,12.968209002,10.890777463,5.5398174378,-13,-0.125904942,2.0774315392,5.4139124961
29,59,2004,222,177,199,144,4,45,203,230,16168,13.829190805,11.025976453,12.396436803,-18,0.2491746091,2.8032143525,12.645611412
29,59,2005,213,182,19,144,2,31,21,36,16204,13.159520573,11.244285185,1.1738539479,-16,0.1235635735,1.9152353886,1.2974175213
29,59,2006,244,187,190,144,4,57,194,245,16449,14.945028022,11.453771476,11.63752182,-6,0.2450004594,3.4912565461,11.88252228
29,59,2007,231,178,306,144,1,53,307,366,16815,13.888888889,10.702260702,18.398268398,6,0.0601250601,3.1866281866,18.458393458
29,59,2008,255,169,-61,144,3,86,-58,29,16844,15.151965299,10.041890728,-3.624587777,1,0.1782584153,5.1100745714,-3.446329362
29,61,2001,111,97,-62,56,0,14,-62,-59,7936,13.935095098,12.177515536,-7.783566631,-11,0,1.7575795619,-7.783566631
29,61,2002,120,90,12,56,-1,30,11,33,7969,15.089594467,11.31719585,1.5089594467,-8,-0.125746621,3.7723986168,1.3832128262
29,61,2003,118,73,10,56,-1,45,9,43,8012,14.76753645,9.1358488205,1.2514861398,-11,-0.125148614,5.6316876291,1.1263375258
29,61,2004,133,96,37,56,0,37,37,66,8078,16.532007458,11.932877564,4.5991298943,-8,0,4.5991298943,4.5991298943
29,61,2005,118,89,-61,56,0,29,-61,-35,8043,14.639290367,11.041498666,-7.567768749,-3,0,3.5977917003,-7.567768749
29,61,2006,121,87,-17,56,0,34,-17,12,8055,15.032923345,10.808796124,-2.11206361,-5,0,4.2241272208,-2.11206361
29,61,2007,126,78,-132,56,0,48,-132,-98,7957,15.738196353,9.7426929803,-16.48763427,-14,0,5.9955033725,-16.48763427
29,61,2008,135,85,-74,56,0,50,-74,-46,7911,17.015376859,10.71338543,-9.326947315,-22,0,6.3019914293,-9.326947315
29,63,2001,115,121,-85,4180,5,-6,-80,-98,13012,8.8048388332,9.2642217288,-6.507924355,-12,0.3828190797,-0.459382896,-6.125105275
29,63,2002,120,100,-29,4197,5,20,-24,-16,12996,9.2279298677,7.6899415564,-2.230083051,-12,0.3844970778,1.5379883113,-1.845585974
29,63,2003,112,119,28,4231,3,-7,31,6,13002,8.6160473883,9.15455035,2.1540118471,-18,0.2307869836,-0.538502962,2.3847988307
29,63,2004,100,111,-612,3538,3,-11,-609,-646,12356,7.8870573389,8.7546336462,-48.26879091,-26,0.2366117202,-0.867576307,-48.03217919
29,63,2005,116,131,-82,3515,4,-15,-78,-103,12253,9.4274452436,10.646511439,-6.664228534,-10,0.3250843187,-1.219066195,-6.339144216
29,63,2006,120,110,21,3514,4,10,25,29,12282,9.7819441614,8.966782148,1.7118402282,-6,0.3260648054,0.8151620135,2.0379050336
29,63,2007,118,123,-61,3508,3,-5,-58,-64,12218,9.6326530612,10.040816327,-4.979591837,-1,0.2448979592,-0.408163265,-4.734693878
29,63,2008,125,115,51,3508,3,10,54,57,12275,10.206997918,9.3904380844,4.1644551505,-7,0.24496795,0.8165598334,4.4094231005
29,65,2001,183,198,122,269,2,-15,124,97,15031,12.214249958,13.215417988,8.1428333055,-12,0.1334890706,-1.001168029,8.2763223761
29,65,2002,170,221,-139,269,2,-51,-137,-198,14833,11.384945084,14.80042861,-9.308866863,-10,0.1339405304,-3.415483525,-9.174926333
29,65,2003,180,197,86,269,2,-17,88,56,14889,12.112240092,13.256173878,5.7869591548,-15,0.1345804455,-1.143933786,5.9215396003
29,65,2004,177,176,68,269,1,1,69,60,14949,11.864065956,11.797037335,4.557946243,-10,0.0670286212,0.0670286212,4.6249748643
29,65,2005,169,191,74,269,2,-22,76,42,14991,11.289245157,12.758851035,4.9432197729,-12,0.1336005344,-1.469605878,5.0768203073
29,65,2006,181,174,121,269,1,7,122,121,15112,12.02537953,11.560309604,8.0390658738,-8,0.0664385609,0.4650699266,8.1055044348
29,65,2007,191,171,-108,269,2,20,-106,-83,15029,12.67376663,11.346670648,-7.166318304,3,0.1327095982,1.3270959822,-7.033608706
29,65,2008,179,185,176,269,1,-6,177,170,15199,11.84332407,12.240307,11.644832606,-1,0.0661638216,-0.39698293,11.710996427
29,67,2001,127,148,-17,125,6,-21,-11,-47,13052,9.7128216894,11.318878819,-1.300141486,-15,0.4588734656,-1.60605713,-0.84126802
29,67,2002,121,144,201,125,6,-23,207,177,13229,9.208173205,10.95848712,15.296221605,-7,0.45660363,-1.750313915,15.752825235
29,67,2003,138,151,-37,125,3,-13,-34,-65,13164,10.457318228,11.442427916,-2.803773728,-18,0.227333005,-0.985109688,-2.576440723
29,67,2004,154,158,118,125,4,-4,122,104,13268,11.652542373,11.955205811,8.9285714286,-14,0.3026634383,-0.302663438,9.2312348668
29,67,2005,144,131,64,125,4,13,68,70,13338,10.824626024,9.8474028415,4.8109448996,-11,0.3006840562,0.9772231827,5.1116289559
29,67,2006,177,152,-4,125,4,25,0,18,13356,13.261407058,11.388326965,-0.299692815,-7,0.2996928149,1.8730800929,0
29,67,2007,144,146,-9,125,4,-2,-5,-8,13348,10.784901138,10.934691432,-0.674056321,-1,0.2995805872,-0.149790294,-0.374475734
29,67,2008,154,147,81,125,4,7,85,90,13438,11.498544016,10.975882924,6.0479354887,-2,0.2986634809,0.5226610916,6.3465989696
29,69,2001,488,467,-246,712,24,21,-222,-234,32873,14.792361322,14.155804789,-7.456805092,-33,0.7274931798,0.6365565323,-6.729311913
29,69,2002,464,470,-215,712,24,-6,-191,-226,32647,14.163614164,14.346764347,-6.562881563,-29,0.7326007326,-0.183150183,-5.83028083
29,69,2003,443,470,-217,712,14,-27,-203,-262,32385,13.624062,14.454422438,-6.673637594,-32,0.4305572641,-0.830360438,-6.24308033
29,69,2004,473,470,-386,712,18,3,-368,-396,31989,14.695373909,14.602168577,-11.9924193,-31,0.5592319881,0.0932053313,-11.43318731
29,69,2005,466,442,40,712,16,24,56,49,32038,14.556359036,13.806675309,1.2494728786,-31,0.4997891515,0.7496837272,1.7492620301
29,69,2006,492,484,-265,712,18,8,-247,-252,31786,15.417397844,15.166708448,-8.304086237,-13,0.5640511406,0.2506893958,-7.740035097
29,69,2007,492,409,-279,712,11,83,-268,-177,31609,15.521728843,12.903225806,-8.80195599,8,0.3470305229,2.6185030365,-8.454925467
29,69,2008,492,424,-249,712,13,68,-236,-155,31454,15.603444175,13.44687059,-7.89686504,13,0.4122861266,2.1565735851,-7.484578913
29,71,2001,1276,836,439,1004,7,440,446,796,94854,13.508935377,8.8506817989,4.6476666384,-90,0.0741085797,4.6582535784,4.7217752181
29,71,2002,1340,905,506,1004,6,435,512,856,95710,14.063516719,9.4981213661,5.3105518356,-91,0.0629709704,4.5653953527,5.373522806
29,71,2003,1296,907,352,1004,2,389,354,614,96324,13.497609798,9.4462438943,3.6660174761,-129,0.0208296448,4.051365904,3.6868471208
29,71,2004,1288,871,601,1004,9,417,610,946,97270,13.306197506,8.9982127545,6.2088701096,-81,0.0929780882,4.3079847516,6.3018481978
29,71,2005,1315,874,527,1004,6,441,533,889,98159,13.457572827,8.9444248295,5.3932630265,-85,0.0614033741,4.5131479975,5.4546664006
29,71,2006,1299,845,435,1004,8,454,443,847,99006,13.176780869,8.5715010271,4.412547866,-50,0.0811503056,4.6052798418,4.4936981716
29,71,2007,1367,886,429,1004,6,481,435,916,99922,13.74366605,8.907745516,4.3131183142,0,0.0603233331,4.8359205341,4.3734416472
29,71,2008,1377,868,416,1004,8,509,424,976,100898,13.713773529,8.644557315,4.1430136441,43,0.0796733393,5.0692162135,4.2226869834
29,73,2001,187,211,58,307,0,-24,58,19,15389,12.159042882,13.719561754,3.7712539419,-15,0,-1.560518873,3.7712539419
29,73,2002,148,205,79,307,0,-57,79,6,15395,9.6153846154,13.318607069,5.1325363825,-16,0,-3.703222453,5.1325363825
29,73,2003,158,193,94,307,-3,-35,91,41,15436,10.249424281,12.519866368,6.0977587493,-15,-0.194609322,-2.270442088,5.9031494275
29,73,2004,192,211,26,307,1,-19,27,-2,15434,12.439261419,13.670229997,1.6844833171,-10,0.0647878199,-1.230968578,1.749271137
29,73,2005,138,219,138,307,-1,-81,137,41,15475,8.9294380278,14.170629914,8.9294380278,-15,-0.064706073,-5.241191886,8.8647319551
29,73,2006,191,208,-45,307,1,-17,-44,-67,15408,12.369264644,13.470193958,-2.914224654,-6,0.0647605479,-1.100929314,-2.849464106
29,73,2007,185,199,-32,307,-1,-14,-33,-42,15366,12.023136414,12.932995386,-2.07967765,5,-0.064989927,-0.909858972,-2.144667577
29,73,2008,176,200,-91,307,1,-24,-90,-105,15261,11.493126979,13.060371568,-5.942469063,9,0.0653018578,-1.567244588,-5.877167205
29,75,2001,74,103,-41,202,5,-29,-36,-72,6778,10.85999413,15.115937775,-6.017023775,-7,0.7337833871,-4.255943645,-5.283240387
29,75,2002,60,93,-130,202,5,-33,-125,-161,6617,8.9585666293,13.885778275,-19.4102277,-3,0.7465472191,-4.927211646,-18.66368048
29,75,2003,60,89,-99,202,3,-29,-96,-130,6487,9.1575091575,13.583638584,-15.10989011,-5,0.4578754579,-4.426129426,-14.65201465
29,75,2004,89,97,-15,202,2,-8,-13,-25,6462,13.746235231,14.98185188,-2.316781219,-4,0.3089041625,-1.23561665,-2.007877056
29,75,2005,89,113,-37,202,3,-24,-34,-62,6400,13.839216296,17.571139792,-5.753382056,-4,0.4664904369,-3.731923496,-5.286891619
29,75,2006,89,82,-97,202,2,7,-95,-92,6308,14.006924772,12.905256531,-15.26597419,-4,0.3147623544,1.1016682405,-14.95121184
29,75,2007,89,89,-79,202,2,0,-77,-82,6226,14.201372267,14.201372267,-12.60571246,-5,0.3191319611,0,-12.2865805
29,75,2008,76,83,-23,202,1,-7,-22,-41,6185,12.247200064,13.375231649,-3.706389493,-12,0.1611473693,-1.128031585,-3.545242124
29,77,2001,3062,2363,1212,11836,177,699,1389,1862,242665,12.666815591,9.7752074594,5.0137754722,-226,0.7322097843,2.8916081313,5.7459852565
29,77,2002,3058,2396,1438,11866,163,662,1601,2043,244708,12.548910178,9.8323050313,5.901024472,-220,0.6688922037,2.7166051464,6.5699166757
29,77,2003,3161,2372,2156,11864,120,789,2276,2860,247568,12.842389229,9.6368703735,8.7593138808,-205,0.4875313848,3.2055188553,9.2468452657
29,77,2004,3201,2404,2623,11886,152,797,2775,3339,250907,12.843171674,9.6454185265,10.5240985,-233,0.6098600732,3.1977531471,11.133958574
29,77,2005,3429,2357,2568,11868,145,1072,2713,3569,254476,13.569906388,9.3275792815,10.162589561,-216,0.5738222299,4.2423271064,10.736411791
29,77,2006,3410,2382,3843,11655,155,1028,3998,4887,259363,13.272639874,9.2713865627,14.957992679,-139,0.6033018124,4.0012533109,15.561294491
29,77,2007,3651,2222,2827,11671,133,1429,2960,4430,263793,13.957595822,8.4945981696,10.80748381,41,0.5084525457,5.4629976527,11.315936356
29,77,2008,3845,2307,1404,11671,137,1538,1541,3151,266944,14.489285654,8.6935713922,5.2907560619,72,0.516263234,5.7957142615,5.8070192958
29,79,2001,120,139,-67,353,11,-19,-56,-84,10330,11.56961049,13.401465484,-6.45969919,-9,1.0605476282,-1.831854994,-5.399151562
29,79,2002,128,167,-146,353,11,-39,-135,-179,10151,12.499389678,16.307797471,-14.25711635,-5,1.0741663005,-3.808407793,-13.18295005
29,79,2003,143,162,62,353,11,-19,73,45,10196,14.05612621,15.923723399,6.0942645107,-9,1.0812404777,-1.867597189,7.1755049885
29,79,2004,114,128,-82,353,10,-14,-72,-97,10099,11.234294161,12.613944321,-8.080808081,-11,0.9854644001,-1.37965016,-7.095343681
29,79,2005,147,149,66,353,11,-2,77,66,10165,14.508487959,14.705882353,6.514015002,-9,1.085669167,-0.197394394,7.599684169
29,79,2006,119,132,-109,353,10,-13,-99,-114,10051,11.772853186,13.058963197,-10.78353779,-2,0.9893153937,-1.286110012,-9.794222398
29,79,2007,125,122,28,353,11,3,39,44,10095,12.409411298,12.111585426,2.7797081306,2,1.0920281942,0.2978258711,3.8717363248
29,79,2008,138,146,22,353,10,-8,32,30,10125,13.649851632,14.441147379,2.1760633037,6,0.9891196835,-0.791295747,3.1651829871
29,81,2001,103,132,-82,228,3,-29,-79,-114,8750,11.695242421,14.988077665,-9.310775519,-6,0.3406381288,-3.292835245,-8.970137391
29,81,2002,99,133,9,228,2,-34,11,-31,8719,11.33436373,15.226973496,1.0303967027,-8,0.2289770451,-3.892609766,1.2593737478
29,81,2003,99,105,8,228,2,-6,10,-7,8712,11.359072916,12.047501578,0.9179048821,-11,0.2294762205,-0.688428662,1.1473811026
29,81,2004,111,141,-25,228,3,-30,-22,-58,8654,12.783600138,16.238627203,-2.87918922,-6,0.3455027064,-3.455027064,-2.533686514
29,81,2005,109,112,120,228,3,-3,123,112,8766,12.51435132,12.858783008,13.777267509,-8,0.3444316877,-0.344431688,14.121699196
29,81,2006,128,127,-5,228,3,1,-2,-6,8760,14.606869793,14.492753623,-0.570580851,-5,0.3423485108,0.1141161703,-0.228232341
29,81,2007,129,105,59,228,3,24,62,86,8846,14.654095195,11.927751903,6.702260593,0,0.3407929115,2.7263432921,7.0430535045
29,81,2008,113,115,-3,228,3,-2,0,-2,8844,12.775579423,13.001695873,-0.339174675,0,0.339174675,-0.22611645,0
29,83,2001,277,281,212,359,7,-4,219,198,22287,12.484225708,12.664503335,9.55471426,-17,0.3154858482,-0.180277628,9.8702001082
29,83,2002,272,298,-91,359,3,-26,-88,-135,22152,12.241499584,13.411642926,-4.095501699,-21,0.1350165395,-1.170143343,-3.960485159
29,83,2003,284,286,242,359,-7,-2,235,218,22370,12.757737748,12.847580971,10.871030053,-15,-0.314451283,-0.089843224,10.55657877
29,83,2004,286,323,58,359,11,-37,69,16,22386,12.780409331,14.433818929,2.5918312628,-16,0.491554205,-1.653409599,3.0833854679
29,83,2005,277,305,-63,359,5,-28,-58,-108,22278,12.403725596,13.657531793,-2.821063944,-22,0.2238939638,-1.253806197,-2.59716998
29,83,2006,287,276,97,359,8,11,105,106,22384,12.852089024,12.359500246,4.3437374054,-10,0.358246384,0.4925887779,4.7019837894
29,83,2007,293,305,-31,359,4,-12,-27,-37,22347,13.100534305,13.637074959,-1.386063357,2,0.1788468847,-0.536540654,-1.207216472
29,83,2008,287,289,-179,359,7,-2,-172,-168,22179,12.891344383,12.981179536,-8.040246148,6,0.3144230337,-0.089835152,-7.725823115
29,85,2001,82,131,82,107,2,-49,84,28,8970,9.1558731577,14.627065654,9.1558731577,-7,0.2233139795,-5.471192497,9.3791871371
29,85,2002,62,136,-94,107,2,-74,-92,-177,8793,6.9808027923,15.312728706,-10.58379778,-11,0.2251871868,-8.331925913,-10.3586106
29,85,2003,61,117,212,107,1,-56,213,162,8955,6.8740139734,13.184584178,23.890015776,5,0.1126887537,-6.310570205,24.00270453
29,85,2004,70,137,146,107,2,-67,148,69,9024,7.7868624506,15.240002225,16.241170254,-12,0.2224817843,-7.453139774,16.463652038
29,85,2005,83,151,151,107,2,-68,153,77,9101,9.1586206897,16.662068966,16.662068966,-8,0.2206896552,-7.503448276,16.882758621
29,85,2006,89,160,84,107,2,-71,86,10,9111,9.7737755326,17.570832418,9.2246870195,-5,0.2196354052,-7.797056886,9.4443224248
29,85,2007,93,114,27,107,1,-21,28,-3,9108,10.209122345,12.514408036,2.9639387453,-10,0.1097755091,-2.305285691,3.0737142543
29,85,2008,86,116,-14,107,1,-30,-13,-60,9048,9.4734523023,12.778144966,-1.54218991,-17,0.1101564221,-3.304692664,-1.432033488
29,87,2001,46,65,5,101,0,-19,5,-20,5304,8.6563793752,12.231840422,0.9409108017,-6,0,-3.575461046,0.9409108017
29,87,2002,41,59,-145,101,-1,-18,-146,-167,5137,7.8536538646,11.301599464,-27.77511733,-3,-0.191552533,-3.447945599,-27.96666986
29,87,2003,65,86,27,101,-1,-21,26,1,5138,12.652068127,16.739659367,5.2554744526,-4,-0.194647202,-4.087591241,5.0608272506
29,87,2004,66,68,-38,101,0,-2,-38,-43,5095,12.899442979,13.29033519,-7.426952018,-3,0,-0.390892211,-7.426952018
29,87,2005,63,74,-57,101,0,-11,-57,-73,5022,12.454284867,14.628842542,-11.2681625,-5,0,-2.174557675,-11.2681625
29,87,2006,54,68,-66,101,0,-14,-66,-83,4939,10.842284911,13.653247666,-13.25168156,-3,0,-2.810962755,-13.25168156
29,87,2007,52,54,25,101,0,-2,25,23,4962,10.503989496,10.907989092,5.04999495,0,0,-0.403999596,5.04999495
29,87,2008,65,68,-57,101,0,-3,-57,-57,4905,13.175230567,13.783318131,-11.55366373,3,0,-0.608087565,-11.55366373
29,89,2001,120,107,-67,793,4,13,-63,-59,10121,11.82207773,10.541352643,-6.600660066,-9,0.3940692577,1.2807250874,-6.206590808
29,89,2002,107,109,-114,793,4,-2,-110,-118,10003,10.634068774,10.832836414,-11.32975552,-6,0.3975352813,-0.198767641,-10.93222023
29,89,2003,112,133,-25,793,2,-21,-23,-56,9947,11.228070175,13.333333333,-2.506265664,-12,0.2005012531,-2.105263158,-2.305764411
29,89,2004,107,110,-67,793,1,-3,-66,-77,9870,10.798809103,11.101579452,-6.761871121,-8,0.1009234496,-0.302770349,-6.660947671
29,89,2005,128,103,19,793,2,25,21,37,9907,12.944329271,10.416139961,1.9214238762,-9,0.2022551449,2.5281893108,2.1236790211
29,89,2006,110,104,-8,793,1,6,-7,-5,9902,11.106062901,10.500277652,-0.807713666,-4,0.1009642082,0.6057852491,-0.706749457
29,89,2007,116,110,-44,793,2,6,-42,-35,9867,11.735545551,11.128534574,-4.45141383,1,0.2023369923,0.6070109768,-4.249076837
29,89,2008,119,104,29,793,1,15,30,51,9918,12.029315138,10.51301491,2.9315137731,6,0.1010866818,1.5163002274,3.0326004549
29,91,2001,469,472,-116,761,20,-3,-96,-131,37100,12.6192302,12.699950223,-3.121174207,-32,0.538133484,-0.080720023,-2.583040723
29,91,2002,477,466,73,761,18,11,91,64,37164,12.846062695,12.549822256,1.9659592804,-38,0.4847570828,0.2962404395,2.4507163632
29,91,2003,496,435,135,761,14,61,149,161,37325,13.31740257,11.67957685,3.6246962639,-49,0.3758944274,1.6378257192,4.0005906912
29,91,2004,534,486,169,761,23,48,192,210,37535,14.266631045,12.984237243,4.5150948437,-30,0.6144803633,1.2823938018,5.1295752071
29,91,2005,516,480,519,761,19,36,538,540,38075,13.648988229,12.696733236,13.728342812,-34,0.5025790239,0.9522549927,14.230921836
29,91,2006,513,466,191,761,21,47,212,240,38315,13.431077366,12.20054981,5.0006545359,-19,0.5498101846,1.230527556,5.5504647205
29,91,2007,577,474,156,761,19,103,175,289,38604,15.002795148,12.324653207,4.0562149794,11,0.4940261834,2.6781419415,4.5502411628
29,91,2008,558,449,237,761,21,109,258,396,39000,14.380702026,11.571568476,6.1079325808,29,0.541209216,2.8091335498,6.6491417968
29,93,2001,117,163,-40,381,0,-46,-40,-95,10537,11.05389957,15.399877179,-3.779110964,-9,0,-4.345977609,-3.779110964
29,93,2002,142,182,-44,381,0,-40,-44,-93,10444,13.536056432,17.349030075,-4.194271007,-9,0,-3.812973643,-4.194271007
29,93,2003,137,180,-141,381,-1,-43,-142,-188,10256,13.236714976,17.391304348,-13.62318841,-3,-0.096618357,-4.154589372,-13.71980676
29,93,2004,140,165,57,381,0,-25,57,24,10280,13.63459291,16.069341644,5.5512271134,-8,0,-2.434748734,5.5512271134
29,93,2005,134,180,-22,381,0,-46,-22,-77,10203,13.084020895,17.575550456,-2.148122834,-9,0,-4.491529561,-2.148122834
29,93,2006,126,125,-53,381,0,1,-53,-56,10147,12.383292383,12.285012285,-5.208845209,-4,0,0.0982800983,-5.208845209
29,93,2007,129,145,-130,381,0,-16,-130,-145,10002,12.804605688,14.392773835,-12.9038662,1,0,-1.588168147,-12.9038662
29,93,2008,137,153,-70,381,0,-16,-70,-84,9918,13.75502008,15.361445783,-7.02811245,2,0,-1.606425703,-7.02811245
29,95,2001,10064,6096,-3752,11835,1517,3968,-2235,2384,658104,15.320164649,9.2797817668,-5.711571717,651,2.3092895243,6.0403828823,-3.402282193
29,95,2002,10090,6059,-3428,11869,1408,4031,-2020,2476,660580,15.30313555,9.1894646481,-5.199122762,465,2.1354623246,6.1136709022,-3.063660437
29,95,2003,10249,5918,-5399,11900,1195,4331,-4204,576,661156,15.508391994,8.95488963,-8.169558823,449,1.8082279669,6.5535023636,-6.361330856
29,95,2004,10339,5929,-5823,11778,1146,4410,-4677,351,661507,15.633611888,8.9652466274,-8.804963925,618,1.732867707,6.6683652601,-7.072096218
29,95,2005,10265,6043,-5012,11787,1181,4222,-3831,350,661857,15.513494398,9.1327858397,-7.57463555,-41,1.7848452882,6.3807085579,-5.789790262
29,95,2006,10591,5964,-4093,11749,1208,4627,-2885,1746,663603,15.98086702,8.9991399212,-6.175969098,4,1.822763418,6.9817270985,-4.35320568
29,95,2007,10735,5917,-3479,11772,1084,4818,-2395,2397,666000,16.147677164,8.9004010972,-5.23314102,-26,1.6305619046,7.2472760666,-3.602579116
29,95,2008,10583,5742,-3495,11772,1092,4841,-2403,2417,668417,15.861608478,8.6060054691,-5.238242618,-21,1.6366697966,7.2556030087,-3.601572822
29,97,2001,1725,1092,124,2632,166,633,290,818,105822,16.364205553,10.359253602,1.1763255006,-105,1.5747583315,6.0049519509,2.7510838322
29,97,2002,1734,1120,520,2632,158,614,678,1201,107023,16.293546947,10.5240903,4.8861847824,-91,1.4846484531,5.7694566469,6.3708332355
29,97,2003,1669,1106,537,2632,126,563,663,1098,108121,15.515189826,10.281485889,4.9920053546,-128,1.1713085189,5.2337039378,6.1633138735
29,97,2004,1712,1131,738,2632,132,581,870,1361,109482,15.735077182,10.395077274,6.7829947197,-90,1.2132185678,5.3399999081,7.9962132875
29,97,2005,1801,1030,648,2632,133,771,781,1454,110936,16.341678084,9.3458791932,5.8797375895,-98,1.2067979929,6.9957988912,7.0865355824
29,97,2006,1778,1096,1222,2632,140,682,1362,1982,112918,15.885353847,9.7920966344,10.917830372,-62,1.2508152635,6.0932572123,12.168645635
29,97,2007,1892,1082,1205,2632,124,810,1329,2131,115049,16.5988937,9.4926019994,10.571705554,-8,1.0878767541,7.1062917001,11.659582308
29,97,2008,1923,1075,778,2632,127,848,905,1764,116813,16.587452881,9.272757071,6.7108883733,11,1.0954792075,7.3146958104,7.8063675807
29,99,2001,2614,1476,899,2030,73,1138,972,1917,200655,13.089863868,7.3912161705,4.5018315293,-193,0.3655547293,5.6986476979,4.8673862586
29,99,2002,2680,1587,960,2030,66,1093,1026,1945,202600,13.291837671,7.8709501432,4.7612552851,-174,0.3273363009,5.4208875277,5.088591586
29,99,2003,2700,1580,1519,2030,45,1120,1564,2481,205081,13.245650398,7.7511583812,7.4519047981,-203,0.22076084,5.494492017,7.6726656381
29,99,2004,2814,1604,2012,2030,72,1210,2084,3107,208188,13.618248647,7.7624985179,9.7369993878,-187,0.34844133,5.8557501289,10.085440718
29,99,2005,2899,1553,1228,2030,64,1346,1292,2445,210633,13.843622932,7.4160560239,5.8640803589,-193,0.3056198233,6.4275669081,6.1697001822
29,99,2006,2932,1664,1793,2030,72,1268,1865,3026,213659,13.82067067,7.8436548415,8.4517266411,-107,0.3393889114,5.9770158287,8.7911155525
29,99,2007,3065,1592,540,2030,61,1473,601,2105,215764,14.27496897,7.4146005221,2.5150026897,31,0.2841021557,6.8603684479,2.7991048453
29,99,2008,3044,1643,391,2030,64,1401,455,1915,217679,14.045676133,7.5811583069,1.8041587937,59,0.2953098793,6.4645178259,2.0994686729
29,101,2001,690,316,423,3467,69,374,492,819,49294,14.114903497,6.464216674,8.6530495351,-47,1.4114903497,7.650686823,10.064539885
29,101,2002,685,345,329,3417,-61,340,268,564,49858,13.817169598,6.9590124254,6.6362756172,-44,-1.230434081,6.8581571728,5.4058415362
29,101,2003,721,355,658,3511,-352,366,306,642,50500,14.368560553,7.0746726718,13.113055262,-30,-7.014886706,7.2938878814,6.0981685566
29,101,2004,761,326,-8,3524,267,435,259,660,51160,14.971473539,6.4135353138,-0.15738737,-34,5.2528034625,8.5579382255,5.0954160929
29,101,2005,708,368,-116,3431,64,340,-52,246,51406,13.805744594,7.1758672465,-2.261958154,-42,1.2479769124,6.6298773473,-1.013981241
29,101,2006,735,345,-345,3428,172,390,-173,193,51599,14.271151886,6.6987039464,-6.698703946,-24,3.3396437066,7.5724479394,-3.35906024
29,101,2007,808,355,-181,3474,32,453,-149,299,51898,15.613979149,6.8601022252,-3.497685923,-5,0.6183754118,8.753876924,-2.879310511
29,101,2008,790,349,-420,3474,79,441,-341,118,52016,15.204880959,6.7170929807,-8.083607599,18,1.5204880959,8.4877879785,-6.563119503
29,103,2001,57,62,-67,90,1,-5,-66,-76,4279,13.203613621,14.361825342,-15.52003706,-5,0.2316423442,-1.158211721,-15.28839472
29,103,2002,48,61,-15,90,1,-13,-14,-30,4249,11.257035647,14.305816135,-3.51782364,-3,0.234521576,-3.048780488,-3.283302064
29,103,2003,53,63,-30,90,1,-10,-29,-44,4205,12.53844334,14.904187367,-7.097232079,-5,0.2365744026,-2.365744026,-6.860657677
29,103,2004,48,44,-32,90,0,4,-32,-33,4172,11.459949863,10.504954041,-7.639966575,-5,0,0.9549958219,-7.639966575
29,103,2005,49,57,-52,90,1,-8,-51,-62,4110,11.832890606,13.764791113,-12.5573533,-3,0.2414875634,-1.931900507,-12.31586573
29,103,2006,48,50,-43,90,0,-2,-43,-47,4063,11.745992903,12.235409274,-10.52245198,-2,0,-0.489416371,-10.52245198
29,103,2007,38,53,-6,90,1,-15,-5,-18,4045,9.3734583128,13.073507647,-1.480019734,2,0.2466699556,-3.700049334,-1.233349778
29,103,2008,49,51,-24,90,0,-2,-24,-25,4020,12.151270924,12.647241166,-5.951642901,1,0,-0.495970242,-5.951642901
29,105,2001,459,320,181,377,7,139,188,297,32886,14.020618557,9.7747231768,5.5288277969,-30,0.2138220695,4.2458953799,5.7426498664
29,105,2002,427,347,-80,377,6,80,-74,-24,32862,12.988988258,10.555454158,-2.4335341,-30,0.1825150575,2.4335340999,-2.251019042
29,105,2003,439,333,199,377,2,106,201,276,33138,13.303030303,10.090909091,6.0303030303,-31,0.0606060606,3.2121212121,6.0909090909
29,105,2004,501,384,264,377,8,117,272,361,33499,15.036691328,11.525128682,7.9235259691,-28,0.2401068475,3.5115626454,8.1636328166
29,105,2005,510,366,596,377,5,144,601,713,34212,15.064022094,10.81065115,17.604229741,-32,0.1476864911,4.2533709442,17.751916232
29,105,2006,526,346,505,377,7,180,512,675,34887,15.224532917,10.014616709,14.616709359,-17,0.2026078525,5.2099162072,14.819317212
29,105,2007,520,366,299,377,4,154,303,459,35346,14.807853858,10.422450985,8.5145159683,2,0.1139065681,4.3854028733,8.6284225364
29,105,2008,536,375,-7,377,6,161,-1,178,35524,15.126287569,10.582757161,-0.1975448,18,0.1693241146,4.5435304078,-0.028220686
29,107,2001,383,376,-130,917,8,7,-122,-144,32869,11.626848001,11.414346863,-3.946449713,-29,0.2428584439,0.2125011384,-3.703591269
29,107,2002,410,437,48,916,6,-27,54,-4,32865,12.474518514,13.296011197,1.4604314358,-31,0.1825539295,-0.821492683,1.6429853653
29,107,2003,444,389,15,913,-4,55,11,19,32884,13.505908835,11.832879588,0.4562807039,-47,-0.121674854,1.6730292476,0.3346058495
29,107,2004,377,357,-100,849,7,20,-93,-95,32789,11.481126186,10.872047874,-3.045391561,-22,0.2131774093,0.6090783122,-2.832214152
29,107,2005,438,356,34,845,3,82,37,86,32875,13.340643275,10.843079922,1.0355750487,-33,0.091374269,2.4975633528,1.1269493177
29,107,2006,422,416,-115,843,6,6,-109,-118,32757,12.859580692,12.676743052,-3.504388103,-15,0.1828376402,0.1828376402,-3.321550463
29,107,2007,434,350,-188,846,2,84,-186,-90,32667,13.267302519,10.699437515,-5.747126437,12,0.0611396429,2.5678650037,-5.685986794
29,107,2008,436,356,145,846,4,80,149,246,32913,13.29673681,10.856968588,4.4220799024,17,0.1219884111,2.439768222,4.5440683135
29,109,2001,461,405,148,629,52,56,200,220,35544,13.010103291,11.429700288,4.1767793645,-36,1.467517074,1.5804030028,5.6442964384
29,109,2002,506,436,365,632,52,70,417,462,36006,14.143955276,12.187281621,10.202655486,-25,1.4535290007,1.9566736548,11.656184486
29,109,2003,492,388,-11,630,39,104,28,80,36086,13.649225989,10.764023747,-0.305165622,-52,1.0819508406,2.8852022416,0.7767852189
29,109,2004,516,417,141,628,36,99,177,249,36335,14.250010356,11.515996741,3.8938981787,-27,0.994186769,2.7340136148,4.8880849477
29,109,2005,501,388,353,686,39,113,392,478,36813,13.698255591,10.608629081,9.6516651173,-27,1.0663312736,3.0896265106,10.717996391
29,109,2006,476,421,249,712,38,55,287,322,37135,12.873911397,11.386379618,6.7344620544,-20,1.0277492292,1.4875317791,7.7622112836
29,109,2007,540,407,340,720,28,133,368,494,37629,14.445455032,10.887592959,9.0952865015,-7,0.7490235942,3.5578620727,9.8443100958
29,109,2008,535,415,-26,720,27,120,1,128,37757,14.193616852,11.010001857,-0.689783249,7,0.7163133738,3.1836149948,0.026530125
29,111,2001,102,121,-96,748,2,-19,-94,-122,10379,9.7701149425,11.590038314,-9.195402299,-9,0.1915708812,-1.819923372,-9.003831418
29,111,2002,112,101,-57,748,2,11,-55,-54,10325,10.819165379,9.756568779,-5.50618238,-10,0.1931993818,1.0625965997,-5.312982998
29,111,2003,122,104,-114,748,1,18,-113,-103,10222,11.875212926,10.123132331,-11.09651044,-8,0.0973378109,1.7520805957,-10.99917263
29,111,2004,90,110,-48,748,0,-20,-48,-76,10146,8.8373919874,10.801256874,-4.713275727,-8,0,-1.963864886,-4.713275727
29,111,2005,105,124,-63,748,1,-19,-62,-89,10057,10.394495867,12.275404643,-6.23669752,-8,0.0989951987,-1.880908776,-6.137702321
29,111,2006,114,135,49,748,0,-21,49,22,10079,11.323003576,13.408820024,4.8669050457,-6,0,-2.085816448,4.8669050457
29,111,2007,123,117,-53,748,1,6,-52,-48,10031,12.23272004,11.636001989,-5.271009448,-2,0.0994530085,0.5967180507,-5.17155644
29,111,2008,122,121,-80,748,0,1,-80,-80,9951,12.210989891,12.11089981,-8.007206486,-1,0,0.1000900811,-8.007206486
29,113,2001,567,309,1239,577,9,258,1248,1495,40751,14.173759796,7.7243241216,30.972289925,-11,0.2249803142,6.4494356744,31.197270239
29,113,2002,612,347,1172,577,7,265,1179,1437,42188,14.757834071,8.3675954617,28.261734528,-7,0.1687987557,6.3902386091,28.430533283
29,113,2003,617,382,1396,577,2,235,1398,1675,43863,14.340333058,8.8784557995,32.445875121,42,0.0464840618,5.4618772588,32.492359182
29,113,2004,651,392,1310,577,11,259,1321,1511,45374,14.590360501,8.7855934198,29.360018826,-69,0.2465345092,5.8047670809,29.606553335
29,113,2005,701,335,1705,577,8,366,1713,2044,47418,15.109061126,7.2204500388,36.74885766,-35,0.1724286576,7.8886110872,36.921286318
29,113,2006,725,349,1821,577,9,376,1830,2176,49594,14.946604544,7.1949861873,37.541747413,-30,0.1855440564,7.7516183565,37.727291469
29,113,2007,776,358,1416,577,6,418,1422,1838,51432,15.362381961,7.0872844614,28.032387702,-2,0.1187813038,8.2750974997,28.151169006
29,113,2008,827,373,903,577,8,454,911,1343,52775,15.872254263,7.1588281018,17.33088948,-22,0.1535405491,8.7134261614,17.484430029
29,115,2001,173,230,-52,239,4,-57,-48,-119,13603,12.662397072,16.834400732,-3.806038426,-14,0.2927721866,-4.17200366,-3.51326624
29,115,2002,162,178,-116,239,3,-16,-113,-139,13464,11.970295932,13.152547382,-8.571323013,-10,0.2216721469,-1.18225145,-8.349650866
29,115,2003,168,173,-135,239,2,-5,-133,-152,13312,12.548550941,12.922019719,-10.08365701,-14,0.1493875112,-0.373468778,-9.934269495
29,115,2004,170,188,-101,239,5,-18,-96,-125,13187,12.830672856,14.189214687,-7.622929167,-11,0.377372731,-1.358541832,-7.245556436
29,115,2005,159,190,-166,239,4,-31,-162,-201,12986,12.149925496,14.518778894,-12.68482788,-8,0.305658503,-2.368853399,-12.37916937
29,115,2006,187,167,-218,239,4,20,-214,-201,12785,14.51243646,12.960304218,-16.91824143,-7,0.3104264483,1.5521322417,-16.60781499
29,115,2007,166,154,-106,239,4,12,-102,-101,12684,13.035454867,12.093132828,-8.323844674,-11,0.3141073462,0.9423220386,-8.009737328
29,115,2008,172,155,-109,239,5,17,-104,-104,12580,13.616212793,12.270424319,-8.628879037,-17,0.3958201393,1.3457884737,-8.233058898
29,117,2001,171,194,11,919,3,-23,14,-25,14472,11.805723359,13.393627671,0.7594324968,-16,0.2071179537,-1.587904312,0.9665504505
29,117,2002,151,176,-98,925,3,-25,-95,-131,14341,10.481379933,12.216707736,-6.802484989,-11,0.2082393364,-1.735327803,-6.594245653
29,117,2003,158,196,-24,919,2,-38,-22,-79,14262,11.04779219,13.704856134,-1.678145649,-19,0.1398454708,-2.657063944,-1.538300178
29,117,2004,177,172,-70,928,5,5,-65,-71,14191,12.441570309,12.090113521,-4.920395037,-11,0.3514567884,0.3514567884,-4.568938249
29,117,2005,173,199,-46,930,4,-26,-42,-79,14112,12.224852489,14.062113557,-3.250538812,-11,0.2826555489,-1.837261068,-2.967883263
29,117,2006,184,216,28,928,4,-32,32,-7,14105,13.041783322,15.309919552,1.9846192012,-7,0.2835170287,-2.26813623,2.2681362299
29,117,2007,174,193,98,925,3,-19,101,76,14181,12.302906031,13.646326805,6.9292229371,-6,0.2121190695,-1.343420774,7.1413420066
29,117,2008,191,187,27,925,5,4,32,32,14213,13.453546524,13.171796858,1.9018102416,-4,0.3521870818,0.2817496654,2.2539973234
29,119,2001,344,189,-224,164,91,155,-133,3,21667,15.877778034,8.7235466525,-10.33901825,-19,4.200226166,7.1542313817,-6.138792089
29,119,2002,374,212,-228,164,87,162,-141,0,21667,17.261272903,9.7844648544,-10.52291503,-21,4.0153228412,7.4768080491,-6.507592191
29,119,2003,359,189,131,164,65,170,196,347,22014,16.437352625,8.6536480392,5.9980311806,-19,2.9761223415,7.7837045855,8.9741535221
29,119,2004,374,206,57,164,68,168,125,276,22290,16.88335139,9.2993860599,2.5731310943,-17,3.0697002528,7.5839653304,5.6428313471
29,119,2005,361,202,58,164,67,159,125,264,22554,16.100258675,9.009009009,2.586745161,-20,2.9881366515,7.0912496655,5.5748818125
29,119,2006,381,197,3,164,68,184,71,244,22798,16.801905098,8.6875992238,0.1322984653,-11,2.9987652143,8.1143058741,3.1310636797
29,119,2007,374,233,-189,164,58,141,-131,5,22803,16.403149054,10.219074143,-8.289291901,-5,2.543803864,6.1840749106,-5.745488038
29,119,2008,377,185,-303,164,60,192,-243,-72,22731,16.559054772,8.1257961084,-13.30873633,-21,2.6353933325,8.4332586639,-10.673343
29,121,2001,194,225,-83,311,1,-31,-82,-127,15611,12.376790328,14.354524865,-5.295224728,-14,0.0637978883,-1.977734537,-5.23142684
29,121,2002,184,215,-141,311,1,-31,-140,-180,15431,11.854906256,13.852200245,-9.084466207,-9,0.0644288383,-1.997293989,-9.020037369
29,121,2003,182,220,160,311,0,-38,160,109,15540,11.75293016,14.206838656,10.332246295,-13,0,-2.453908495,10.332246295
29,121,2004,191,231,-32,311,3,-40,-29,-82,15458,12.323375702,14.904187367,-2.064649332,-13,0.1935608749,-2.580811665,-1.871088457
29,121,2005,196,209,107,311,2,-13,109,83,15541,12.645569212,13.484305945,6.9034484983,-13,0.1290364205,-0.838736733,7.0324849189
29,121,2006,195,223,29,311,2,-28,31,-5,15536,12.549473887,14.351449625,1.866332014,-8,0.1287125527,-1.801975738,1.9950445667
29,121,2007,198,217,48,311,1,-19,49,23,15559,12.735166425,13.95722785,3.0873130728,-7,0.0643190224,-1.222061425,3.1516320952
29,121,2008,204,215,77,311,3,-11,80,62,15621,13.085311097,13.790891597,4.9390635022,-7,0.1924310455,-0.7055805,5.1314945478
29,123,2001,142,147,22,230,4,-5,26,10,11811,12.027782483,12.451295951,1.863459258,-11,0.3388107742,-0.423513468,2.2022700322
29,123,2002,129,153,60,230,3,-24,63,28,11839,10.909090909,12.938689218,5.0739957717,-11,0.2536997886,-2.029598309,5.3276955603
29,123,2003,148,160,-18,230,3,-12,-15,-42,11797,12.523269589,13.538669826,-1.523100355,-15,0.2538500592,-1.015400237,-1.269250296
29,123,2004,151,150,118,230,4,1,122,112,11909,12.739390872,12.655024045,9.9552855817,-11,0.3374673079,0.084366827,10.29275289
29,123,2005,147,155,88,230,4,-8,92,73,11982,12.305889247,12.975597505,7.3667908417,-11,0.3348541292,-0.669708258,7.7016449709
29,123,2006,140,133,37,230,4,7,41,42,12024,11.663750729,11.080563193,3.0825626927,-6,0.3332500208,0.5831875364,3.4158127135
29,123,2007,169,173,140,230,4,-4,144,146,12170,13.970405886,14.30106638,11.573117302,6,0.3306604943,-0.330660494,11.903777796
29,123,2008,168,162,94,230,4,6,98,106,12276,13.74457989,13.253702037,7.6904197006,2,0.3272519022,0.4908778532,8.0176716027
29,125,2001,108,98,-124,85,2,10,-122,-122,8776,12.221342084,11.089736336,-14.03191128,-10,0.2263211497,1.1316057486,-13.80559013
29,125,2002,98,97,-20,85,2,1,-18,-25,8751,11.18274662,11.06863696,-2.282193188,-8,0.2282193188,0.1141096594,-2.053973869
29,125,2003,89,108,21,85,-1,-19,20,-8,8743,10.174917114,12.347090431,2.4008231394,-9,-0.114324911,-2.172173317,2.286498228
29,125,2004,98,83,189,85,2,15,191,192,8935,11.087227062,9.3902025116,21.382509334,-14,0.22626994,1.6970245503,21.608779274
29,125,2005,112,81,37,85,1,31,38,60,8995,12.493028444,9.0351366425,4.1271611824,-9,0.1115448968,3.4578918015,4.2387060792
29,125,2006,98,92,26,85,1,6,27,29,9024,10.877407181,10.211443476,2.8858427216,-4,0.1109939508,0.665963705,2.9968366724
29,125,2007,92,101,93,85,0,-9,93,86,9110,10.146685784,11.139296349,10.256975846,2,0,-0.992610566,10.256975846
29,125,2008,112,106,-79,85,2,6,-77,-64,9046,12.337519277,11.676580745,-8.702357347,7,0.2203128442,0.6609385327,-8.482044503
29,127,2001,422,323,-293,1258,12,99,-281,-204,28105,14.960825327,11.451058248,-10.38749247,-22,0.4254263126,3.5097670791,-9.962066154
29,127,2002,406,354,-122,1258,11,52,-111,-82,28023,14.466932725,12.614025086,-4.347206385,-23,0.3919612315,1.8529076397,-3.955245154
29,127,2003,375,370,185,1258,2,5,187,159,28182,13.34400854,13.166088426,6.5830442131,-33,0.0711680455,0.1779201139,6.6542122587
29,127,2004,366,362,-109,1258,5,4,-104,-124,28058,13.015647226,12.873399716,-3.876244666,-24,0.1778093883,0.1422475107,-3.698435277
29,127,2005,379,350,61,1258,4,29,65,68,28126,13.491385448,12.459063078,2.171436708,-26,0.1423892923,1.0323223694,2.3138260003
29,127,2006,385,346,62,1258,4,39,66,91,28217,13.66629395,12.281916121,2.2008057789,-14,0.1419874696,1.3843778287,2.3427932485
29,127,2007,448,339,-176,1258,2,109,-174,-60,28157,15.893851776,12.026820875,-6.244013198,5,0.0709546954,3.8670309008,-6.173058502
29,127,2008,426,326,-44,1258,3,100,-41,68,28225,15.111205704,11.563974318,-1.56078181,9,0.1064169416,3.5472313859,-1.454364868
29,129,2001,39,53,-18,60,1,-14,-17,-36,3720,10.433386838,14.17870519,-4.81540931,-5,0.2675227394,-3.745318352,-4.54788657
29,129,2002,43,46,-80,60,1,-3,-79,-85,3635,11.692726037,12.508497621,-21.75390891,-3,0.2719238613,-0.815771584,-21.48198504
29,129,2003,48,40,-23,60,1,8,-22,-19,3616,13.239553165,11.032960971,-6.343952558,-5,0.2758240243,2.2065921942,-6.068128534
29,129,2004,37,40,-43,60,0,-3,-43,-50,3566,10.303536619,11.138958507,-11.9743804,-4,0,-0.835421888,-11.9743804
29,129,2005,51,47,-55,60,1,4,-54,-52,3514,14.406779661,13.276836158,-15.53672316,-2,0.2824858757,1.1299435028,-15.25423729
29,129,2006,37,31,-23,60,0,6,-23,-18,3496,10.556348074,8.8445078459,-6.562054208,-1,0,1.7118402282,-6.562054208
29,129,2007,54,29,-22,60,1,25,-21,0,3496,15.446224256,8.295194508,-6.292906178,-4,0.2860411899,7.1510297483,-6.006864989
29,129,2008,46,33,15,60,0,13,15,27,3523,13.107280239,9.4030488674,4.2741131215,-1,0,3.704231372,4.2741131215
29,131,2001,295,260,282,396,2,35,284,300,23925,12.407991588,10.935856993,11.861198738,-19,0.0841219769,1.4721345952,11.945320715
29,131,2002,321,275,144,396,1,46,145,172,24097,13.3688726,11.453084003,5.9972512598,-19,0.0416475782,1.9157885969,6.038898838
29,131,2003,282,253,-35,396,-2,29,-37,-43,24054,11.713152375,10.508608336,-1.453760047,-35,-0.083072003,1.2045440385,-1.536832049
29,131,2004,353,285,382,396,4,68,386,426,24480,14.546503482,11.744344171,15.741542012,-28,0.1648329006,2.802159311,15.906374912
29,131,2005,334,277,40,396,1,57,41,74,24554,13.623200228,11.298282824,1.6315209854,-24,0.0407880246,2.3249174043,1.6723090101
29,131,2006,314,281,196,396,3,33,199,219,24773,12.731364162,11.393354552,7.9469661646,-13,0.1216372372,1.3380096093,8.0686034018
29,131,2007,359,250,-19,396,1,109,-18,94,24867,14.464141821,10.07252216,-0.765511684,3,0.0402900886,4.3916196616,-0.725221595
29,131,2008,340,277,-1,396,3,63,2,82,24949,13.650232857,11.120925004,-0.040147744,17,0.1204432311,2.5293078529,0.0802954874
29,133,2001,221,174,-169,270,2,47,-167,-130,13232,16.620290291,13.085658419,-12.70963375,-10,0.1504098669,3.5346318719,-12.55922389
29,133,2002,186,164,-74,270,2,22,-72,-60,13172,14.088774428,12.422360248,-5.605211332,-10,0.1514921982,1.6664141797,-5.453719133
29,133,2003,194,166,304,678,2,28,306,337,13509,14.542183576,12.44331172,22.787751584,3,0.1499194183,2.0988718564,22.937671002
29,133,2004,194,207,122,897,2,-13,124,97,13606,14.309422829,15.268301678,8.9987092015,-14,0.147519823,-0.958878849,9.1462290245
29,133,2005,202,181,34,911,2,21,36,47,13653,14.820793133,13.280017609,2.4945889431,-10,0.1467405261,1.5407755237,2.6413294692
29,133,2006,185,162,58,941,2,23,60,76,13729,13.512526477,11.832590753,4.2363596523,-7,0.1460813673,1.6799357242,4.3824410196
29,133,2007,195,173,-163,906,2,22,-161,-140,13589,14.27630134,12.665641701,-11.93352368,-1,0.1464236035,1.6106596383,-11.78710008
29,133,2008,189,157,-120,906,2,32,-118,-85,13504,13.951943306,11.589709519,-8.858376702,1,0.1476396117,2.3622337873,-8.710737091
29,135,2001,193,170,-92,1275,4,23,-88,-82,14753,13.04582939,11.491145059,-6.218737326,-17,0.2703798837,1.5546843315,-5.948357442
29,135,2002,192,142,112,1281,3,50,115,156,14909,12.945856652,9.5745398153,7.5517497134,-9,0.2022790102,3.3713168364,7.7540287236
29,135,2003,207,136,-6,1274,2,71,-4,43,14952,13.864237634,9.1088711028,-0.40186196,-24,0.1339539868,4.7553665316,-0.267907974
29,135,2004,202,150,-117,1209,3,52,-114,-74,14878,13.543412672,10.056989608,-7.844451894,-12,0.2011397922,3.486423064,-7.643312102
29,135,2005,224,148,116,1283,3,76,119,180,15058,14.96525922,9.8877605559,7.7498663816,-15,0.2004275788,5.0774986638,7.9502939604
29,135,2006,210,146,-61,1377,3,64,-58,0,15058,13.946075176,9.6958427414,-4.051002789,-6,0.1992296454,4.2502324346,-3.851773144
29,135,2007,238,134,-41,1353,2,104,-39,68,15126,15.769944341,8.8788762258,-2.716671084,3,0.1325205407,6.8910681156,-2.584150543
29,135,2008,231,131,-112,1353,2,100,-110,-5,15121,15.274242074,8.6620160677,-7.405693127,5,0.1322445201,6.6122260059,-7.273448606
29,137,2001,111,88,-54,186,2,23,-52,-36,9287,11.929070392,9.4572810317,-5.803331542,-7,0.2149382053,2.4717893606,-5.588393337
29,137,2002,118,121,-22,186,1,-3,-21,-33,9254,12.728547543,13.052154684,-2.373119033,-9,0.107869047,-0.323607141,-2.265249987
29,137,2003,109,108,24,186,0,1,24,11,9265,11.771693936,11.663696744,2.5919326098,-14,0,0.1079971921,2.5919326098
29,137,2004,101,116,-1,186,1,-15,0,-21,9244,10.913609595,12.534442704,-0.108055541,-6,0.1080555405,-1.620833108,0
29,137,2005,101,108,-38,186,1,-7,-37,-52,9192,10.956823606,11.71620742,-4.122369278,-8,0.108483402,-0.759383814,-4.013885875
29,137,2006,111,117,-17,186,1,-6,-16,-26,9166,12.092820569,12.746486545,-1.852053601,-4,0.1089443294,-0.653665977,-1.743109271
29,137,2007,98,107,12,186,1,-9,13,1,9167,10.691103475,11.672939508,1.3091147112,-3,0.1090928926,-0.981836033,1.4182076038
29,137,2008,103,102,-40,186,1,1,-39,-40,9127,11.260522576,11.151197114,-4.373018476,-2,0.1093254619,0.1093254619,-4.263693014
29,139,2001,157,165,-53,323,3,-8,-50,-69,12062,12.978960856,13.64030918,-4.381432646,-11,0.2480056215,-0.661348324,-4.133427024
29,139,2002,160,169,-69,323,3,-9,-66,-84,11978,13.311148087,14.059900166,-5.740432612,-9,0.2495840266,-0.74875208,-5.490848586
29,139,2003,162,173,-22,323,2,-11,-20,-47,11931,13.551382325,14.471537915,-1.84031118,-16,0.1673010164,-0.92015559,-1.673010164
29,139,2004,160,134,74,323,2,26,76,91,12022,13.359495679,11.188577631,6.1787667516,-11,0.166993696,2.1709180478,6.3457604475
29,139,2005,161,152,-6,323,2,9,-4,-5,12017,13.394899954,12.646116727,-0.499188818,-10,0.1663962727,0.7487832273,-0.332792545
29,139,2006,162,195,-74,323,2,-33,-72,-111,11906,13.543451908,16.302303223,-6.186515069,-6,0.16720311,-2.758851315,-6.019311959
29,139,2007,160,153,-28,323,2,7,-26,-18,11888,13.448768597,12.860384971,-2.353534504,1,0.1681096075,0.5883836261,-2.185424897
29,139,2008,156,163,-84,323,2,-7,-82,-84,11804,13.169002195,13.75991896,-7.091001182,5,0.1688333615,-0.590916765,-6.92216782
29,141,2001,229,237,286,287,6,-8,292,270,19637,11.742385396,12.152599733,14.665162547,-14,0.3076607527,-0.410214337,14.9728233
29,141,2002,230,259,92,287,5,-29,97,53,19690,11.696798637,13.171612378,4.6787194548,-15,0.2542782312,-1.474813741,4.9329976861
29,141,2003,235,280,277,287,5,-45,282,232,19922,11.865091386,14.137130163,13.985660911,-5,0.2524487529,-2.272038776,14.238109664
29,141,2004,250,263,307,287,6,-13,313,275,20197,12.462922805,13.11099479,15.304469204,-25,0.2991101473,-0.648071986,15.603579351
29,141,2005,250,260,177,287,6,-10,183,154,20351,12.331064417,12.824306994,8.7303936076,-19,0.295945546,-0.493242577,9.0263391536
29,141,2006,285,242,200,287,6,43,206,239,20590,13.922473804,11.821890037,9.7701570553,-10,0.2931047117,2.1005837669,10.063261767
29,141,2007,303,272,167,287,6,31,173,204,20794,14.643340421,13.14517688,8.0707519814,0,0.2899671371,1.4981635415,8.3607191185
29,141,2008,287,272,51,287,6,15,57,67,20861,13.77985836,13.059656704,2.448685632,-5,0.2880806626,0.7202016565,2.7367662946
29,143,2001,272,257,-185,350,1,15,-184,-186,19480,13.896694426,13.130332601,-9.451795841,-17,0.0510907883,0.766361825,-9.400705053
29,143,2002,216,225,-380,350,0,-9,-380,-395,19085,11.201866978,11.668611435,-19.7069882,-6,0,-0.466744457,-19.7069882
29,143,2003,251,255,-164,350,0,-4,-164,-187,18898,13.216438933,13.427059474,-8.635442171,-19,0,-0.210620541,-8.635442171
29,143,2004,238,234,-313,350,1,4,-312,-328,18570,12.704174229,12.490658695,-16.70759048,-20,0.0533788833,0.2135155333,-16.65421159
29,143,2005,278,228,-509,350,1,50,-508,-469,18101,15.161844509,12.434894058,-27.76035559,-11,0.054539009,2.7269504513,-27.70581659
29,143,2006,221,230,-220,350,1,-9,-219,-235,17866,12.289042734,12.789501487,-12.23343621,-7,0.0556065282,-0.500458754,-12.17782968
29,143,2007,267,248,-131,350,1,19,-130,-109,17757,14.990315246,13.923588693,-7.354798866,2,0.0561435028,1.0667265531,-7.298655363
29,143,2008,238,230,-170,350,1,8,-169,-168,17589,13.466870367,13.014202456,-9.619193119,-7,0.0565834889,0.4526679115,-9.562609631
29,145,2001,721,545,-85,968,33,176,-52,68,52774,13.670838074,10.333712552,-1.611679939,-56,0.6257110353,3.3371255214,-0.985968904
29,145,2002,729,534,105,968,31,195,136,281,53055,13.776942048,10.091751788,1.9843332168,-50,0.5858507592,3.6851902598,2.570183976
29,145,2003,729,536,533,968,23,193,556,709,53764,13.649257155,10.035667812,9.9794980294,-40,0.4306349994,3.6135893427,10.410133029
29,145,2004,710,508,370,968,29,202,399,554,54318,13.138172869,9.4002701652,6.8466534668,-47,0.536629596,3.7379027035,7.3832830629
29,145,2005,749,526,426,968,26,223,452,621,54939,13.710791986,9.6286736777,7.7981273511,-54,0.4759420449,4.0821183082,8.274069396
29,145,2006,781,526,222,968,28,255,250,479,55418,14.15406363,9.5326984242,4.023306179,-26,0.5074440226,4.6213652057,4.5307502016
29,145,2007,807,510,246,968,23,297,269,576,55994,14.486769827,9.1552076976,4.41604136,10,0.4128819158,5.3315621298,4.8289232758
29,145,2008,818,503,-228,968,25,315,-203,126,56120,14.592289991,8.9730096152,-4.067288653,14,0.445974633,5.6192803753,-3.62131402
29,147,2001,231,187,20,2914,20,44,40,63,21938,10.544815466,8.5362791865,0.912971036,-21,0.912971036,2.0085362792,1.825942072
29,147,2002,204,200,50,2914,19,4,69,48,21986,9.2887715144,9.1066387396,2.2766596849,-25,0.8651306803,0.1821327748,3.1417903652
29,147,2003,213,183,-76,2900,13,30,-63,-62,21924,9.7016624915,8.3352311546,-3.461626053,-29,0.592120246,1.3664313368,-2.869505807
29,147,2004,241,198,20,2912,16,43,36,65,21989,10.976248491,9.0178307107,0.910891991,-14,0.7287135928,1.9584177806,1.6396055838
29,147,2005,229,183,2,2900,15,46,17,42,22031,10.404361654,8.3144025443,0.0908677874,-21,0.6815084053,2.0899591095,0.7723761926
29,147,2006,258,206,-88,2900,15,52,-73,-31,22000,11.719016148,9.3570439009,-3.997183802,-10,0.6813381481,2.3619722468,-3.315845654
29,147,2007,244,198,3,2900,13,46,16,59,22059,11.076057105,8.9879479788,0.13618103,-3,0.5901177966,2.0881091264,0.7262988266
29,147,2008,250,186,-89,2900,15,64,-74,-5,22054,11.334527237,8.4328882642,-4.035091696,5,0.6800716342,2.9016389726,-3.355020062
29,149,2001,114,151,-107,110,2,-37,-105,-152,10180,11.115444618,14.723088924,-10.43291732,-10,0.1950078003,-3.607644306,-10.23790952
29,149,2002,103,135,98,110,2,-32,100,60,10240,10.088148874,13.222331048,9.5984329089,-8,0.1958863859,-3.134182174,9.7943192948
29,149,2003,111,124,65,110,1,-13,66,41,10281,10.818186248,12.085181034,6.3349739291,-12,0.0974611374,-1.266994786,6.4324350665
29,149,2004,114,133,63,110,0,-19,63,36,10317,11.069035829,12.913875134,6.1170987475,-8,0,-1.844839305,6.1170987475
29,149,2005,115,149,1,110,1,-34,2,-41,10276,11.168843782,14.470936726,0.0971203807,-9,0.0971203807,-3.302092944,0.1942407614
29,149,2006,122,113,34,110,0,9,34,38,10314,11.850412822,10.97620204,3.3025740651,-5,0,0.8742107819,3.3025740651
29,149,2007,114,137,-2,110,1,-23,-1,-29,10285,11.068498471,13.301616583,-0.194184184,-5,0.0970920918,-2.233118113,-0.097092092
29,149,2008,127,124,-10,110,0,3,-10,-21,10264,12.360698817,12.068713806,-0.973283371,-14,0,0.2919850114,-0.973283371
29,151,2001,158,135,-36,202,1,23,-35,-24,13057,12.089677864,10.329788048,-2.754610146,-12,0.0765169485,1.7598898156,-2.678093198
29,151,2002,171,152,-22,202,0,19,-22,-18,13039,13.105456775,11.649294911,-1.686082158,-15,0,1.4561618639,-1.686082158
29,151,2003,208,127,119,202,-1,81,118,186,13225,15.839171489,9.6710325921,9.0618336887,-13,-0.076149863,6.1681388973,8.9856838258
29,151,2004,184,109,-66,202,0,75,-66,-2,13223,13.914095584,8.2425892317,-4.99092559,-11,0,5.6715063521,-4.99092559
29,151,2005,197,123,35,202,0,74,35,96,13319,14.844397559,9.2683294401,2.6373295155,-13,0,5.5760681185,2.6373295155
29,151,2006,182,116,77,202,0,66,77,137,13456,13.594771242,8.664799253,5.7516339869,-6,0,4.9299719888,5.7516339869
29,151,2007,189,104,-187,202,0,85,-187,-98,13358,14.097113448,7.7571417916,-13.94793764,4,0,6.3399716566,-13.94793764
29,151,2008,189,105,18,202,0,84,18,107,13465,14.092383402,7.8291018902,1.3421317526,5,0,6.2632815121,1.3421317526
29,153,2001,95,123,-87,74,3,-28,-84,-120,9409,10.03273841,12.989756046,-9.187876228,-8,0.3168233182,-2.957017636,-8.871052909
29,153,2002,113,122,23,74,3,-9,26,8,9417,12.004674386,12.960798895,2.4434292999,-9,0.3187081696,-0.956124509,2.7621374695
29,153,2003,99,124,72,74,-1,-25,71,39,9456,10.491177873,13.140465215,7.6299475441,-7,-0.105971494,-2.649287342,7.5239760504
29,153,2004,110,125,-45,74,0,-15,-45,-68,9388,11.674803651,13.266822331,-4.776056039,-8,0,-1.59201868,-4.776056039
29,153,2005,101,138,1,74,0,-37,1,-39,9349,10.780808027,14.730212948,0.1067406735,-3,0,-3.949404921,0.1067406735
29,153,2006,111,116,1,74,0,-5,1,-11,9338,11.87991652,12.415047894,0.107026275,-7,0,-0.535131375,0.107026275
29,153,2007,107,114,-94,74,0,-7,-94,-121,9217,11.53327944,12.287793048,-10.13203988,-20,0,-0.754513608,-10.13203988
29,153,2008,109,120,51,74,0,-11,51,10,9227,11.819561917,13.012361744,5.5302537411,-30,0,-1.192799827,5.5302537411
29,155,2001,357,256,-289,278,11,101,-278,-191,19824,17.9221366,12.851728206,-14.5083963,-14,0.5522226964,5.0704083938,-13.9561736
29,155,2002,325,222,-169,278,11,103,-158,-70,19754,16.423265451,11.218353631,-8.540098034,-15,0.5558643691,5.2049118197,-7.984233665
29,155,2003,343,247,-379,278,9,96,-370,-279,19475,17.487063142,12.59272477,-19.32244003,-5,0.4588442224,4.8943383721,-18.86359581
29,155,2004,298,237,-319,278,8,61,-311,-271,19204,15.408878203,12.254711859,-16.49473875,-21,0.4136611598,3.1541663435,-16.08107759
29,155,2005,310,239,-211,278,9,71,-202,-147,19057,16.204490212,12.493139228,-11.02950785,-16,0.4704529416,3.711350984,-10.55905491
29,155,2006,344,242,-304,278,8,102,-296,-202,18855,18.147288457,12.766406415,-16.03713864,-8,0.4220299641,5.3808820426,-15.61510867
29,155,2007,299,236,-194,278,8,63,-186,-115,18740,15.906370528,12.554861019,-10.32052135,8,0.4255885091,3.3515095092,-9.894932837
29,155,2008,310,216,-339,278,7,94,-332,-225,18515,16.642061468,11.595758959,-18.19889948,13,0.3757884848,5.0463025097,-17.82311099
29,157,2001,232,208,-2,379,4,24,2,8,18144,12.789415656,11.466372657,-0.110253583,-18,0.2205071665,1.3230429989,0.1102535832
29,157,2002,247,173,51,379,4,74,55,112,18256,13.571428571,9.5054945055,2.8021978022,-17,0.2197802198,4.0659340659,3.021978022
29,157,2003,237,192,-69,379,3,45,-66,-42,18214,12.996983822,10.529202084,-3.783931999,-21,0.1645187826,2.4677817384,-3.619413216
29,157,2004,259,183,39,379,6,76,45,109,18323,14.177409202,10.017242795,2.134822235,-12,0.32843419,4.1601664067,2.463256425
29,157,2005,237,179,68,379,5,58,73,112,18435,12.895152076,9.7393764623,3.6998748572,-19,0.2720496219,3.1557756135,3.971924479
29,157,2006,235,173,-43,379,5,62,-38,17,18452,12.741616288,9.3799983734,-2.331444682,-7,0.2710982189,3.3616179142,-2.060346464
29,157,2007,284,169,167,379,3,115,170,289,18741,15.27169091,9.0877315624,8.9801844433,4,0.1613206786,6.1839593472,9.1415051219
29,157,2008,265,190,-89,379,5,75,-84,2,18743,14.13936613,10.137658734,-4.748692776,11,0.266780493,4.0017073952,-4.481912283
29,159,2001,571,443,-136,687,82,128,-54,35,39469,14.473467422,11.228977352,-3.447270699,-39,2.0785014511,3.2444900701,-1.368769248
29,159,2002,571,442,-256,687,70,129,-186,-91,39378,14.483747004,11.211586998,-6.493588849,-34,1.775590701,3.2721600061,-4.717998148
29,159,2003,597,425,-97,687,29,172,-68,50,39428,15.151130625,10.785980763,-2.461741492,-54,0.7359845697,4.3651498617,-1.725756922
29,159,2004,563,413,-90,687,78,150,-12,111,39539,14.259120899,10.460065597,-2.279433181,-27,1.9755087568,3.7990553016,-0.303924424
29,159,2005,598,398,246,687,64,200,310,470,40009,15.034947453,10.006536934,6.1849449389,-40,1.6090913662,5.0284105194,7.7940363051
29,159,2006,642,393,162,687,73,249,235,465,40474,15.953679659,9.7660375483,4.0256948672,-19,1.8140476871,6.1876421108,5.8397425543
29,159,2007,652,381,-50,687,51,271,1,274,40748,16.054763488,9.3816946148,-1.231193519,2,1.2558173894,6.673068873,0.0246238704
29,159,2008,642,385,-62,687,56,257,-6,258,41006,15.705653546,9.4184994006,-1.516745358,7,1.3699635492,6.2871541454,-0.146781809
29,161,2001,493,403,-129,2446,105,90,-24,31,39911,12.357283403,10.101389881,-3.233447381,-35,2.6318757755,2.2558935218,-0.601571606
29,161,2002,503,457,602,2443,93,46,695,718,40629,12.490687857,11.348398311,14.949093618,-23,2.3094114726,1.1422895456,17.258505091
29,161,2003,536,379,260,2440,70,157,330,432,41061,13.122781246,9.2789815155,6.3655282164,-55,1.7137960583,3.8437997307,8.0793242747
29,161,2004,521,428,305,2446,97,93,402,461,41522,12.617608951,10.365329426,7.3865081191,-34,2.3491517625,2.2522795248,9.7356598816
29,161,2005,543,424,269,2445,90,119,359,442,41964,13.008169034,10.157391658,6.4441942362,-36,2.1560501162,2.8507773758,8.6002443523
29,161,2006,613,380,127,2444,97,233,224,436,42400,14.532264947,9.0085818596,3.0107628846,-21,2.2995590536,5.5236830876,5.3103219383
29,161,2007,563,401,-203,2440,83,162,-120,43,42443,13.271572198,9.4527539102,-4.785309336,1,1.9565550487,3.8188182879,-2.828754287
29,161,2008,602,407,-526,2440,87,195,-439,-238,42205,14.223608355,9.616293356,-12.42793687,6,2.0555713071,4.6073149986,-10.37236556
29,163,2001,192,216,-31,2248,22,-24,-9,-50,18261,10.49983594,11.812315433,-1.695286011,-17,1.2031062015,-1.312479493,-0.49217981
29,163,2002,238,195,-8,2295,21,43,13,38,18299,13.019693654,10.667396061,-0.437636761,-18,1.1487964989,2.352297593,0.7111597374
29,163,2003,206,208,88,2301,18,-2,106,84,18383,11.231666758,11.340712066,4.7979935663,-20,0.9814077749,-0.109045308,5.7794013413
29,163,2004,260,216,-123,2172,22,44,-101,-72,18311,14.171254156,11.773041914,-6.704093312,-15,1.1991061209,2.3982122418,-5.504987191
29,163,2005,218,199,287,2244,20,19,307,309,18620,11.805800005,10.776854133,15.542498172,-17,1.0831009179,1.028945872,16.62559909
29,163,2006,247,223,-61,2242,22,24,-39,-23,18597,13.273504044,11.983770857,-3.278071849,-8,1.1822554209,1.2897331864,-2.095816428
29,163,2007,199,170,-215,2248,20,29,-195,-167,18430,10.748912955,9.1824884544,-11.61314716,-1,1.0802927593,1.566424501,-10.5328544
29,163,2008,229,189,-18,2248,22,40,4,46,18476,12.409906248,10.242237035,-0.975451146,2,1.1922180675,2.1676692137,0.2167669214
29,165,2001,1033,503,1153,844,146,530,1299,1770,76016,13.749317858,6.6949727809,15.346528064,-59,1.9432724175,7.0543450773,17.289800482
29,165,2002,1014,504,1177,844,134,510,1311,1773,77789,13.185527129,6.553753129,15.305094113,-48,1.7424661097,6.6317739995,17.047560222
29,165,2003,1079,465,848,844,90,614,938,1489,79278,13.739359636,5.9210400657,10.797939733,-63,1.1460077547,7.8183195706,11.943947487
29,165,2004,1055,513,835,844,127,542,962,1429,80707,13.188736444,6.4131012282,10.438478607,-75,1.5876488421,6.7756352158,12.026127449
29,165,2005,1072,475,759,844,117,597,876,1396,82103,13.16872428,5.8350224188,9.3237516123,-77,1.4372581537,7.3337018611,10.761009766
29,165,2006,1088,534,361,844,128,554,489,1001,83104,13.171354725,6.4646171167,4.3702748673,-42,1.5495711441,6.706737608,5.9198460114
29,165,2007,1092,499,905,844,106,593,1011,1618,84722,13.013478245,5.9466352055,10.784979681,14,1.2632130897,7.0668430398,12.048192771
29,165,2008,1145,521,435,844,111,624,546,1174,85896,13.421796059,6.1072102592,5.0991102932,4,1.3011522817,7.3145857999,6.4002625749
29,167,2001,345,257,278,1600,30,88,308,367,27432,12.661247408,9.4317118373,10.202396462,-29,1.1009780355,3.2295355708,11.303374498
29,167,2002,338,311,309,1600,29,27,338,350,27782,12.243271634,11.265258811,11.192813417,-15,1.0504582171,0.9780128228,12.243271634
29,167,2003,342,315,408,1600,17,27,425,437,28219,12.214067606,11.249799111,14.571168372,-15,0.6071320155,0.9642684952,15.178300387
29,167,2004,375,308,218,1600,21,67,239,280,28499,13.22331535,10.860749674,7.6871539899,-26,0.7405056596,2.3625656758,8.4276596495
29,167,2005,394,318,473,1600,19,76,492,543,29042,13.694582993,11.052988304,16.440451157,-25,0.6603986723,2.641594689,17.100849829
29,167,2006,388,314,521,1600,21,74,542,601,29643,13.223140496,10.701201329,17.755814944,-15,0.7156854392,2.5219391667,18.471500383
29,167,2007,449,302,348,1600,19,147,367,519,30162,15.015466934,10.099490009,11.637822925,5,0.6353983781,4.915976925,12.273221303
29,167,2008,445,322,95,1600,21,123,116,242,30404,14.694713205,10.633028432,3.1370736057,3,0.693458376,4.0616847736,3.8305319816
29,169,2001,597,261,913,6480,-90,336,823,1141,42853,14.119316502,6.172766511,21.592857565,-18,-2.128540176,7.9465499911,19.464317389
29,169,2002,637,304,1106,7352,-522,333,584,912,43765,14.708259253,7.019326237,25.537417165,-5,-12.05292203,7.6889330162,13.48449514
29,169,2003,656,283,1781,7796,-1455,373,326,782,44547,14.856418154,6.4090950267,40.334269408,83,-32.95135429,8.4473231271,7.3829151191
29,169,2004,635,290,-1404,7796,636,345,-768,-493,44054,14.333923996,6.5462015101,-31.69264455,-70,14.356497105,7.7877224862,-17.33614745
29,169,2005,672,261,-504,7796,-62,411,-566,-189,43865,15.286798076,5.9372831811,-11.46509856,-34,-1.410389108,9.3495148944,-12.87548766
29,169,2006,706,245,-866,7796,301,461,-565,-123,43742,16.117433538,5.5931603639,-19.77010969,-19,6.8715970185,10.524273175,-12.89851268
29,169,2007,741,269,217,7796,-120,472,97,558,44300,16.832875219,6.1107198837,4.9294654824,-11,-2.725971695,10.722155335,2.2034937871
29,169,2008,707,266,-217,7796,34,441,-183,246,44546,15.915179074,5.9878891565,-4.884856943,-12,0.7653692907,9.9272899174,-4.119487653
29,171,2001,53,70,-31,57,1,-17,-30,-53,5187,10.165915412,13.426680733,-5.946101467,-6,0.1918097248,-3.260765321,-5.754291743
29,171,2002,60,80,-23,57,1,-20,-22,-46,5141,11.618900077,15.49186677,-4.453911696,-4,0.1936483346,-3.872966692,-4.260263362
29,171,2003,52,84,-12,57,1,-32,-11,-50,5091,10.164190774,16.419077404,-2.345582486,-7,0.1954652072,-6.25488663,-2.150117279
29,171,2004,58,62,-45,57,0,-4,-45,-54,5037,11.453396524,12.24328594,-8.886255924,-5,0,-0.789889415,-8.886255924
29,171,2005,68,79,10,57,1,-11,11,-3,5034,13.504120743,15.688610863,1.9859001092,-3,0.1985900109,-2.18449012,2.1844901201
29,171,2006,70,63,-14,57,1,7,-13,-9,5025,13.917884482,12.526096033,-2.783576896,-3,0.1988269212,1.3917884482,-2.584749975
29,171,2007,53,66,-120,57,2,-13,-118,-133,4892,10.688716346,13.310476959,-24.2008672,-2,0.4033477866,-2.621760613,-23.79751941
29,171,2008,60,73,-13,57,1,-13,-12,-30,4862,12.302645069,14.968218167,-2.665573098,-5,0.2050440845,-2.665573098,-2.460529014
29,173,2001,73,87,5,105,2,-14,7,-17,9636,7.5690808233,9.0206853647,0.5184301934,-10,0.2073720773,-1.451604541,0.7258022707
29,173,2002,77,100,26,105,2,-23,28,-4,9632,7.9925264688,10.379904505,2.6987751713,-9,0.2075980901,-2.387378036,2.9063732614
29,173,2003,101,103,-46,105,2,-2,-44,-60,9572,10.51864195,10.726931889,-4.790668611,-14,0.2082899396,-0.20828994,-4.582378671
29,173,2004,108,93,-26,105,1,15,-25,-17,9555,11.292936686,9.7244732577,-2.718669943,-7,0.1045642286,1.5684634287,-2.614105714
29,173,2005,114,78,114,105,2,36,116,143,9698,11.842310289,8.1026333558,11.842310289,-9,0.2077598296,3.7396769335,12.050070119
29,173,2006,110,79,62,105,1,31,63,90,9788,11.290157036,8.1083855075,6.3635430566,-4,0.1026377912,3.1817715283,6.4661808478
29,173,2007,123,53,-13,105,2,70,-11,58,9846,12.529285933,5.3987980035,-1.324233473,-1,0.2037282265,7.1304879291,-1.120505246
29,173,2008,129,84,-69,105,1,45,-68,-14,9832,13.111088525,8.5374529932,-7.012907816,9,0.1016363452,4.5736355321,-6.911271471
29,175,2001,357,313,-17,2294,20,44,3,21,24693,14.463688848,12.681049326,-0.688747088,-26,0.8102906918,1.7826395219,0.1215436038
29,175,2002,353,286,-50,2287,19,67,-31,13,24706,14.291787283,11.579181765,-2.024332476,-23,0.769246341,2.7126055183,-1.255086135
29,175,2003,336,304,264,2296,17,32,281,299,25005,13.518134819,12.230693408,10.621391644,-14,0.6839532498,1.2874414114,11.305344893
29,175,2004,352,265,103,2216,18,87,121,188,25193,14.024463126,10.558189569,4.1037491534,-20,0.7171600462,3.4662735567,4.8209091996
29,175,2005,357,258,143,2235,19,99,162,238,25431,14.103982301,10.192793932,5.649494311,-23,0.7506321113,3.9111883692,6.4001264223
29,175,2006,332,283,6,2187,19,49,25,63,25494,13.038782523,11.114383898,0.235640648,-11,0.7461953854,1.9243986254,0.9818360334
29,175,2007,349,229,2,2277,15,120,17,141,25635,13.651743629,8.9577343582,0.0782334878,4,0.5867511588,4.6940092707,0.6649846467
29,175,2008,366,258,-41,2277,16,108,-25,88,25723,14.252891468,10.047120215,-1.596635383,5,0.6230772226,4.2057712528,-0.97355816
29,177,2001,279,220,-17,324,-1,59,-18,18,23392,11.931745285,9.4085446692,-0.727023906,-23,-0.042766112,2.5232006158,-0.769790018
29,177,2002,276,236,72,324,-2,40,70,89,23481,11.776502464,10.069762977,3.0721310776,-21,-0.085336974,1.7067394876,2.9867941032
29,177,2003,294,229,99,324,-4,65,95,132,23613,12.485666964,9.7252303903,4.204357243,-28,-0.16987302,2.7604365737,4.034484223
29,177,2004,315,236,-50,324,2,79,-48,16,23629,13.335591211,9.9911096059,-2.11676051,-15,0.0846704204,3.3444816054,-2.032090089
29,177,2005,262,257,-144,324,-1,5,-145,-162,23467,11.126210294,10.913878036,-6.115169016,-22,-0.042466452,0.2123322575,-6.157635468
29,177,2006,315,199,53,324,1,116,54,157,23624,13.378352551,8.4517211357,2.2509609055,-13,0.0424709605,4.9266314158,2.293431866
29,177,2007,298,218,-257,324,-1,80,-258,-178,23446,12.661992777,9.262800085,-10.91990652,0,-0.042489909,3.3991926917,-10.96239643
29,177,2008,307,224,-76,324,1,83,-75,-1,23445,13.094197181,9.55407221,-3.241560214,-9,0.0426521081,3.5401249707,-3.198908106
29,179,2001,57,84,-158,156,1,-27,-157,-190,6527,8.6076713984,12.684989429,-23.85986107,-6,0.1510117789,-4.077318031,-23.70884929
29,179,2002,85,94,75,156,1,-9,76,63,6590,12.960280552,14.332545552,11.435541663,-4,0.1524738888,-1.372265,11.588015552
29,179,2003,56,82,-11,156,1,-26,-10,-44,6546,8.5261875761,12.484774665,-1.674786845,-8,0.1522533496,-3.958587089,-1.522533496
29,179,2004,58,69,14,156,0,-11,14,-1,6545,8.861049576,10.541593461,2.1388740356,-4,0,-1.680543885,2.1388740356
29,179,2005,70,92,-35,156,1,-22,-34,-62,6483,10.746085355,14.123426466,-5.373042677,-6,0.1535155051,-3.377341111,-5.219527172
29,179,2006,68,85,4,156,0,-17,4,-17,6466,10.502741524,13.128426906,0.617808325,-4,0,-2.625685381,0.617808325
29,179,2007,63,67,-34,156,1,-4,-33,-40,6426,9.7735029476,10.394042817,-5.274588892,-3,0.1551349674,-0.62053987,-5.119453925
29,179,2008,62,80,-19,156,0,-18,-19,-38,6388,9.6769158733,12.486343062,-2.965506477,-1,0,-2.809427189,-2.965506477
29,181,2001,199,180,-100,159,2,19,-98,-90,13402,14.79883989,13.385885328,-7.43660296,-11,0.1487320592,1.4129545624,-7.287870901
29,181,2002,185,180,79,159,2,5,81,74,13476,13.765905201,13.393853709,5.8784135724,-12,0.1488205968,0.3720514919,6.0272341692
29,181,2003,169,160,62,159,2,9,64,62,13538,12.512030799,11.845709632,4.5902124824,-11,0.1480713704,0.6663211668,4.7382838528
29,181,2004,182,174,20,159,1,8,21,19,13557,13.434212954,12.843698099,1.4762871378,-10,0.0738143569,0.5905148551,1.5501014947
29,181,2005,182,195,19,159,2,-13,21,-4,13553,13.426779786,14.385835485,1.4016967909,-12,0.1475470306,-0.959055699,1.5492438215
29,181,2006,176,164,28,159,1,12,29,34,13587,12.969786293,12.085482682,2.0633750921,-7,0.0736919676,0.8843036109,2.1370670597
29,181,2007,161,199,-23,159,2,-38,-21,-63,13524,11.877097857,14.680388034,-1.696728265,-4,0.1475415883,-2.803290177,-1.549186677
29,181,2008,162,169,-15,159,1,-7,-14,-39,13485,11.996001333,12.514347069,-1.110740864,-18,0.0740493909,-0.518345737,-1.036691473
29,183,2001,4241,1623,5884,3788,199,2618,6083,8490,294653,14.603592188,5.5886890168,20.261149831,-211,0.6852428308,9.0149031707,20.946392661
29,183,2002,4272,1740,5536,3788,179,2532,5715,8076,302729,14.302406166,5.8254182416,18.534204245,-171,0.5992815318,8.476987924,19.133485776
29,183,2003,4302,1843,5281,3788,127,2459,5408,7753,310482,14.031059456,6.0109815382,17.224087631,-114,0.4142130523,8.0200779177,17.638300683
29,183,2004,4523,1974,5734,3788,161,2549,5895,8075,318557,14.380666382,6.2762404239,18.230984088,-369,0.5118919495,8.1044259577,18.742876038
29,183,2005,4544,1844,6223,3788,154,2700,6377,8818,327375,14.069592465,5.7095793365,19.26828211,-259,0.4768303784,8.3600131283,19.745112489
29,183,2006,4540,2026,5954,3788,166,2514,6120,8445,335820,13.691297431,6.1098168714,17.955503283,-189,0.5006069105,7.58148056,18.456110194
29,183,2007,4735,1897,4424,3788,142,2838,4566,7387,343207,13.946426283,5.5874066863,13.030409689,-17,0.418245519,8.3590195972,13.448655208
29,183,2008,4973,2041,3112,3788,147,2932,3259,6200,349407,14.360090902,5.8936146252,8.9862463075,9,0.4244788584,8.4664762768,9.4107251658
29,185,2001,92,138,-29,182,-1,-46,-30,-84,9587,9.5544708692,14.331706304,-3.011735383,-8,-0.103852944,-4.777235435,-3.115588327
29,185,2002,93,135,34,182,-1,-42,33,-18,9569,9.7097515139,14.094800585,3.5498016287,-9,-0.10440593,-4.385049071,3.4453956985
29,185,2003,80,146,-3,182,-2,-66,-5,-83,9486,8.3967462608,15.324061926,-0.314877985,-12,-0.209918657,-6.927315665,-0.524796641
29,185,2004,101,140,47,182,1,-39,48,1,9487,10.64670848,14.757813735,4.9544088969,-8,0.1054129553,-4.111105255,5.0598218521
29,185,2005,91,132,21,182,0,-41,21,-26,9461,9.605235381,13.932868904,2.2165927802,-6,0,-4.327633523,2.2165927802
29,185,2006,89,141,-32,182,0,-52,-32,-89,9372,9.4514947167,14.973716349,-3.398290235,-5,0,-5.522221632,-3.398290235
29,185,2007,90,135,78,182,-1,-45,77,24,9396,9.5907928389,14.386189258,8.3120204604,-8,-0.106564365,-4.795396419,8.2054560955
29,185,2008,94,134,-76,182,1,-40,-75,-126,9270,10.071788278,14.357655631,-8.14314797,-11,0.1071466838,-4.285867352,-8.036001286
29,186,2001,189,165,-18,354,2,24,-16,-9,17899,10.556595079,9.2160750691,-1.005390008,-17,0.1117100008,1.3405200101,-0.893680007
29,186,2002,182,195,-1,354,2,-13,1,-30,17869,10.176694252,10.903600984,-0.055915902,-18,0.111831805,-0.726906732,0.0559159025
29,186,2003,195,172,53,354,2,23,55,57,17926,10.895376449,9.6102807655,2.9613074452,-21,0.1117474508,1.2850956838,3.0730548959
29,186,2004,186,161,-9,354,1,25,-8,5,17931,10.374543325,8.9801154586,-0.501994032,-12,0.0557771146,1.3944278662,-0.446216917
29,186,2005,182,143,-74,354,2,39,-72,-44,17887,10.162488134,7.9848121056,-4.13200067,-11,0.1116756938,2.1776760288,-4.020324976
29,186,2006,183,177,-3,354,1,6,-2,-5,17882,10.23232408,9.8968380441,-0.167743018,-9,0.0559143392,0.3354860354,-0.111828678
29,186,2007,200,150,-97,354,2,50,-95,-60,17822,11.203226529,8.4024198969,-5.433564867,-15,0.1120322653,2.8008066323,-5.321532601
29,186,2008,195,167,-114,354,1,28,-113,-102,17720,10.972933431,9.3973327331,-6.414945698,-17,0.0562714535,1.5756006978,-6.358674245
29,187,2001,704,707,379,3876,18,-3,397,345,56089,12.590201461,12.643852888,6.7779635707,-49,0.3219085601,-0.053651427,7.0998721308
29,187,2002,724,741,501,3875,15,-17,516,455,56544,12.855912566,13.157777916,8.8961494411,-44,0.2663517797,-0.30186535,9.1625012208
29,187,2003,733,655,1064,4469,8,78,1072,1142,57686,12.833756456,11.468090694,18.629081677,-8,0.1400682833,1.3656657621,18.769149961
29,187,2004,751,687,2673,6067,19,64,2692,2632,60318,12.728382089,11.643673096,45.303549032,-124,0.3220229823,1.0847089929,45.625572015
29,187,2005,742,712,1312,6690,15,30,1327,1304,61622,12.169919633,11.677874364,21.518779728,-53,0.2460226341,0.4920452682,21.764802362
29,187,2006,800,694,363,6558,17,106,380,454,62076,12.934728128,11.220876651,5.8691328882,-32,0.2748629727,1.713851477,6.1439958609
29,187,2007,867,649,448,6543,13,218,461,686,62762,13.890001442,10.397475128,7.1773017831,7,0.2082699178,3.4925263141,7.3855717009
29,187,2008,846,671,243,6543,15,175,258,452,63214,13.431129739,10.65282276,3.857877691,19,0.2381405982,2.7783069791,4.0960182892
29,189,2001,12647,9752,-4553,19294,1909,2895,-2644,-640,1015690,12.447712129,9.5983307251,-4.481255106,-891,1.8789185146,2.8493814037,-2.602336591
29,189,2002,12220,9779,-6056,19278,1755,2441,-4301,-2687,1013003,12.047165342,9.6406898432,-5.970346425,-827,1.7301780013,2.4064754993,-4.240168424
29,189,2003,12125,9631,-6860,19263,1453,2494,-5407,-3958,1009045,11.992791467,9.5259855355,-6.785199956,-1045,1.4371567836,2.4668059314,-5.348043172
29,189,2004,12407,9601,-7977,19241,1458,2806,-6519,-4579,1004466,12.323746928,9.5365756631,-7.923472978,-866,1.4482165729,2.7871712645,-6.475256405
29,189,2005,12064,9441,-7867,19236,1484,2623,-6383,-4649,999817,12.038220152,9.4208253026,-7.850188821,-889,1.4808288051,2.6173948489,-6.369360016
29,189,2006,12225,9294,-6866,19152,1507,2931,-5359,-2864,996953,12.244775312,9.3090340901,-6.877106527,-436,1.509437742,2.9357412221,-5.367668785
29,189,2007,12470,8860,-8472,19142,1336,3610,-7136,-3441,993512,12.529735514,8.9024423941,-8.512583743,85,1.3423998915,3.6272931199,-7.170183852
29,189,2008,12226,8931,-6396,19142,1350,3295,-5046,-1682,991830,12.316265913,8.9969385627,-6.443222377,69,1.3599671996,3.3193273501,-5.083255177
29,195,2001,283,311,-346,1663,46,-28,-300,-343,23403,12.004496384,13.192220408,-14.67687544,-15,1.9512608963,-1.187724024,-12.72561454
29,195,2002,275,274,-482,1665,44,1,-438,-446,22957,11.863675582,11.820534944,-20.79378775,-9,1.8981880932,0.0431406385,-18.89559965
29,195,2003,294,243,-159,1666,32,51,-127,-98,22859,12.833944474,10.607647983,-6.940806705,-22,1.3968919155,2.2262964903,-5.54391479
29,195,2004,286,291,58,1603,39,-5,97,75,22934,12.490992073,12.70936606,2.5331382526,-17,1.7033171009,-0.218373987,4.2364553534
29,195,2005,305,332,-76,1572,37,-27,-39,-87,22847,13.324304843,14.503833468,-3.320154649,-21,1.6163910793,-1.179528625,-1.70376357
29,195,2006,299,274,-206,1558,39,25,-167,-152,22695,13.130736463,12.032848799,-9.046594352,-10,1.712704756,1.0978876641,-7.333889596
29,195,2007,299,270,-138,1540,35,29,-103,-81,22614,13.198260831,11.918161955,-6.091504999,-7,1.54494692,1.2800988766,-4.546558079
29,195,2008,312,235,-210,1540,37,77,-173,-109,22505,13.830093752,10.416897538,-9.308716949,-13,1.6401072719,3.4131962145,-7.668609677
29,197,2001,51,50,-24,54,2,1,-22,-26,4143,12.271414822,12.030798845,-5.774783446,-5,0.4812319538,0.2406159769,-5.293551492
29,197,2002,40,51,40,54,2,-11,42,27,4170,9.6234812944,12.26993865,9.6234812944,-4,0.4811740647,-2.646457356,10.104655359
29,197,2003,35,58,12,54,2,-23,14,-15,4155,8.4084084084,13.933933934,2.8828828829,-6,0.4804804805,-5.525525526,3.3633633634
29,197,2004,40,47,25,54,1,-7,26,16,4171,9.6084554408,11.289935143,6.0052846505,-3,0.240211386,-1.681479702,6.2454960365
29,197,2005,46,60,-52,54,2,-14,-50,-67,4104,11.117824773,14.501510574,-12.56797583,-3,0.4833836858,-3.383685801,-12.08459215
29,197,2006,44,51,-28,54,1,-7,-27,-36,4068,10.768477729,12.48164464,-6.852667646,-2,0.2447381302,-1.713166911,-6.607929515
29,197,2007,50,48,15,54,2,2,17,20,4088,12.260912212,11.770475723,3.6782736636,1,0.4904364885,0.4904364885,4.168710152
29,197,2008,47,47,20,54,1,0,21,22,4110,11.466211271,11.466211271,4.8792388387,1,0.2439619419,0,5.1232007807
29,199,2001,63,73,-10,124,2,-10,-8,-23,4953,12.690099708,14.704401249,-2.014301541,-5,0.4028603082,-2.014301541,-1.611441233
29,199,2002,64,70,-74,124,2,-6,-72,-80,4873,13.026663953,14.247913698,-15.0620802,-2,0.4070832485,-1.221249746,-14.65499695
29,199,2003,64,68,3,124,1,-4,4,-6,4867,13.141683778,13.963039014,0.6160164271,-6,0.205338809,-0.821355236,0.8213552361
29,199,2004,71,52,-56,124,0,19,-56,-42,4825,14.65125877,10.730499381,-11.55592241,-5,0,3.9207593892,-11.55592241
29,199,2005,53,65,-37,124,1,-12,-36,-52,4773,11.043967493,13.544488435,-7.709939571,-4,0.2083767452,-2.500520942,-7.501562826
29,199,2006,62,53,1,124,0,9,1,7,4780,12.980215639,11.095990788,0.2093583168,-3,0,1.8842248508,0.2093583168
29,199,2007,78,58,1,124,1,20,2,22,4802,16.280525986,12.106032144,0.2087246921,0,0.2087246921,4.1744938426,0.4174493843
29,199,2008,72,66,-13,124,0,6,-13,-4,4798,15,13.75,-2.708333333,3,0,1.25,-2.708333333
29,201,2001,539,406,-78,570,13,133,-65,28,40418,13.34026334,10.048510049,-1.930501931,-40,0.3217503218,3.2917532918,-1.608751609
29,201,2002,576,398,-301,570,12,178,-289,-141,40277,14.275977446,9.8643038602,-7.460189603,-30,0.2974161968,4.4116735857,-7.162773406
29,201,2003,577,438,43,570,8,139,51,127,40404,14.303243639,10.857574894,1.0659263024,-63,0.1983118702,3.4456687448,1.2642381726
29,201,2004,597,409,-134,570,13,188,-121,39,40443,14.768637055,10.117876978,-3.31490346,-28,0.3215951118,4.6507600777,-2.993308348
29,201,2005,606,397,10,570,11,209,21,190,40633,14.9489368,9.7932803789,0.2466821254,-40,0.271350338,5.1556564211,0.5180324634
29,201,2006,588,382,-229,570,13,206,-216,-28,40605,14.475984145,9.4044658903,-5.63775573,-18,0.3200472685,5.071518255,-5.317708462
29,201,2007,646,401,-163,570,9,245,-154,100,40705,15.889804452,9.8634854261,-4.009346944,9,0.2213749846,6.026319026,-3.787971959
29,201,2008,627,404,-278,570,11,223,-267,-32,40673,15.409570154,9.9289734326,-6.832313402,12,0.270343336,5.4805967215,-6.561970066
29,203,2001,93,78,-31,70,2,15,-29,-21,8298,11.193356201,9.387976169,-3.731118734,-7,0.2407173377,1.8053800325,-3.490401396
29,203,2002,97,93,-37,70,2,4,-35,-40,8258,11.717806233,11.234597729,-4.469678666,-9,0.2416042522,0.4832085045,-4.228074414
29,203,2003,90,102,-58,70,2,-12,-56,-77,8181,10.949571142,12.409513961,-7.056390291,-9,0.2433238032,-1.459942819,-6.813066488
29,203,2004,86,93,46,70,1,-7,47,33,8214,10.491003355,11.344922232,5.6114669106,-7,0.1219884111,-0.853918878,5.7334553217
29,203,2005,114,88,17,70,2,26,19,38,8252,13.846714442,10.68869185,2.0648609255,-7,0.2429248148,3.158022592,2.3077857403
29,203,2006,106,98,40,70,1,8,41,45,8297,12.810441719,11.843615928,4.8341289504,-4,0.1208532238,0.9668257901,4.9549821741
29,203,2007,102,76,77,70,2,26,79,107,8404,12.214837435,9.1012514221,9.2210047303,2,0.2395066164,3.1135860128,9.4605113466
29,203,2008,108,84,-9,70,1,24,-8,19,8423,12.836512747,9.9839543591,-1.069709396,3,0.1188565995,2.8525583883,-0.950852796
29,205,2001,90,81,-11,256,2,9,-9,-8,6780,13.266509434,11.939858491,-1.621462264,-8,0.2948113208,1.3266509434,-1.326650943
29,205,2002,78,106,-34,256,2,-28,-32,-66,6714,11.560693642,15.710686231,-5.039276716,-6,0.2964280421,-4.149992589,-4.742848673
29,205,2003,72,87,-47,256,2,-15,-45,-65,6649,10.776023348,13.021028212,-7.034348574,-5,0.2993339819,-2.245004864,-6.735014593
29,205,2004,89,89,-8,256,1,0,-7,-11,6638,13.396553022,13.396553022,-1.204184541,-4,0.1505230677,0,-1.053661474
29,205,2005,87,95,26,256,2,-8,28,12,6650,13.094521373,14.298615292,3.9133052378,-8,0.3010234798,-1.204093919,4.2143287176
29,205,2006,88,85,-118,256,1,3,-117,-117,6533,13.350527194,12.895395585,-17.90184328,-3,0.1517105363,0.4551316089,-17.75013275
29,205,2007,93,93,-46,256,2,0,-44,-41,6492,14.280230326,14.280230326,-7.063339731,3,0.3071017274,0,-6.756238004
29,205,2008,92,97,-83,256,1,-5,-82,-81,6411,14.260249554,15.035263117,-12.86522514,6,0.1550027125,-0.775013563,-12.71022243
29,207,2001,372,393,0,813,6,-21,6,-43,29650,12.537283252,13.245033113,0,-28,0.202214246,-0.707749861,0.202214246
29,207,2002,300,360,202,813,5,-60,207,125,29775,10.096760623,12.116112747,6.7984854859,-22,0.1682793437,-2.019352125,6.9667648296
29,207,2003,353,366,-120,813,4,-13,-116,-169,29606,11.889324868,12.327175359,-4.041696839,-40,0.134723228,-0.437850491,-3.906973611
29,207,2004,372,372,99,813,7,0,106,81,29687,12.547855565,12.547855565,3.3393486584,-25,0.2361155617,0,3.5754642201
29,207,2005,380,357,79,813,6,23,85,82,29769,12.782561895,12.008880517,2.6574273412,-26,0.2018299247,0.7736813778,2.8592572659
29,207,2006,375,365,-8,813,6,10,-2,-6,29763,12.598266479,12.262312706,-0.268763018,-14,0.2015722637,0.3359537728,-0.067190755
29,207,2007,366,364,-78,813,5,2,-73,-76,29687,12.312867956,12.245584525,-2.624053827,-5,0.1682085786,0.0672834315,-2.455845248
29,207,2008,376,349,-173,813,7,27,-166,-150,29537,12.697555045,11.785762529,-5.842226125,-11,0.2363906524,0.9117925165,-5.605835472
29,209,2001,322,304,160,261,12,18,172,164,28904,11.172021373,10.547498439,5.5513149677,-26,0.4163486226,0.6245229339,5.9676635903
29,209,2002,280,317,461,261,12,-37,473,424,29328,9.6167055914,10.887484545,15.833218849,-12,0.4121445253,-1.270778953,16.245363374
29,209,2003,289,298,588,261,4,-9,592,588,29916,9.7562622375,10.060090473,19.850111404,5,0.1350347715,-0.303828236,19.985146175
29,209,2004,312,334,455,261,8,-22,463,404,30320,10.359253602,11.089713792,15.107244837,-37,0.2656218872,-0.73046019,15.372866724
29,209,2005,290,304,181,261,6,-14,187,154,30474,9.5404151725,10.00098694,5.954534987,-19,0.1973879001,-0.460571767,6.1519228871
29,209,2006,278,295,705,261,8,-17,713,676,31150,9.0224587823,9.5741918733,22.880695833,-20,0.2596391016,-0.551733091,23.140334934
29,209,2007,340,351,367,261,3,-11,370,341,31491,10.85550997,11.206717645,11.717565173,-18,0.0957839115,-0.351207675,11.813349084
29,209,2008,315,343,135,261,5,-28,140,60,31551,9.9933377748,10.881634466,4.2828590464,-52,0.1586244091,-0.888296691,4.4414834555
29,211,2001,111,99,-12,151,25,12,13,17,7243,15.343147419,13.684428779,-1.65871864,-8,3.455663833,1.6587186399,1.7969451932
29,211,2002,105,89,-17,151,24,16,7,15,7258,14.481759879,12.275015516,-2.344665885,-8,3.3101165437,2.2067443625,0.9654506586
29,211,2003,82,89,-221,151,17,-7,-204,-208,7050,11.462119094,12.440592675,-30.89180878,3,2.3762929829,-0.978473581,-28.5155158
29,211,2004,90,83,-131,151,18,7,-113,-116,6934,12.871853547,11.870709382,-18.73569794,-10,2.5743707094,1.0011441648,-16.16132723
29,211,2005,112,113,-94,151,18,-1,-76,-80,6854,16.246011024,16.391064694,-13.63504497,-3,2.6109660574,-0.14505367,-11.02407891
29,211,2006,93,89,-109,151,18,4,-91,-91,6763,13.659396343,13.071895425,-16.00940001,-4,2.6437541309,0.587500918,-13.36564588
29,211,2007,113,58,-160,151,15,55,-145,-106,6657,16.840536513,8.6438152012,-23.84500745,-16,2.2354694486,8.1967213115,-21.609538
29,211,2008,96,73,-47,151,15,23,-32,-28,6629,14.451302123,10.989010989,-7.075116664,-19,2.2580159566,3.4622911335,-4.817100708
29,213,2001,562,442,179,1461,30,120,209,292,40231,14.02020706,11.026568542,4.4655107896,-37,0.7484096295,2.9936385181,5.2139204191
29,213,2002,551,423,540,1461,29,128,569,672,40903,13.582468509,10.427194518,13.31131215,-25,0.7148667636,3.1552739912,14.026178914
29,213,2003,551,443,476,1461,23,108,499,587,41490,13.374922627,10.753340696,11.55437962,-20,0.5582998556,2.6215819305,12.112679475
29,213,2004,603,437,499,1461,26,166,525,648,42138,14.421007318,10.451045105,11.933802076,-43,0.6218013106,3.9699622136,12.555603386
29,213,2005,563,426,812,1461,25,137,837,934,43072,13.214411454,9.9988264288,19.058795916,-40,0.5867855885,3.2155850252,19.645581505
29,213,2006,580,444,944,1461,27,136,971,1082,44154,13.298787059,10.180450783,21.644922386,-25,0.6190814665,3.1183362759,22.264003852
29,213,2007,671,422,1216,1461,23,249,1239,1523,45677,14.93916354,9.3954202892,27.073059412,35,0.5120726698,5.5437432512,27.585132081
29,213,2008,690,440,1036,1461,25,250,1061,1346,47023,14.886731392,9.4929881338,22.35167206,35,0.5393743258,5.3937432578,22.891046386
29,215,2001,269,269,1017,1412,5,0,1022,1024,24025,11.440479735,11.440479735,43.252668736,2,0.2126483222,0,43.465317059
29,215,2002,252,288,204,1609,-1,-36,203,151,24176,10.456214601,11.949959544,8.4645546773,-16,-0.041492915,-1.493744943,8.4230617622
29,215,2003,299,299,-149,1446,-15,0,-164,-191,23985,12.4166857,12.4166857,-6.187579162,-27,-0.622910654,0,-6.810489815
29,215,2004,289,311,353,1577,14,-22,367,318,24303,11.969847581,12.881047051,14.620609675,-27,0.5798542081,-0.91119947,15.200463883
29,215,2005,298,305,9,1554,4,-7,13,-17,24286,12.266150775,12.554281833,0.370454218,-23,0.1646463191,-0.288131058,0.5351005372
29,215,2006,294,282,252,1617,10,12,262,263,24549,12.040544691,11.549093888,10.320466878,-11,0.4095423364,0.4914508037,10.730009215
29,215,2007,300,287,-9,1612,4,13,-5,8,24557,12.218466175,11.688999308,-0.366553985,0,0.1629128823,0.5294668676,-0.203641103
29,215,2008,315,286,6,1612,7,29,13,41,24598,12.816600549,11.636659546,0.2441257247,-1,0.2848133455,1.1799410029,0.5289390703
29,217,2001,286,208,-61,1059,4,78,-57,2,20416,14.009306882,10.188586823,-2.98799902,-19,0.195934362,3.8207200588,-2.792064658
29,217,2002,241,259,-112,1062,3,-18,-109,-146,20270,11.846826918,12.731652165,-5.505579315,-19,0.1474708745,-0.884825247,-5.35810844
29,217,2003,287,264,-77,1062,0,23,-77,-77,20193,14.185799372,13.048958308,-3.805946173,-23,0,1.1368410647,-3.805946173
29,217,2004,264,233,11,1042,1,31,12,29,20222,13.064456266,11.530372386,0.5443523444,-14,0.0494865768,1.5340838797,0.5938389212
29,217,2005,301,245,-37,1039,1,56,-36,1,20223,14.884410928,12.115218198,-1.829645197,-19,0.0494498702,2.7691927309,-1.780195327
29,217,2006,287,241,-177,1038,1,46,-176,-138,20085,14.24034931,11.957923985,-8.782375707,-8,0.0496179418,2.282425325,-8.732757765
29,217,2007,289,248,-145,1033,0,41,-145,-97,19988,14.42367679,12.377411225,-7.236792853,7,0,2.0462655653,-7.236792853
29,217,2008,281,223,-46,1033,0,58,-46,21,20009,14.051053829,11.150836313,-2.300172513,9,0,2.9002175163,-2.300172513
29,219,2001,316,207,493,270,15,109,508,604,25324,12.62888658,8.2727200064,19.702661658,-13,0.5994724642,4.3561665734,20.302134122
29,219,2002,344,209,608,270,15,135,623,752,26076,13.385214008,8.1322957198,23.657587549,-6,0.5836575875,5.2529182879,24.241245136
29,219,2003,351,221,644,270,8,130,652,793,26869,13.259042402,8.3482859571,24.327131929,11,0.3022003966,4.9107564454,24.629332326
29,219,2004,368,259,631,270,7,109,638,709,27578,13.517732841,9.5138391463,23.178503866,-38,0.2571307877,4.0038936948,23.435634654
29,219,2005,406,225,843,270,8,181,851,1007,28585,14.457917134,8.0123925004,30.019763902,-25,0.2848850667,6.4455246337,30.304648968
29,219,2006,441,219,672,270,7,222,679,885,29470,15.19248988,7.5445698045,23.15046077,-16,0.241150633,7.6479200758,23.391611403
29,219,2007,503,231,650,270,6,272,656,944,30414,16.799145014,7.7149155033,21.708636698,16,0.2003874157,9.0842295104,21.909024113
29,219,2008,495,237,521,270,5,258,526,800,31214,16.064126696,7.6913091452,16.907899007,16,0.162263906,8.3728175505,17.070162913
29,221,2001,311,207,-43,1152,5,104,-38,44,23454,13.272447934,8.8340730625,-1.835097303,-22,0.2133834073,4.438374872,-1.621713896
29,221,2002,350,218,97,1248,4,132,101,212,23666,14.855687606,9.2529711375,4.117147708,-21,0.1697792869,5.6027164686,4.2869269949
29,221,2003,318,268,35,1248,4,50,39,55,23721,13.421402494,11.311119083,1.4771983877,-34,0.1688226729,2.1102834111,1.6460210606
29,221,2004,310,246,95,1245,5,64,100,146,23867,13.028494578,10.338740859,3.9926031773,-18,0.2101370093,2.6897537194,4.2027401866
29,221,2005,334,267,-104,1208,5,67,-99,-49,23818,14.008598092,11.198490091,-4.361958687,-17,0.2097095523,2.8101080004,-4.152249135
29,221,2006,364,231,139,1223,5,133,144,265,24083,15.198012568,9.644892591,5.8036366673,-12,0.2087639089,5.5531199766,6.0124005762
29,221,2007,369,265,100,1219,4,104,104,199,24282,15.258968262,10.958337641,4.1352217513,-9,0.1654088701,4.3006306213,4.3006306213
29,221,2008,358,255,162,1219,4,103,166,266,24548,14.663116936,10.444398935,6.6352652058,-3,0.1638337088,4.2187180012,6.7990989146
29,223,2001,176,162,-11,142,3,14,-8,-8,13248,13.281014187,12.224569876,-0.830063387,-14,0.2263809236,1.0564443103,-0.603682463
29,223,2002,177,206,-127,142,3,-29,-124,-168,13080,13.445761167,15.648738985,-9.647523549,-15,0.2278942571,-2.202977818,-9.419629292
29,223,2003,134,205,67,142,2,-71,69,-15,13065,10.250525913,15.681774718,5.1252629566,-13,0.1529929241,-5.431248805,5.2782558807
29,223,2004,151,220,-79,142,1,-69,-78,-155,12910,11.626564004,16.939364774,-6.082771896,-8,0.0769971126,-5.31280077,-6.005774783
29,223,2005,132,189,62,142,2,-57,64,-5,12905,10.226612435,14.642649622,4.8034088708,-12,0.1549486733,-4.416037188,4.9583575441
29,223,2006,148,177,-109,142,1,-29,-108,-142,12763,11.531868474,13.791491351,-8.493065295,-5,0.0779180302,-2.259622877,-8.415147265
29,223,2007,127,177,-74,142,2,-50,-72,-124,12639,9.9992126604,13.935910558,-5.826312889,-2,0.1574679159,-3.936697898,-5.668844973
29,223,2008,137,192,71,142,1,-55,72,13,12652,10.83389348,15.183266775,5.6146455261,-4,0.0790795145,-4.349373295,5.6937250405
29,225,2001,518,267,465,963,8,251,473,701,31962,16.386441643,8.4462932793,14.70983661,-23,0.2530724578,7.9401483637,14.962909068
29,225,2002,442,272,345,971,7,170,352,494,32456,13.722872489,8.4448446086,10.711291875,-28,0.2173305598,5.2780278804,10.928622435
29,225,2003,505,286,208,953,6,219,214,396,32852,15.465180376,8.7584981932,6.3698168678,-37,0.1837447173,6.7066821829,6.5535615851
29,225,2004,493,299,608,931,5,194,613,767,33619,14.833536429,8.9964044471,18.293691986,-40,0.1504415459,5.8371319824,18.444133532
29,225,2005,535,237,387,901,6,298,393,660,34279,15.758932516,6.981059825,11.399452119,-31,0.1767356918,8.7778726914,11.576187811
29,225,2006,551,311,475,934,5,240,480,701,34980,15.911289508,8.980782281,13.716628886,-19,0.1443855672,6.9305072265,13.861014453
29,225,2007,585,289,600,927,5,296,605,903,35883,16.510731976,8.1565838308,16.934084078,2,0.1411173673,8.354148145,17.075201445
29,225,2008,576,294,296,927,4,282,300,590,36473,15.921278125,8.1264857095,8.1817679253,8,0.1105644314,7.7947924153,8.2923323567
29,227,2001,14,40,-52,49,1,-26,-51,-80,2295,5.9957173448,17.130620985,-22.26980728,-3,0.4282655246,-11.13490364,-21.84154176
29,227,2002,26,27,-22,49,1,-1,-21,-25,2270,11.39101862,11.829134721,-9.638554217,-3,0.4381161008,-0.438116101,-9.200438116
29,227,2003,18,38,-31,49,1,-20,-30,-51,2219,8.0196034752,16.930274003,-13.81153932,-1,0.4455335264,-8.910670528,-13.36600579
29,227,2004,30,31,-37,49,0,-1,-37,-40,2179,13.642564802,14.097316962,-16.82582992,-2,0,-0.45475216,-16.82582992
29,227,2005,21,26,-54,49,1,-5,-53,-58,2121,9.7674418605,12.093023256,-25.11627907,0,0.4651162791,-2.325581395,-24.65116279
29,227,2006,13,31,-14,49,0,-18,-14,-33,2088,6.1772392492,14.730339748,-6.652411499,-1,0,-8.553100499,-6.652411499
29,227,2007,20,24,12,49,1,-4,13,5,2093,9.5670892131,11.480507056,5.7402535279,-4,0.4783544607,-1.913417843,6.2186079885
29,227,2008,21,22,-47,49,0,-1,-47,-54,2039,10.164569216,10.648596321,-22.74927396,-6,0,-0.484027106,-22.74927396
29,229,2001,262,202,-91,218,4,60,-87,-42,17907,14.614011602,11.267291388,-5.075858992,-15,0.2231146809,3.3467202142,-4.852744311
29,229,2002,257,227,78,218,4,30,82,97,18004,14.313163098,12.642365849,4.3440728468,-15,0.2227729665,1.6707972488,4.5668458133
29,229,2003,257,215,-49,218,3,42,-46,-26,17978,14.284920238,11.950419654,-2.723584014,-22,0.1667500417,2.3345005836,-2.556833973
29,229,2004,255,230,-87,218,4,25,-83,-73,17905,14.212858457,12.819440961,-4.849092885,-15,0.2229467993,1.3934174958,-4.626146086
29,229,2005,280,191,90,218,4,89,94,168,18073,15.565067541,10.617599644,5.003057424,-15,0.2223581077,4.947467897,5.2254155317
29,229,2006,275,230,35,218,4,45,39,73,18146,15.185399928,12.700516304,1.9326872636,-11,0.2208785444,2.4848836246,2.153565808
29,229,2007,285,218,46,218,4,67,50,110,18256,15.658480303,11.977363881,2.527333663,-7,0.2197681446,3.6811164222,2.7471018076
29,229,2008,272,222,141,218,4,50,145,187,18443,14.823292188,12.0984223,7.6841330826,-8,0.217989591,2.7248698875,7.9021226736
29,510,2001,5308,4156,-7757,10551,1733,1152,-6024,3091,349955,15.234946234,11.928492191,-22.26403126,7963,4.974031994,3.3064540433,-17.28999927
29,510,2002,5286,4110,-8621,10516,1629,1176,-6992,516,350471,15.093671566,11.735715122,-24.6164477,6332,4.6514549717,3.3579564437,-19.96499273
29,510,2003,5151,4051,-7261,10640,1437,1100,-5824,-2432,348039,14.74853617,11.598974961,-20.78996722,2292,4.1144722338,3.1495612089,-16.67549498
29,510,2004,5357,3866,-7241,10632,1313,1491,-5928,2666,350705,15.333226475,11.065569078,-20.72575936,7103,3.7581718054,4.2676573967,-16.96758756
29,510,2005,5064,3585,-9660,10646,1382,1479,-8278,1867,352572,14.401153457,10.195129373,-27.47139463,8666,3.9301726062,4.2060240844,-23.54122202
29,510,2006,5244,3418,-8223,10656,1379,1826,-6844,1265,353837,14.846922958,9.6771134003,-23.28113034,6283,3.904253768,5.1698095579,-19.37687657
29,510,2007,5419,3334,-6253,10603,1262,2085,-4991,1826,355663,15.275546159,9.3981677237,-17.62649753,4732,3.5574348132,5.8773784355,-14.06906272
29,510,2008,5316,3389,-4115,10603,1266,1927,-2849,-1302,354361,14.974141719,9.5461561863,-11.59115748,-380,3.5660766397,5.4279855329,-8.025080842
30,0,2001,10919,8189,-399,25011,377,2730,-22,2571,905854,12.070948745,9.052935184,-0.44109429,-137,0.4167733013,3.0180135612,-0.024320988
30,0,2002,10934,8361,1376,25405,184,2573,1560,4005,909859,12.043753611,9.2096052625,1.5156580363,-128,0.2026752025,2.8341483483,1.7183332388
30,0,2003,11197,8410,4566,25396,-260,2787,4306,6895,916754,12.25984924,9.2082997329,4.9994169537,-198,-0.284679897,3.0515495072,4.7147370571
30,0,2004,11445,8443,6102,25789,540,3002,6642,9215,925969,12.421834427,9.1636127622,6.6228076602,-429,0.5860891735,3.2582216644,7.2088968337
30,0,2005,11585,8445,5731,26235,282,3140,6013,8919,934888,12.451252299,9.0764631565,6.1595275725,-234,0.3030861587,3.3747891429,6.4626137312
30,0,2006,11933,8297,6568,26513,408,3636,6976,10540,945428,12.692547423,8.8251123747,6.98605979,-72,0.4339696094,3.8674350482,7.4200293993
30,0,2007,12559,7835,6308,26596,231,4724,6539,11196,956624,13.205737803,8.2384708725,6.6328365365,-67,0.2428955675,4.9672669307,6.8757321041
30,0,2008,12726,8242,5986,26596,313,4484,6299,10816,967440,13.228250204,8.5672825852,6.2222462454,33,0.3253530028,4.6609676185,6.5475992483
30,1,2001,98,94,-179,435,6,4,-173,-173,9018,10.763907958,10.324564776,-19.66060739,-4,0.6590147729,0.4393431819,-19.00159262
30,1,2002,101,70,-89,438,5,31,-84,-59,8959,11.236580075,7.7877287645,-9.901540858,-6,0.5562663403,3.44885131,-9.345274517
30,1,2003,75,90,-101,426,2,-15,-99,-119,8840,8.4274397438,10.112927693,-11.34895219,-5,0.2247317265,-1.685487949,-11.12422046
30,1,2004,87,75,-38,463,5,12,-33,-28,8812,9.8572399728,8.4976206662,-4.305461138,-7,0.5665080444,1.3596193066,-3.738953093
30,1,2005,82,78,-49,440,4,4,-45,-48,8764,9.3309057806,8.875739645,-5.575785162,-7,0.4551661356,0.4551661356,-5.120619026
30,1,2006,92,79,59,506,4,13,63,71,8835,10.455139497,8.9777828286,6.7049264163,-5,0.4545712825,1.477356668,7.1594976987
30,1,2007,97,60,-66,506,4,37,-62,-28,8807,10.996485659,6.8019498923,-7.482144882,-3,0.4534633262,4.1945357669,-7.028681555
30,1,2008,96,82,77,506,5,14,82,96,8903,10.84133258,9.2603049125,8.6956521739,0,0.5646527386,1.581027668,9.2603049125
30,3,2001,254,96,-1,216,4,158,3,147,12806,19.948949539,7.5397604555,-0.078539171,-14,0.3141566856,12.409189083,0.2356175142
30,3,2002,277,107,-201,216,4,170,-197,-33,12773,21.658391649,8.3662379296,-15.71601705,-6,0.3127565581,13.29215372,-15.40326049
30,3,2003,254,103,-185,216,-1,151,-186,-40,12733,19.916882302,8.0765310123,-14.50639065,-5,-0.078412922,11.84035129,-14.58480358
30,3,2004,267,98,-52,216,3,169,-49,109,12842,20.879765396,7.6637341153,-4.066471163,-11,0.2346041056,13.216031281,-3.831867058
30,3,2005,255,101,-223,216,1,154,-222,-78,12764,19.917206905,7.8887760681,-17.4177927,-10,0.0781066937,12.028430837,-17.33968601
30,3,2006,250,111,-219,216,2,139,-217,-83,12681,19.650225978,8.7247003341,-17.21359796,-5,0.1572018078,10.925525644,-17.05639615
30,3,2007,291,101,-107,216,1,190,-106,84,12765,22.871964159,7.9383793131,-8.409966203,0,0.078597815,14.933584846,-8.331368388
30,3,2008,274,96,-104,216,3,178,-101,76,12841,21.401234086,7.4982425994,-8.123096149,-1,0.2343200812,13.902991486,-7.888776068
30,5,2001,97,77,-237,66,1,20,-236,-220,6757,14.125527887,11.21304791,-34.51288772,-4,0.1456239988,2.9124799767,-34.36726373
30,5,2002,91,77,21,66,0,14,21,29,6786,13.438676807,11.371188068,3.1012331094,-6,0,2.0674887396,3.1012331094
30,5,2003,116,67,-119,66,0,49,-119,-71,6715,17.183912303,9.9251907266,-17.62832383,-1,0,7.2587215762,-17.62832383
30,5,2004,112,63,-166,66,1,49,-165,-124,6591,16.834510747,9.4694122952,-24.95114986,-8,0.1503081317,7.3650984518,-24.80084173
30,5,2005,135,58,-51,66,1,77,-50,22,6613,20.448348985,8.785216601,-7.724931839,-5,0.1514692517,11.663132384,-7.573462587
30,5,2006,115,60,-110,66,1,55,-109,-57,6556,17.465259321,9.112309211,-16.70590022,-3,0.1518718202,8.3529501101,-16.5540284
30,5,2007,122,52,-98,66,0,70,-98,-32,6524,18.654434251,7.9510703364,-14.98470948,-4,0,10.703363914,-14.98470948
30,5,2008,130,37,-121,66,1,93,-120,-33,6491,19.976949673,5.6857472148,-18.59393008,-6,0.1536688436,14.291202459,-18.44026124
30,7,2001,30,43,13,60,2,-13,15,-1,4365,6.8720650555,9.849959913,2.9778948574,-3,0.4581376704,-2.977894857,3.4360325278
30,7,2002,42,48,-12,60,1,-6,-11,-22,4343,9.6463022508,11.024345429,-2.756086357,-5,0.2296738631,-1.378043179,-2.526412494
30,7,2003,34,37,24,60,0,-3,24,18,4361,7.8125,8.5018382353,5.5147058824,-3,0,-0.689338235,5.5147058824
30,7,2004,38,45,88,60,1,-7,89,77,4438,8.6373451529,10.228435049,20.002272986,-5,0.2272985567,-1.591089897,20.229571542
30,7,2005,34,36,0,60,1,-2,1,-6,4432,7.6662908681,8.1172491545,0,-5,0.2254791432,-0.450958286,0.2254791432
30,7,2006,36,54,80,60,1,-18,81,59,4491,8.0690350779,12.103552617,17.931189062,-4,0.2241398633,-4.034517539,18.155328925
30,7,2007,44,53,94,60,1,-9,95,88,4579,9.7023153252,11.686879824,20.727673649,2,0.2205071665,-1.984564498,20.948180816
30,7,2008,45,39,117,60,2,6,119,125,4704,9.6951416568,8.4024561026,25.207368308,0,0.4308951847,1.2926855542,25.638263492
30,9,2001,76,85,83,101,5,-9,88,71,9635,7.9170790145,8.8546278452,8.6462836606,-8,0.5208604615,-0.937548831,9.1671441221
30,9,2002,97,108,31,101,5,-11,36,16,9651,10.059110235,11.199834077,3.2147671886,-9,0.5185108369,-1.140723841,3.7332780255
30,9,2003,68,99,31,101,5,-31,36,-5,9646,7.0477276261,10.260662279,3.2129346531,-10,0.5182152666,-3.212934653,3.7311499197
30,9,2004,96,77,-1,101,4,19,3,16,9662,9.9440646364,7.9759685105,-0.103584007,-6,0.4143360265,1.968096126,0.3107520199
30,9,2005,87,89,90,101,5,-2,95,84,9746,8.9653751031,9.1714756801,9.2745259687,-9,0.5152514427,-0.206100577,9.7897774114
30,9,2006,83,100,-42,101,4,-17,-38,-59,9687,8.5421705347,10.291771729,-4.322544126,-4,0.4116708691,-1.749601194,-3.910873257
30,9,2007,91,86,16,101,4,5,20,22,9709,9.3833780161,8.8678077954,1.6498247061,-3,0.4124561765,0.5155702207,2.0622808827
30,9,2008,88,99,-44,101,3,-11,-41,-52,9657,9.0880925333,10.2241041,-4.544046267,0,0.3098213364,-1.136011567,-4.23422493
30,11,2001,6,17,14,17,2,-11,16,5,1350,4.452690167,12.615955473,10.38961039,0,1.4842300557,-8.163265306,11.873840445
30,11,2002,7,13,-12,17,2,-6,-10,-17,1333,5.218039508,9.6906448006,-8.945210585,-1,1.4908684309,-4.472605293,-7.454342154
30,11,2003,9,25,-14,17,1,-16,-13,-29,1304,6.8259385666,18.960940463,-10.61812666,0,0.7584376185,-12.1350019,-9.859689041
30,11,2004,7,11,1,17,0,-4,1,-5,1299,5.3784095275,8.4517864003,0.7683442182,-2,0,-3.073376873,0.7683442182
30,11,2005,8,10,-25,17,1,-2,-24,-26,1273,6.2208398134,7.7760497667,-19.44012442,0,0.7776049767,-1.555209953,-18.66251944
30,11,2006,5,12,1,17,0,-7,1,-7,1266,3.9385584876,9.4525403702,0.7877116975,-1,0,-5.513981883,0.7877116975
30,11,2007,7,9,-3,17,1,-2,-2,-4,1262,5.5379746835,7.1202531646,-2.373417722,0,0.7911392405,-1.582278481,-1.582278481
30,11,2008,8,8,-28,17,0,0,-28,-28,1234,6.4102564103,6.4102564103,-22.43589744,0,0,0,-22.43589744
30,13,2001,1044,791,-529,2063,-6,253,-535,180,80380,13.002864616,9.8517872711,-6.588616266,462,-0.074729107,3.1510773446,-6.663345373
30,13,2002,1047,788,-245,2175,-161,259,-406,210,80590,13.008635149,9.7906442194,-3.044045474,357,-2.00037274,3.21799093,-5.044418215
30,13,2003,1124,761,227,2129,-460,363,-233,469,81059,13.906674338,9.4154618958,2.8085543369,339,-5.69134359,4.4912124418,-2.882789253
30,13,2004,1119,751,-353,2189,225,368,-128,631,81690,13.751236567,9.2289353544,-4.337968282,391,2.7649939477,4.5223012123,-1.572974335
30,13,2005,1138,785,-604,2290,-9,353,-613,101,81791,13.922107156,9.6035624935,-7.389237893,361,-0.110104538,4.3185446627,-7.499342431
30,13,2006,1146,782,-782,2201,113,364,-669,63,81854,14.005927465,9.5572733661,-9.557273366,368,1.381038223,4.4486540988,-8.176235143
30,13,2007,1177,670,-532,2192,-25,507,-557,-70,81784,14.385411701,8.1888070008,-6.502157201,-20,-0.3055525,6.1966047006,-6.807709701
30,13,2008,1177,742,-216,2192,32,435,-184,242,82026,14.370307063,9.0592759905,-2.637201636,-9,0.3906965387,5.3110310726,-2.246505097
30,15,2001,43,70,-199,199,2,-27,-197,-225,5750,7.3347547974,11.940298507,-33.9445629,-1,0.3411513859,-4.60554371,-33.60341151
30,15,2002,47,52,-148,199,2,-5,-146,-152,5598,8.2833979556,9.1646105041,-26.08389143,-1,0.3524850194,-0.881212548,-25.73140642
30,15,2003,48,61,-83,199,-1,-13,-84,-99,5499,8.6509867532,10.993962332,-14.95899793,-2,-0.180228891,-2.342975579,-15.13922682
30,15,2004,36,66,-72,199,2,-30,-70,-105,5394,6.6097493803,12.117873864,-13.21949876,-5,0.3672082989,-5.508124484,-12.85229046
30,15,2005,53,59,-76,199,0,-6,-76,-86,5308,9.904690712,11.025976453,-14.20295272,-4,0,-1.121285741,-14.20295272
30,15,2006,38,60,-26,199,1,-22,-25,-49,5259,7.1922021387,11.35610864,-4.920980411,-2,0.1892684773,-4.163906501,-4.731711933
30,15,2007,39,47,-5,199,0,-8,-5,-14,5245,7.4257425743,8.9489718203,-0.952018279,-1,0,-1.523229246,-0.952018279
30,15,2008,47,56,-17,199,2,-9,-15,-20,5225,8.9780324737,10.697230181,-3.247373448,4,0.3820439351,-1.719197708,-2.865329513
30,17,2001,140,136,-245,421,5,4,-240,-241,11426,12.124886329,11.778461005,-21.21855108,-5,0.4330316546,0.3464253237,-20.78551942
30,17,2002,135,153,5,421,5,-18,10,-21,11405,11.826026017,13.402829486,0.4380009636,-13,0.4380009636,-1.576803469,0.8760019272
30,17,2003,130,127,-126,421,3,3,-123,-127,11278,11.462328616,11.19781334,-11.10964158,-7,0.2645152758,0.2645152758,-10.84512631
30,17,2004,129,136,42,421,2,-7,44,27,11305,11.424522871,12.044458221,3.7196120976,-10,0.1771243856,-0.61993535,3.8967364832
30,17,2005,140,145,-127,421,3,-5,-124,-138,11167,12.45995016,12.90494838,-11.30295479,-9,0.266998932,-0.44499822,-11.03595586
30,17,2006,149,148,-80,421,2,1,-78,-83,11084,13.39265651,13.302772909,-7.190688059,-6,0.1797672015,0.0898836007,-7.010920857
30,17,2007,148,137,65,421,3,11,68,81,11165,13.303968718,12.315160232,5.8429592341,2,0.2696750416,0.9888084858,6.1126342757
30,17,2008,133,142,-14,421,2,-9,-12,-16,11149,11.920767231,12.727435691,-1.254817603,5,0.1792596576,-0.806668459,-1.075557946
30,19,2001,12,16,-3,37,1,-4,-2,-9,2003,5.9775840598,7.9701120797,-1.494396015,-3,0.498132005,-1.99252802,-0.99626401
30,19,2002,17,31,-80,37,1,-14,-79,-92,1911,8.6867654573,15.840572305,-40.87889627,1,0.5109862034,-7.153806847,-40.36791007
30,19,2003,12,32,-16,37,1,-20,-15,-36,1875,6.3391442155,16.904384575,-8.452192287,-1,0.528262018,-10.56524036,-7.923930269
30,19,2004,13,40,-53,37,1,-27,-52,-82,1793,7.0883315158,21.810250818,-28.89858233,-3,0.5452562704,-14.7219193,-28.35332606
30,19,2005,14,26,-17,37,1,-12,-16,-28,1765,7.8695896571,14.61495222,-9.555930298,0,0.5621135469,-6.745362563,-8.993816751
30,19,2006,10,19,-55,37,1,-9,-54,-64,1701,5.7703404501,10.963646855,-31.73687248,-1,0.577034045,-5.193306405,-31.15983843
30,19,2007,11,14,-51,37,1,-3,-50,-56,1645,6.5750149432,8.3682008368,-30.48416019,-3,0.5977286312,-1.793185894,-29.88643156
30,19,2008,12,20,9,37,1,-8,10,-2,1643,7.299270073,12.165450122,5.4744525547,-4,0.6082725061,-4.866180049,6.0827250608
30,21,2001,101,100,-131,482,2,1,-129,-133,8903,11.260382407,11.148893472,-14.60505045,-5,0.2229778694,0.1114889347,-14.38207258
30,21,2002,82,108,-183,484,2,-26,-181,-209,8694,9.3197704154,12.274819572,-20.79899983,-2,0.2273114735,-2.955049156,-20.57168836
30,21,2003,81,108,-8,483,2,-27,-6,-45,8649,9.3409444733,12.454592631,-0.922562417,-12,0.2306406043,-3.113648158,-0.691921813
30,21,2004,79,109,-54,486,1,-30,-53,-91,8558,9.1823095252,12.669262509,-6.276515372,-8,0.1162317661,-3.486952984,-6.160283606
30,21,2005,99,109,0,487,2,-10,2,-14,8544,11.577593264,12.747047129,0,-6,0.233890773,-1.169453865,0.233890773
30,21,2006,100,103,6,490,1,-3,7,-1,8543,11.704804822,12.055948967,0.7022882893,-5,0.1170480482,-0.351144145,0.8193363376
30,21,2007,103,85,-1,490,2,18,1,11,8554,12.048897467,9.9432649003,-0.116979587,-8,0.2339591741,2.1056325671,0.1169795871
30,21,2008,106,104,-62,490,1,2,-61,-64,8490,12.438394743,12.20370805,-7.275287491,-5,0.1173433466,0.2346866933,-7.157944145
30,23,2001,86,129,-111,386,-1,-43,-112,-164,9221,9.2443297861,13.866494679,-11.93163496,-9,-0.107492207,-4.622164893,-12.03912716
30,23,2002,90,142,-68,375,-1,-52,-69,-127,9094,9.828009828,15.506415506,-7.425607426,-6,-0.109200109,-5.678405678,-7.534807535
30,23,2003,67,115,-54,388,-3,-48,-57,-113,8981,7.4135546335,12.724757953,-5.975103734,-8,-0.331950207,-5.31120332,-6.307053942
30,23,2004,85,135,78,395,1,-50,79,21,9002,9.4533726297,15.014180059,8.6748595896,-8,0.1112161486,-5.560807429,8.7860757382
30,23,2005,82,131,48,447,-1,-49,47,-12,8990,9.1151622944,14.562027568,5.3357047577,-10,-0.111160516,-5.446865273,5.2245442419
30,23,2006,68,125,-101,434,0,-57,-101,-162,8828,7.6327309462,14.030755416,-11.33685038,-4,0,-6.39802447,-11.33685038
30,23,2007,71,86,32,437,-1,-15,31,10,8838,8.0380391713,9.736216461,3.622778218,-6,-0.113211819,-1.69817729,3.5095663987
30,23,2008,79,117,45,437,1,-38,46,5,8843,8.9361461456,13.234545557,5.0902098298,-3,0.113115774,-4.298399412,5.2033256038
30,25,2001,19,27,-84,46,0,-8,-84,-92,2719,6.8716094033,9.7649186257,-30.37974684,0,0,-2.893309222,-30.37974684
30,25,2002,26,36,-17,46,-1,-10,-18,-31,2688,9.6171629369,13.316071759,-6.288144997,-3,-0.369890882,-3.698908822,-6.658035879
30,25,2003,28,30,31,46,-1,-2,30,26,2714,10.366530914,11.106997408,11.477230655,-2,-0.370233247,-0.740466494,11.106997408
30,25,2004,30,24,-16,46,0,6,-16,-11,2703,11.076241462,8.8609931697,-5.90732878,-1,0,2.2152482924,-5.90732878
30,25,2005,33,26,-82,46,0,7,-82,-78,2625,12.387387387,9.7597597598,-30.78078078,-3,0,2.6276276276,-30.78078078
30,25,2006,33,26,6,46,0,7,6,12,2637,12.542759407,9.8821740783,2.2805017104,-1,0,2.6605853288,2.2805017104
30,25,2007,54,36,34,46,0,18,34,53,2690,20.274075465,13.51605031,12.765158626,1,0,6.7580251549,12.765158626
30,25,2008,41,33,18,46,0,8,18,26,2716,15.168331484,12.208657048,6.6592674806,0,0,2.9596744358,6.6592674806
30,27,2001,98,178,-118,557,1,-80,-117,-205,11675,8.3209509658,15.113563999,-10.01910422,-8,0.0849076629,-6.792613033,-9.934196561
30,27,2002,103,144,-57,557,0,-41,-57,-107,11568,8.8628834488,12.390827346,-4.904702491,-9,0,-3.527943897,-4.904702491
30,27,2003,110,173,-71,557,-1,-63,-72,-146,11422,9.5693779904,15.050021749,-6.176598521,-11,-0.086994345,-5.480643758,-6.263592866
30,27,2004,102,146,-7,557,0,-44,-7,-60,11362,8.9536516854,12.816011236,-0.614466292,-9,0,-3.862359551,-0.614466292
30,27,2005,81,137,-78,557,0,-56,-78,-143,11219,7.1741729773,12.134095036,-6.908462867,-9,0,-4.959922058,-6.908462867
30,27,2006,111,155,49,557,0,-44,49,0,11219,9.8939299403,13.815848115,4.3675906944,-5,0,-3.921918175,4.3675906944
30,27,2007,97,133,-16,557,0,-36,-16,-54,11165,8.6669049321,11.883488206,-1.429592566,-2,0,-3.216583274,-1.429592566
30,27,2008,100,157,86,557,1,-57,87,30,11195,8.9445438283,14.04293381,7.6923076923,0,0.0894454383,-5.098389982,7.7817531306
30,29,2001,964,673,1014,1145,33,291,1047,1277,75987,12.793884417,8.9318300962,13.457467634,-61,0.437964923,3.8620543209,13.895432557
30,29,2002,975,659,986,1145,31,316,1017,1282,77269,12.72380853,8.59998956,12.86735919,-51,0.4045518609,4.1238189696,13.271911051
30,29,2003,995,703,1560,1145,25,292,1585,1883,79152,12.722076959,8.9885629167,19.946170911,6,0.3196501748,3.7335140422,20.265821085
30,29,2004,992,779,1319,1145,33,213,1352,1474,80626,12.417228905,9.7510295535,16.510408191,-91,0.413073139,2.6661993516,16.92348133
30,29,2005,1083,726,1597,1145,30,357,1627,1904,82530,13.27563804,8.8994581873,19.576356371,-80,0.3677462061,4.3761798524,19.944102577
30,29,2006,1111,697,1616,1145,32,414,1648,2019,84549,13.299098031,8.343358531,19.344142591,-43,0.3830523285,4.9557395005,19.72719492
30,29,2007,1206,723,1674,1145,28,483,1702,2217,86766,14.079327555,8.4405918921,19.542947203,32,0.3268832268,5.6387356624,19.869830429
30,29,2008,1228,738,1172,1145,30,490,1202,1707,88473,14.015145031,8.4227825998,13.376017896,15,0.3423895366,5.5923624307,13.718407432
30,31,2001,812,339,1292,3000,87,473,1379,1812,70170,11.723261723,4.8943173943,18.653268653,-40,1.2560637561,6.8289443289,19.909332409
30,31,2002,857,348,1236,3160,86,509,1322,1797,71967,12.058788352,4.896684185,17.391671416,-34,1.2101001147,7.1621041671,18.60177153
30,31,2003,996,385,2002,3149,70,611,2072,2722,74689,13.582806022,5.250381846,27.301985599,39,0.9546148811,8.3324241763,28.25660048
30,31,2004,1021,391,2134,3173,72,630,2206,2719,77408,13.425642846,5.1414557815,28.061039994,-117,0.946764236,8.2841870648,29.00780423
30,31,2005,979,361,2637,3230,72,618,2709,3263,80671,12.386211957,4.5673365849,33.363065303,-64,0.9109369366,7.8188753724,34.274002239
30,31,2006,1166,393,2906,3290,71,773,2977,3699,84370,14.129822287,4.7624529662,35.215491908,-51,0.8603922662,9.3673693204,36.075884174
30,31,2007,1244,431,1993,3290,65,813,2058,2873,87243,14.497736185,5.0229294983,23.226678632,2,0.7575183698,9.4748066871,23.984197001
30,31,2008,1300,418,1639,3290,67,882,1706,2581,89824,14.683707297,4.721376654,18.512766354,-7,0.7567756838,9.9623306432,19.269542038
30,33,2001,16,13,-7,12,1,3,-6,-5,1262,12.653222618,10.280743377,-5.535784895,-2,0.7908264136,2.3724792408,-4.744958482
30,33,2002,17,13,-22,12,1,4,-21,-17,1245,13.562026326,10.370961308,-17.5508576,0,0.7977662545,3.1910650179,-16.75309134
30,33,2003,18,20,-8,12,1,-2,-7,-11,1234,14.521984671,16.135538524,-6.454215409,-2,0.8067769262,-1.613553852,-5.647438483
30,33,2004,16,9,-28,12,0,7,-28,-23,1211,13.08793456,7.3619631902,-22.90388548,-2,0,5.7259713701,-22.90388548
30,33,2005,15,15,-39,12,1,0,-38,-38,1173,12.583892617,12.583892617,-32.71812081,0,0.8389261745,0,-31.87919463
30,33,2006,17,6,18,12,0,11,18,28,1201,14.321819714,5.0547598989,15.164279697,-1,0,9.2670598147,15.164279697
30,33,2007,15,10,-2,12,1,5,-1,4,1205,12.46882793,8.3125519534,-1.662510391,0,0.8312551953,4.1562759767,-0.831255195
30,33,2008,14,8,-27,12,0,6,-27,-21,1184,11.720385098,6.6973629134,-22.60359983,0,0,5.023022185,-22.60359983
30,35,2001,238,106,-189,186,7,132,-182,-59,13138,18.074805392,8.0501234099,-14.35352193,-9,0.5316119233,10.024681982,-13.82191001
30,35,2002,252,115,-108,186,7,137,-101,26,13164,19.162040909,8.7445821611,-8.212303247,-10,0.5322789142,10.417458748,-7.680024333
30,35,2003,275,92,-85,186,7,183,-78,90,13254,20.819138466,6.9649481414,-6.435006435,-15,0.5299417064,13.854190325,-5.905064729
30,35,2004,274,107,97,186,6,167,103,257,13511,20.47450028,7.9955165328,7.248271997,-13,0.4483467215,12.478983747,7.6966187185
30,35,2005,256,135,-221,186,7,121,-214,-101,13410,19.018610007,10.029345121,-16.41840942,-8,0.5200401174,8.9892648861,-15.8983693
30,35,2006,263,122,-154,186,6,141,-148,-14,13396,19.622472581,9.1024397523,-11.48996493,-7,0.4476609714,10.520032828,-11.04230396
30,35,2007,240,94,-200,186,5,146,-195,-62,13334,17.957351291,7.0332959222,-14.96445941,-13,0.3741114852,10.924055368,-14.59034792
30,35,2008,273,127,-171,186,4,146,-167,-37,13297,20.502421989,9.5377567497,-12.84217641,-16,0.3004017874,10.96466524,-12.54177462
30,37,2001,16,6,-16,162,1,10,-15,-8,1015,15.701668302,5.8881256133,-15.7016683,-3,0.9813542689,9.8135426889,-14.72031403
30,37,2002,9,6,35,162,1,3,36,39,1054,8.6998550024,5.7999033349,33.832769454,0,0.9666505558,2.8999516675,34.79942001
30,37,2003,9,5,-20,162,1,4,-19,-14,1040,8.5959885387,4.7755491882,-19.10219675,1,0.9551098376,3.8204393505,-18.14708691
30,37,2004,10,9,44,162,0,1,44,41,1081,9.42951438,8.486562942,41.489863272,-4,0,0.942951438,41.489863272
30,37,2005,10,10,32,162,1,0,33,32,1113,9.1157702826,9.1157702826,29.170464904,-1,0.9115770283,0,30.082041933
30,37,2006,6,6,-12,162,0,0,-12,-11,1102,5.4176072235,5.4176072235,-10.83521445,1,0,0,-10.83521445
30,37,2007,6,5,14,162,1,1,15,16,1118,5.4054054054,4.5045045045,12.612612613,0,0.9009009009,0.9009009009,13.513513514
30,37,2008,8,8,-36,162,0,0,-36,-37,1081,7.2760345612,7.2760345612,-32.74215553,-1,0,0,-32.74215553
30,39,2001,23,31,45,32,1,-8,46,36,2879,8.0391471513,10.835372247,15.728766166,-2,0.349528137,-2.796225096,16.078294303
30,39,2002,12,28,12,32,1,-16,13,-6,2873,4.1724617524,9.735744089,4.1724617524,-3,0.347705146,-5.563282337,4.5201668985
30,39,2003,19,32,5,32,1,-13,6,-11,2862,6.6259808195,11.159546643,1.743679163,-4,0.3487358326,-4.533565824,2.0924149956
30,39,2004,30,15,-22,32,0,15,-22,-10,2852,10.500525026,5.2502625131,-7.700385019,-3,0,5.2502625131,-7.700385019
30,39,2005,23,25,46,32,1,-2,47,44,2896,8.0027835769,8.698677801,16.005567154,-1,0.347947112,-0.695894224,16.353514266
30,39,2006,24,30,-12,32,0,-6,-12,-20,2876,8.316008316,10.395010395,-4.158004158,-2,0,-2.079002079,-4.158004158
30,39,2007,23,8,-44,32,1,15,-43,-35,2841,8.0461780654,2.7986706315,-15.39268847,-7,0.3498338289,5.247507434,-15.04285464
30,39,2008,25,11,-24,32,0,14,-24,-20,2821,8.8308018368,3.8855528082,-8.477569763,-10,0,4.9452490286,-8.477569763
30,41,2001,273,150,-275,345,1,123,-274,-161,16467,16.497960417,9.0648134159,-16.6188246,-10,0.0604320894,7.4331470011,-16.55839251
30,41,2002,266,150,-280,370,1,116,-279,-170,16297,16.237333659,9.156391161,-17.09193017,-7,0.0610426077,7.0809424979,-17.03088756
30,41,2003,226,143,-160,393,-2,83,-162,-95,16202,13.90812025,8.8002707776,-9.846456814,-16,-0.12308071,5.1078494723,-9.969537524
30,41,2004,252,137,-90,354,1,115,-89,13,16215,15.54739797,8.4523552457,-5.552642132,-13,0.0616960237,7.0950427245,-5.490946109
30,41,2005,276,154,-112,433,0,122,-112,-4,16211,17.023376303,9.4985505459,-6.908036761,-14,0,7.5248257571,-6.908036761
30,41,2006,294,152,87,471,0,142,87,220,16431,18.013602108,9.3131548312,5.3305557258,-9,0,8.7004472765,5.3305557258
30,41,2007,267,135,-19,471,-1,132,-20,105,16536,16.198016198,8.19000819,-1.152667819,-7,-0.060666727,8.008008008,-1.213334547
30,41,2008,281,130,-229,471,1,151,-228,-82,16454,17.035465293,7.881176114,-13.88299485,-5,0.0606244316,9.1542891785,-13.82237042
30,43,2001,87,95,61,221,0,-8,61,43,10120,8.6151408625,9.4073377234,6.0405010645,-10,0,-0.792196861,6.0405010645
30,43,2002,90,91,114,221,-1,-1,113,106,10226,8.846947803,8.945247223,11.206133884,-6,-0.09829942,-0.09829942,11.107834464
30,43,2003,87,79,90,221,-3,8,87,86,10312,8.4721004966,7.6930567728,8.7642418931,-9,-0.292141396,0.7790437238,8.4721004966
30,43,2004,105,78,245,221,3,27,248,262,10574,10.054582017,7.4691180695,23.460691372,-13,0.2872737719,2.5854639471,23.747965144
30,43,2005,97,87,206,221,0,10,206,205,10779,9.0853744205,8.1487378823,19.294712687,-11,0,0.9366365382,19.294712687
30,43,2006,106,82,57,221,2,24,59,78,10857,9.7984840081,7.579959327,5.2689961176,-5,0.1848770568,2.2185246811,5.4538731743
30,43,2007,107,67,193,221,-1,40,192,233,11090,9.7507632023,6.1056180799,17.587825215,1,-0.091128628,3.6451451223,17.496696587
30,43,2008,102,80,139,221,1,22,140,165,11255,9.1295591855,7.1604385769,12.441262027,3,0.0895054822,1.9691206086,12.53076751
30,45,2001,15,21,-61,0,1,-6,-60,-69,2263,6.528835691,9.1403699674,-26.55059848,-3,0.4352557127,-2.611534276,-26.11534276
30,45,2002,20,19,-27,0,1,1,-26,-25,2238,8.8869140191,8.4425683182,-11.99733393,0,0.444345701,0.444345701,-11.55298822
30,45,2003,18,24,-48,0,1,-6,-47,-54,2184,8.1411126187,10.854816825,-21.70963365,-1,0.4522840344,-2.713704206,-21.25734962
30,45,2004,12,20,1,0,0,-8,1,-8,2176,5.504587156,9.1743119266,0.4587155963,-1,0,-3.669724771,0.4587155963
30,45,2005,9,14,-36,0,1,-5,-35,-41,2135,4.1753653445,6.4950127581,-16.70146138,-1,0.4639294827,-2.319647414,-16.2375319
30,45,2006,14,17,-9,0,0,-3,-9,-14,2121,6.5789473684,7.9887218045,-4.229323308,-2,0,-1.409774436,-4.229323308
30,45,2007,15,16,-82,0,1,-1,-81,-81,2040,7.2098053353,7.6904590243,-39.4136025,1,0.480653689,-0.480653689,-38.93294881
30,45,2008,12,11,-24,0,0,1,-24,-26,2014,5.9200789344,5.4267390232,-11.84015787,-3,0,0.4933399112,-11.84015787
30,47,2001,370,251,115,616,10,119,125,219,26843,13.840312716,9.3889688967,4.3017188172,-25,0.3740625058,4.4513438196,4.6757813231
30,47,2002,338,251,-75,616,10,87,-65,-8,26835,12.593613771,9.3520622974,-2.794440926,-30,0.3725921234,3.2415514736,-2.421848802
30,47,2003,384,253,162,616,9,131,171,271,27106,14.237778313,9.3806195658,6.0065627259,-31,0.3336979292,4.8571587475,6.3402606552
30,47,2004,383,262,404,616,6,121,410,500,27606,14.000584881,9.5774235999,14.768240971,-31,0.2193303114,4.4231612809,14.987571282
30,47,2005,356,259,282,616,8,97,290,363,27969,12.811515969,9.3207377418,10.148448043,-24,0.2878992353,3.4907782276,10.436347278
30,47,2006,404,250,227,616,7,154,234,374,28343,14.348629067,8.8791021452,8.0622247478,-14,0.2486148601,5.4695269214,8.3108396079
30,47,2007,454,263,-151,616,7,191,-144,52,28395,16.003383975,9.2706827875,-5.32271141,5,0.2467482111,6.7327011879,-5.075963199
30,47,2008,415,245,99,616,6,170,105,295,28690,14.539721468,8.5836909871,3.4685118683,20,0.2102128405,5.9560304809,3.6787247088
30,49,2001,675,452,120,1299,25,223,145,310,56191,12.045827682,8.0662431294,2.1414804768,-58,0.446141766,3.9795845528,2.5876222428
30,49,2002,653,478,-207,1233,17,175,-190,-64,56127,11.627699923,8.5115475703,-3.685963069,-49,0.3027119429,3.1161523531,-3.383251126
30,49,2003,663,474,599,1398,-4,189,595,739,56866,11.735240236,8.3899002593,10.602426699,-45,-0.070800846,3.3453399768,10.531625853
30,49,2004,662,494,697,1447,32,168,729,841,57707,11.555951228,8.6233231215,12.166915416,-56,0.5585958297,2.9326281061,12.725511246
30,49,2005,691,490,218,1382,20,201,238,388,58095,11.934163486,8.4627208511,3.7650472358,-51,0.3454171776,3.4714426348,4.1104644134
30,49,2006,684,501,624,1372,26,183,650,803,58898,11.693007274,8.564614977,10.667304881,-30,0.4444710367,3.128392297,11.111775918
30,49,2007,796,471,671,1372,19,325,690,1031,59929,13.397628485,7.9274912267,11.29372954,16,0.3197926397,5.4701372584,11.613522179
30,49,2008,744,499,698,1372,23,245,721,996,60925,12.312376918,8.2578979595,11.551127807,30,0.3806245552,4.0544789581,11.931752362
30,51,2001,22,23,-63,64,1,-1,-62,-64,2089,10.372465818,10.843941537,-29.7029703,-1,0.471475719,-0.471475719,-29.23149458
30,51,2002,17,20,-82,64,1,-3,-81,-83,2006,8.3028083028,9.768009768,-40.04884005,1,0.4884004884,-1.465201465,-39.56043956
30,51,2003,15,24,13,64,1,-9,14,3,2009,7.4719800747,11.95516812,6.4757160648,-2,0.498132005,-4.483188045,6.9738480697
30,51,2004,13,20,-4,64,0,-7,-4,-12,1997,6.4902646031,9.9850224663,-1.997004493,-1,0,-3.494757863,-1.997004493
30,51,2005,16,20,-56,64,1,-4,-55,-59,1938,8.1321473952,10.165184244,-28.46251588,0,0.5082592122,-2.033036849,-27.95425667
30,51,2006,12,25,-82,64,0,-13,-82,-96,1842,6.3492063492,13.227513228,-43.38624339,-1,0,-6.878306878,-43.38624339
30,51,2007,12,21,-35,64,1,-9,-34,-45,1797,6.5952184666,11.541632317,-19.23605386,-2,0.5496015389,-4.94641385,-18.68645232
30,51,2008,14,19,-61,64,0,-5,-61,-72,1725,7.950028393,10.789324248,-34.63940943,-6,0,-2.839295855,-34.63940943
30,53,2001,188,186,-258,191,4,2,-254,-264,18548,10.064239829,9.9571734475,-13.81156317,-12,0.2141327623,0.1070663812,-13.59743041
30,53,2002,184,186,-54,191,3,-2,-51,-68,18480,9.9384249757,10.046451334,-2.916711678,-15,0.1620395376,-0.108026358,-2.75467214
30,53,2003,202,188,97,191,2,14,99,89,18569,10.904477854,10.148721963,5.2363086723,-24,0.1079651273,0.7557558908,5.3442737996
30,53,2004,156,208,95,191,5,-52,100,33,18602,8.3936402034,11.191520271,5.1115116623,-15,0.2690269296,-2.797880068,5.3805385919
30,53,2005,161,195,132,191,4,-34,136,85,18687,8.6352543646,10.458848454,7.0798358765,-17,0.2145404811,-1.823594089,7.2943763576
30,53,2006,176,199,-22,191,4,-23,-18,-50,18637,9.4309291609,10.663380131,-1.178866145,-9,0.2143392991,-1.23245097,-0.964526846
30,53,2007,173,217,246,191,2,-44,248,211,18848,9.2303588102,11.577964519,13.1252501,7,0.1067093504,-2.347605709,13.23195945
30,53,2008,179,215,138,191,4,-36,142,123,18971,9.4661413575,11.369946323,7.2979190354,17,0.2115338851,-1.903804966,7.5094529205
30,55,2001,20,21,-93,0,2,-1,-91,-92,1873,10.422094841,10.943199583,-48.46274101,0,1.0422094841,-0.521104742,-47.42053153
30,55,2002,15,17,-53,0,2,-2,-51,-54,1819,8.1256771398,9.2091007584,-28.71072589,-1,1.0834236186,-1.083423619,-27.62730228
30,55,2003,10,19,-31,0,1,-9,-30,-39,1780,5.5570991942,10.558488469,-17.2270075,0,0.5557099194,-5.001389275,-16.67129758
30,55,2004,11,11,-20,0,0,0,-20,-23,1757,6.2199604184,6.2199604184,-11.30901894,-3,0,0,-11.30901894
30,55,2005,13,19,-6,0,1,-6,-5,-11,1746,7.4222095347,10.847844705,-3.42563517,0,0.570939195,-3.42563517,-2.854695975
30,55,2006,16,17,-24,0,0,-1,-24,-26,1720,9.2325447201,9.8095787651,-13.84881708,-1,0,-0.577034045,-13.84881708
30,55,2007,16,12,-5,0,1,4,-4,-4,1716,9.3131548312,6.9848661234,-2.910360885,-4,0.5820721769,2.3282887078,-2.328288708
30,55,2008,14,14,-38,0,0,0,-38,-40,1676,8.2547169811,8.2547169811,-22.40566038,-2,0,0,-22.40566038
30,57,2001,43,82,7,74,0,-39,7,-39,6834,6.2741664843,11.964689575,1.0213759393,-7,0,-5.69052309,1.0213759393
30,57,2002,60,78,78,74,-1,-18,77,55,6889,8.7444436348,11.367776725,11.367776725,-4,-0.145740727,-2.62333309,11.222035998
30,57,2003,48,72,-32,74,-2,-24,-34,-66,6823,7.0011668611,10.501750292,-4.667444574,-8,-0.291715286,-3.500583431,-4.95915986
30,57,2004,42,76,121,74,1,-34,122,79,6902,6.1202185792,11.074681239,17.632058288,-9,0.14571949,-4.954462659,17.777777778
30,57,2005,54,59,197,74,0,-5,197,186,7088,7.719799857,8.4345961401,28.162973553,-6,0,-0.714796283,28.162973553
30,57,2006,54,63,108,74,1,-9,109,97,7185,7.5667343936,8.8278567925,15.133468787,-3,0.140124711,-1.261122399,15.273593498
30,57,2007,50,67,234,74,-1,-17,233,220,7405,6.8540095956,9.1843728581,32.076764907,4,-0.137080192,-2.330363263,31.939684716
30,57,2008,54,75,127,74,1,-21,128,104,7509,7.2415180367,10.05766394,17.030977605,-3,0.1341021859,-2.816145903,17.165079791
30,59,2001,16,21,-4,26,3,-5,-1,-8,1921,8.3116883117,10.909090909,-2.077922078,-2,1.5584415584,-2.597402597,-0.519480519
30,59,2002,21,17,-16,26,3,4,-13,-11,1910,10.963194988,8.8749673714,-8.352910467,-2,1.5661707126,2.0882276168,-6.786739755
30,59,2003,24,28,19,26,1,-4,20,16,1926,12.513034411,14.598540146,9.9061522419,0,0.5213764338,-2.085505735,10.427528676
30,59,2004,20,24,30,26,0,-4,30,24,1950,10.319917441,12.383900929,15.479876161,-2,0,-2.063983488,15.479876161
30,59,2005,19,30,-30,26,1,-11,-29,-42,1908,9.8496630378,15.552099533,-15.55209953,-2,0.5184033178,-5.702436496,-15.03369622
30,59,2006,23,18,2,26,0,5,2,5,1913,12.038733316,9.4216173776,1.0468463753,-2,0,2.6171159382,1.0468463753
30,59,2007,25,17,-27,26,1,8,-26,-19,1894,13.133701077,8.9309167323,-14.18439716,-1,0.5253480431,4.2027843446,-13.65904912
30,59,2008,23,14,-31,26,0,9,-31,-26,1868,12.227538543,7.4428495481,-16.48059543,-4,0,4.7846889952,-16.48059543
30,61,2001,41,34,-79,63,2,7,-77,-73,3815,10.645203168,8.8277294561,-20.51148903,-3,0.5192782033,1.8174737115,-19.99221083
30,61,2002,31,29,-36,63,2,2,-34,-34,3781,8.1621906266,7.635597683,-9.478672986,-2,0.5265929437,0.5265929437,-8.952080042
30,61,2003,38,54,72,63,0,-16,72,56,3837,9.9763717511,14.176949331,18.902599107,0,0,-4.200577579,18.902599107
30,61,2004,56,46,1,63,1,10,2,9,3846,14.577638943,11.974489132,0.2603149811,-3,0.2603149811,2.6031498113,0.5206299623
30,61,2005,42,33,91,63,1,9,92,98,3944,10.783055199,8.4724005135,23.363286264,-3,0.2567394095,2.3106546855,23.620025674
30,61,2006,48,46,10,63,1,2,11,11,3955,12.153437144,11.64704393,2.5319660717,-2,0.2531966072,0.5063932143,2.7851626788
30,61,2007,46,33,-95,63,0,13,-95,-83,3872,11.754184234,8.4323495592,-24.2749457,-1,0,3.3218346748,-24.2749457
30,61,2008,43,46,-7,63,0,-3,-7,-10,3862,11.119731058,11.895526248,-1.810188777,0,0,-0.77579519,-1.810188777
30,63,2001,1116,658,771,3746,83,458,854,1231,97398,11.531010255,6.798749774,7.9663162245,-81,0.8575930566,4.732260481,8.8239092811
30,63,2002,1127,666,1054,3850,78,461,1132,1527,98925,11.481079649,6.784737397,10.737407232,-66,0.7946088843,4.6963422523,11.532016116
30,63,2003,1093,694,579,3813,56,399,635,929,99854,10.997137525,6.9826289497,5.8255650748,-105,0.5634398,4.0145085748,6.3890048748
30,63,2004,1196,711,479,3849,65,485,544,956,100810,11.920424192,7.0864729099,4.7741498226,-73,0.6478491409,4.8339512817,5.4219989634
30,63,2005,1172,693,877,3824,63,479,940,1330,102140,11.549642769,6.8292682927,8.6425227889,-89,0.6208425721,4.7203744765,9.2633653609
30,63,2006,1220,666,1264,3875,67,554,1331,1833,103973,11.838166443,6.4624744679,12.265116708,-52,0.6501288128,5.3756919748,12.915245521
30,63,2007,1303,704,1003,3928,60,599,1063,1665,105638,12.432553635,6.7172047269,9.570108439,3,0.5724890392,5.7153489082,10.142597478
30,63,2008,1367,698,919,3928,62,669,981,1682,107320,12.83821223,6.5552832014,8.630809831,32,0.5822744391,6.2829290283,9.2130842701
30,65,2001,45,52,-86,115,1,-7,-85,-95,4397,10.124873439,11.699853752,-19.34975813,-3,0.2249971875,-1.574980313,-19.12476094
30,65,2002,47,63,12,115,1,-16,13,-8,4389,10.698839062,14.340997041,2.731618484,-5,0.2276348737,-3.642157979,2.9592533576
30,65,2003,51,51,19,115,1,0,20,12,4401,11.604095563,11.604095563,4.3230944255,-8,0.2275312856,0,4.550625711
30,65,2004,44,69,47,115,0,-25,47,18,4419,9.977324263,15.646258503,10.657596372,-4,0,-5.66893424,10.657596372
30,65,2005,49,47,-41,115,1,2,-40,-40,4379,11.138895203,10.68424642,-9.320300068,-2,0.2273243919,0.4546487838,-9.092975676
30,65,2006,40,53,99,115,0,-13,99,83,4462,9.0487501414,11.989593937,22.3956566,-3,0,-2.940843796,22.3956566
30,65,2007,38,55,28,115,1,-17,29,8,4470,8.5087326467,12.315270936,6.2695924765,-4,0.223914017,-3.806538289,6.4935064935
30,65,2008,43,62,57,115,0,-19,57,28,4498,9.5896520963,13.826940232,12.711864407,-10,0,-4.237288136,12.711864407
30,67,2001,179,147,-55,214,8,32,-47,-29,15691,11.397281207,9.3597784216,-3.501957913,-14,0.5093756964,2.0375027856,-2.992582216
30,67,2002,159,160,61,214,8,-1,69,55,15746,10.115469033,10.179088335,3.8807774279,-13,0.5089544168,-0.063619302,4.3897318446
30,67,2003,149,148,-111,214,3,1,-108,-123,15623,9.4998246677,9.4360674551,-7.077050591,-16,0.1912716376,0.0637572125,-6.885778954
30,67,2004,154,147,-10,214,6,7,-4,-7,15616,9.8594705336,9.4113127821,-0.640225359,-10,0.3841352156,0.4481577515,-0.256090144
30,67,2005,158,138,126,214,4,20,130,134,15750,10.074603073,8.7993368616,8.0341771345,-16,0.2550532424,1.2752662118,8.2892303768
30,67,2006,148,133,81,214,6,15,87,95,15845,9.3685709764,8.4190536477,5.1273935749,-7,0.3798069315,0.9495173287,5.5072005064
30,67,2007,168,142,188,214,5,26,193,227,16072,10.527305198,8.8980793934,11.780555817,8,0.3133126547,1.6292258044,12.093868471
30,67,2008,163,142,83,214,7,21,90,117,16189,10.105080438,8.8031989089,5.1455317566,6,0.4339605096,1.3018815288,5.5794922662
30,69,2001,6,2,-13,0,1,4,-12,-9,483,12.307692308,4.1025641026,-26.66666667,-1,2.0512820513,8.2051282051,-24.61538462
30,69,2002,3,5,10,0,1,-2,11,9,492,6.1538461538,10.256410256,20.512820513,0,2.0512820513,-4.102564103,22.564102564
30,69,2003,4,1,-11,0,1,3,-10,-8,484,8.1967213115,2.0491803279,-22.54098361,-1,2.0491803279,6.1475409836,-20.49180328
30,69,2004,4,5,8,0,0,-1,8,7,491,8.2051282051,10.256410256,16.41025641,0,0,-2.051282051,16.41025641
30,69,2005,6,2,-35,0,1,4,-34,-31,460,12.61829653,4.2060988433,-73.60672976,-1,2.1030494217,8.4121976866,-71.50368034
30,69,2006,1,3,1,0,0,-2,1,1,461,2.1715526602,6.5146579805,2.1715526602,2,0,-4.34310532,2.1715526602
30,69,2007,6,3,-30,0,1,3,-29,-28,433,13.422818792,6.711409396,-67.11409396,-2,2.2371364653,6.711409396,-64.87695749
30,69,2008,3,0,2,0,0,3,2,3,436,6.9044879171,0,4.6029919448,-2,0,6.9044879171,4.6029919448
30,71,2001,44,56,-92,79,2,-12,-90,-104,4444,9.7864768683,12.455516014,-20.46263345,-2,0.4448398577,-2.669039146,-20.01779359
30,71,2002,44,70,-118,79,1,-26,-117,-144,4300,10.064043916,16.010978957,-26.98993596,-1,0.2287282708,-5.946935041,-26.76120769
30,71,2003,40,57,-83,79,-1,-17,-84,-103,4197,9.415087678,13.416499941,-19.53630693,-2,-0.235377192,-4.001412263,-19.77168412
30,71,2004,38,46,-42,79,0,-8,-42,-54,4143,9.1127098321,11.03117506,-10.07194245,-4,0,-1.918465228,-10.07194245
30,71,2005,32,38,-92,79,0,-6,-92,-99,4044,7.8172712837,9.2830096494,-22.47465494,-1,0,-1.465738366,-22.47465494
30,71,2006,31,46,-75,79,0,-15,-75,-91,3953,7.7529073403,11.504314118,-18.75703389,-1,0,-3.751406778,-18.75703389
30,71,2007,48,27,-29,79,0,21,-29,-19,3934,12.17192849,6.8467097756,-7.353873463,-11,0,5.3252187143,-7.353873463
30,71,2008,42,49,-17,79,1,-7,-16,-30,3904,10.717019648,12.503189589,-4.337841286,-7,0.2551671345,-1.786169941,-4.082674152
30,73,2001,80,78,-49,77,0,2,-49,-51,6326,12.595449894,12.280563646,-7.71471306,-4,0,0.3148862473,-7.71471306
30,73,2002,65,79,-88,77,0,-14,-88,-106,6220,10.361868325,12.593655348,-14.02837558,-4,0,-2.231787024,-14.02837558
30,73,2003,76,74,-92,77,-2,2,-94,-95,6125,12.312677197,11.988659376,-14.90481977,-3,-0.324017821,0.324017821,-15.22883759
30,73,2004,71,89,-100,77,1,-18,-99,-122,6003,11.708443272,14.676781003,-16.49076517,-5,0.1649076517,-2.968337731,-16.32585752
30,73,2005,75,84,-12,77,0,-9,-12,-27,5976,12.521913348,14.02454295,-2.003506136,-6,0,-1.502629602,-2.003506136
30,73,2006,77,63,-50,77,0,14,-50,-39,5937,12.927054478,10.576680937,-8.39419122,-3,0,2.3503735415,-8.39419122
30,73,2007,83,67,-31,77,-1,16,-32,-16,5921,13.998988025,11.300387924,-5.228537696,0,-0.168662506,2.6986001012,-5.397200202
30,73,2008,88,67,-92,77,1,21,-91,-69,5852,14.94946063,11.381975707,-15.62898157,1,0.1698802344,3.5674849231,-15.45910133
30,75,2001,16,26,-31,33,0,-10,-31,-43,1813,8.7217225402,14.172799128,-16.89833742,-2,0,-5.451076588,-16.89833742
30,75,2002,13,18,16,33,0,-5,16,9,1822,7.1526822558,9.9037138927,8.803301238,-2,0,-2.751031637,8.803301238
30,75,2003,11,18,4,33,-1,-7,3,-7,1815,6.0489414352,9.8982678031,2.1996150674,-3,-0.549903767,-3.849326368,1.6497113005
30,75,2004,14,19,-48,33,0,-5,-48,-55,1760,7.8321678322,10.629370629,-26.85314685,-2,0,-2.797202797,-26.85314685
30,75,2005,7,20,-45,33,0,-13,-45,-60,1700,4.0462427746,11.560693642,-26.01156069,-2,0,-7.514450867,-26.01156069
30,75,2006,10,18,44,33,0,-8,44,36,1736,5.8207217695,10.477299185,25.611175786,0,0,-4.656577416,25.611175786
30,75,2007,9,13,-34,33,0,-4,-34,-38,1698,5.2417006407,7.5713453698,-19.8019802,0,0,-2.329644729,-19.8019802
30,75,2008,11,12,-2,33,0,-1,-2,-4,1694,6.4858490566,7.0754716981,-1.179245283,-1,0,-0.589622642,-1.179245283
30,77,2001,44,58,-146,1395,-1,-14,-147,-167,7011,6.2019874551,8.1753470999,-20.57932201,-6,-0.14095426,-1.973359645,-20.72027627
30,77,2002,60,71,-34,1407,-2,-11,-36,-53,6958,8.5904502828,10.165366168,-4.867921827,-6,-0.286348343,-1.574915885,-5.15427017
30,77,2003,55,87,-56,1410,-4,-32,-60,-98,6860,7.9606310609,12.592270951,-8.105369807,-6,-0.578954986,-4.63163989,-8.684324794
30,77,2004,54,78,7,1468,1,-24,8,-21,6839,7.8837871377,11.387692532,1.0219724067,-5,0.1459960581,-3.503905395,1.1679684649
30,77,2005,54,72,133,1548,-1,-18,132,107,6946,7.8346028292,10.446137106,19.296336598,-7,-0.145085238,-2.611534276,19.15125136
30,77,2006,50,71,178,1692,1,-21,179,154,7100,7.1194646163,10.109639755,25.345294034,-4,0.1423892923,-2.990175139,25.487683326
30,77,2007,60,51,8,1701,-1,9,7,15,7115,8.4417868449,7.1755188181,1.1255715793,-1,-0.140696447,1.2662680267,0.9848751319
30,77,2008,62,74,-65,1701,1,-12,-64,-74,7041,8.7595365923,10.454930771,-9.183385137,2,0.1412828483,-1.695394179,-9.042102289
30,79,2001,8,17,33,24,1,-9,34,24,1209,6.6833751044,14.202172097,27.568922306,-1,0.8354218881,-7.518796992,28.404344194
30,79,2002,7,25,-23,24,1,-18,-22,-40,1169,5.8873002523,21.02607233,-19.34398654,0,0.8410428932,-15.13877208,-18.50294365
30,79,2003,7,19,1,24,1,-12,2,-12,1157,6.018916595,16.337059329,0.8598452279,-2,0.8598452279,-10.31814273,1.7196904557
30,79,2004,11,17,-11,24,0,-6,-11,-18,1139,9.5818815331,14.808362369,-9.581881533,-1,0,-5.226480836,-9.581881533
30,79,2005,6,21,-47,24,1,-15,-46,-62,1077,5.4151624549,18.953068592,-42.41877256,-1,0.9025270758,-13.53790614,-41.51624549
30,79,2006,3,12,-9,24,0,-9,-9,-18,1059,2.808988764,11.235955056,-8.426966292,0,0,-8.426966292,-8.426966292
30,79,2007,7,9,-14,24,1,-2,-13,-16,1043,6.6603235014,8.5632730733,-13.320647,-1,0.9514747859,-1.902949572,-12.36917222
30,79,2008,6,8,25,24,0,-2,25,21,1064,5.6953013764,7.5937351685,23.730422402,-2,0,-1.898433792,23.730422402
30,81,2001,394,336,394,587,8,58,402,433,36740,10.787575123,9.19955645,10.787575123,-27,0.2190370583,1.5880186729,11.006612181
30,81,2002,401,355,631,587,7,46,638,669,37409,10.816059556,9.5753145693,17.019784488,-15,0.1888090197,1.2407449864,17.208593508
30,81,2003,436,380,839,587,4,56,843,906,38315,11.515503671,10.036448154,22.159421055,7,0.1056468227,1.4790555174,22.265067878
30,81,2004,424,342,557,587,7,82,564,605,38920,10.979478216,8.8560885609,14.423512656,-41,0.1812649705,2.1233896549,14.604777627
30,81,2005,436,387,284,587,6,49,290,309,39229,11.158172209,9.9041574428,7.268167219,-30,0.1535528286,1.2540147667,7.4217200476
30,81,2006,459,340,484,587,6,119,490,588,39817,11.613490879,8.6025858361,12.246033955,-21,0.1518103383,3.0109050426,12.397844293
30,81,2007,395,347,457,587,5,48,462,514,40331,9.8567649848,8.6589808854,11.40390278,4,0.124769177,1.1977840994,11.528671957
30,81,2008,446,391,264,587,7,55,271,333,40664,11.013025495,9.6549169702,6.518920921,7,0.1728501759,1.3581085252,6.691771097
30,83,2001,94,95,-226,114,3,-1,-223,-229,9384,9.8962994157,10.001579197,-23.79323051,-5,0.3158393431,-0.105279781,-23.47739117
30,83,2002,93,110,-155,114,3,-17,-152,-172,9212,10.002151,11.830501183,-16.67025167,-3,0.3226500323,-1.828350183,-16.34760163
30,83,2003,91,103,-118,114,2,-12,-116,-132,9080,9.949704789,11.261753772,-12.901815,-4,0.2186748305,-1.312048983,-12.68314017
30,83,2004,83,106,-99,114,1,-23,-98,-130,8950,9.2068774265,11.75818081,-10.98169717,-9,0.1109262341,-2.551303383,-10.87077094
30,83,2005,103,87,60,114,2,16,62,71,9021,11.46291247,9.6822658728,6.6774247399,-7,0.2225808247,1.7806465973,6.9000055645
30,83,2006,93,106,77,114,1,-13,78,59,9080,10.275675377,11.712060107,8.5078172477,-6,0.1104911331,-1.43638473,8.6183083808
30,83,2007,101,93,83,114,2,8,85,91,9171,11.067886691,10.191222399,9.0953920333,-2,0.2191660731,0.8766642924,9.3145581064
30,83,2008,122,97,75,114,1,25,76,99,9270,13.231386584,10.520036874,8.1340491297,-2,0.1084539884,2.7113497099,8.2425031181
30,85,2001,191,107,-143,268,2,84,-141,-65,10540,18.065736581,10.120595886,-13.52565618,-8,0.1891700166,7.9451406952,-13.33648617
30,85,2002,206,117,-256,268,1,89,-255,-168,10372,19.701606733,11.189747513,-24.48355011,-2,0.0956388676,8.5118592196,-24.38791125
30,85,2003,200,128,-116,268,1,72,-115,-52,10320,19.331142471,12.371931181,-11.21206263,-9,0.0966557124,6.9592112894,-11.11540692
30,85,2004,211,131,38,268,2,80,40,112,10432,20.33538936,12.625289129,3.6622976099,-8,0.1927525058,7.7101002313,3.8550501157
30,85,2005,240,113,-148,268,2,127,-146,-27,10405,23.035945674,10.846091088,-14.20549983,-8,0.1919662139,12.189854586,-14.01353362
30,85,2006,217,112,-268,268,2,105,-266,-165,10240,21.022039235,10.850084766,-25.96270283,-4,0.1937515137,10.171954468,-25.76895132
30,85,2007,223,82,-248,268,1,141,-247,-106,10134,21.89064494,8.0494748209,-24.34475312,0,0.0981643271,13.841170119,-24.24658879
30,85,2008,221,105,-164,268,2,116,-162,-45,10089,21.85630223,10.384215992,-16.21915641,1,0.1977945903,11.472086238,-16.02136182
30,87,2001,153,70,-225,96,6,83,-219,-140,9248,16.419832582,7.5123417042,-24.14681262,-4,0.6439150032,8.9074908779,-23.50289762
30,87,2002,163,69,-142,96,6,94,-136,-45,9203,17.668419056,7.4792694163,-15.39211967,-3,0.6503712536,10.18914964,-14.74174841
30,87,2003,172,68,-87,96,3,104,-84,11,9214,18.678394961,7.3844817288,-9.4477928,-9,0.3257859586,11.293913232,-9.122006842
30,87,2004,181,78,-162,96,2,103,-160,-68,9146,19.716775599,8.4967320261,-17.64705882,-11,0.2178649237,11.220043573,-17.4291939
30,87,2005,171,86,-85,96,3,85,-82,-5,9141,18.701810029,9.4055886695,-9.296221359,-8,0.3281019303,9.2962213594,-8.968119429
30,87,2006,164,77,-131,96,2,87,-129,-46,9095,17.986400526,8.4448343935,-14.36718579,-4,0.2193463479,9.5415661329,-14.14783944
30,87,2007,182,43,-67,96,2,139,-65,66,9161,19.938650307,4.7107800175,-7.340052585,-8,0.2191060473,15.227870289,-7.120946538
30,87,2008,188,71,-88,96,1,117,-87,29,9190,20.48934663,7.7379979293,-9.590757997,-1,0.1089858863,12.7513487,-9.481772111
30,89,2001,111,102,155,194,5,9,160,159,10405,10.750084742,9.8784562491,15.011379594,-10,0.4842380514,0.8716284926,15.495617646
30,89,2002,99,117,-36,194,4,-18,-32,-59,10346,9.5417088333,11.276564985,-3.469712303,-9,0.3855235892,-1.734856152,-3.084188714
30,89,2003,94,105,61,194,0,-11,61,38,10384,9.0689821515,10.13024602,5.8851905451,-12,0,-1.061263869,5.8851905451
30,89,2004,99,134,343,194,1,-35,344,291,10675,9.4021558479,12.72615034,32.575146018,-18,0.0949712712,-3.323994492,32.67011729
30,89,2005,89,122,96,194,1,-33,97,53,10728,8.3165911321,11.40027099,8.9707050413,-11,0.0934448442,-3.083679858,9.0641498855
30,89,2006,94,106,165,194,1,-12,166,149,10877,8.7016894237,9.8125433927,15.274242074,-5,0.0925711641,-1.110853969,15.366813238
30,89,2007,111,110,129,194,1,1,130,134,11011,10.14254386,10.051169591,11.787280702,3,0.091374269,0.091374269,11.878654971
30,89,2008,124,120,11,194,2,4,13,23,11034,11.249716489,10.886822409,0.9979587208,6,0.1814470401,0.3628940803,1.1794057609
30,91,2001,21,62,-106,121,2,-41,-104,-147,3926,5.250656332,15.501937742,-26.50331291,-2,0.5000625078,-10.25128141,-26.00325041
30,91,2002,8,54,-100,121,1,-46,-99,-144,3782,2.0757654385,14.01141671,-25.94706798,1,0.2594706798,-11.93565127,-25.6875973
30,91,2003,21,62,-106,121,1,-41,-105,-147,3635,5.6626668464,16.718349737,-28.58298503,-1,0.2696508022,-11.05568289,-28.31333423
30,91,2004,29,54,-6,121,2,-25,-4,-30,3605,8.0110497238,14.917127072,-1.657458564,-1,0.5524861878,-6.906077348,-1.104972376
30,91,2005,27,61,-90,121,2,-34,-88,-125,3480,7.6217360621,17.21947777,-25.40578687,-3,0.5645730416,-9.597741708,-24.84121383
30,91,2006,15,56,-39,121,2,-41,-37,-79,3401,4.3598314199,16.276703967,-11.33556169,-1,0.581310856,-11.91687255,-10.75425084
30,91,2007,19,54,0,121,0,-35,0,-36,3365,5.6163168785,15.96216376,0,-1,0,-10.34584688,0
30,91,2008,28,51,-58,121,0,-23,-58,-82,3283,8.4235860409,15.342960289,-17.4488568,-1,0,-6.919374248,-17.4488568
30,93,2001,354,428,-722,1092,7,-74,-715,-804,33711,10.377275525,12.546536511,-21.16495178,-15,0.2052003635,-2.169260986,-20.95975141
30,93,2002,372,434,-285,1092,6,-62,-279,-363,33348,11.094707646,12.943825586,-8.499977632,-22,0.1789468975,-1.849117941,-8.321030734
30,93,2003,384,398,-253,1092,1,-14,-252,-295,33053,11.566090872,11.987771269,-7.620367163,-29,0.0301200283,-0.421680396,-7.590247135
30,93,2004,398,442,-112,1092,9,-44,-103,-174,32879,12.073044955,13.407753443,-3.397439786,-27,0.2730085543,-1.334708488,-3.124431232
30,93,2005,372,445,-31,1092,6,-73,-25,-124,32755,11.335588262,13.560045099,-0.944632355,-26,0.1828320687,-2.224456836,-0.761800286
30,93,2006,393,424,-72,1092,8,-31,-64,-111,32644,12.018532393,12.966559122,-2.20186853,-16,0.2446520589,-0.948026728,-1.957216471
30,93,2007,405,392,-71,1092,6,13,-65,-42,32602,12.414554149,12.016062287,-2.176378629,10,0.1839193207,0.3984918616,-1.992459308
30,93,2008,402,387,156,1092,8,15,164,201,32803,12.292638178,11.833957648,4.7702775017,22,0.2446296155,0.458680529,5.0149071172
30,95,2001,97,76,103,172,4,21,107,122,8337,11.720637989,9.1831802803,12.445625906,-6,0.4833252779,2.537457709,12.928951184
30,95,2002,95,68,1,172,4,27,5,24,8361,11.378608217,8.1446879866,0.1197748233,-8,0.4790992933,3.23392023,0.5988741167
30,95,2003,84,62,-33,172,2,22,-31,-19,8342,10.0580734,7.4238160809,-3.951385979,-10,0.2394779381,2.634257319,-3.71190804
30,95,2004,95,63,-65,172,1,32,-64,-39,8303,11.414839291,7.569840793,-7.810153199,-7,0.1201562031,3.844998498,-7.689996996
30,95,2005,105,80,-2,172,2,25,0,16,8319,12.633858741,9.6257971363,-0.240644928,-9,0.2406449284,3.0080616051,0
30,95,2006,104,78,130,172,1,26,131,153,8472,12.387588589,9.2906914418,15.484485736,-4,0.1191114287,3.0968971473,15.603597165
30,95,2007,101,59,114,172,1,42,115,158,8630,11.811484037,6.8997778038,13.331774062,1,0.1169453865,4.9117062332,13.448719448
30,95,2008,105,72,18,172,0,33,18,57,8687,12.126811803,8.3155280938,2.0788820234,6,0,3.8112837096,2.0788820234
30,97,2001,34,49,-31,57,6,-15,-25,-43,3596,9.398756047,13.545266068,-8.569454043,-3,1.6586040083,-4.146510021,-6.910850035
30,97,2002,45,41,11,57,6,4,17,17,3613,12.484394507,11.374670551,3.0517408795,-4,1.6645859342,1.1097239562,4.7163268137
30,97,2003,36,39,-33,57,1,-3,-32,-38,3575,10.016694491,10.851419032,-9.18196995,-3,0.2782415136,-0.834724541,-8.903728436
30,97,2004,38,26,69,57,0,12,69,76,3651,10.517575422,7.1962358151,19.09770274,-5,0,3.321339607,19.09770274
30,97,2005,34,27,-20,57,1,7,-19,-13,3638,9.3291260804,7.4084236521,-5.487721224,-1,0.2743860612,1.9207024283,-5.213335163
30,97,2006,41,42,54,57,0,-1,54,50,3688,11.193011193,11.466011466,14.742014742,-3,0,-0.273000273,14.742014742
30,97,2007,36,35,111,57,1,1,112,106,3794,9.623095429,9.3557872227,29.671210906,-7,0.2673082064,0.2673082064,29.938519113
30,97,2008,37,31,-2,57,0,6,-2,-4,3790,9.7573839662,8.1751054852,-0.52742616,-8,0,1.582278481,-0.52742616
30,99,2001,68,64,-55,66,0,4,-55,-56,6379,10.613391603,9.9890744498,-8.584360855,-5,0,0.6243171531,-8.584360855
30,99,2002,56,64,-77,66,0,-8,-77,-89,6290,8.8404767543,10.103402005,-12.15565554,-4,0,-1.262925251,-12.15565554
30,99,2003,70,73,33,66,-1,-3,32,21,6311,11.110229347,11.586382033,5.2376795492,-8,-0.158717562,-0.476152686,5.0789619871
30,99,2004,68,60,-118,66,2,8,-116,-115,6196,10.87391061,9.5946270089,-18.86943312,-7,0.3198209003,1.2792836012,-18.54961222
30,99,2005,56,76,-98,66,0,-20,-98,-122,6074,9.1279543602,12.38793806,-15.97392013,-4,0,-3.2599837,-15.97392013
30,99,2006,65,55,-69,66,1,10,-68,-61,6013,10.755356995,9.1006866882,-11.41722512,-3,0.1654670307,1.6546703069,-11.25175809
30,99,2007,61,46,-7,66,-1,15,-8,-7,6006,10.150594891,7.6545469673,-1.164822365,-14,-0.166403195,2.4960479241,-1.33122556
30,99,2008,66,59,-7,66,1,7,-6,-14,5992,11.001833639,9.8349724954,-1.166861144,-15,0.1666944491,1.1668611435,-1.000166694
30,101,2001,61,53,-57,459,1,8,-56,15,5277,11.576050859,10.057880254,-10.81696556,63,0.1897713256,1.5181706044,-10.62719423
30,101,2002,49,51,-91,487,0,-2,-91,-6,5271,9.2908608267,9.6700796359,-17.25445582,87,0,-0.379218809,-17.25445582
30,101,2003,48,63,-240,368,-1,-15,-241,-247,5024,9.3249150073,12.238950947,-46.62457504,9,-0.194269063,-2.91403594,-46.8188441
30,101,2004,37,60,68,492,2,-23,70,44,5068,7.3325406262,11.890606421,13.47602061,-3,0.3963535474,-4.558065795,13.872374158
30,101,2005,53,58,18,512,1,-5,19,130,5198,10.325345802,11.299435028,3.5067212157,116,0.1948178453,-0.974089227,3.701539061
30,101,2006,38,47,-57,569,1,-9,-56,-65,5133,7.3564998548,9.0988287678,-11.03474978,0,0.1935921014,-1.742328913,-10.84115768
30,101,2007,48,53,36,636,0,-5,36,29,5162,9.3249150073,10.296260321,6.9936862555,-2,0,-0.971345313,6.9936862555
30,101,2008,46,47,-23,636,2,-1,-21,-21,5141,8.9294380278,9.1235562458,-4.464719014,1,0.388236436,-0.194118218,-4.076482578
30,103,2001,3,3,-32,0,1,0,-31,-33,821,3.5820895522,3.5820895522,-38.20895522,-2,1.1940298507,0,-37.01492537
30,103,2002,5,6,-55,0,1,-1,-54,-56,765,6.3051702396,7.5662042875,-69.35687264,-1,1.2610340479,-1.261034048,-68.09583859
30,103,2003,1,10,-14,0,1,-9,-13,-23,742,1.3271400133,13.271400133,-18.57996019,-1,1.3271400133,-11.94426012,-17.25282017
30,103,2004,7,5,-1,0,0,2,-1,-1,741,9.4403236682,6.7430883345,-1.348617667,-2,0,2.6972353338,-1.348617667
30,103,2005,4,6,-44,0,1,-2,-43,-43,698,5.5594162613,8.3391243919,-61.15357887,2,1.3898540653,-2.779708131,-59.76372481
30,103,2006,7,7,-22,0,0,0,-22,-22,676,10.18922853,10.18922853,-32.02328967,0,0,0,-32.02328967
30,103,2007,3,5,-22,0,1,-2,-21,-28,648,4.5317220544,7.5528700906,-33.2326284,-5,1.5105740181,-3.021148036,-31.72205438
30,103,2008,4,2,-3,0,0,2,-3,-11,637,6.2256809339,3.1128404669,-4.6692607,-10,0,3.1128404669,-4.6692607
30,105,2001,98,87,-139,184,2,11,-137,-131,7507,12.941564873,11.488940244,-18.35589303,-5,0.2641135688,1.4526246286,-18.09177947
30,105,2002,91,117,-109,184,2,-26,-107,-137,7370,12.233649257,15.728977616,-14.65349197,-4,0.2688714122,-3.495328359,-14.38462056
30,105,2003,81,96,-132,184,1,-15,-131,-149,7221,11.102734562,13.158796518,-18.09334521,-3,0.1370707971,-2.056061956,-17.95627442
30,105,2004,79,103,-39,184,2,-24,-37,-66,7155,10.990539789,14.329437952,-5.425709516,-5,0.2782415136,-3.338898164,-5.147468002
30,105,2005,68,87,-97,184,2,-19,-95,-117,7038,9.5821884027,12.259564574,-13.66870993,-3,0.2818290707,-2.677376171,-13.38688086
30,105,2006,77,78,-127,184,2,-1,-125,-131,6907,11.043384726,11.186805307,-18.21441377,-5,0.2868411617,-0.143420581,-17.92757261
30,105,2007,82,64,-28,184,1,18,-27,-23,6884,11.891813502,9.2814154159,-4.060619244,-14,0.1450221159,2.6103980857,-3.915597129
30,105,2008,78,88,31,184,1,-10,32,8,6892,11.324041812,12.775842044,4.5005807201,-14,0.1451800232,-1.451800232,4.6457607433
30,107,2001,25,33,-72,352,1,-8,-71,-80,2171,11.307100859,14.925373134,-32.56445047,-1,0.4522840344,-3.618272275,-32.11216644
30,107,2002,24,26,8,352,1,-2,9,5,2176,11.042097999,11.962272832,3.6806993329,-2,0.4600874166,-0.920174833,4.1407867495
30,107,2003,25,38,-63,352,1,-13,-62,-74,2102,11.687704535,17.765310893,-29.45301543,1,0.4675081814,-6.077606358,-28.98550725
30,107,2004,10,26,-12,352,0,-16,-12,-29,2073,4.7904191617,12.45508982,-5.748502994,-1,0,-7.664670659,-5.748502994
30,107,2005,25,30,-37,352,1,-5,-36,-41,2032,12.180267966,14.616321559,-18.02679659,0,0.4872107186,-2.436053593,-17.53958587
30,107,2006,18,20,-64,352,0,-2,-64,-67,1965,9.0067550663,10.007505629,-32.02401801,-1,0,-1.000750563,-32.02401801
30,107,2007,18,14,17,352,1,4,18,17,1982,9.1208512795,7.0939954396,8.6141373195,-5,0.50671396,2.0268558399,9.1208512795
30,107,2008,20,12,27,352,0,8,27,28,2010,10.02004008,6.0120240481,13.527054108,-7,0,4.0080160321,13.527054108
30,109,2001,5,22,-39,37,2,-17,-37,-55,1016,4.7915668424,21.082894106,-37.37422137,-1,1.9166267369,-16.29132726,-35.45759463
30,109,2002,8,16,-13,37,2,-8,-11,-19,997,7.9483358172,15.896671634,-12.9160457,0,1.9870839543,-7.948335817,-10.92896175
30,109,2003,3,17,-12,37,1,-14,-11,-26,971,3.0487804878,17.276422764,-12.19512195,-1,1.0162601626,-14.22764228,-11.17886179
30,109,2004,9,14,-9,37,0,-5,-9,-15,956,9.3409444733,14.53035807,-9.340944473,-1,0,-5.189413596,-9.340944473
30,109,2005,5,25,-18,37,1,-20,-17,-37,919,5.3333333333,26.666666667,-19.2,0,1.0666666667,-21.33333333,-18.13333333
30,109,2006,7,19,-20,37,0,-12,-20,-33,886,7.756232687,21.052631579,-22.16066482,-1,0,-13.29639889,-22.16066482
30,109,2007,6,13,12,37,1,-7,13,6,892,6.7491563555,14.623172103,13.498312711,0,1.1248593926,-7.874015748,14.623172103
30,109,2008,6,10,-21,37,0,-4,-21,-26,866,6.8259385666,11.376564278,-23.89078498,-1,0,-4.550625711,-23.89078498
30,111,2001,1749,1145,582,3007,29,604,611,1073,130601,13.447174287,8.8033245044,4.4747029359,-142,0.2229662975,4.6438497822,4.6976692333
30,111,2002,1715,1177,708,3032,23,538,731,1149,131750,13.074087768,8.9727121299,5.3973493526,-120,0.1753376202,4.101375638,5.5726869728
30,111,2003,1782,1196,819,3045,13,586,832,1278,133028,13.460332807,9.0339831859,6.186314573,-140,0.0981954694,4.4263496212,6.2845100424
30,111,2004,1836,1156,899,3079,30,680,929,1499,134527,13.724280989,8.641213956,6.7201136215,-110,0.2242529573,5.0830670329,6.9443665788
30,111,2005,1897,1218,1335,3248,24,679,1359,1920,136447,14.001343302,8.9897923786,9.8533438632,-118,0.1771387661,5.0115509237,10.030482629
30,111,2006,1907,1207,868,3219,27,700,895,1524,137971,13.8985052,8.7967990438,6.3261156338,-71,0.1967800946,5.1017061563,6.5228957284
30,111,2007,1999,1195,976,3179,22,804,998,1795,139766,14.394913173,8.6052632526,7.0282317444,-7,0.1584232565,5.7896499206,7.186655001
30,111,2008,1983,1197,1750,3179,25,786,1775,2582,142348,14.058146707,8.4859312193,12.406332192,21,0.177233317,5.5722154874,12.583565509
31,0,2001,24736,15135,-8364,51131,4212,9601,-4152,4511,1717705,14.419544265,8.8227604485,-4.875690016,-938,2.4553331357,5.5967838167,-2.42035688
31,0,2002,24873,15567,-5419,51625,3607,9306,-1812,6531,1724236,14.452891552,9.0454775372,-3.148804701,-963,2.095910418,5.4074140144,-1.052894283
31,0,2003,25688,15428,-2685,51720,2422,10260,-263,8637,1732873,14.860971986,8.9253766659,-1.553320997,-1360,1.401170747,5.9355953197,-0.15215025
31,0,2004,26351,15277,-5123,51166,3611,11074,-1512,8577,1741450,15.168998392,8.794231279,-2.949063746,-985,2.0786783497,6.3747671129,-0.870385396
31,0,2005,26280,14884,-3515,52028,3233,11396,-282,9619,1751069,15.049309682,8.5233609323,-2.012873803,-1495,1.8513857763,6.5259487493,-0.161488026
31,0,2006,26227,15004,-5168,52442,3495,11223,-1673,8710,1759779,14.940549975,8.5472227792,-2.944018083,-840,1.9909719817,6.3933271962,-0.953046102
31,0,2007,26906,14686,-5367,52729,2931,12220,-2436,9694,1769473,15.247423533,8.3224433959,-3.041437676,-90,1.6609751868,6.9249801374,-1.380462489
31,0,2008,27487,14946,-1491,52993,2953,12541,1462,13959,1783432,15.472972117,8.4133969245,-0.839313182,-44,1.662301694,7.0595751927,0.8229885122
31,1,2001,371,279,-265,1648,108,92,-157,428,31578,11.828848361,8.8955490371,-8.449177401,493,3.4434383369,2.9332993241,-5.005739064
31,1,2002,406,319,-478,1506,105,87,-373,113,31691,12.834089364,10.083927358,-15.11008551,399,3.3191610425,2.7501620067,-11.79092447
31,1,2003,405,293,-144,1597,90,112,-54,451,32142,12.689361302,9.1802045964,-4.511772907,393,2.8198580671,3.5091567058,-1.69191484
31,1,2004,432,294,-128,1716,83,138,-45,511,32653,13.334362219,9.0747742881,-3.950922139,418,2.5619260745,4.2595879312,-1.388996065
31,1,2005,452,317,78,1853,87,135,165,295,32948,13.78027774,9.6644868218,2.3780125303,-5,2.6523985915,4.1157909178,5.0304111218
31,1,2006,436,307,-293,1722,87,129,-206,-76,32872,13.248252811,9.3284715892,-8.903068976,1,2.643573382,3.9197812215,-6.259495594
31,1,2007,446,287,-249,1622,79,159,-170,-3,32869,13.568397195,8.7312331726,-7.575181394,8,2.4033708036,4.8371640225,-5.17181059
31,1,2008,466,306,110,1627,79,160,189,369,33238,14.098355696,9.2577185472,3.3279380398,20,2.3900645923,4.8406371489,5.7180026321
31,3,2001,61,84,-177,104,1,-23,-176,-204,7236,8.3128917961,11.447260834,-24.1210139,-5,0.1362769147,-3.134369038,-23.98473699
31,3,2002,74,78,-18,104,1,-4,-17,-26,7210,10.245050533,10.798837048,-2.492039319,-5,0.1384466288,-0.553786515,-2.35359269
31,3,2003,61,81,-46,104,1,-20,-45,-74,7136,8.5041126446,11.292346299,-6.412937404,-9,0.1394116827,-2.788233654,-6.273525721
31,3,2004,76,90,-97,104,0,-14,-97,-119,7017,10.739772486,12.718151629,-13.7073412,-8,0,-1.978379142,-13.7073412
31,3,2005,73,66,-87,104,1,7,-86,-85,6932,10.466700122,9.4630439458,-12.47401247,-6,0.1433794537,1.0036561761,-12.33063302
31,3,2006,87,76,-119,104,0,11,-119,-110,6822,12.650865203,11.051330522,-17.304057,-2,0,1.5995346808,-17.304057
31,3,2007,68,73,-80,104,1,-5,-79,-79,6743,10.025801696,10.762992997,-11.79506082,5,0.1474382602,-0.737191301,-11.64762256
31,3,2008,76,69,-77,104,0,7,-77,-64,6679,11.324690806,10.281627179,-11.4736999,6,0,1.0430636269,-11.4736999
31,5,2001,4,2,-37,0,1,2,-36,-33,409,9.4007050529,4.7003525264,-86.95652174,1,2.3501762632,4.7003525264,-84.60634548
31,5,2002,7,6,-16,0,1,1,-15,-15,394,17.434620174,14.943960149,-39.8505604,-1,2.4906600249,2.4906600249,-37.35990037
31,5,2003,5,6,6,0,1,-1,7,6,400,12.594458438,15.113350126,15.113350126,0,2.5188916877,-2.518891688,17.632241814
31,5,2004,7,3,-19,0,0,4,-19,-16,384,17.857142857,7.6530612245,-48.46938776,-1,0,10.204081633,-48.46938776
31,5,2005,5,4,-18,0,1,1,-17,-15,369,13.280212483,10.624169987,-47.80876494,1,2.6560424967,2.6560424967,-45.15272244
31,5,2006,4,6,-1,0,0,-2,-1,-4,365,10.899182561,16.348773842,-2.72479564,-1,0,-5.449591281,-2.72479564
31,5,2007,6,4,-11,0,1,2,-10,-11,354,16.68984701,11.126564673,-30.59805285,-3,2.7816411683,5.5632823366,-27.81641168
31,5,2008,6,0,-16,0,0,6,-16,-16,338,17.341040462,0,-46.24277457,-6,0,17.341040462,-46.24277457
31,7,2001,5,3,-14,0,1,2,-13,-13,810,6.123698714,3.6742192284,-17.1463564,-2,1.2247397428,2.4494794856,-15.92161666
31,7,2002,3,5,-38,0,1,-2,-37,-39,771,3.7950664137,6.3251106894,-48.07084124,0,1.2650221379,-2.530044276,-46.8058191
31,7,2003,5,5,-8,0,1,0,-7,-8,763,6.518904824,6.518904824,-10.43024772,-1,1.3037809648,0,-9.126466754
31,7,2004,4,3,-15,0,0,1,-15,-15,748,5.294506949,3.9708802118,-19.85440106,-1,0,1.3236267373,-19.85440106
31,7,2005,6,5,-21,0,1,1,-20,-19,729,8.124576845,6.7704807041,-28.43601896,0,1.3540961408,1.3540961408,-27.08192282
31,7,2006,4,4,14,0,0,0,14,13,742,5.4384772264,5.4384772264,19.034670292,-1,0,0,19.034670292
31,7,2007,7,2,-17,0,1,5,-16,-10,732,9.4979647218,2.7137042062,-23.06648575,1,1.3568521031,6.7842605156,-21.70963365
31,7,2008,6,2,-1,0,0,4,-1,3,735,8.1799591002,2.7266530334,-1.363326517,0,0,5.4533060668,-1.363326517
31,9,2001,7,5,-26,0,1,2,-25,-22,560,12.259194396,8.7565674256,-45.53415061,1,1.7513134851,3.5026269702,-43.78283713
31,9,2002,3,1,-21,0,1,2,-20,-18,542,5.444646098,1.8148820327,-38.11252269,0,1.8148820327,3.6297640653,-36.29764065
31,9,2003,5,1,-15,0,1,4,-14,-11,531,9.3196644921,1.8639328984,-27.95899348,-1,1.8639328984,7.4557315937,-26.09506058
31,9,2004,6,3,-35,0,0,3,-35,-32,499,11.650485437,5.8252427184,-67.96116505,0,0,5.8252427184,-67.96116505
31,9,2005,3,7,-23,0,1,-4,-22,-26,473,6.1728395062,14.403292181,-47.32510288,0,2.0576131687,-8.230452675,-45.26748971
31,9,2006,5,6,-4,0,0,-1,-4,-6,467,10.638297872,12.765957447,-8.510638298,-1,0,-2.127659574,-8.510638298
31,9,2007,7,4,-30,0,1,3,-29,-27,440,15.435501654,8.8202866593,-66.15214994,-1,2.2050716648,6.6152149945,-63.94707828
31,9,2008,6,0,-13,0,0,6,-13,-12,428,13.824884793,0,-29.95391705,-5,0,13.824884793,-29.95391705
31,11,2001,65,56,-87,112,2,9,-85,-79,6134,10.528873411,9.0710293999,-14.0924921,-3,0.3239653357,1.4578440107,-13.76852677
31,11,2002,55,73,-83,112,2,-18,-81,-104,6030,9.0430779349,12.002630714,-13.6468267,-5,0.3288391976,-2.959552779,-13.3179875
31,11,2003,59,67,-173,112,1,-8,-172,-180,5850,9.9326599327,11.279461279,-29.12457912,0,0.1683501684,-1.346801347,-28.95622896
31,11,2004,58,74,-64,112,0,-16,-64,-85,5765,9.9870856651,12.74214378,-11.02023246,-5,0,-2.755058115,-11.02023246
31,11,2005,53,87,-43,112,1,-34,-42,-80,5685,9.2576419214,15.19650655,-7.510917031,-4,0.1746724891,-5.938864629,-7.336244541
31,11,2006,44,73,-104,112,0,-29,-104,-135,5550,7.8326657766,12.995104584,-18.51357365,-2,0,-5.162438807,-18.51357365
31,11,2007,59,70,-30,112,1,-11,-29,-45,5505,10.673903211,12.663952962,-5.427408412,-5,0.1809136137,-1.990049751,-5.246494799
31,11,2008,56,67,-42,112,0,-11,-42,-59,5446,10.227376495,12.23632545,-7.670532371,-6,0,-2.008948954,-7.670532371
31,13,2001,135,138,-290,227,19,-3,-271,-279,11834,11.274898735,11.52545204,-24.22015284,-5,1.5868375997,-0.250553305,-22.63331524
31,13,2002,165,125,-117,227,19,40,-98,-66,11768,13.981865944,10.592322685,-9.914414033,-8,1.610033048,3.389543259,-8.304380985
31,13,2003,181,128,-348,227,13,53,-335,-275,11493,15.562529556,11.005545763,-29.92132754,7,1.1177507416,4.5569837926,-28.8035768
31,13,2004,137,115,-247,227,12,22,-235,-228,11265,12.039722295,10.106336233,-21.70665261,-15,1.0545742157,1.933386062,-20.65207839
31,13,2005,127,130,-145,227,13,-3,-132,-145,11120,11.346884074,11.614920706,-12.95510386,-10,1.1614920706,-0.268036632,-11.79361179
31,13,2006,145,117,-195,227,12,28,-183,-159,10961,13.133463158,10.597346135,-17.66224356,-4,1.0869072959,2.5361170237,-16.57533626
31,13,2007,153,101,-48,227,12,52,-36,13,10974,13.950307727,9.2090266697,-4.37656713,-3,1.0941417825,4.7412810577,-3.282425348
31,13,2008,158,110,8,227,11,48,19,69,11043,14.35254576,9.9922786937,0.7267111777,2,0.9992278694,4.3602670664,1.7259390471
31,15,2001,24,28,-36,46,1,-4,-35,-41,2386,9.9729898192,11.635154789,-14.95948473,-2,0.4155412425,-1.66216497,-14.54394349
31,15,2002,15,36,-16,46,1,-21,-15,-38,2348,6.3371356147,15.209125475,-6.759611322,-2,0.4224757076,-8.871989861,-6.337135615
31,15,2003,22,41,-32,46,1,-19,-31,-50,2298,9.4705122686,17.649591046,-13.77529057,0,0.4304778304,-8.179078777,-13.34481274
31,15,2004,18,41,-32,46,0,-23,-32,-59,2239,7.9347586511,18.073616927,-14.1062376,-4,0,-10.13885828,-14.1062376
31,15,2005,11,33,-5,46,1,-22,-4,-28,2211,4.9438202247,14.831460674,-2.247191011,-2,0.4494382022,-9.887640449,-1.797752809
31,15,2006,14,39,-49,46,0,-25,-49,-75,2136,6.4412238325,17.943409248,-22.54428341,-1,0,-11.50218542,-22.54428341
31,15,2007,14,28,-14,46,1,-14,-13,-27,2109,6.5959952886,13.191990577,-6.595995289,0,0.4711425206,-6.595995289,-6.124852768
31,15,2008,17,22,-14,46,0,-5,-14,-19,2090,8.0971659919,10.478685401,-6.668254346,0,0,-2.381519409,-6.668254346
31,17,2001,37,53,-9,49,1,-16,-8,-28,3491,10.556348074,15.12125535,-2.567760342,-4,0.2853067047,-4.564907275,-2.282453638
31,17,2002,31,44,-4,49,1,-13,-3,-19,3472,8.9042079563,12.638230648,-1.148930059,-3,0.2872325147,-3.734022691,-0.861697544
31,17,2003,39,44,-19,49,1,-5,-18,-26,3446,11.274934952,12.720439433,-5.492917028,-3,0.2891008962,-1.445504481,-5.203816132
31,17,2004,34,44,-28,49,0,-10,-28,-43,3403,9.928456709,12.848591035,-8.176376113,-5,0,-2.920134326,-8.176376113
31,17,2005,34,37,-113,49,1,-3,-112,-116,3287,10.164424514,11.061285501,-33.78176383,-1,0.2989536622,-0.896860987,-33.48281016
31,17,2006,26,38,11,49,0,-12,11,-3,3284,7.91355958,11.565971694,3.3480444377,-2,0,-3.652412114,3.3480444377
31,17,2007,29,32,-87,49,1,-3,-86,-85,3199,8.9464753972,9.8719728521,-26.83942619,4,0.3084991516,-0.925497455,-26.53092704
31,17,2008,27,42,-33,49,0,-15,-33,-50,3149,8.5066162571,13.232514178,-10.39697543,-2,0,-4.725897921,-10.39697543
31,19,2001,570,325,-173,2706,45,245,-128,79,42422,13.448947089,7.6682593051,-4.081873415,-38,1.0617589807,5.7806877839,-3.020114434
31,19,2002,592,317,244,2779,44,275,288,523,42945,13.869528038,7.4267574121,5.7164946642,-40,1.0308433001,6.4427706257,6.7473379643
31,19,2003,631,318,-10,2906,31,313,21,270,43215,14.647168059,7.3816155989,-0.232126277,-64,0.7195914578,7.2655524605,0.4874651811
31,19,2004,636,362,203,2912,32,274,235,478,43693,14.636166981,8.3306485019,4.6716067566,-31,0.7364109173,6.3055184793,5.4080176739
31,19,2005,666,334,6,2864,32,332,38,336,44029,15.184332323,7.6149654591,0.1367957867,-34,0.729577529,7.5693668635,0.8663733157
31,19,2006,647,324,154,2822,33,323,187,485,44514,14.61436816,7.3184780276,3.4785358526,-25,0.7454005399,7.2958901325,4.2239363925
31,19,2007,709,330,40,2659,25,379,65,425,44939,15.85189988,7.378176249,0.8943243938,-19,0.5589527461,8.4737236314,1.45327714
31,19,2008,712,332,30,2623,25,380,55,415,45354,15.770879249,7.353836953,0.6645033391,-20,0.5537527826,8.4170422956,1.2182561217
31,21,2001,86,107,-98,113,0,-21,-98,-127,7662,11.131965569,13.850236231,-12.68526309,-8,0,-2.718270662,-12.68526309
31,21,2002,92,115,-148,113,-1,-23,-149,-173,7489,12.14441291,15.180516138,-19.53666425,-1,-0.132004488,-3.036103228,-19.66866873
31,21,2003,71,112,-74,113,-2,-41,-76,-124,7365,9.559714555,15.080113101,-9.963646156,-7,-0.269287734,-5.520398546,-10.23293389
31,21,2004,77,105,65,113,1,-28,66,31,7396,10.4328975,14.226678409,8.8069913962,-7,0.1354921753,-3.793780909,8.9424835716
31,21,2005,80,102,-145,113,-1,-22,-146,-174,7222,10.945409769,13.955397455,-19.83855521,-6,-0.136817622,-3.009987686,-19.97537283
31,21,2006,73,94,-59,113,0,-21,-59,-83,7139,10.166422951,13.091010375,-8.216698002,-3,0,-2.924587424,-8.216698002
31,21,2007,86,99,-78,113,0,-13,-78,-88,7051,12.121212121,13.953488372,-10.99365751,3,0,-1.832276251,-10.99365751
31,21,2008,78,113,9,113,-1,-35,8,-28,7023,11.084268865,16.057979253,1.2789540998,-1,-0.142106011,-4.973710388,1.1368480887
31,23,2001,133,112,36,102,6,21,42,55,8912,14.969891384,12.606224323,4.0520006753,-8,0.6753334459,2.3636670606,4.7273341212
31,23,2002,95,116,-38,102,5,-21,-33,-61,8851,10.696391375,13.060856837,-4.27855655,-7,0.5629679671,-2.364465462,-3.715588583
31,23,2003,97,104,-93,102,3,-7,-90,-102,8749,11.022727273,11.818181818,-10.56818182,-5,0.3409090909,-0.795454545,-10.22727273
31,23,2004,107,88,-100,102,4,19,-96,-85,8664,12.289668638,10.10739103,-11.48567162,-8,0.459426865,2.1822776087,-11.02624476
31,23,2005,84,102,-133,102,4,-18,-129,-154,8510,9.7822289507,11.878420869,-15.48852917,-7,0.4658204262,-2.096191918,-15.02270875
31,23,2006,73,97,-75,102,4,-24,-71,-97,8413,8.6273119423,11.463688471,-8.863676653,-2,0.4727294215,-2.836376529,-8.390947232
31,23,2007,90,98,-26,102,1,-8,-25,-33,8380,10.718751861,11.671529804,-3.096528315,0,0.1190972429,-0.952777943,-2.977431072
31,23,2008,84,104,-36,102,0,-20,-36,-54,8326,10.056267209,12.450616545,-4.309828804,2,0,-2.394349336,-4.309828804
31,25,2001,310,219,57,251,8,91,65,132,24525,12.674271229,8.9537593524,2.3304305164,-24,0.3270779672,3.720511877,2.6575084836
31,25,2002,350,239,99,251,-1,111,98,183,24708,14.218105742,9.7089350639,4.021692767,-26,-0.040623159,4.5091706782,3.9810696078
31,25,2003,308,190,228,251,-18,118,210,308,25016,12.388383879,7.6421848604,9.1706218325,-20,-0.72399646,4.7461990186,8.4466253721
31,25,2004,304,230,163,251,17,74,180,232,25248,12.096132421,9.1516791342,6.4857552125,-22,0.6764284577,2.9444532866,7.1621836702
31,25,2005,333,199,9,251,4,134,13,125,25373,13.156595089,7.8623496177,0.3555836511,-22,0.1580371782,5.2942454712,0.5136208293
31,25,2006,317,216,-39,251,11,101,-28,61,25434,12.478595469,8.502765367,-1.535221525,-12,0.4330111992,3.9758301022,-1.102210325
31,25,2007,320,201,-71,251,3,119,-68,46,25480,12.570216443,7.8956672035,-2.789016773,-5,0.1178457792,4.6745492399,-2.671170994
31,25,2008,336,198,-21,251,5,138,-16,118,25598,13.156349113,7.7528485845,-0.82227182,-4,0.1957790047,5.4035005286,-0.626492815
31,27,2001,95,108,-175,186,1,-13,-174,-191,9389,10.016342453,11.386999842,-18.45115715,-4,0.1054351837,-1.370657388,-18.34572197
31,27,2002,105,112,-125,186,1,-7,-124,-136,9253,11.264885742,12.015878125,-13.41057826,-5,0.1072846261,-0.750992383,-13.30329364
31,27,2003,95,135,-114,186,1,-40,-113,-159,9094,10.355916499,14.716302393,-12.4270998,-6,0.1090096474,-4.360385894,-12.31809015
31,27,2004,111,106,-96,186,0,5,-96,-100,8994,12.273330385,11.720477665,-10.61477222,-9,0,0.55285272,-10.61477222
31,27,2005,114,99,-74,186,1,15,-73,-64,8930,12.720374916,11.046641375,-8.257085472,-6,0.1115822361,1.6737335416,-8.145503236
31,27,2006,127,103,-248,186,0,24,-248,-228,8702,14.405626134,11.683303085,-28.13067151,-4,0,2.722323049,-28.13067151
31,27,2007,95,101,-172,186,1,-6,-171,-176,8526,11.028558161,11.725098677,-19.96749478,1,0.1160900859,-0.696540515,-19.85140469
31,27,2008,109,110,-123,186,0,-1,-123,-119,8407,12.874269179,12.99238174,-14.52784504,5,0,-0.118112561,-14.52784504
31,29,2001,48,59,-69,100,1,-11,-68,-82,3965,11.98202696,14.727908138,-17.22416375,-3,0.2496255617,-2.745881178,-16.97453819
31,29,2002,43,52,20,100,1,-9,21,10,3975,10.831234257,13.098236776,5.0377833753,-2,0.2518891688,-2.267002519,5.2896725441
31,29,2003,46,43,10,100,1,3,11,9,3984,11.559241111,10.80537756,2.5128785023,-5,0.2512878502,0.7538635507,2.7641663526
31,29,2004,44,68,-71,100,0,-24,-71,-100,3884,11.184544992,17.285205897,-18.04778851,-5,0,-6.100660905,-18.04778851
31,29,2005,45,53,-57,100,1,-8,-56,-66,3818,11.685276552,13.76265905,-14.8013503,-2,0.2596728123,-2.077382498,-14.54167749
31,29,2006,53,45,-51,100,0,8,-51,-46,3772,13.965744401,11.85770751,-13.43873518,-3,0,2.1080368906,-13.43873518
31,29,2007,38,42,-79,100,1,-4,-78,-78,3694,10.179480311,11.251004554,-21.1626038,4,0.2678810608,-1.071524243,-20.89472274
31,29,2008,41,56,-48,100,0,-15,-48,-65,3629,11.197596613,15.294278301,-13.1093814,-2,0,-4.096681688,-13.1093814
31,31,2001,73,78,-109,80,5,-5,-104,-113,6034,11.985879649,12.806830309,-17.89672441,-4,0.8209506609,-0.820950661,-17.07577375
31,31,2002,63,58,-33,80,5,5,-28,-29,6005,10.465985547,9.6353517734,-5.482182906,-6,0.8306337736,0.8306337736,-4.651549132
31,31,2003,68,68,-48,80,1,0,-47,-52,5953,11.373139321,11.373139321,-8.028098344,-5,0.1672520488,0,-7.860846295
31,31,2004,84,70,-1,80,0,14,-1,9,5962,14.099874108,11.74989509,-0.167855644,-4,0,2.349979018,-0.167855644
31,31,2005,73,68,-53,80,1,5,-52,-51,5911,12.296807883,11.454560768,-8.927819422,-4,0.1684494231,0.8422471153,-8.759369999
31,31,2006,68,58,-138,80,0,10,-138,-129,5782,11.630890276,9.9204652356,-23.60386556,-1,0,1.7104250406,-23.60386556
31,31,2007,72,49,-110,80,1,23,-109,-91,5691,12.551207182,8.5417937767,-19.17545542,-5,0.174322322,4.0094134054,-19.0011331
31,31,2008,70,68,-86,80,0,2,-86,-82,5609,12.389380531,12.03539823,-15.22123894,2,0,0.3539823009,-15.22123894
31,33,2001,130,136,89,126,4,-6,93,80,9904,13.179237632,13.787510138,9.0227088402,-7,0.4055150041,-0.608272506,9.4282238443
31,33,2002,121,131,14,126,3,-10,17,-3,9901,12.219136582,13.22898258,1.4137843979,-10,0.3029537995,-1.009845998,1.7167381974
31,33,2003,108,111,-60,126,3,-3,-57,-73,9828,10.948350144,11.252470982,-6.082416747,-13,0.3041208373,-0.304120837,-5.77829591
31,33,2004,144,101,-34,126,4,43,-30,5,9833,14.64828849,10.274146788,-3.458623671,-8,0.4068969025,4.3741417018,-3.051726769
31,33,2005,142,105,88,126,4,37,92,119,9952,14.35430882,10.614101592,8.895628001,-10,0.4043467273,3.7402072277,9.2999747283
31,33,2006,122,105,-207,126,4,17,-203,-189,9763,12.376363175,10.651787979,-20.99923916,-3,0.4057823992,1.7245751966,-20.59345676
31,33,2007,138,111,143,126,4,27,147,179,9942,14.00659731,11.266176097,14.51408272,5,0.4059883278,2.7404212129,14.920071048
31,33,2008,144,113,-17,126,3,31,-14,23,9965,14.467272819,11.352790476,-1.70794193,6,0.3014015171,3.1144823429,-1.406540413
31,35,2001,78,77,-121,102,5,1,-116,-119,6906,11.19804752,11.054482808,-17.37133013,-4,0.717823559,0.1435647118,-16.65350657
31,35,2002,76,74,-79,102,4,2,-75,-77,6829,11.066618129,10.775391336,-11.50345832,-4,0.5824535857,0.2912267929,-10.92100473
31,35,2003,75,88,-61,102,2,-13,-59,-80,6749,11.047282369,12.962144646,-8.985122993,-8,0.2945941965,-1.914862277,-8.690528797
31,35,2004,62,70,-86,102,3,-8,-83,-98,6651,9.2537313433,10.447761194,-12.8358209,-7,0.447761194,-1.194029851,-12.3880597
31,35,2005,75,75,-162,102,3,0,-159,-162,6489,11.415525114,11.415525114,-24.65753425,-3,0.4566210046,0,-24.20091324
31,35,2006,76,72,-94,102,3,4,-91,-90,6399,11.793916822,11.173184358,-14.58721291,-3,0.4655493482,0.6207324643,-14.12166356
31,35,2007,77,69,-72,102,1,8,-71,-64,6335,12.093607665,10.837128946,-11.30830847,-1,0.1570598398,1.2564787184,-11.15124863
31,35,2008,72,77,-58,102,0,-5,-58,-65,6270,11.42403808,12.217374058,-9.202697342,-2,0,-0.793335978,-9.202697342
31,37,2001,168,110,-166,132,92,58,-74,-26,10422,16.09966459,10.541447053,-15.90800192,-10,8.8164829899,5.5582175371,-7.091518927
31,37,2002,188,98,-147,132,84,90,-63,21,10443,18.020608675,9.3937215433,-14.09058231,-6,8.0517613228,8.6268871316,-6.038820992
31,37,2003,196,92,-244,132,68,104,-176,-68,10375,18.829858776,8.8385051398,-23.44125276,4,6.5328081468,9.9913536363,-16.90844462
31,37,2004,207,91,-159,132,66,116,-93,11,10386,19.941235971,8.7664370695,-15.31718125,-12,6.3580752372,11.174798902,-8.959106016
31,37,2005,204,108,-402,132,69,96,-333,-238,10148,19.869484757,10.519138989,-39.1545729,-1,6.7205610207,9.350345768,-32.43401188
31,37,2006,172,101,-351,132,70,71,-281,-216,9932,17.131474104,10.059760956,-34.96015936,-6,6.9721115538,7.0717131474,-27.98804781
31,37,2007,198,75,-184,132,59,123,-125,-30,9902,19.965715438,7.5627709993,-18.55399818,-28,5.9493798528,12.402944439,-12.60461833
31,37,2008,213,82,-62,132,58,131,-4,87,9989,21.41672113,8.2449348952,-6.233975165,-40,5.8317832185,13.171786235,-0.402191946
31,39,2001,128,113,-149,241,21,15,-128,-119,10055,12.655099115,11.172079688,-14.73132631,-6,2.0762271986,1.4830194276,-12.65509912
31,39,2002,120,108,-123,241,21,12,-102,-97,9958,11.992205067,10.79298456,-12.29201019,-7,2.0986358867,1.1992205067,-10.19337431
31,39,2003,148,125,-181,241,20,23,-161,-141,9817,14.968394437,12.642225032,-18.30594185,-3,2.0227560051,2.3261694058,-16.28318584
31,39,2004,127,111,-151,241,19,16,-132,-126,9691,13.020299364,11.379946689,-15.48082838,-10,1.9479188025,1.6403526758,-13.53290958
31,39,2005,145,122,-105,241,20,23,-85,-70,9621,15.016570008,12.634631317,-10.87406794,-8,2.0712510356,2.381938691,-8.802816901
31,39,2006,94,140,-147,241,19,-46,-128,-177,9444,9.8610018358,14.686598479,-15.4209284,-3,1.9931812221,-4.825596643,-13.42774718
31,39,2007,125,118,-152,241,19,7,-133,-122,9322,13.321965256,12.575935202,-16.19950975,4,2.024938719,0.7460300544,-14.17457103
31,39,2008,138,129,-48,241,18,9,-30,-16,9306,14.816405411,13.850118102,-5.153532317,5,1.9325746189,0.9662873094,-3.220957698
31,41,2001,120,145,-180,238,0,-25,-180,-211,11570,10.277932423,12.419168344,-15.41689863,-6,0,-2.141235921,-15.41689863
31,41,2002,136,175,-62,238,0,-39,-62,-111,11459,11.811194581,15.198228321,-5.384515177,-10,0,-3.38703374,-5.384515177
31,41,2003,137,163,-114,238,-1,-26,-115,-148,11311,12.033377251,14.317083882,-10.01317523,-7,-0.08783487,-2.283706632,-10.1010101
31,41,2004,142,157,-58,238,0,-15,-58,-82,11229,12.599822538,13.930789707,-5.146406389,-9,0,-1.330967169,-5.146406389
31,41,2005,105,153,-49,238,0,-48,-49,-107,11122,9.3955527717,13.69066261,-4.384591293,-10,0,-4.295109838,-4.384591293
31,41,2006,156,154,-151,238,0,2,-151,-152,10970,14.12275937,13.941698352,-13.67010683,-3,0,0.1810610176,-13.67010683
31,41,2007,110,151,-94,238,0,-41,-94,-131,10839,10.087578523,13.847494154,-8.620294374,4,0,-3.759915631,-8.620294374
31,41,2008,127,155,26,238,-1,-28,25,3,10842,11.715326784,14.298233476,2.3984133573,6,-0.092246668,-2.582906692,2.3061666897
31,43,2001,361,145,-360,291,153,216,-207,-3,20270,17.808252966,7.1528993908,-17.75892263,-12,7.5475421158,10.655353575,-10.21138051
31,43,2002,403,165,-374,291,147,238,-227,2,20272,19.880617631,8.1397069705,-18.45000247,-9,7.2517389374,11.740910661,-11.19826353
31,43,2003,399,152,-292,291,130,247,-162,74,20346,19.64646216,7.484366537,-14.37786203,-11,6.4011029593,12.162095623,-7.976759072
31,43,2004,422,147,-471,291,118,275,-353,-106,20240,20.79534815,7.243877199,-23.20997388,-28,5.8148129897,13.551470951,-17.39516089
31,43,2005,411,161,-612,291,121,250,-491,-251,19989,20.433020955,8.0041760919,-30.42581223,-10,6.0155609138,12.428844863,-24.41025131
31,43,2006,380,182,-181,291,121,198,-60,127,20116,18.950255579,9.0761750405,-9.026305947,-11,6.0341603291,9.8740805386,-2.992145618
31,43,2007,329,166,-97,291,114,163,17,162,20278,16.289547953,8.219042432,-4.802693469,-18,5.6444026341,8.0705055206,0.8417091647
31,43,2008,297,145,-341,291,113,152,-228,-104,20174,14.684070009,7.1689904084,-16.85948779,-28,5.5868683872,7.5150796005,-11.2726194
31,45,2001,111,93,45,1056,3,18,48,55,9090,12.248275862,10.262068966,4.9655172414,-11,0.3310344828,1.9862068966,5.2965517241
31,45,2002,93,92,15,1111,2,1,17,11,9101,10.224836458,10.11489198,1.6491671706,-7,0.2198889561,0.109944478,1.8690561267
31,45,2003,94,90,27,1089,-1,4,26,18,9119,10.318331504,9.8792535675,2.9637760703,-12,-0.109769484,0.4390779363,2.8540065862
31,45,2004,110,96,-241,998,5,14,-236,-235,8884,12.220185525,10.664889185,-26.77331556,-13,0.5554629784,1.5552963395,-26.21785258
31,45,2005,103,100,-92,963,2,3,-90,-94,8790,11.65553921,11.316057486,-10.41077289,-7,0.2263211497,0.3394817246,-10.18445174
31,45,2006,100,82,-103,929,4,18,-99,-85,8705,11.431837668,9.3741068877,-11.7747928,-4,0.4572735067,2.0577307802,-11.31751929
31,45,2007,103,78,75,1079,2,25,77,106,8811,11.760675953,8.906142955,8.5635989952,4,0.2283626399,2.8545329984,8.7919616351
31,45,2008,121,84,-130,1059,2,37,-128,-87,8724,13.80096949,9.5808383234,-14.82748788,4,0.2281151982,4.2201311662,-14.59937268
31,47,2001,448,226,-416,473,207,222,-209,-3,24383,18.372326683,9.268182657,-17.06001763,-16,8.4889991593,9.1041440259,-8.571018475
31,47,2002,419,224,-546,473,195,195,-351,-162,24221,17.24137931,9.2173483664,-22.46728664,-6,8.024030944,8.024030944,-14.4432557
31,47,2003,411,214,-286,473,173,197,-113,64,24285,16.946357152,8.8236506824,-11.79235558,-20,7.1331381685,8.1227064693,-4.659217416
31,47,2004,498,227,-408,473,161,271,-247,-4,24281,20.508174443,9.3481036116,-16.80187786,-28,6.6301527818,11.160070831,-10.17172508
31,47,2005,466,216,-382,473,165,250,-217,13,24294,19.186824498,8.8934637159,-15.72825528,-20,6.7936181163,10.293360782,-8.934637159
31,47,2006,374,228,-36,473,165,146,129,262,24556,15.312180143,9.3346980553,-1.473899693,-13,6.7553735926,5.977482088,5.2814738997
31,47,2007,452,210,-410,473,155,242,-255,0,24556,18.406906662,8.5518814139,-16.69653038,13,6.3121029484,9.8550252484,-10.38442743
31,47,2008,446,185,-310,473,155,261,-155,109,24665,18.122346153,7.5171166778,-12.59624957,3,6.2981247841,10.605229475,-6.298124784
31,49,2001,20,29,-8,23,1,-9,-7,-17,2083,9.5625149414,13.865646665,-3.825005977,-1,0.4781257471,-4.303131724,-3.34688023
31,49,2002,19,31,-59,23,1,-12,-58,-71,2012,9.2796092796,15.14041514,-28.81562882,-1,0.4884004884,-5.860805861,-28.32722833
31,49,2003,18,47,10,23,1,-29,11,-20,1992,8.991008991,23.476523477,4.995004995,-2,0.4995004995,-14.48551449,5.4945054945
31,49,2004,21,26,-11,23,0,-5,-11,-18,1974,10.590015129,13.111447302,-5.547150782,-2,0,-2.521432173,-5.547150782
31,49,2005,20,30,-30,23,1,-10,-29,-40,1934,10.235414534,15.353121801,-15.3531218,-1,0.5117707267,-5.117707267,-14.84135107
31,49,2006,20,25,-29,23,0,-5,-29,-36,1898,10.438413361,13.048016701,-15.13569937,-2,0,-2.60960334,-15.13569937
31,49,2007,22,22,-12,23,1,0,-11,-11,1887,11.624834875,11.624834875,-6.340819022,0,0.5284015852,0,-5.812417437
31,49,2008,20,25,-4,23,0,-5,-4,-7,1880,10.618529334,13.273161667,-2.123705867,2,0,-2.654632333,-2.123705867
31,51,2001,75,71,-79,111,14,4,-65,-65,6251,11.936022917,11.299435028,-12.57261081,-4,2.2280576112,0.6365878889,-10.34455319
31,51,2002,77,84,-71,111,14,-7,-57,-67,6184,12.384398874,13.510253317,-11.41938078,-3,2.2517088862,-1.125854443,-9.167671894
31,51,2003,82,66,-82,111,6,16,-76,-64,6120,13.3289987,10.728218466,-13.3289987,-4,0.9752925878,2.6007802341,-12.35370611
31,51,2004,72,64,-64,111,7,8,-57,-54,6066,11.816838996,10.503856885,-10.50385688,-5,1.1488593468,1.3129821106,-9.354997538
31,51,2005,65,72,72,111,7,-7,79,72,6138,10.652245166,11.799410029,11.799410029,0,1.147164864,-1.147164864,12.946574893
31,51,2006,86,59,-16,111,7,27,-9,15,6153,13.993979334,9.6005207062,-2.603531039,-3,1.1390448296,4.3934586283,-1.464486209
31,51,2007,86,75,73,111,5,11,78,66,6219,13.902360168,12.124151309,11.800840608,-23,0.808276754,1.7782088587,12.609117362
31,51,2008,90,70,85,111,4,20,89,74,6293,14.386189258,11.189258312,13.586956522,-35,0.6393861893,3.1969309463,14.226342711
31,53,2001,468,403,-272,1199,34,65,-238,-201,36019,12.956989992,11.157408048,-7.530558286,-28,0.9413197857,1.7995819433,-6.5892385
31,53,2002,456,408,-252,1167,33,48,-219,-197,35822,12.694700798,11.358416503,-7.015492546,-26,0.9186954525,1.3362842945,-6.096797094
31,53,2003,483,402,-68,1150,26,81,-42,-7,35815,13.484651786,11.223250555,-1.898460293,-46,0.7258818767,2.2614012312,-1.172578416
31,53,2004,532,427,-131,1089,27,105,-104,-29,35786,14.860127652,11.927207721,-3.659166771,-30,0.7541794109,2.9329199313,-2.904987361
31,53,2005,507,390,-66,1119,26,117,-40,48,35834,14.158056409,10.890812622,-1.843060598,-29,0.7260541748,3.2672437867,-1.117006423
31,53,2006,498,377,-111,1131,28,121,-83,22,35856,13.893151067,10.517505928,-3.096666202,-16,0.7811410239,3.3756451388,-2.315525178
31,53,2007,507,410,-60,1179,23,97,-37,55,35911,14.12905653,11.425864255,-1.672077696,-5,0.6409631168,2.703192275,-1.031114579
31,53,2008,539,389,-217,1085,23,150,-194,-39,35872,15.017483248,10.838220749,-6.045999749,5,0.6408202499,4.1792624995,-5.405179499
31,55,2001,7697,3659,-1999,11772,1641,4038,-358,3254,467928,16.506505455,7.8468628633,-4.286930545,-426,3.5191861051,8.6596425914,-0.76774444
31,55,2002,7705,3672,-1590,11896,1501,4033,-89,3517,471445,16.404559211,7.8179807169,-3.385236748,-427,3.1957486536,8.5865784944,-0.189488095
31,55,2003,8073,3667,-613,11887,1254,4406,641,4354,475799,17.045238608,7.7424612877,-1.294281093,-693,2.6476810621,9.3027773203,1.3533999688
31,55,2004,8209,3625,-430,11795,1266,4584,836,5105,480904,17.161020714,7.5781094028,-0.898920564,-315,2.6465893804,9.582911311,1.7476688168
31,55,2005,8291,3520,17,11963,1280,4771,1297,5593,486497,17.140772027,7.2772304349,0.0351457152,-475,2.6462656127,9.8635415924,2.6814113279
31,55,2006,8314,3541,-925,12116,1302,4773,377,4911,491408,17.003696678,7.2420122609,-1.891799306,-239,2.662835347,9.7616844172,0.7710360413
31,55,2007,8579,3630,-1602,12339,1157,4949,-445,4539,495947,17.377741542,7.352978412,-3.245033448,35,2.343635268,10.02476313,-0.90139818
31,55,2008,8615,3632,-174,12398,1168,4983,994,6085,502032,17.264892347,7.2787102735,-0.348704732,108,2.3407306166,9.986182074,1.9920258843
31,57,2001,19,26,-90,87,2,-7,-88,-95,2197,8.4651370016,11.583871686,-40.09801738,0,0.8910670528,-3.118734685,-39.20695032
31,57,2002,25,31,-19,87,2,-6,-17,-25,2172,11.444266423,14.190890364,-8.697642481,-2,0.9155413138,-2.746623941,-7.782101167
31,57,2003,18,29,18,87,-2,-11,16,3,2175,8.281573499,13.342535082,8.281573499,-2,-0.920174833,-5.060961583,7.3613986657
31,57,2004,19,32,-11,87,2,-13,-9,-23,2152,8.7820660966,14.790848163,-5.084354056,-1,0.9244280102,-6.008782066,-4.159926046
31,57,2005,16,34,-50,87,0,-18,-50,-68,2084,7.5542965061,16.052880076,-23.60717658,0,0,-8.498583569,-23.60717658
31,57,2006,23,38,-19,87,2,-15,-17,-34,2050,11.127237542,18.384131592,-9.192065796,-2,0.9675858732,-7.256894049,-8.224479923
31,57,2007,17,18,-27,87,0,-1,-27,-27,2023,8.3476552909,8.8386938375,-13.25804076,1,0,-0.491038547,-13.25804076
31,57,2008,18,17,-24,87,0,1,-24,-21,2002,8.9440993789,8.4472049689,-11.92546584,2,0,0.4968944099,-11.92546584
31,59,2001,74,98,-75,271,4,-24,-71,-100,6513,11.275331403,14.932195642,-11.42770075,-5,0.6094773732,-3.656864239,-10.81822337
31,59,2002,61,99,-77,254,4,-38,-73,-115,6398,9.4493067927,15.335760204,-11.92781349,-4,0.6196266749,-5.886453412,-11.30818682
31,59,2003,78,84,11,258,3,-6,14,-1,6397,12.192262603,13.130128957,1.7194216491,-9,0.468933177,-0.937866354,2.1883548261
31,59,2004,72,93,-53,259,2,-21,-51,-78,6319,11.324315823,14.627241271,-8.335954703,-6,0.3145643284,-3.302925448,-8.021390374
31,59,2005,44,94,-92,273,3,-50,-89,-145,6174,7.043944609,15.048427119,-14.72824782,-6,0.4802689506,-8.00448251,-14.24797887
31,59,2006,73,103,-37,257,2,-30,-35,-68,6106,11.889250814,16.7752443,-6.026058632,-3,0.325732899,-4.885993485,-5.700325733
31,59,2007,59,71,-71,242,2,-12,-69,-80,6026,9.7263435542,11.704582921,-11.70458292,1,0.3297065612,-1.978239367,-11.37487636
31,59,2008,63,87,-5,244,1,-24,-4,-25,6001,10.476428037,14.467448241,-0.831462543,3,0.1662925085,-3.991020205,-0.665170034
31,61,2001,27,69,-48,106,2,-42,-46,-90,3458,7.7076791322,19.697402227,-13.70254068,-2,0.570939195,-11.98972309,-13.13160148
31,61,2002,33,46,17,106,2,-13,19,4,3462,9.5375722543,13.294797688,4.9132947977,-2,0.5780346821,-3.757225434,5.4913294798
31,61,2003,27,63,-18,106,1,-36,-17,-56,3406,7.862550961,18.345952242,-5.241700641,-3,0.2912055911,-10.48340128,-4.95049505
31,61,2004,26,41,-23,106,0,-15,-23,-41,3365,7.6798109585,12.110471127,-6.793678925,-3,0,-4.430660168,-6.793678925
31,61,2005,36,53,17,106,1,-17,18,-2,3363,10.701545779,15.755053508,5.0535077289,-3,0.2972651605,-5.053507729,5.3507728894
31,61,2006,34,48,-55,106,0,-14,-55,-70,3293,10.216346154,14.423076923,-16.52644231,-1,0,-4.206730769,-16.52644231
31,61,2007,30,37,-136,106,1,-7,-135,-141,3152,9.3095422808,11.481768813,-42.20325834,1,0.310318076,-2.172226532,-41.89294026
31,61,2008,29,51,-30,106,0,-22,-30,-49,3103,9.2725819345,16.306954436,-9.592326139,3,0,-7.034372502,-9.592326139
31,63,2001,27,33,-41,144,2,-6,-39,-48,3039,8.8148873653,10.773751224,-13.3855697,-3,0.6529546197,-1.958863859,-12.73261508
31,63,2002,30,32,-63,144,2,-2,-61,-64,2975,9.9767209844,10.641835717,-20.95111407,-1,0.6651147323,-0.665114732,-20.28599933
31,63,2003,26,33,-82,144,1,-7,-81,-88,2887,8.8706925964,11.258955988,-27.97679973,0,0.3411804845,-2.388263391,-27.63561924
31,63,2004,19,16,-22,144,0,3,-22,-22,2865,6.6063977747,5.5632823366,-7.649513213,-3,0,1.0431154381,-7.649513213
31,63,2005,41,28,-90,144,1,13,-89,-76,2789,14.503006721,9.9044923948,-31.83586841,0,0.3537318712,4.5985143261,-31.48213654
31,63,2006,18,19,-75,144,0,-1,-75,-77,2712,6.5442646791,6.9078349391,-27.2677695,-1,0,-0.36357026,-27.2677695
31,63,2007,31,23,-57,144,1,8,-56,-54,2658,11.545623836,8.5661080074,-21.22905028,-6,0.3724394786,2.9795158287,-20.8566108
31,63,2008,27,20,-72,144,0,7,-72,-74,2584,10.301411675,7.6306753148,-27.47043113,-9,0,2.6707363602,-27.47043113
31,65,2001,60,83,-81,134,1,-23,-80,-105,5185,11.455847255,15.84725537,-15.46539379,-2,0.1909307876,-4.391408115,-15.27446301
31,65,2002,62,98,27,134,1,-36,28,-12,5173,11.971423055,18.922571925,5.2133616528,-4,0.1930874686,-6.95114887,5.4064491215
31,65,2003,38,78,-54,134,1,-40,-53,-97,5076,7.4153575959,15.22099717,-10.53761343,-4,0.1951409894,-7.805639575,-10.34247244
31,65,2004,59,78,-107,134,0,-19,-107,-130,4946,11.774096987,15.565755338,-21.35302335,-4,0,-3.791658352,-21.35302335
31,65,2005,45,69,-71,134,1,-24,-70,-99,4847,9.190237925,14.091698152,-14.50015317,-5,0.2042275094,-4.901460227,-14.29592566
31,65,2006,45,77,-8,134,0,-32,-8,-41,4806,9.3235263649,15.953589558,-1.657515798,-1,0,-6.630063193,-1.657515798
31,65,2007,43,69,-80,134,1,-26,-79,-102,4704,9.0431125131,14.511041009,-16.82439537,3,0.2103049422,-5.467928496,-16.61409043
31,65,2008,41,73,-32,134,0,-32,-32,-59,4645,8.7709915499,15.616643491,-6.845651941,5,0,-6.845651941,-6.845651941
31,67,2001,281,294,149,1036,3,-13,152,117,23092,12.199622289,12.764017627,6.4688388651,-22,0.1302450778,-0.564395337,6.599083943
31,67,2002,254,255,44,1036,2,-1,46,25,23117,10.993529399,11.036811011,1.9043909195,-20,0.0865632236,-0.043281612,1.9909541431
31,67,2003,283,283,77,1036,-1,0,76,50,23167,12.228847982,12.228847982,3.3272837266,-26,-0.043211477,0,3.2840722496
31,67,2004,275,272,40,1036,5,3,45,33,23200,11.86188453,11.732482153,1.7253650225,-15,0.2156706278,0.1294023767,1.9410356504
31,67,2005,274,287,-127,1036,2,-13,-125,-157,23043,11.850442229,12.412689488,-5.492723223,-19,0.0864995783,-0.562247259,-5.406223645
31,67,2006,278,278,94,1036,4,0,98,86,23129,12.041930174,12.041930174,4.0717317855,-12,0.1732651824,0,4.2449969679
31,67,2007,268,280,46,1036,2,-12,48,32,23161,11.579174768,12.09764528,1.987470296,-4,0.086411752,-0.518470512,2.073882048
31,67,2008,283,263,-155,1036,2,20,-153,-126,23035,12.252143043,11.386267209,-6.710537709,7,0.0865875833,0.8658758334,-6.623950126
31,69,2001,15,35,6,60,1,-20,7,-15,2265,6.600660066,15.401540154,2.6402640264,-2,0.4400440044,-8.800880088,3.0803080308
31,69,2002,14,38,-30,60,1,-24,-29,-55,2210,6.2569832402,16.983240223,-13.40782123,-2,0.4469273743,-10.72625698,-12.96089385
31,69,2003,15,32,4,60,1,-17,5,-15,2195,6.8104426788,14.528944381,1.8161180477,-3,0.4540295119,-7.718501703,2.2701475596
31,69,2004,18,35,-66,60,0,-17,-66,-85,2110,8.362369338,16.260162602,-30.66202091,-2,0,-7.897793264,-30.66202091
31,69,2005,15,44,-127,60,1,-29,-126,-155,1955,7.3800738007,21.648216482,-62.48462485,0,0.49200492,-14.26814268,-61.99261993
31,69,2006,18,28,-27,60,0,-10,-27,-39,1916,9.2999225006,14.466546112,-13.94988375,-2,0,-5.166623611,-13.94988375
31,69,2007,16,27,-70,60,1,-11,-69,-89,1827,8.5492920118,14.42693027,-37.40315255,-9,0.5343307507,-5.877638258,-36.8688218
31,69,2008,12,22,-37,60,0,-10,-37,-62,1765,6.6815144766,12.249443207,-20.6013363,-15,0,-5.567928731,-20.6013363
31,71,2001,23,39,-5,57,2,-16,-3,-19,1872,12.224289131,20.72814244,-2.657454159,0,1.0629816636,-8.503853309,-1.594472495
31,71,2002,16,39,20,57,2,-23,22,-4,1868,8.5561497326,20.855614973,10.695187166,-3,1.0695187166,-12.29946524,11.764705882
31,71,2003,17,37,-25,57,1,-20,-24,-44,1824,9.2091007584,20.043336945,-13.54279523,0,0.5417118093,-10.83423619,-13.00108342
31,71,2004,20,47,13,57,0,-27,13,-15,1809,11.010184421,25.873933388,7.1566198734,-1,0,-14.86374897,7.1566198734
31,71,2005,14,24,-12,57,1,-10,-11,-24,1785,7.7907623817,13.355592654,-6.677796327,-3,0.5564830273,-5.564830273,-6.1213133
31,71,2006,16,31,-16,57,0,-15,-16,-31,1754,9.0421022888,17.519073185,-9.042102289,0,0,-8.476970896,-9.042102289
31,71,2007,16,27,-30,57,1,-11,-29,-40,1714,9.2272202999,15.570934256,-17.30103806,0,0.5767012687,-6.343713956,-16.72433679
31,71,2008,16,24,2,57,0,-8,2,-4,1710,9.3457943925,14.018691589,1.1682242991,2,0,-4.672897196,1.1682242991
31,73,2001,27,31,-65,51,1,-4,-64,-68,2073,12.814428097,14.712861889,-30.84954912,0,0.474608448,-1.898433792,-30.37494067
31,73,2002,30,30,-15,51,1,0,-14,-17,2056,14.531363526,14.531363526,-7.265681763,-3,0.4843787842,0,-6.781302979
31,73,2003,26,28,15,51,1,-2,16,12,2068,12.609117362,13.579049467,7.2744907856,-2,0.4849660524,-0.969932105,7.759456838
31,73,2004,14,28,-24,51,0,-14,-24,-41,2027,6.8376068376,13.675213675,-11.72161172,-3,0,-6.837606838,-11.72161172
31,73,2005,30,30,-23,51,1,0,-22,-23,2004,14.884644009,14.884644009,-11.41156041,-1,0.4961548003,0,-10.91540561
31,73,2006,17,17,-48,51,0,0,-48,-49,1955,8.5880272796,8.5880272796,-24.24854761,-1,0,0,-24.24854761
31,73,2007,25,14,13,51,1,11,14,20,1975,12.72264631,7.1246819338,6.6157760814,-5,0.5089058524,5.5979643766,7.1246819338
31,73,2008,20,25,-43,51,0,-5,-43,-49,1926,10.253781082,12.817226352,-22.04562933,-1,0,-2.56344527,-22.04562933
31,75,2001,7,4,-4,0,1,3,-3,0,746,9.3833780161,5.3619302949,-5.361930295,0,1.3404825737,4.0214477212,-4.021447721
31,75,2002,3,4,-27,0,1,-1,-26,-28,718,4.0983606557,5.4644808743,-36.8852459,-1,1.3661202186,-1.366120219,-35.51912568
31,75,2003,7,8,-39,0,1,-1,-38,-37,681,10.007147963,11.436740529,-55.75411008,2,1.4295925661,-1.429592566,-54.32451751
31,75,2004,7,7,-22,0,0,0,-22,-23,658,10.455563854,10.455563854,-32.86034354,-1,0,0,-32.86034354
31,75,2005,6,3,-17,0,1,3,-16,-12,646,9.2024539877,4.6012269939,-26.07361963,1,1.5337423313,4.6012269939,-24.5398773
31,75,2006,3,4,-8,0,0,-1,-8,-10,636,4.6801872075,6.24024961,-12.48049922,-1,0,-1.560062402,-12.48049922
31,75,2007,6,4,-26,0,1,2,-25,-25,611,9.623095429,6.4153969527,-41.70008019,-2,1.6038492382,3.2076984763,-40.09623095
31,75,2008,5,3,-5,0,0,2,-5,-7,604,8.2304526749,4.9382716049,-8.230452675,-4,0,3.29218107,-8.230452675
31,77,2001,34,33,-44,62,1,1,-43,-43,2662,12.670020496,12.297372834,-16.39649711,-1,0.3726476616,0.3726476616,-16.02384945
31,77,2002,28,34,-28,62,1,-6,-27,-36,2626,10.590015129,12.859304085,-10.59001513,-3,0.378214826,-2.269288956,-10.2118003
31,77,2003,30,43,-52,62,1,-13,-51,-63,2563,11.562921565,16.57352091,-20.04239738,1,0.3854307188,-5.010599345,-19.65696666
31,77,2004,35,32,-47,62,0,3,-47,-48,2515,13.784954707,12.60338716,-18.51122489,-4,0,1.1815675463,-18.51122489
31,77,2005,27,36,-83,62,1,-9,-82,-91,2424,10.933387325,14.577849767,-33.61004252,0,0.4049402713,-3.644462442,-33.20510225
31,77,2006,25,32,-24,62,0,-7,-24,-33,2391,10.384215992,13.291796469,-9.968847352,-2,0,-2.907580478,-9.968847352
31,77,2007,28,24,-78,62,1,4,-77,-79,2312,11.907293217,10.206251329,-33.17031682,-6,0.425260472,1.7010418882,-32.74505635
31,77,2008,26,26,-17,62,0,0,-17,-22,2290,11.299435028,11.299435028,-7.388092134,-5,0,0,-7.388092134
31,79,2001,893,488,-729,1253,265,405,-464,-95,53397,16.70892234,9.1309676393,-13.64031846,-36,4.9584148041,7.5779547007,-8.681903657
31,79,2002,918,510,-437,1253,255,408,-182,188,53585,17.161765531,9.5343141837,-8.169598624,-38,4.7671570918,7.627451347,-3.402441532
31,79,2003,948,479,-366,1253,224,469,-142,273,53858,17.646566086,8.916355649,-6.812914755,-54,4.1696527461,8.7302104372,-2.643262009
31,79,2004,920,513,-230,1254,201,407,-29,335,54193,17.028995567,9.4955160063,-4.257248892,-43,3.7204653358,7.5334795606,-0.536783556
31,79,2005,934,483,-537,1254,216,451,-321,84,54277,17.221351526,8.9056882087,-9.901355213,-46,3.9826680188,8.315663317,-5.918687195
31,79,2006,965,514,-64,1253,210,451,146,568,54845,17.686625978,9.4206484485,-1.172999029,-29,3.8489030626,8.2659775297,2.675904034
31,79,2007,970,521,-82,1254,189,449,107,549,55394,17.598127704,9.4521902412,-1.487676775,-7,3.4289135424,8.1459374631,1.9412367674
31,79,2008,974,481,308,1253,189,493,497,1007,56401,17.42475066,8.6050360034,5.5100854242,17,3.381188783,8.8197146563,8.8912742073
31,81,2001,102,95,-54,148,1,7,-53,-53,9327,10.90500882,10.156625862,-5.773239964,-7,0.1069118512,0.7483829583,-5.666328112
31,81,2002,121,95,12,148,1,26,13,29,9356,12.952951881,10.169672965,1.2845902692,-10,0.1070491891,2.7832789167,1.3916394583
31,81,2003,117,104,34,148,1,13,35,36,9392,12.481331342,11.094516748,3.6270535524,-12,0.1066780457,1.3868145936,3.733731598
31,81,2004,118,91,-32,148,0,27,-32,-13,9379,12.572585371,9.6958073624,-3.409514677,-8,0,2.8767780086,-3.409514677
31,81,2005,98,95,-32,148,1,3,-31,-38,9341,10.47008547,10.14957265,-3.418803419,-10,0.1068376068,0.3205128205,-3.311965812
31,81,2006,92,93,-89,148,0,-1,-89,-92,9249,9.8977945132,10.005379236,-9.575040344,-2,0,-0.107584723,-9.575040344
31,81,2007,101,74,5,148,1,27,6,33,9282,10.90065296,7.9866170201,0.5396362851,0,0.107927257,2.9140359398,0.6475635422
31,81,2008,110,92,-5,148,0,18,-5,18,9300,11.839414487,9.9020557529,-0.538155204,5,0,1.9373587343,-0.538155204
31,83,2001,29,42,-37,55,1,-13,-36,-54,3716,7.7477958857,11.220945765,-9.885118889,-5,0.2671653754,-3.47314988,-9.617953513
31,83,2002,33,38,-70,55,1,-5,-69,-77,3639,8.9734874235,10.33310673,-19.03467029,-3,0.2719238613,-1.359619307,-18.76274643
31,83,2003,29,35,23,55,1,-6,24,14,3653,7.9539221064,9.5995611629,6.3082830499,-4,0.2742731761,-1.645639057,6.582556226
31,83,2004,33,61,-70,55,0,-28,-70,-101,3552,9.1603053435,16.932685635,-19.43095073,-3,0,-7.772380291,-19.43095073
31,83,2005,36,51,-80,55,1,-15,-79,-96,3456,10.273972603,14.554794521,-22.83105023,-2,0.2853881279,-4.280821918,-22.5456621
31,83,2006,30,35,-48,55,0,-5,-48,-55,3401,8.7501822955,10.208546011,-14.00029167,-2,0,-1.458363716,-14.00029167
31,83,2007,38,38,-5,55,1,0,-4,-10,3391,11.189634865,11.189634865,-1.472320377,-6,0.2944640754,0,-1.177856302
31,83,2008,34,32,-61,55,0,2,-61,-69,3322,10.129599285,9.5337405035,-18.17369283,-10,0,0.5958587815,-18.17369283
31,85,2001,7,11,19,0,1,-4,20,16,1086,6.4935064935,10.204081633,17.625231911,0,0.9276437848,-3.710575139,18.552875696
31,85,2002,10,6,4,0,1,4,5,9,1095,9.1701054562,5.5020632737,3.6680421825,0,0.9170105456,3.6680421825,4.5850527281
31,85,2003,13,7,-15,0,1,6,-14,-9,1086,11.921137093,6.4190738193,-13.75515818,-1,0.9170105456,5.5020632737,-12.83814764
31,85,2004,7,11,-26,0,0,-4,-26,-31,1055,6.5390004671,10.275572163,-24.28771602,-1,0,-3.736571695,-24.28771602
31,85,2005,9,7,-17,0,1,2,-16,-13,1042,8.5836909871,6.6762041011,-16.21363853,1,0.953743443,1.907486886,-15.25989509
31,85,2006,6,10,-47,0,0,-4,-47,-52,990,5.905511811,9.842519685,-46.25984252,-1,0,-3.937007874,-46.25984252
31,85,2007,7,5,-14,0,1,2,-13,-12,978,7.1138211382,5.081300813,-14.22764228,-1,1.0162601626,2.0325203252,-13.21138211
31,85,2008,7,2,24,0,0,5,24,27,1005,7.0600100857,2.0171457388,24.205748865,-2,0,5.0428643469,24.205748865
31,87,2001,25,37,-3,61,0,-12,-3,-18,3086,8.0775444265,11.954765751,-0.969305331,-3,0,-3.877221325,-0.969305331
31,87,2002,33,46,-36,61,0,-13,-36,-50,3036,10.780790591,15.027768703,-11.76086246,-1,0,-4.246978112,-11.76086246
31,87,2003,32,48,-1,61,-1,-16,-2,-22,3014,10.578512397,15.867768595,-0.330578512,-4,-0.330578512,-5.289256198,-0.661157025
31,87,2004,44,46,2,61,0,-2,2,-3,3011,14.605809129,15.269709544,0.6639004149,-3,0,-0.663900415,0.6639004149
31,87,2005,21,39,-91,61,0,-18,-91,-110,2901,7.1041948579,13.193504736,-30.78484438,-1,0,-6.089309878,-30.78484438
31,87,2006,30,37,-13,61,0,-7,-13,-22,2879,10.380622837,12.802768166,-4.498269896,-2,0,-2.422145329,-4.498269896
31,87,2007,28,30,-41,61,0,-2,-41,-45,2834,9.8022054962,10.502363032,-14.35322948,-2,0,-0.700157535,-14.35322948
31,87,2008,33,39,7,61,-1,-6,6,2,2836,11.64021164,13.756613757,2.4691358025,2,-0.352733686,-2.116402116,2.1164021164
31,89,2001,120,116,-185,225,2,4,-183,-186,11301,10.531858873,10.180796911,-16.23661576,-7,0.1755309812,0.3510619624,-16.06108478
31,89,2002,136,143,-171,225,2,-7,-169,-181,11120,12.131483877,12.755898488,-15.25355693,-5,0.1784041747,-0.624414611,-15.07515276
31,89,2003,108,130,-187,225,1,-22,-186,-213,10907,9.8061470014,11.803695465,-16.97916194,-5,0.0907976574,-1.997548463,-16.88836428
31,89,2004,114,123,-195,225,4,-9,-191,-213,10694,10.555066895,11.38836165,-18.05471969,-13,0.3703532244,-0.833294755,-17.68436646
31,89,2005,127,143,-46,225,2,-16,-44,-71,10623,11.915372707,13.416522025,-4.315804288,-11,0.1876436647,-1.501149317,-4.128160623
31,89,2006,123,136,-206,225,3,-13,-203,-220,10403,11.699800247,12.936364501,-19.59478741,-4,0.2853609816,-1.236564254,-19.30942642
31,89,2007,118,117,-101,225,1,1,-100,-93,10310,11.39381065,11.297252933,-9.752329455,6,0.0965577174,0.0965577174,-9.655771738
31,89,2008,124,129,-82,225,1,-5,-81,-77,10233,12.072238719,12.559022538,-7.983254637,9,0.0973567639,-0.486783819,-7.885897873
31,91,2001,9,9,-30,26,1,0,-29,-29,753,11.726384365,11.726384365,-39.08794788,0,1.3029315961,0,-37.78501629
31,91,2002,7,14,-12,26,1,-7,-11,-18,735,9.4086021505,18.817204301,-16.12903226,0,1.3440860215,-9.408602151,-14.78494624
31,91,2003,7,11,6,26,1,-4,7,3,738,9.5044127631,14.935505771,8.1466395112,0,1.3577732519,-5.431093007,9.5044127631
31,91,2004,10,13,13,26,0,-3,13,9,747,13.468013468,17.508417508,17.508417508,-1,0,-4.04040404,17.508417508
31,91,2005,5,15,2,26,1,-10,3,-6,741,6.7204301075,20.161290323,2.688172043,1,1.3440860215,-13.44086022,4.0322580645
31,91,2006,3,8,9,26,0,-5,9,3,744,4.0404040404,10.774410774,12.121212121,-1,0,-6.734006734,12.121212121
31,91,2007,8,12,-11,26,1,-4,-10,-15,729,10.862186015,16.293279022,-14.93550577,-1,1.3577732519,-5.431093007,-13.57773252
31,91,2008,11,9,5,26,0,2,5,7,736,15.017064846,12.28668942,6.8259385666,0,0,2.7303754266,6.8259385666
31,93,2001,65,66,-55,42,2,-1,-53,-59,6483,9.980806142,10.134357006,-8.445297505,-5,0.3071017274,-0.153550864,-8.138195777
31,93,2002,54,54,0,42,2,0,2,-5,6478,8.3326903788,8.3326903788,0,-7,0.3086181622,0,0.3086181622
31,93,2003,93,65,73,42,1,28,74,96,6574,14.250689549,9.9601593625,11.18602513,-6,0.153233221,4.2905301869,11.339258351
31,93,2004,76,65,-33,42,0,11,-33,-27,6547,11.58448289,9.9077814191,-5.030104413,-5,0,1.6767014709,-5.030104413
31,93,2005,94,60,-51,42,1,34,-50,-20,6527,14.379684871,9.1785222579,-7.801743919,-4,0.152975371,5.2011626128,-7.648768548
31,93,2006,70,77,2,42,0,-7,2,-9,6518,10.732081257,11.805289383,0.3066308931,-4,0,-1.073208126,0.3066308931
31,93,2007,76,57,44,42,1,19,45,57,6575,11.609256855,8.7069426411,6.7211487054,-7,0.1527533797,2.9023142137,6.8739020851
31,93,2008,86,63,7,42,0,23,7,18,6593,13.061968408,9.5686512758,1.0631834751,-12,0,3.4933171324,1.0631834751
31,95,2001,95,113,-61,166,1,-18,-60,-85,8253,11.451992044,13.621843168,-7.353384365,-7,0.1205472847,-2.169851124,-7.23283708
31,95,2002,78,109,-47,166,1,-31,-46,-86,8167,9.5006090134,13.276492083,-5.724725944,-9,0.1218026797,-3.775883069,-5.602923264
31,95,2003,86,102,-127,166,1,-16,-126,-145,8022,10.624498116,12.601148928,-15.68966582,-3,0.1235406758,-1.976650812,-15.56612515
31,95,2004,83,103,-61,166,0,-20,-61,-87,7935,10.402957949,12.909694805,-7.645547409,-6,0,-2.506736855,-7.645547409
31,95,2005,83,99,-118,166,1,-16,-117,-138,7797,10.551741673,12.585812357,-15.00127129,-5,0.1271294177,-2.034070684,-14.87414188
31,95,2006,77,104,-69,166,0,-27,-69,-99,7698,9.9386899,13.42368506,-8.906098742,-3,0,-3.48499516,-8.906098742
31,95,2007,77,106,-167,166,1,-29,-166,-193,7505,10.129579688,13.944616194,-21.96934815,2,0.131552983,-3.815036506,-21.83779517
31,95,2008,73,102,-72,166,0,-29,-72,-100,7405,9.7920858484,13.682092555,-9.657947686,1,0,-3.890006707,-9.657947686
31,97,2001,48,55,-116,62,5,-7,-111,-121,4360,10.85850017,12.442031444,-26.24137541,-3,1.1310937677,-1.583531275,-25.11028164
31,97,2002,27,59,0,62,4,-32,4,-32,4328,6.2154696133,13.581952118,0,-4,0.9208103131,-7.366482505,0.9208103131
31,97,2003,59,54,152,107,0,5,152,158,4486,13.387792149,12.253233492,34.490583163,1,0,1.1345586567,34.490583163
31,97,2004,49,60,280,383,1,-11,281,265,4751,10.609505251,12.991230919,60.625744289,-5,0.2165205153,-2.381725669,60.842264805
31,97,2005,65,48,-175,310,1,17,-174,-155,4596,13.908205841,10.270675083,-37.44516957,2,0.2139723976,3.6375307585,-37.23119718
31,97,2006,55,63,0,412,1,-8,1,-11,4585,11.981265657,13.723995207,0,-4,0.2178411938,-1.74272955,0.2178411938
31,97,2007,55,64,-112,399,1,-9,-111,-118,4467,12.152010605,14.140521432,-24.74591251,2,0.2209456474,-1.988510826,-24.52496686
31,97,2008,48,67,72,459,0,-19,72,32,4499,10.707115771,14.945349097,16.060673656,-21,0,-4.238233326,16.060673656
31,99,2001,64,71,-42,262,0,-7,-42,-56,6830,9.3321668125,10.352872558,-6.124234471,-7,0,-1.020705745,-6.124234471
31,99,2002,74,81,-50,262,-1,-7,-51,-63,6767,10.88475399,11.914392881,-7.354563507,-5,-0.14709127,-1.029638891,-7.501654777
31,99,2003,73,67,10,262,-1,6,9,5,6772,10.783662013,9.8973336288,1.4772139744,-10,-0.147721397,0.8863283847,1.329492577
31,99,2004,79,74,-33,262,1,5,-32,-31,6741,11.692444313,10.952416192,-4.884185599,-4,0.1480056242,0.7400281211,-4.736179975
31,99,2005,86,69,-97,262,-1,17,-98,-88,6653,12.841570853,10.3031208,-14.48409736,-7,-0.149320591,2.5384500523,-14.63341795
31,99,2006,68,77,-97,262,0,-9,-97,-107,6546,10.303810895,11.667550572,-14.69808319,-1,0,-1.363739677,-14.69808319
31,99,2007,78,59,18,262,0,19,18,37,6583,11.882093076,8.9877370706,2.7420214792,0,0,2.8943560058,2.7420214792
31,99,2008,76,69,-114,262,-1,7,-115,-104,6479,11.636809064,10.564997703,-17.4552136,4,-0.153115909,1.0718113612,-17.60832951
31,101,2001,82,102,-118,100,6,-20,-112,-140,8720,9.3287827076,11.604095563,-13.42434585,-8,0.6825938567,-2.275312856,-12.74175199
31,101,2002,103,92,-85,100,6,11,-79,-77,8643,11.864309163,10.59724702,-9.790934746,-9,0.6911248056,1.2670621436,-9.099809941
31,101,2003,86,87,-315,100,6,-1,-309,-303,8340,10.127774834,10.245539657,-37.09591945,7,0.7065889419,-0.117764824,-36.38933051
31,101,2004,89,105,-114,100,5,-16,-109,-132,8208,10.756586899,12.69035533,-13.77810007,-7,0.6043026348,-1.933768431,-13.17379744
31,101,2005,86,89,-86,100,6,-3,-80,-87,8121,10.533406822,10.900851246,-10.53340682,-4,0.7348888481,-0.367444424,-9.798517974
31,101,2006,85,98,-92,100,5,-13,-87,-104,8017,10.534143016,12.145247243,-11.40166068,-4,0.6196554716,-1.611104226,-10.78200521
31,101,2007,107,100,-11,100,6,7,-5,-5,8012,13.350801672,12.47738474,-1.372512321,-7,0.7486430844,0.8734169318,-0.623869237
31,101,2008,98,92,-188,100,5,6,-183,-191,7821,12.379207983,11.62129729,-23.74786838,-14,0.631592244,0.7579106929,-23.11627613
31,103,2001,12,6,-24,0,1,6,-23,-18,961,12.371134021,6.1855670103,-24.74226804,-1,1.0309278351,6.1855670103,-23.71134021
31,103,2002,12,11,-13,0,1,1,-12,-11,950,12.558869702,11.512297227,-13.60544218,0,1.0465724751,1.0465724751,-12.5588697
31,103,2003,9,5,0,0,1,4,1,3,953,9.4587493431,5.2548607462,0,-2,1.0509721492,4.203888597,1.0509721492
31,103,2004,19,8,-33,0,0,11,-33,-23,930,20.180562931,8.497079129,-35.05045141,-1,0,11.683483802,-35.05045141
31,103,2005,8,8,-42,0,1,0,-41,-40,890,8.7912087912,8.7912087912,-46.15384615,1,1.0989010989,0,-45.05494505
31,103,2006,14,6,-23,0,0,8,-23,-15,875,15.864022663,6.7988668555,-26.06232295,0,0,9.0651558074,-26.06232295
31,103,2007,10,8,-23,0,1,2,-22,-24,851,11.587485516,9.2699884125,-26.65121669,-4,1.1587485516,2.3174971031,-25.49246813
31,103,2008,11,2,-16,0,0,9,-16,-15,836,13.040901008,2.3710729105,-18.96858328,-8,0,10.669828097,-18.96858328
31,105,2001,47,46,-35,60,2,1,-33,-34,4024,11.630784459,11.38332096,-8.66122247,-2,0.4949269983,0.2474634991,-8.166295471
31,105,2002,41,60,-18,60,2,-19,-16,-39,3985,10.238481708,14.983143963,-4.494943189,-4,0.4994381321,-4.744662255,-3.995505057
31,105,2003,33,59,-92,60,2,-26,-90,-115,3870,8.4022915341,15.022278803,-23.42457034,1,0.5092297899,-6.619987269,-22.91534055
31,105,2004,31,67,-27,60,1,-36,-26,-65,3805,8.0781758958,17.459283388,-7.035830619,-3,0.2605863192,-9.381107492,-6.7752443
31,105,2005,39,51,-12,60,2,-12,-10,-26,3779,10.284810127,13.449367089,-3.164556962,-4,0.5274261603,-3.164556962,-2.637130802
31,105,2006,55,56,-62,60,1,-1,-61,-64,3715,14.678409394,14.945289565,-16.54657059,-2,0.2668801708,-0.266880171,-16.27969042
31,105,2007,35,54,-110,60,2,-19,-108,-123,3592,9.5798549336,14.780347612,-30.10811551,4,0.5474202819,-5.200492678,-29.56069522
31,105,2008,41,49,-52,60,1,-8,-51,-58,3534,11.50715689,13.752455796,-14.59444289,1,0.2806623632,-2.245298905,-14.31378052
31,107,2001,111,132,-169,244,2,-21,-167,-192,9142,12.01558779,14.288807101,-18.29400303,-4,0.2164970773,-2.273219312,-18.07750595
31,107,2002,105,143,-61,244,2,-38,-59,-104,9038,11.551155116,15.731573157,-6.710671067,-7,0.2200220022,-4.180418042,-6.490649065
31,107,2003,94,133,-32,244,1,-39,-31,-79,8959,10.446185475,14.780241151,-3.556148247,-9,0.1111296327,-4.334055676,-3.445018614
31,107,2004,96,125,-38,244,0,-29,-38,-74,8885,10.759919301,14.010311589,-4.259134723,-7,0,-3.250392289,-4.259134723
31,107,2005,102,137,-123,244,1,-35,-122,-164,8721,11.586958991,15.562876292,-13.97250937,-7,0.1135976372,-3.975917301,-13.85891173
31,107,2006,89,124,-29,244,0,-35,-29,-68,8653,10.245193968,14.274202832,-3.33832163,-4,0,-4.029008864,-3.33832163
31,107,2007,114,123,6,244,1,-9,7,-8,8645,13.180714533,14.22129726,0.6937218176,-6,0.1156203029,-1.040582726,0.8093421205
31,107,2008,107,119,-129,244,0,-12,-129,-147,8498,12.483229306,13.88321764,-15.04987458,-6,0,-1.399988333,-15.04987458
31,109,2001,3711,1684,189,12136,1001,2027,1190,2965,254343,14.676076335,6.6597985846,0.7474477034,-252,3.9587045031,8.01627775,4.7061522065
31,109,2002,3718,1727,960,12342,914,1991,1874,3641,257984,14.514167709,6.7417879596,3.7476065091,-224,3.5680336972,7.7723797497,7.3156402064
31,109,2003,3977,1731,1319,12342,786,2246,2105,4048,262032,15.29568321,6.6574874619,5.0729208332,-303,3.0229839082,8.6381957478,8.0959047414
31,109,2004,4068,1715,-634,11983,791,2353,157,2319,264351,15.456426214,6.5161678854,-2.408892384,-191,3.0054162084,8.940258329,0.5965238239
31,109,2005,4137,1659,621,12495,795,2478,1416,3636,267987,15.54275667,6.2328821162,2.3331041556,-258,2.9868241606,9.3098745534,5.3199283162
31,109,2006,4126,1764,68,12592,809,2362,877,3104,271091,15.307617822,6.5445074739,0.252282601,-135,3.0014209446,8.7631103477,3.2537035457
31,109,2007,4178,1657,371,12961,726,2521,1097,3634,274725,15.309188444,6.0716431911,1.3594324827,16,2.6602371495,9.2375452533,4.0196696323
31,109,2008,4418,1726,470,13297,732,2692,1202,4003,278728,15.965221979,6.2372053273,1.6984278701,109,2.6452110658,9.7280166518,4.3436389359
31,111,2001,497,329,-218,670,20,168,-198,-58,34577,14.361671386,9.5070219037,-6.299485638,-28,0.5779344622,4.8546494827,-5.721551176
31,111,2002,457,366,-300,670,19,91,-281,-215,34362,13.258097739,10.618082653,-8.703346437,-25,0.551211941,2.6400150858,-8.152134496
31,111,2003,467,346,69,670,14,121,83,163,34525,13.55843628,10.04543673,2.0032807351,-41,0.4064627578,3.51299955,2.409743493
31,111,2004,506,337,169,670,18,169,187,328,34853,14.586756609,9.7148952117,4.871861397,-28,0.5188964802,4.871861397,5.3907578771
31,111,2005,463,340,203,670,16,123,219,311,35164,13.225359556,9.7119271034,5.7985917706,-31,0.4570318637,3.5134324521,6.2556236343
31,111,2006,512,339,107,670,18,173,125,279,35443,14.502811336,9.6024473494,3.0308609628,-19,0.509864461,4.9003639866,3.5407254238
31,111,2007,527,356,-193,670,15,171,-178,-8,35435,14.87062276,10.045430176,-5.445977595,-1,0.4232625074,4.8251925844,-5.022715088
31,111,2008,525,342,-44,670,15,183,-29,147,35582,14.785192278,9.6314966839,-1.239139924,-7,0.4224340651,5.153695594,-0.816705859
31,113,2001,12,10,3,0,1,2,4,6,779,15.463917526,12.886597938,3.8659793814,0,1.2886597938,2.5773195876,5.1546391753
31,113,2002,11,14,-16,0,1,-3,-15,-18,761,14.285714286,18.181818182,-20.77922078,0,1.2987012987,-3.896103896,-19.48051948
31,113,2003,12,14,-30,0,1,-2,-29,-30,731,16.085790885,18.766756032,-40.21447721,1,1.3404825737,-2.680965147,-38.87399464
31,113,2004,6,5,0,0,0,1,0,1,732,8.2023239918,6.8352699932,0,0,0,1.3670539986,0
31,113,2005,11,11,6,0,1,0,7,7,739,14.955812373,14.955812373,8.1577158396,0,1.3596193066,0,9.5173351462
31,113,2006,14,7,1,0,0,7,1,8,747,18.842530283,9.4212651413,1.3458950202,0,0,9.4212651413,1.3458950202
31,113,2007,13,1,-15,0,1,12,-14,-1,746,17.414601474,1.3395847287,-20.09377093,1,1.3395847287,16.075016745,-18.7541862
31,113,2008,14,3,-21,0,0,11,-21,-11,735,18.906144497,4.0513166779,-28.35921675,-1,0,14.854827819,-28.35921675
31,115,2001,5,3,8,0,1,2,9,11,721,6.9881201957,4.1928721174,11.180992313,0,1.3976240391,2.7952480783,12.578616352
31,115,2002,8,6,21,0,1,2,22,23,744,10.921501706,8.1911262799,28.66894198,-1,1.3651877133,2.7303754266,30.034129693
31,115,2003,10,9,-12,0,1,1,-11,-10,734,13.531799729,12.178619756,-16.23815968,0,1.3531799729,1.3531799729,-14.8849797
31,115,2004,4,13,-39,0,0,-9,-39,-49,685,5.6377730796,18.322762509,-54.96828753,-1,0,-12.68498943,-54.96828753
31,115,2005,3,5,-14,0,1,-2,-13,-16,669,4.4313146233,7.3855243722,-20.67946824,-1,1.4771048744,-2.954209749,-19.20236337
31,115,2006,4,5,-24,0,0,-1,-24,-25,644,6.092916984,7.61614623,-36.5575019,0,0,-1.523229246,-36.5575019
31,115,2007,3,2,0,0,1,1,1,-2,642,4.66562986,3.1104199067,0,-4,1.5552099533,1.5552099533,1.5552099533
31,115,2008,4,2,-19,0,0,2,-19,-23,619,6.3441712926,3.1720856463,-30.13481364,-6,0,3.1720856463,-30.13481364
31,117,2001,4,1,-6,0,1,3,-5,-3,528,7.5542965061,1.8885741265,-11.33144476,-1,1.8885741265,5.6657223796,-9.442870633
31,117,2002,7,2,4,0,1,5,5,8,536,13.157894737,3.7593984962,7.5187969925,-2,1.8796992481,9.3984962406,9.3984962406
31,117,2003,2,5,-14,0,1,-3,-13,-16,520,3.7878787879,9.4696969697,-26.51515152,0,1.8939393939,-5.681818182,-24.62121212
31,117,2004,3,0,-14,0,0,3,-14,-12,508,5.8365758755,0,-27.23735409,-1,0,5.8365758755,-27.23735409
31,117,2005,5,5,-14,0,1,0,-13,-13,495,9.9700897308,9.9700897308,-27.91625125,0,1.9940179462,0,-25.9222333
31,117,2006,6,4,-14,0,0,2,-14,-12,483,12.26993865,8.1799591002,-28.62985685,0,0,4.0899795501,-28.62985685
31,117,2007,7,3,17,0,1,4,18,21,504,14.184397163,6.0790273556,34.447821682,-1,2.0263424519,8.1053698075,36.474164134
31,117,2008,5,1,9,0,0,4,9,10,514,9.8231827112,1.9646365422,17.68172888,-3,0,7.858546169,17.68172888
31,119,2001,545,308,66,1326,78,237,144,346,35529,15.414639665,8.7113926915,1.8667270053,-35,2.2061319154,6.7032469736,4.0728589207
31,119,2002,549,371,8,1326,77,178,85,227,35756,15.402959949,10.408921933,0.2244511468,-36,2.160342288,4.9940380164,2.3847934348
31,119,2003,573,336,-332,1326,62,237,-270,-58,35698,16.038290369,9.4046519439,-9.292691802,-25,1.7353822039,6.6336384247,-7.557309598
31,119,2004,596,359,-427,1326,61,237,-366,-168,35530,16.734991857,10.080305498,-11.98966698,-39,1.7128095693,6.6546863593,-10.27685742
31,119,2005,601,365,-412,1326,62,236,-350,-138,35392,16.94819661,10.292997941,-11.61839768,-24,1.7483996503,6.655198669,-9.869998026
31,119,2006,542,344,-470,1326,64,198,-406,-224,35168,15.362811791,9.7505668934,-13.32199546,-16,1.8140589569,5.612244898,-11.50793651
31,119,2007,528,347,-1388,1326,52,181,-1336,-1128,34040,15.258351636,10.027742458,-40.11096983,27,1.502716449,5.2306091781,-38.60825338
31,119,2008,522,357,-227,1326,52,165,-175,-20,34020,15.339406406,10.490743462,-6.670584778,-10,1.5280634734,4.8486629445,-5.142521305
31,121,2001,83,75,-133,135,3,8,-130,-126,8038,10.245648685,9.2581162819,-16.41772621,-4,0.3703246513,0.9875324034,-16.04740156
31,121,2002,83,84,-3,135,3,-1,0,-8,8030,10.331092855,10.455563854,-0.373412995,-7,0.3734129948,-0.124470998,0
31,121,2003,105,100,-42,135,3,5,-39,-45,7985,13.112706837,12.488292226,-5.245082735,-11,0.3746487668,0.6244146113,-4.870433968
31,121,2004,86,81,-32,135,2,5,-30,-32,7953,10.791818296,10.164387,-4.015560296,-7,0.2509725185,0.6274312963,-3.764587778
31,121,2005,87,91,-124,135,3,-4,-121,-131,7822,11.030110935,11.537242472,-15.72107765,-6,0.3803486529,-0.507131537,-15.340729
31,121,2006,71,65,-71,135,2,6,-69,-66,7756,9.1154191809,8.345102067,-9.115419181,-3,0.2567723713,0.7703171139,-8.85864681
31,121,2007,79,84,-90,135,2,-5,-88,-91,7665,10.245768757,10.894235134,-11.67239479,2,0.2593865508,-0.648466377,-11.41300824
31,121,2008,84,82,28,135,1,2,29,35,7700,10.933940774,10.673608851,3.6446469248,4,0.1301659616,0.2603319232,3.7748128864
31,123,2001,64,59,-97,108,2,5,-95,-93,5344,11.872739078,10.945181338,-17.99462017,-3,0.3710230962,0.9275577405,-17.62359707
31,123,2002,68,74,-133,108,2,-6,-131,-136,5208,12.888551933,14.025777104,-25.20849128,1,0.3790750569,-1.137225171,-24.82941622
31,123,2003,60,49,-48,108,0,11,-48,-43,5165,11.568495132,9.4476043575,-9.254796105,-6,0,2.1208907741,-9.254796105
31,123,2004,54,68,-55,108,1,-14,-54,-73,5092,10.52939456,13.259237594,-10.72438335,-5,0.1949887881,-2.729843034,-10.52939456
31,123,2005,60,49,-61,108,1,11,-60,-54,5038,11.846001974,9.6742349457,-12.04343534,-5,0.1974333662,2.1717670286,-11.84600197
31,123,2006,60,55,-43,108,1,5,-42,-40,4998,11.956954962,10.960542049,-8.569151056,-3,0.1992825827,0.9964129135,-8.369868473
31,123,2007,51,39,7,108,0,12,7,21,5019,10.182689428,7.7867625037,1.3976240391,2,0,2.3959269242,1.3976240391
31,123,2008,65,51,-45,108,-1,14,-46,-30,4989,12.989608313,10.191846523,-8.992805755,2,-0.199840128,2.7977617906,-9.192645883
31,125,2001,48,43,-49,112,1,5,-48,-47,3991,11.956657118,10.711172001,-12.20575414,-4,0.2490970233,1.2454851165,-11.95665712
31,125,2002,46,63,-105,112,1,-17,-104,-121,3870,11.70334563,16.028495102,-26.7141585,0,0.2544205572,-4.325149472,-26.45973795
31,125,2003,27,52,-118,112,1,-25,-117,-138,3732,7.1033938437,13.680610366,-31.04446198,4,0.2630886609,-6.577216522,-30.78137332
31,125,2004,48,66,-60,112,0,-18,-60,-82,3650,13.004605798,17.881332972,-16.25575725,-4,0,-4.876727174,-16.25575725
31,125,2005,44,63,32,112,1,-19,33,10,3660,12.038303694,17.236662107,8.755129959,-4,0.2735978112,-5.198358413,9.0287277702
31,125,2006,43,59,-26,112,0,-16,-26,-43,3617,11.818056892,16.215473409,-7.145801841,-1,0,-4.397416518,-7.145801841
31,125,2007,39,38,-65,112,1,1,-64,-63,3554,10.877144052,10.598242923,-18.12857342,0,0.2789011295,0.2789011295,-17.84967229
31,125,2008,43,49,1,112,0,-6,1,-4,3550,12.105855856,13.795045045,0.2815315315,1,0,-1.689189189,0.2815315315
31,127,2001,74,99,-142,477,1,-25,-141,-172,7395,9.8917257051,13.23352493,-18.9814196,-6,0.133671969,-3.341799225,-18.84774763
31,127,2002,79,99,-131,459,1,-20,-130,-152,7243,10.793824293,13.526438038,-17.89862003,-2,0.1366306873,-2.732613745,-17.76198934
31,127,2003,64,88,-133,450,1,-24,-132,-159,7084,8.9341802192,12.284497801,-18.56634327,-3,0.1395965659,-3.350317582,-18.4267467
31,127,2004,84,87,-61,404,0,-3,-61,-70,7014,11.916583913,12.342176195,-8.653709746,-6,0,-0.425592283,-8.653709746
31,127,2005,79,55,20,494,1,24,21,38,7052,11.232759846,7.8202758425,2.84373667,-7,0.1421868335,3.412484004,2.9859235035
31,127,2006,78,91,79,490,0,-13,79,63,7115,11.011505612,12.846756547,11.15267876,-3,0,-1.835250935,11.15267876
31,127,2007,83,82,-88,438,1,1,-87,-91,7024,11.740575713,11.599122993,-12.44783931,-5,0.1414527194,0.1414527194,-12.30638659
31,127,2008,86,85,69,425,0,1,69,61,7085,12.190800198,12.049046708,9.7809908569,-9,0,0.1417534907,9.7809908569
31,129,2001,43,75,-71,44,6,-32,-65,-103,4925,8.6406108711,15.070832915,-14.26705516,-6,1.2056666332,-6.430222044,-13.06138853
31,129,2002,58,80,-107,44,6,-22,-101,-123,4802,11.925568007,16.449059319,-22.00061684,0,1.233679449,-4.523491313,-20.76693739
31,129,2003,62,77,20,44,2,-15,22,3,4805,12.907255126,16.029978141,4.163630686,-4,0.4163630686,-3.122723014,4.5799937546
31,129,2004,53,78,0,44,1,-25,1,-28,4777,11.062408683,16.280525986,0,-4,0.2087246921,-5.218117303,0.2087246921
31,129,2005,52,72,-80,44,2,-20,-78,-101,4676,11.001798371,15.233259283,-16.92584365,-3,0.4231460912,-4.231460912,-16.50269756
31,129,2006,57,61,-88,44,1,-4,-87,-91,4585,12.309685779,13.173523378,-19.00442717,0,0.2159593996,-0.863837599,-18.78846777
31,129,2007,58,69,-63,44,2,-11,-61,-69,4516,12.745852104,15.163168883,-13.84463246,3,0.4395121415,-2.417316778,-13.40512032
31,129,2008,58,64,-48,44,1,-6,-47,-49,4467,12.913280641,14.249137259,-10.68685294,4,0.2226427697,-1.335856618,-10.46421017
31,131,2001,177,162,40,360,3,15,43,44,15474,11.454827854,10.484079731,2.5886616619,-14,0.1941496246,0.9707481232,2.7828112866
31,131,2002,193,187,-53,360,2,6,-51,-59,15415,12.496357927,12.107870116,-3.431642332,-14,0.1294959371,0.3884878112,-3.302146395
31,131,2003,203,211,-54,360,-1,-8,-55,-83,15332,13.20454028,13.724916252,-3.512537809,-20,-0.065046996,-0.520375972,-3.577584805
31,131,2004,168,179,19,360,6,-11,25,5,15337,10.955688154,11.673024879,1.2390361603,-9,0.3912745769,-0.717336724,1.6303107372
31,131,2005,199,157,4,360,3,42,7,36,15373,12.9599479,10.224682514,0.2605014653,-13,0.195376099,2.7352653859,0.4558775643
31,131,2006,173,168,150,360,5,5,155,152,15525,11.198135802,10.874490258,9.709366302,-8,0.3236455434,0.3236455434,10.033011845
31,131,2007,197,193,109,360,3,4,112,102,15627,12.647663071,12.39085773,6.9979455573,-14,0.1926040062,0.2568053416,7.1905495634
31,131,2008,198,196,-71,360,3,2,-68,-78,15549,12.702078522,12.573774698,-4.554785733,-12,0.1924557352,0.1283038235,-4.362329997
31,133,2001,28,54,-56,54,1,-26,-55,-83,3000,9.2059838895,17.754397501,-18.41196778,-2,0.3287851389,-8.548413612,-18.08318264
31,133,2002,29,51,8,54,1,-22,9,-16,2984,9.692513369,17.045454545,2.6737967914,-3,0.3342245989,-7.352941176,3.0080213904
31,133,2003,14,60,-85,54,1,-46,-84,-129,2855,4.7953416681,20.551464292,-29.11457441,1,0.3425244049,-15.75612262,-28.77205001
31,133,2004,27,34,-5,54,0,-7,-5,-13,2842,9.4786729858,11.936106723,-1.755309812,-1,0,-2.457433737,-1.755309812
31,133,2005,18,39,-17,54,1,-21,-16,-38,2804,6.3761955367,13.815090329,-6.021962451,-1,0.3542330854,-7.438894793,-5.667729366
31,133,2006,25,44,-74,54,0,-19,-74,-93,2711,9.0661831369,15.956482321,-26.83590209,0,0,-6.890299184,-26.83590209
31,133,2007,23,33,-9,54,1,-10,-8,-23,2688,8.5200963141,12.224486016,-3.333950732,-5,0.3704389702,-3.704389702,-2.963511761
31,133,2008,24,41,-66,54,0,-17,-66,-86,2602,9.0737240076,15.50094518,-24.95274102,-3,0,-6.427221172,-24.95274102
31,135,2001,40,38,-78,54,1,2,-77,-76,3101,12.742911755,12.105766168,-24.84867792,-1,0.3185727939,0.6371455878,-24.53010513
31,135,2002,32,42,-15,54,1,-10,-14,-26,3075,10.362694301,13.601036269,-4.857512953,-2,0.3238341969,-3.238341969,-4.533678756
31,135,2003,25,45,-39,54,1,-20,-38,-60,3015,8.210180624,14.778325123,-12.80788177,-2,0.328407225,-6.568144499,-12.47947455
31,135,2004,45,42,31,54,0,3,31,30,3045,14.851485149,13.861386139,10.231023102,-4,0,0.9900990099,10.231023102
31,135,2005,34,33,-11,54,1,1,-10,-11,3034,11.186050337,10.857048857,-3.619016286,-2,0.3290014805,0.3290014805,-3.290014805
31,135,2006,36,40,-83,54,0,-4,-83,-89,2945,12.042147516,13.380163907,-27.76384011,-2,0,-1.338016391,-27.76384011
31,135,2007,39,29,-26,54,1,10,-25,-14,2931,13.274336283,9.8706603131,-8.849557522,1,0.340367597,3.40367597,-8.509189925
31,135,2008,36,38,-42,54,0,-2,-42,-47,2884,12.381771281,13.069647463,-14.44539983,-3,0,-0.687876182,-14.44539983
31,137,2001,141,124,-50,259,2,17,-48,-40,9693,14.516627201,12.766395552,-5.147740142,-9,0.2059096057,1.7502316483,-4.941830536
31,137,2002,114,116,-26,259,2,-2,-24,-35,9658,11.78233683,11.989044494,-2.687199628,-9,0.2067076637,-0.206707664,-2.480491964
31,137,2003,105,103,-126,259,2,2,-124,-125,9533,10.942629358,10.734198322,-13.13115523,-3,0.2084310354,0.2084310354,-12.92272419
31,137,2004,110,112,-45,259,1,-2,-44,-54,9479,11.571638965,11.782032401,-4.733852304,-8,0.1051967179,-0.210393436,-4.628655586
31,137,2005,108,117,-132,259,2,-9,-130,-146,9333,11.482032745,12.438868807,-14.03359558,-7,0.212630236,-0.956836062,-13.82096534
31,137,2006,119,125,-4,259,1,-6,-3,-15,9318,12.760709882,13.404107018,-0.428931425,-6,0.1072328561,-0.643397137,-0.321698568
31,137,2007,110,105,-183,259,2,5,-181,-170,9148,11.913787501,11.372251706,-19.82021012,6,0.2166143182,0.5415357955,-19.6035958
31,137,2008,104,97,-32,259,1,7,-31,-21,9127,11.381668947,10.615595075,-3.502051984,3,0.1094391245,0.7660738714,-3.392612859
31,139,2001,73,94,-77,131,2,-21,-75,-102,7735,9.3758027228,12.072951451,-9.889545338,-6,0.2568713075,-2.697148728,-9.63267403
31,139,2002,80,98,-95,131,2,-18,-93,-116,7619,10.420737267,12.765403152,-12.3746255,-5,0.2605184317,-2.344665885,-12.11410707
31,139,2003,91,66,-45,131,2,25,-43,-27,7592,11.965025311,8.6779304451,-5.916770758,-9,0.2629675892,3.2870948656,-5.653803169
31,139,2004,95,109,-126,131,1,-14,-125,-146,7446,12.634658864,14.496608592,-16.75754755,-7,0.1329964091,-1.861949727,-16.62455114
31,139,2005,74,78,27,131,2,-4,29,18,7464,9.9262240107,10.46277666,3.6217303823,-7,0.2682763246,-0.536552649,3.8900067069
31,139,2006,97,73,-119,131,1,24,-118,-98,7366,13.081591369,9.8449089683,-16.04855024,-4,0.1348617667,3.2366824005,-15.91368847
31,139,2007,77,67,-122,131,2,10,-120,-105,7261,10.528474738,9.1611403569,-16.68147946,5,0.2734668763,1.3673343816,-16.40801258
31,139,2008,94,76,-53,131,1,18,-52,-30,7231,12.972674579,10.488545404,-7.314380348,4,0.1380071764,2.4841291747,-7.176373171
31,141,2001,464,250,-371,328,66,214,-305,-125,31396,14.749590731,7.9469777644,-11.793315,-34,2.0980021298,6.8026129663,-9.695312873
31,141,2002,407,252,-534,328,65,155,-469,-337,31059,13.033384037,8.0698102634,-17.10031222,-23,2.081498679,4.9635737731,-15.01881355
31,141,2003,454,260,-369,328,50,194,-319,-147,30912,14.652014652,8.3910216069,-11.90879605,-22,1.6136580013,6.2609930451,-10.29513805
31,141,2004,449,245,-271,328,49,204,-222,-44,30868,14.535448365,7.9313693752,-8.773065717,-26,1.586273875,6.60407899,-7.186791842
31,141,2005,467,233,-16,328,51,234,35,258,31126,15.065974127,7.51685647,-0.516178985,-11,1.6453205149,7.5491176565,1.1291415298
31,141,2006,477,236,-42,328,52,241,10,230,31356,15.268397298,7.5541756026,-1.344387184,-21,1.6644793701,7.7142216958,0.3200921865
31,141,2007,484,256,231,328,47,228,278,444,31800,15.32712648,8.106909874,7.3152194566,-62,1.4883779847,7.2202166065,8.8035974413
31,141,2008,479,298,136,328,47,181,183,272,32072,14.998747495,9.3311623246,4.2585170341,-92,1.4716933868,5.6675851703,5.7302104208
31,143,2001,65,62,-119,159,4,3,-115,-116,5497,11.701170117,11.161116112,-21.42214221,-4,0.7200720072,0.5400540054,-20.70207021
31,143,2002,56,58,-13,159,4,-2,-9,-16,5481,10.202222627,10.566587721,-2.36837311,-5,0.7287301876,-0.364365094,-1.639642922
31,143,2003,68,83,-49,159,2,-15,-47,-69,5412,12.485082163,15.239144405,-8.996603323,-7,0.3672082989,-2.754062242,-8.629395024
31,143,2004,67,67,-94,159,1,0,-93,-100,5312,12.495337561,12.495337561,-17.5307721,-7,0.1864975755,0,-17.34427452
31,143,2005,63,72,-23,159,2,-9,-21,-33,5279,11.896893589,13.596449816,-4.343310358,-3,0.3776791616,-1.699556227,-3.965631196
31,143,2006,56,58,-83,159,1,-2,-82,-88,5191,10.697230181,11.079274117,-15.8548233,-4,0.1910219675,-0.382043935,-15.66380134
31,143,2007,68,65,-2,159,2,3,0,0,5191,13.099595454,12.521672125,-0.385282219,-3,0.3852822192,0.5779233288,0
31,143,2008,63,66,-66,159,1,-3,-65,-69,5122,12.21758945,12.799379424,-12.79937942,-1,0.1939299913,-0.581789974,-12.60544943
31,145,2001,150,134,-59,262,5,16,-54,-48,11399,13.131401558,11.730718725,-5.165017946,-10,0.4377133853,1.4006828329,-4.727304561
31,145,2002,135,114,-112,262,4,21,-108,-94,11305,11.89217759,10.042283298,-9.866102889,-7,0.3523608175,1.8498942918,-9.513742072
31,145,2003,136,147,-82,280,1,-11,-81,-103,11202,12.085129071,13.062602746,-7.28662194,-11,0.0888612432,-0.977473675,-7.197760697
31,145,2004,149,125,-102,264,4,24,-98,-84,11118,13.35125448,11.200716846,-9.139784946,-10,0.3584229391,2.1505376344,-8.781362007
31,145,2005,127,134,-75,273,2,-7,-73,-91,11027,11.469857756,12.10205464,-6.773538045,-11,0.1806276812,-0.632196884,-6.592910364
31,145,2006,145,119,-183,260,3,26,-180,-158,10869,13.244428206,10.869565217,-16.7153818,-4,0.2740226525,2.3748629887,-16.44135915
31,145,2007,118,128,-136,258,1,-10,-135,-141,10728,10.927443626,11.853498171,-12.59434181,4,0.0926054545,-0.926054545,-12.50173635
31,145,2008,133,122,-42,261,1,11,-41,-24,10704,12.411347518,11.384845091,-3.9193729,6,0.0933184024,1.0265024263,-3.826054498
31,147,2001,73,152,-190,204,2,-79,-188,-272,9231,7.7933169638,16.227180527,-20.28397566,-5,0.2135155333,-8.433863564,-20.07046013
31,147,2002,83,148,-92,204,2,-65,-90,-161,9070,9.0705425933,16.173979564,-10.0540954,-6,0.2185672914,-7.103436971,-9.835528113
31,147,2003,94,150,-148,204,1,-56,-147,-207,8863,10.483466235,16.728935482,-16.50588301,-4,0.1115262365,-6.245469247,-16.39435677
31,147,2004,97,148,-37,204,0,-51,-37,-95,8768,11.003346379,16.788610969,-4.197152742,-7,0,-5.785264591,-4.197152742
31,147,2005,90,147,-41,204,1,-57,-40,-105,8663,10.326429924,16.866502209,-4.704262521,-8,0.1147381103,-6.540072285,-4.589524411
31,147,2006,78,139,-80,204,0,-61,-80,-144,8519,9.0792690024,16.179722966,-9.312070772,-3,0,-7.100453963,-9.312070772
31,147,2007,81,111,-153,204,1,-30,-152,-177,8342,9.6079710575,13.166478857,-18.14838978,5,0.1186169266,-3.558507799,-18.02977285
31,147,2008,90,141,-5,204,0,-51,-5,-48,8294,10.819908632,16.95119019,-0.601106035,8,0,-6.131281558,-0.601106035
31,149,2001,10,20,-33,30,1,-10,-32,-43,1712,5.7686760888,11.537352178,-19.03663109,-1,0.5768676089,-5.768676089,-18.45976348
31,149,2002,13,21,-37,30,1,-8,-36,-44,1668,7.6923076923,12.426035503,-21.89349112,0,0.5917159763,-4.733727811,-21.30177515
31,149,2003,8,25,-71,30,1,-17,-70,-85,1583,4.9215625961,15.379883113,-43.67886804,2,0.6151953245,-10.45832052,-43.06367272
31,149,2004,23,19,-11,30,0,4,-11,-8,1575,14.566181127,12.032932236,-6.966434452,-1,0,2.5332488917,-6.966434452
31,149,2005,13,24,-40,30,1,-11,-39,-50,1525,8.3870967742,15.483870968,-25.80645161,0,0.6451612903,-7.096774194,-25.16129032
31,149,2006,17,18,-3,30,0,-1,-3,-4,1521,11.162179908,11.818778726,-1.969796454,0,0,-0.656598818,-1.969796454
31,149,2007,16,17,-6,30,1,-1,-5,-6,1515,10.540184453,11.198945982,-3.95256917,0,0.6587615283,-0.658761528,-3.293807642
31,149,2008,18,17,-8,30,0,1,-8,-7,1508,11.908699967,11.247105524,-5.292755541,0,0,0.6615944426,-5.292755541
31,151,2001,157,152,35,861,63,5,98,91,13953,11.28887291,10.929354665,2.5166277189,-12,4.5299298939,0.3595182456,7.0465576128
31,151,2002,184,165,10,899,58,19,68,73,14026,13.152721684,11.794560206,0.7148218307,-14,4.1459666178,1.3581614783,4.8607884485
31,151,2003,167,178,62,899,47,-11,109,81,14107,11.87217858,12.654178367,4.4076351616,-17,3.341271816,-0.781999787,7.7489069776
31,151,2004,202,158,-135,856,43,44,-92,-61,14046,14.350158065,11.224381061,-9.590452172,-13,3.0547366178,3.1257770042,-6.535715554
31,151,2005,192,140,-191,865,46,52,-145,-105,13941,13.720656019,10.004645014,-13.64919427,-12,3.2872405045,3.7160110051,-10.36195376
31,151,2006,217,158,-256,814,46,59,-210,-155,13786,15.652612977,11.396833411,-18.4657554,-4,3.3180654236,4.255779565,-15.14768998
31,151,2007,200,142,-63,884,41,58,-22,37,13823,14.488029266,10.286500779,-4.563729219,1,2.9700459995,4.2015284871,-1.593683219
31,151,2008,185,146,-134,891,41,39,-93,-52,13771,13.408712039,10.582010582,-9.712256288,2,2.9716605059,2.8267014568,-6.740595782
31,153,2001,2143,600,1324,1454,104,1543,1428,2865,126017,17.201176711,4.816008412,10.627325229,-106,0.8347747914,12.385168299,11.46210002
31,153,2002,2297,608,1609,1649,-199,1689,1410,3016,129033,18.01215448,4.7676926093,12.617133895,-83,-1.560478338,13.24446187,11.056655558
31,153,2003,2327,626,1954,1611,-714,1701,1240,2900,131933,17.833740794,4.7975598354,14.97513086,-41,-5.471977192,13.036180958,9.5031536675
31,153,2004,2372,610,1486,1490,475,1762,1961,3589,135522,17.737563328,4.5615150212,11.112149707,-134,3.5519994018,13.176048307,14.664149109
31,153,2005,2399,602,1879,1450,26,1797,1905,3572,139094,17.471669531,4.3843039007,13.684563172,-130,0.189355318,13.087365631,13.87391849
31,153,2006,2452,646,1361,1580,281,1806,1642,3373,142467,17.417184908,4.5887036912,9.6675320801,-75,1.9960150731,12.828481217,11.663547153
31,153,2007,2574,668,1891,1506,38,1906,1929,3848,146315,17.82659584,4.6263271257,13.096384124,13,0.2631742976,13.200268715,13.359558421
31,153,2008,2694,692,2068,1501,112,2002,2180,4152,150467,18.154739843,4.6633555943,13.936155158,-30,0.7547627552,13.491384248,14.690917913
31,155,2001,249,165,-11,255,10,84,-1,64,19916,12.522631261,8.2981291491,-0.55320861,-19,0.5029169181,4.2245021123,-0.050291692
31,155,2002,238,192,-122,255,9,46,-113,-86,19830,11.976047904,9.6613495698,-6.138982539,-19,0.4528757611,2.3146983344,-5.686106778
31,155,2003,260,180,63,255,4,80,67,122,19952,13.071238248,9.0493187874,3.1672615756,-25,0.2010959731,4.0219194611,3.3683575486
31,155,2004,238,193,52,255,11,45,63,93,20045,11.900892567,9.6507238043,2.6001950146,-15,0.5500412531,2.2501687627,3.1502362677
31,155,2005,238,165,92,255,8,73,100,156,20201,11.827262337,8.1995726283,4.57188292,-17,0.3975550365,3.6276897083,4.9694379566
31,155,2006,252,183,-214,255,10,69,-204,-144,20057,12.519250832,9.0913607233,-10.63142729,-9,0.4967956679,3.4278901088,-10.13463163
31,155,2007,256,198,2,255,8,58,10,62,20119,12.743926722,9.8566308244,0.0995619275,-6,0.3982477101,2.887295898,0.4978096376
31,155,2008,264,178,-173,255,8,86,-165,-85,20034,13.149702388,8.8660872164,-8.617039823,-6,0.39847583,4.283615172,-8.218563993
31,157,2001,532,412,-602,652,63,120,-539,-439,36527,14.477569292,11.211952159,-16.38251262,-20,1.7144489951,3.2656171336,-14.66806363
31,157,2002,543,461,-69,652,60,82,-9,38,36565,14.857987194,12.614239588,-1.888031522,-35,1.6417665408,2.2437476058,-0.246264981
31,157,2003,530,464,-192,652,42,66,-150,-123,36442,14.519155697,12.711109894,-5.259769611,-39,1.1505746024,1.8080458038,-4.109195009
31,157,2004,537,438,-304,652,46,99,-258,-194,36248,14.775072225,12.051176228,-8.364286697,-35,1.2656486449,2.7238959967,-7.098638052
31,157,2005,548,432,-139,652,45,116,-94,-11,36237,15.120369732,11.919707526,-3.835276264,-33,1.2416362006,3.200662206,-2.593640063
31,157,2006,524,403,-238,652,48,121,-190,-84,36153,14.477137726,11.134134549,-6.575493853,-15,1.3261500207,3.3430031772,-5.249343832
31,157,2007,538,453,25,652,41,85,66,147,36300,14.85100686,12.504658192,0.6901025492,-4,1.1317681808,2.3463486674,1.82187073
31,157,2008,559,431,72,652,41,128,113,254,36554,15.345760013,11.831882944,1.9765558514,13,1.1255387487,3.5138770692,3.1020946002
31,159,2001,192,146,57,1451,8,46,65,94,16625,11.581614187,8.8068524551,3.4382917119,-17,0.4825672578,2.7747617324,3.9208589697
31,159,2002,180,150,-54,1442,6,30,-48,-32,16593,10.837497742,9.0312481185,-3.251249323,-14,0.3612499247,1.8062496237,-2.889999398
31,159,2003,188,170,-52,1369,1,18,-51,-54,16539,11.348545213,10.261982374,-3.138959314,-21,0.0603646022,1.0865628396,-3.078594712
31,159,2004,210,170,121,1378,10,40,131,157,16696,12.637279976,10.230179028,7.2814803671,-14,0.6017752369,2.4071009478,7.883255604
31,159,2005,181,179,-76,1396,7,2,-69,-83,16613,10.867933592,10.747845928,-4.563331232,-16,0.420306824,0.120087664,-4.143024408
31,159,2006,203,191,54,1419,9,12,63,67,16680,12.194755654,11.473883399,3.2439251494,-8,0.5406541916,0.7208722554,3.784579341
31,159,2007,197,156,-209,1333,6,41,-203,-157,16523,11.866397615,9.3967412583,-12.58922387,5,0.3614131253,2.4696563564,-12.22781074
31,159,2008,213,165,179,1357,6,48,185,235,16758,12.800096151,9.9155674409,10.756888315,2,0.3605660888,2.8845287101,11.117454403
31,161,2001,72,84,-191,136,1,-12,-190,-204,5971,11.855754981,13.831714145,-31.45068335,-2,0.1646632636,-1.975959164,-31.28602009
31,161,2002,68,81,-10,136,1,-13,-9,-28,5943,11.41514185,13.59744838,-1.678697331,-6,0.1678697331,-2.18230653,-1.510827598
31,161,2003,61,93,-153,136,1,-32,-152,-181,5762,10.422896198,15.890645023,-26.14267407,3,0.1708671508,-5.467748825,-25.97180692
31,161,2004,81,71,-32,136,0,10,-32,-26,5736,14.089406853,12.349973909,-5.566185424,-4,0,1.7394329449,-5.566185424
31,161,2005,77,87,-141,136,1,-10,-140,-154,5582,13.606644283,15.373740944,-24.91606291,-4,0.176709666,-1.76709666,-24.73935324
31,161,2006,57,72,-89,136,0,-15,-89,-106,5476,10.309278351,13.022246337,-16.09694339,-2,0,-2.712967987,-16.09694339
31,161,2007,76,84,-38,136,1,-8,-37,-46,5430,13.93728223,15.40436457,-6.968641115,-1,0.1833852925,-1.46708234,-6.785255822
31,161,2008,75,81,-91,136,0,-6,-91,-93,5337,13.93145723,15.045973809,-16.90350144,4,0,-1.114516578,-16.90350144
31,163,2001,33,50,-19,55,1,-17,-18,-39,3258,10.068649886,15.25553013,-5.797101449,-4,0.3051106026,-5.186880244,-5.491990847
31,163,2002,32,44,-79,55,1,-12,-78,-91,3167,9.9610894942,13.696498054,-24.59143969,-1,0.3112840467,-3.73540856,-24.28015564
31,163,2003,33,45,-22,55,1,-12,-21,-36,3131,10.479517307,14.290250873,-6.986344871,-3,0.3175611305,-3.810733566,-6.668783741
31,163,2004,40,41,8,55,0,-1,8,3,3134,12.769353551,13.08858739,2.5538707103,-4,0,-0.319233839,2.5538707103
31,163,2005,32,42,-34,55,1,-10,-33,-46,3088,10.286081646,13.50048216,-10.92896175,-3,0.3214400514,-3.214400514,-10.6075217
31,163,2006,23,47,-38,55,0,-24,-38,-63,3025,7.5249468346,15.377065271,-12.43252086,-1,0,-7.852118436,-12.43252086
31,163,2007,34,39,-27,55,1,-5,-26,-31,2994,11.297557734,12.958963283,-8.971589965,0,0.3322811098,-1.661405549,-8.639308855
31,163,2008,35,41,4,55,0,-6,4,0,2994,11.69004676,13.694054776,1.336005344,2,0,-2.004008016,1.336005344
31,165,2001,9,8,-72,0,1,1,-71,-71,1399,6.2739630533,5.5768560474,-50.19170443,-1,0.6971070059,0.6971070059,-49.49459742
31,165,2002,7,6,28,0,1,1,29,30,1429,4.9504950495,4.243281471,19.801980198,0,0.7072135785,0.7072135785,20.509193777
31,165,2003,8,4,31,0,1,4,32,38,1467,5.5248618785,2.7624309392,21.408839779,2,0.6906077348,2.7624309392,22.099447514
31,165,2004,12,10,-55,0,0,2,-55,-55,1412,8.3362278569,6.9468565474,-38.20771101,-2,0,1.3893713095,-38.20771101
31,165,2005,9,9,-12,0,1,0,-11,-10,1402,6.3965884861,6.3965884861,-8.528784648,1,0.710732054,0,-7.818052594
31,165,2006,12,14,-36,0,0,-2,-36,-38,1364,8.6767895879,10.122921186,-26.03036876,0,0,-1.446131598,-26.03036876
31,165,2007,13,4,-20,0,1,9,-19,-19,1345,9.5976375046,2.9531192322,-14.76559616,-9,0.738279808,6.6445182724,-14.02731635
31,165,2008,14,2,-56,0,0,12,-56,-58,1287,10.638297872,1.5197568389,-42.55319149,-14,0,9.1185410334,-42.55319149
31,167,2001,70,54,-47,120,8,16,-39,-28,6396,10.920436817,8.4243369735,-7.332293292,-5,1.248049922,2.496099844,-6.08424337
31,167,2002,102,55,38,120,8,47,46,88,6484,15.838509317,8.5403726708,5.900621118,-5,1.2422360248,7.298136646,7.1428571429
31,167,2003,78,59,-22,120,7,19,-15,-6,6478,12.035179756,9.1035334053,-3.39453788,-10,1.0800802345,2.9316463509,-2.314457645
31,167,2004,86,45,-38,120,6,41,-32,4,6482,13.271604938,6.9444444444,-5.864197531,-5,0.9259259259,6.3271604938,-4.938271605
31,167,2005,86,61,-67,120,7,25,-60,-39,6443,13.30754352,9.4390715667,-10.36750484,-4,1.083172147,3.8684719536,-9.284332689
31,167,2006,76,44,-25,120,6,32,-19,10,6453,11.786600496,6.82382134,-3.877171216,-3,0.9305210918,4.9627791563,-2.946650124
31,167,2007,90,48,-119,120,5,42,-114,-70,6383,14.023060143,7.4789654098,-18.54160175,2,0.7790588969,6.5440947336,-17.76254285
31,167,2008,84,50,-112,120,4,34,-108,-73,6310,13.235641692,7.8783581502,-17.64752226,1,0.630268652,5.3572835421,-17.0172536
31,169,2001,70,94,-146,180,1,-24,-145,-171,5862,11.769651114,15.804960067,-24.54812947,-2,0.1681378731,-4.035308953,-24.37999159
31,169,2002,42,98,-132,180,1,-56,-131,-187,5675,7.2809222502,16.988818584,-22.8828985,0,0.1733552917,-9.707896334,-22.70954321
31,169,2003,48,95,-76,180,1,-47,-75,-123,5552,8.5508149996,16.92348802,-13.53879042,-1,0.1781419792,-8.37267302,-13.36064844
31,169,2004,54,100,-96,180,0,-46,-96,-149,5403,9.8585120949,18.25650388,-17.52624372,-7,0,-8.397991785,-17.52624372
31,169,2005,50,74,-39,180,1,-24,-38,-67,5336,9.3118539901,13.781543905,-7.263246112,-5,0.1862370798,-4.469689915,-7.077009032
31,169,2006,49,82,-118,180,0,-33,-118,-153,5183,9.3164749501,15.590835631,-22.43559274,-2,0,-6.274360681,-22.43559274
31,169,2007,65,67,-10,180,1,-2,-9,-9,5174,12.551897268,12.938109491,-1.931061118,2,0.1931061118,-0.386212224,-1.737955006
31,169,2008,53,85,-37,180,0,-32,-37,-70,5104,10.313290523,16.540182915,-7.199844328,-1,0,-6.226892392,-7.199844328
31,171,2001,8,10,-25,0,1,-2,-24,-27,704,11.149825784,13.93728223,-34.84320557,-1,1.393728223,-2.787456446,-33.44947735
31,171,2002,2,10,-29,0,1,-8,-28,-36,668,2.915451895,14.577259475,-42.27405248,0,1.4577259475,-11.66180758,-40.81632653
31,171,2003,8,6,-15,0,1,2,-14,-13,655,12.093726379,9.0702947846,-22.67573696,-1,1.5117157974,3.0234315949,-21.16402116
31,171,2004,7,4,-35,0,0,3,-35,-33,622,10.963194988,6.2646828504,-54.81597494,-1,0,4.6985121378,-54.81597494
31,171,2005,5,7,-13,0,1,-2,-12,-15,607,8.1366965012,11.391375102,-21.1554109,-1,1.6273393002,-3.2546786,-19.5280716
31,171,2006,4,6,-2,0,0,-2,-2,-4,603,6.6115702479,9.9173553719,-3.305785124,0,0,-3.305785124,-3.305785124
31,171,2007,12,5,-9,0,1,7,-8,-3,600,19.950124688,8.3125519534,-14.96259352,-2,1.6625103907,11.637572735,-13.30008313
31,171,2008,6,3,-17,0,0,3,-17,-17,583,10.143702451,5.0718512257,-28.74049028,-3,0,5.0718512257,-28.74049028
31,173,2001,168,76,-99,100,12,92,-87,0,7157,23.473522426,10.618974431,-13.83261143,-5,1.6766801733,12.854547995,-12.15593126
31,173,2002,151,84,-126,100,12,67,-114,-50,7107,21.172181716,11.777902412,-17.66685362,-3,1.6825574874,9.3942793045,-15.98429613
31,173,2003,152,75,-37,100,2,77,-35,34,7141,21.336327906,10.527793375,-5.193711398,-8,0.2807411567,10.808534531,-4.912970241
31,173,2004,163,67,-98,100,1,96,-97,-9,7132,22.840327892,9.3883556365,-13.73222168,-8,0.140124711,13.451972255,-13.59209697
31,173,2005,158,73,19,100,2,85,21,101,7233,21.997911591,10.163592064,2.6453184824,-5,0.2784545771,11.834319527,2.9237730595
31,173,2006,155,79,-109,100,1,76,-108,-37,7196,21.484510361,10.950169797,-15.10846212,-5,0.1386097443,10.534340564,-14.96985238
31,173,2007,176,64,-126,100,1,112,-125,-15,7181,24.483550115,8.9031091326,-17.5279961,-2,0.1391110802,15.580440982,-17.38888502
31,173,2008,167,62,-180,100,0,105,-180,-79,7102,23.384443044,8.6816495134,-25.20478891,-4,0,14.702793531,-25.20478891
31,175,2001,43,54,-24,85,1,-11,-23,-37,4607,9.2962922927,11.674413577,-5.188628256,-3,0.216192844,-2.378121284,-4.972435412
31,175,2002,46,73,-65,85,1,-27,-64,-94,4513,10.087719298,16.00877193,-14.25438596,-3,0.2192982456,-5.921052632,-14.03508772
31,175,2003,50,57,33,85,1,-7,34,24,4537,11.049723757,12.596685083,7.2928176796,-3,0.2209944751,-1.546961326,7.5138121547
31,175,2004,46,70,-80,85,0,-24,-80,-109,4428,10.262130508,15.616285555,-17.84718349,-5,0,-5.354155047,-17.84718349
31,175,2005,40,51,-85,85,1,-11,-84,-98,4330,9.1345055949,11.646494633,-19.41082439,-3,0.2283626399,-2.511989039,-19.18246175
31,175,2006,55,56,-30,85,0,-1,-30,-33,4297,12.750666512,12.982496812,-6.954909007,-2,0,-0.2318303,-6.954909007
31,175,2007,52,47,-37,85,1,5,-36,-31,4266,12.145276188,10.97746117,-8.641831134,0,0.2335630036,1.1678150181,-8.40826813
31,175,2008,47,64,-71,85,0,-17,-71,-84,4182,11.126893939,15.151515152,-16.80871212,4,0,-4.024621212,-16.80871212
31,177,2001,229,159,220,576,19,70,239,295,19087,12.09113229,8.3951529871,11.615934951,-14,1.0031943821,3.6959793025,12.619129333
31,177,2002,236,154,8,575,18,82,26,88,19175,12.335999164,8.0497621661,0.4181694632,-20,0.9408812921,4.2862369975,1.3590507553
31,177,2003,210,178,154,522,14,32,168,184,19359,10.899465407,9.238594488,7.9929412986,-16,0.7266310271,1.6608709192,8.7195723257
31,177,2004,222,163,-15,507,13,59,-2,43,19402,11.454812827,8.4105157246,-0.77397384,-14,0.6707773277,3.0442971028,-0.103196512
31,177,2005,217,154,165,520,15,63,180,224,19626,11.12022138,7.8917700113,8.4554678692,-19,0.7686788972,3.2284513682,9.2241467664
31,177,2006,247,155,76,579,14,92,90,173,19799,12.530120482,7.8630310717,3.8554216867,-9,0.7102092581,4.6670894103,4.5656309448
31,177,2007,220,169,57,557,12,51,69,125,19924,11.07670619,8.5089243008,2.8698738766,5,0.604183974,2.5677818896,3.4740578506
31,177,2008,241,170,-201,513,11,71,-190,-112,19812,12.130058385,8.55647272,-10.11677069,7,0.5536541172,3.5735856654,-9.563116569
31,179,2001,99,68,-122,1217,11,31,-111,-88,9719,10.14032572,6.9650722114,-12.49615897,-8,1.1267028577,3.1752535081,-11.36945611
31,179,2002,95,64,-188,1208,11,31,-177,-150,9569,9.8506843633,6.6362505185,-19.4939859,-4,1.1406055579,3.2144338449,-18.35338034
31,179,2003,99,74,-31,1240,9,25,-22,-10,9559,10.35131744,7.7373483898,-3.241321623,-13,0.9410288582,2.6139690506,-2.300292765
31,179,2004,115,66,-151,1187,7,49,-144,-105,9454,12.096986273,6.9426182086,-15.88386893,-10,0.7363382949,5.154368064,-15.14753064
31,179,2005,98,61,-29,1225,9,37,-20,7,9461,10.362146445,6.4499074808,-3.066349458,-10,0.9516256939,3.9122389638,-2.114723764
31,179,2006,97,65,34,1284,8,32,42,70,9531,10.214827296,6.8449873631,3.5804549284,-4,0.8424599832,3.3698399326,4.4229149115
31,179,2007,119,63,-302,1168,7,56,-295,-230,9301,12.638062872,6.6907391674,-32.07306712,9,0.743415463,5.9473237043,-31.32965166
31,179,2008,114,68,-82,1220,6,46,-76,-27,9274,12.274562584,7.3216689098,-8.829071332,3,0.6460296097,4.9528936743,-8.183041723
31,181,2001,43,59,-52,161,1,-16,-51,-70,3983,10.701841712,14.683922349,-12.94176207,-3,0.2488800398,-3.982080637,-12.69288203
31,181,2002,33,66,-57,161,1,-33,-56,-92,3891,8.382016764,16.764033528,-14.47802896,-3,0.254000508,-8.382016764,-14.22402845
31,181,2003,37,57,-37,161,-1,-20,-38,-61,3830,9.5842507447,14.764926823,-9.584250745,-3,-0.259033804,-5.180676078,-9.843284549
31,181,2004,32,59,-16,161,0,-27,-16,-46,3784,8.4055686893,15.497767271,-4.202784345,-3,0,-7.092198582,-4.202784345
31,181,2005,25,67,-43,161,0,-42,-43,-88,3696,6.6844919786,17.914438503,-11.4973262,-3,0,-11.22994652,-11.4973262
31,181,2006,31,69,-32,161,0,-38,-32,-72,3624,8.4699453552,18.852459016,-8.743169399,-2,0,-10.38251366,-8.743169399
31,181,2007,25,52,5,161,0,-27,5,-21,3603,6.9185000692,14.390480144,1.3837000138,1,0,-7.471980075,1.3837000138
31,181,2008,29,64,-61,161,-1,-35,-62,-95,3508,8.1563774434,18.000281254,-17.15651807,2,-0.281254395,-9.843903811,-17.43777247
31,183,2001,9,9,-33,0,1,0,-32,-33,849,10.398613518,10.398613518,-38.12824957,-1,1.155401502,0,-36.97284806
31,183,2002,11,12,-25,0,1,-1,-24,-26,823,13.157894737,14.354066986,-29.90430622,-1,1.1961722488,-1.196172249,-28.70813397
31,183,2003,9,8,-28,0,1,1,-27,-26,797,11.111111111,9.8765432099,-34.56790123,0,1.2345679012,1.2345679012,-33.33333333
31,183,2004,7,8,-7,0,0,-1,-7,-8,789,8.8272383354,10.088272383,-8.827238335,0,0,-1.261034048,-8.827238335
31,183,2005,5,8,18,0,1,-3,19,15,804,6.2774639046,10.043942247,22.598870056,-1,1.2554927809,-3.766478343,23.854362837
31,183,2006,8,8,-4,0,0,0,-4,-6,798,9.9875156055,9.9875156055,-4.993757803,-2,0,0,-4.993757803
31,183,2007,7,3,4,0,1,4,5,8,806,8.7281795511,3.7406483791,4.9875311721,-1,1.246882793,4.9875311721,6.2344139651
31,183,2008,9,3,-2,0,0,6,-2,1,807,11.15933044,3.7197768134,-2.479851209,-3,0,7.4395536268,-2.479851209
31,185,2001,172,162,-89,779,18,10,-71,-73,14498,11.833912415,11.145894252,-6.123361657,-12,1.2384326946,0.6880181637,-4.884928962
31,185,2002,160,146,-204,810,18,14,-186,-179,14319,11.104556338,10.132907659,-14.15830933,-7,1.2492625881,0.9716486796,-12.90904674
31,185,2003,192,145,-102,809,17,47,-85,-51,14268,13.43267919,10.144471263,-7.13611082,-13,1.1893518033,3.2882079267,-5.946759016
31,185,2004,176,131,-269,740,16,45,-253,-226,14042,12.433768986,9.254680325,-19.00388555,-18,1.1303426351,3.1790886613,-17.87354292
31,185,2005,151,132,55,760,17,19,72,77,14119,10.724050993,9.3746670928,3.9061112887,-14,1.2073434892,1.3493838997,5.1134547779
31,185,2006,202,130,98,831,16,72,114,179,14298,14.216842031,9.1494527923,6.8972797973,-7,1.1260864975,5.0673892388,8.0233662948
31,185,2007,187,144,-13,900,13,43,0,41,14339,13.060027237,10.05691937,-0.907916332,-2,0.907916332,3.0031078674,0
31,185,2008,192,144,-204,829,12,48,-192,-140,14199,13.45574322,10.091807415,-14.29672717,4,0.8409839512,3.3639358049,-13.45574322
32,0,2001,31007,15569,47859,33677,12704,15438,60563,75729,2093973,15.080429851,7.5720712209,23.276495379,-272,6.1786622642,7.5083586299,29.455157644
32,0,2002,32013,16831,44015,33562,11534,15182,55549,70545,2164518,15.034903209,7.9046779716,20.671641668,-186,5.4169422925,7.1302252371,26.088583961
32,0,2003,32976,17000,43286,33566,9282,15976,52568,69312,2233830,14.994720745,7.7301750566,19.682844559,768,4.2206755809,7.2645456885,23.90352014
32,0,2004,34409,17836,67007,33526,10112,16573,77119,90045,2323875,15.099265968,7.8267461365,29.403833728,-3647,4.4373209762,7.2725198318,33.841154704
32,0,2005,35765,18199,52331,33434,9978,17566,62309,77796,2401671,15.136875189,7.7023903693,22.148128491,-2079,4.2230040719,7.4344848193,26.371132563
32,0,2006,38312,18513,53827,33392,10288,19799,64115,82525,2484196,15.682784652,7.578184179,22.033755729,-1389,4.2113303534,8.1046004732,26.245086082
32,0,2007,39768,19065,40312,33364,9061,20703,49373,70148,2554344,15.785525172,7.5676684119,16.001460741,72,3.5966768151,8.2178567601,19.598137556
32,0,2008,40339,19461,16316,33364,9198,20878,25514,45823,2600167,15.651921201,7.5510557646,6.3307654208,-569,3.5689127446,8.1008654361,9.8996781654
32,1,2001,543,207,-39,476,29,336,-10,302,24310,22.476095865,8.5682354402,-1.614305228,-24,1.2003808105,13.907860425,-0.413924417
32,1,2002,524,180,-549,366,-20,344,-569,-231,24079,21.657814793,7.4397073715,-22.69110748,-6,-0.826634152,14.218107421,-23.51774164
32,1,2003,347,247,0,396,-113,100,-113,-48,24031,14.425275411,10.268135523,0,-35,-4.697568073,4.1571398878,-4.697568073
32,1,2004,335,221,-117,342,87,114,-30,63,24094,13.922077922,9.1844155844,-4.862337662,-21,3.6155844156,4.7376623377,-1.246753247
32,1,2005,359,216,200,398,13,143,213,339,24433,14.795886826,8.9022605972,8.2428338863,-17,0.5357842026,5.8936262287,8.7786180889
32,1,2006,355,260,52,295,52,95,104,185,24618,14.474730383,10.601210984,2.1202421969,-14,2.1202421969,3.8735193982,4.2404843938
32,1,2007,363,250,61,282,12,113,73,166,24784,14.695761305,10.121047731,2.4695356463,-20,0.4858102911,4.5747135743,2.9553459374
32,1,2008,370,229,-44,282,27,141,-17,112,24896,14.895330113,9.2190016103,-1.771336554,-12,1.0869565217,5.6763285024,-0.684380032
32,3,2001,22460,10615,41311,19355,10190,11845,51501,62753,1455993,15.765646404,7.4511280755,28.997979456,-593,7.1528021752,8.3145183283,36.150781631
32,3,2002,23309,11430,37491,19350,9226,11879,46717,58135,1514128,15.695656844,7.6966561295,25.245436129,-461,6.2125415093,7.9990007141,31.457977638
32,3,2003,24218,11435,35714,19324,7376,12783,43090,56213,1570341,15.703189106,7.4145663322,23.157308438,340,4.7826708584,8.2886227743,27.939979296
32,3,2004,25438,12038,53848,19338,8120,13400,61968,72543,1642884,15.833313882,7.4927837297,33.516482662,-2825,5.0541123015,8.3405301527,38.570594963
32,3,2005,26748,12289,39186,19190,7980,14459,47166,60073,1702957,15.988805206,7.3458362188,23.423707223,-1552,4.7701011495,8.6429689875,28.193808373
32,3,2006,28629,12590,44436,19251,8249,16039,52685,67719,1770676,16.483606645,7.2488947451,25.584740817,-1005,4.7494942615,9.2347118996,30.334235079
32,3,2007,29594,12954,32876,19236,7245,16640,40121,56979,1827655,16.448736928,7.2000046688,18.272915971,218,4.0268669002,9.2487322595,22.299782872
32,3,2008,30074,13270,14365,19236,7372,16804,21737,38091,1865746,16.2852612,7.1857889246,7.7787383498,-450,3.9919846234,9.099472275,11.770722973
32,5,2001,295,291,685,236,47,4,732,707,42133,7.0608791393,6.9651384052,16.395600713,-29,1.1249536256,0.0957407341,17.520554339
32,5,2002,385,309,818,236,45,76,863,916,43049,9.0394684323,7.2550538846,19.205935526,-23,1.0565612453,1.7844145477,20.262496772
32,5,2003,429,304,713,236,35,125,748,861,43910,9.8667187985,6.9918007337,16.398532642,-12,0.8049770582,2.8749180648,17.2035097
32,5,2004,407,351,1610,236,38,56,1648,1639,45549,9.0991403883,7.8471702121,35.994142568,-65,0.849551191,1.2519701763,36.843693759
32,5,2005,341,383,161,236,39,-42,200,130,45679,7.4757749814,8.3965449204,3.5296180997,-28,0.8550006577,-0.920769939,4.3846187574
32,5,2006,369,370,-214,236,40,-1,-174,-200,45479,8.0958336076,8.1177735361,-4.695144694,-25,0.877597139,-0.021939928,-3.817547555
32,5,2007,415,363,-197,236,33,52,-164,-174,45305,9.1425801903,7.9970038773,-4.339971801,-62,0.7270003525,1.145576313,-3.612971449
32,5,2008,434,385,-121,236,33,49,-88,-125,45180,9.5927501796,8.50969774,-2.674476433,-86,0.7294026634,1.0830524396,-1.945073769
32,7,2001,618,214,-764,794,154,404,-610,-232,45003,13.697112081,4.7430129214,-16.9329994,-26,3.4131962145,8.95409916,-13.51980319
32,7,2002,588,238,-1455,794,143,350,-1312,-959,44044,13.206508922,5.3454917066,-32.67937157,3,3.2117870338,7.8610172156,-29.46758453
32,7,2003,599,259,-1059,794,130,340,-929,-576,43468,13.689551147,5.9191882256,-24.2023951,13,2.9710211171,7.7703629217,-21.23137398
32,7,2004,638,277,-363,794,118,361,-245,79,43547,14.664138367,6.3667183819,-8.343389071,-37,2.7121760616,8.2974199851,-5.631213009
32,7,2005,595,220,393,794,124,375,517,856,44403,13.530415009,5.0028425242,8.9368959636,-36,2.8197839682,8.5275724844,11.756679932
32,7,2006,608,239,769,794,124,369,893,1236,45639,13.504808867,5.3086337487,17.080917794,-26,2.7542702294,8.1961751183,19.835188023
32,7,2007,741,271,629,794,112,470,741,1208,46847,16.024046883,5.8603464308,13.60205869,-3,2.4219881928,10.163700452,16.024046883
32,7,2008,763,265,-357,794,111,498,-246,224,47071,16.248216529,5.6432206819,-7.602376541,-28,2.3637641347,10.604995847,-5.238612407
32,9,2001,6,6,-35,6,3,0,-32,-34,938,6.2827225131,6.2827225131,-36.64921466,-2,3.1413612565,0,-33.5078534
32,9,2002,9,9,-65,6,3,0,-62,-62,876,9.9228224917,9.9228224917,-71.66482911,0,3.3076074972,0,-68.35722161
32,9,2003,1,15,-54,6,2,-14,-52,-64,812,1.1848341232,17.772511848,-63.98104265,2,2.3696682464,-16.58767773,-61.61137441
32,9,2004,7,10,-23,6,1,-3,-22,-25,787,8.7554721701,12.507817386,-28.76797999,0,1.2507817386,-3.752345216,-27.51719825
32,9,2005,2,8,-12,6,2,-6,-10,-17,770,2.5690430315,10.276172126,-15.41425819,-1,2.5690430315,-7.707129094,-12.84521516
32,9,2006,2,15,-7,6,1,-13,-6,-20,750,2.6315789474,19.736842105,-9.210526316,-1,1.3157894737,-17.10526316,-7.894736842
32,9,2007,0,4,-58,6,2,-4,-56,-64,686,0,5.5710306407,-80.77994429,-4,2.7855153203,-5.571030641,-77.99442897
32,9,2008,2,5,1,6,1,-3,2,-9,677,2.9347028613,7.3367571533,1.4673514307,-8,1.4673514307,-4.402054292,2.9347028613
32,11,2001,14,10,-21,9,11,4,-10,-8,1619,8.6260012323,6.1614294516,-12.93900185,-2,6.7775723968,2.4645717807,-6.161429452
32,11,2002,21,11,-47,9,11,10,-36,-27,1592,13.080037372,6.851448147,-29.27436936,-1,6.851448147,6.2285892245,-22.42292121
32,11,2003,10,11,-153,9,6,-1,-147,-139,1453,6.5681444992,7.2249589491,-100.4926108,9,3.9408866995,-0.65681445,-96.55172414
32,11,2004,20,13,-62,9,5,7,-57,-52,1401,14.015416959,9.1100210231,-43.44779257,-2,3.5038542397,4.9053959355,-39.94393833
32,11,2005,13,22,-20,9,6,-9,-14,-24,1377,9.3592512599,15.838732901,-14.39884809,-1,4.3196544276,-6.479481641,-10.07919366
32,11,2006,16,8,76,9,5,8,81,88,1465,11.259676284,5.6298381422,53.48346235,-1,3.5186488388,5.6298381422,57.002111189
32,11,2007,26,5,72,9,5,21,77,98,1563,17.173051519,3.3025099075,47.556142668,0,3.3025099075,13.870541612,50.858652576
32,11,2008,19,2,47,9,4,17,51,65,1628,11.908492636,1.2535255406,29.457850204,-3,2.5070510812,10.654967095,31.964901285
32,13,2001,230,104,-870,223,52,126,-818,82,15981,14.429109159,6.5244667503,-54.57967378,774,3.2622333752,7.904642409,-51.3174404
32,13,2002,221,98,-644,223,52,123,-592,137,16118,13.769899374,6.1061092246,-40.12586062,606,3.2399763232,7.6637901492,-36.8858843
32,13,2003,201,108,-324,223,48,93,-276,444,16562,12.301101591,6.6095471236,-19.82864137,627,2.9375764994,5.6915544676,-16.89106487
32,13,2004,227,121,128,223,44,106,172,279,16841,13.591593569,7.2448582463,7.663982277,1,2.6344939077,6.3467353232,10.298476185
32,13,2005,226,111,-37,223,48,115,11,126,16967,13.369616659,6.5664931377,-2.188831046,0,2.8395646001,6.8031235211,0.6507335542
32,13,2006,235,125,112,223,47,110,159,269,17236,13.741484665,7.3093003538,6.549133117,0,2.748296933,6.4321843113,9.29743005
32,13,2007,279,115,42,223,45,164,87,248,17484,16.071428571,6.6244239631,2.4193548387,-3,2.5921658986,9.4470046083,5.0115207373
32,13,2008,276,118,82,223,44,158,126,279,17763,15.660907311,6.6956052997,4.6528782591,-5,2.496666383,8.9653020115,7.1495446421
32,15,2001,81,40,-354,86,6,41,-348,-303,5391,14.614343708,7.2169598557,-63.87009472,4,1.0825439783,7.3973838521,-62.78755074
32,15,2002,90,34,-383,86,6,56,-377,-314,5077,17.19526175,6.4959877723,-73.17539167,7,1.1463507833,10.699273978,-72.02904089
32,15,2003,48,35,-239,86,5,13,-234,-210,4867,9.6540627514,7.0394207562,-48.06918745,11,1.0056315366,2.6146419952,-47.06355591
32,15,2004,58,47,8,86,4,11,12,21,4888,11.891337775,9.6360840595,1.6401845208,-2,0.8200922604,2.255253716,2.4602767811
32,15,2005,64,56,-26,86,5,8,-21,-17,4871,13.116097961,11.476585716,-5.328414797,-4,1.0246951532,1.6395122451,-4.303719643
32,15,2006,61,29,86,86,4,32,90,120,4991,12.370715879,5.8811600081,17.440681403,-2,0.8111944839,6.489555871,18.251875887
32,15,2007,77,33,47,86,4,44,51,89,5080,15.291430841,6.5534703604,9.3337305134,-6,0.7943600437,8.7379604806,10.128090557
32,15,2008,73,36,-28,86,3,37,-25,6,5086,14.361597482,7.0824316349,-5.508557938,-6,0.5902026362,7.2791658469,-4.918355302
32,17,2001,41,40,-32,351,4,1,-28,-31,4141,9.8640683267,9.6234812944,-7.698785035,-4,0.9623481294,0.2405870324,-6.736436906
32,17,2002,36,49,63,351,4,-13,67,52,4193,8.6393088553,11.759059275,15.118790497,-2,0.9599232061,-3.11975042,16.078713703
32,17,2003,45,48,24,351,2,-3,26,19,4212,10.707911957,11.421772754,5.7108863772,-4,0.4759071981,-0.713860797,6.1867935753
32,17,2004,46,49,-8,351,1,-3,-7,-13,4199,10.938057306,11.651408869,-1.902270836,-3,0.2377838545,-0.713351563,-1.664486981
32,17,2005,28,44,154,351,2,-16,156,145,4344,6.5550743299,10.30083109,36.052908814,5,0.468219595,-3.74575676,36.521128409
32,17,2006,25,53,213,351,1,-28,214,181,4525,5.6376141617,11.951742023,48.032472658,-5,0.2255045665,-6.314127861,48.257977224
32,17,2007,52,55,231,351,2,-3,233,198,4723,11.24567474,11.894463668,49.956747405,-32,0.4325259516,-0.648788927,50.389273356
32,17,2008,57,55,213,351,1,2,214,175,4898,11.849080137,11.433322939,44.278141565,-41,0.2078785989,0.4157571978,44.486020164
32,19,2001,432,312,1135,509,51,120,1186,1288,36130,12.173815026,8.7921997407,31.98444457,-18,1.4371864961,3.3816152849,33.421631066
32,19,2002,420,373,1540,509,49,47,1589,1632,37762,11.367942402,10.095815515,41.682455476,-4,1.3262599469,1.2721268879,43.008715423
32,19,2003,467,399,1938,509,42,68,1980,2122,39884,12.02895191,10.277412874,49.91886253,74,1.0818329341,1.7515390361,51.000695464
32,19,2004,541,433,2914,509,44,108,2958,2951,42835,13.080428922,10.469178786,70.455397188,-115,1.063842648,2.611250136,71.519239836
32,19,2005,561,446,3624,509,44,115,3668,3756,46591,12.546686646,9.9747277078,81.050253841,-27,0.9840538546,2.5719589381,82.034307696
32,19,2006,650,448,3482,509,45,202,3527,3693,50284,13.419354839,9.2490322581,71.886451613,-36,0.9290322581,4.1703225806,72.815483871
32,19,2007,748,452,1754,509,40,296,1794,2079,52363,14.574220386,8.8068818378,34.175377751,-11,0.7793700741,5.7673385486,34.954747825
32,19,2008,771,485,370,509,40,286,410,659,53022,14.632063387,9.2043459695,7.0218721829,-37,0.7591213171,5.4277174171,7.7809935
32,21,2001,48,77,-135,109,3,-29,-132,-163,4844,9.7452035326,15.632930667,-27.40838494,-2,0.6090752208,-5.887727134,-26.79930971
32,21,2002,37,76,-114,109,2,-39,-112,-152,4692,7.7600671141,15.939597315,-23.90939597,-1,0.4194630872,-8.179530201,-23.48993289
32,21,2003,45,84,52,109,2,-39,54,12,4704,9.5785440613,17.879948914,11.068539804,-3,0.4257130694,-8.301404853,11.494252874
32,21,2004,39,73,160,109,3,-34,163,122,4826,8.184679958,15.320041973,33.578174187,-7,0.629590766,-7.135362015,34.207764953
32,21,2005,43,83,6,109,3,-40,9,-34,4792,8.9415678935,17.259305469,1.2476606363,-3,0.6238303182,-8.317737575,1.8714909545
32,21,2006,44,82,-3,109,3,-38,0,-40,4752,9.2204526404,17.18357083,-0.628667225,-2,0.6286672255,-7.963118189,0
32,21,2007,46,63,22,109,3,-17,25,7,4759,9.6730101987,13.247818316,4.626222269,-1,0.6308484912,-3.574808117,5.2570707602
32,21,2008,43,60,-60,109,2,-17,-58,-75,4684,9.1072752303,12.707825903,-12.7078259,0,0.4235941968,-3.600550672,-12.28423171
32,23,2001,292,383,829,231,55,-91,884,751,33868,8.7183697843,11.435395984,24.751810107,-42,1.6421586922,-2.7170262,26.393968799
32,23,2002,315,466,833,231,52,-151,885,715,34583,9.2036639348,13.615579027,24.338577961,-19,1.5193349988,-4.411915093,25.85791296
32,23,2003,311,428,1094,231,43,-117,1137,1041,35624,8.8595154329,12.192516416,31.164983549,21,1.2249490792,-3.333000983,32.389932628
32,23,2004,335,533,1978,231,41,-198,2019,1737,37361,9.1799684867,14.605740906,54.202918408,-84,1.1235185312,-5.425772419,55.326436939
32,23,2005,372,536,2845,231,42,-164,2887,2700,40061,9.6096716696,13.846193588,73.493322311,-23,1.0849629304,-4.236521919,74.578285242
32,23,2006,441,576,2329,231,41,-135,2370,2208,42269,10.712984331,13.992469331,56.57718936,-27,0.9959917406,-3.279484999,57.5731811
32,23,2007,459,567,1810,231,40,-108,1850,1753,44022,10.638421156,13.141579075,41.951072534,11,0.9270955256,-2.503157919,42.878168059
32,23,2008,500,596,405,231,39,-96,444,353,44375,11.312601106,13.484620519,9.1632068962,5,0.8823828863,-2.172019412,10.045589782
32,27,2001,69,38,-159,1414,11,31,-148,-119,6534,10.464851748,5.7632516873,-24.11465838,-2,1.6683096989,4.7016000607,-22.44634868
32,27,2002,70,43,-36,1414,10,27,-26,-6,6528,10.718113612,6.5839840759,-5.512172715,-7,1.5311590874,4.1341295361,-3.981013627
32,27,2003,58,39,-193,1414,4,19,-189,-165,6363,8.9985261035,6.0507330696,-29.94337134,5,0.6205880071,2.9477930339,-29.32278334
32,27,2004,41,58,-28,1414,10,-17,-18,-41,6322,6.4643279464,9.1446590461,-4.414662988,-6,1.5766653528,-2.6803311,-2.837997635
32,27,2005,56,45,-19,1414,7,11,-12,-5,6317,8.8614605586,7.1208165203,-3.006566975,-4,1.1076825698,1.7406440383,-1.898884405
32,27,2006,59,40,-11,1414,9,19,-2,13,6330,9.3302759548,6.3256108168,-1.739542975,-4,1.4232624338,3.004665138,-0.316280541
32,27,2007,54,31,-7,1414,5,23,-2,20,6350,8.5173501577,4.8895899054,-1.104100946,-1,0.7886435331,3.6277602524,-0.315457413
32,27,2008,61,44,-83,1414,5,17,-78,-59,6291,9.651135195,6.9614745669,-13.13187248,2,0.7910766553,2.6896606281,-12.34079582
32,29,2001,4,21,41,4,4,-17,45,23,3416,1.1749155529,6.168306653,12.042884418,-5,1.1749155529,-4.9933911,13.217799971
32,29,2002,8,17,-9,4,4,-9,-5,-18,3398,2.3481068389,4.9897270326,-2.641620194,-4,1.1740534194,-2.641620194,-1.467566774
32,29,2003,20,22,109,4,3,-2,112,114,3512,5.7887120116,6.3675832127,31.548480463,4,0.8683068017,-0.578871201,32.416787265
32,29,2004,15,15,165,4,2,0,167,158,3670,4.1771094403,4.1771094403,45.948203843,-9,0.5569479254,0,46.505151768
32,29,2005,24,22,342,4,3,2,345,346,4016,6.2451209992,5.7246942493,88.992974239,-1,0.7806401249,0.5204267499,89.773614364
32,29,2006,37,14,37,4,2,23,39,60,4076,9.1448344043,3.4602076125,9.1448344043,-2,0.4943153732,5.6846267919,9.6391497776
32,29,2007,23,11,92,4,2,12,94,101,4177,5.5737307646,2.6656973222,22.294923058,-5,0.4846722404,2.9080334424,22.779595299
32,29,2008,31,8,148,4,1,23,149,164,4341,7.2787039211,1.8783752054,34.749941301,-8,0.2347969007,5.4003287157,34.984738201
32,31,2001,5068,2573,6084,5410,1868,2495,7952,10205,351590,14.626790288,7.4259533172,17.559075003,-242,5.3912478805,7.200836971,22.950322883
32,31,2002,5164,2741,5945,5410,1744,2423,7689,9889,361479,14.483871827,7.6878955613,16.674403178,-223,4.891532236,6.795976266,21.565935414
32,31,2003,5393,2819,5300,5410,1522,2574,6822,9175,370654,14.732295908,7.7007866057,14.478243707,-221,4.1577145136,7.0315093023,18.635958221
32,31,2004,5442,2866,6337,5410,1426,2576,7763,9918,380572,14.488316432,7.6301938431,16.871088061,-421,3.7964607189,6.8581225889,20.66754878
32,31,2005,5511,2969,5457,5410,1485,2542,6942,9158,389730,14.308673741,7.7086649132,14.16846899,-326,3.8556306488,6.6000088277,18.024099639
32,31,2006,5916,2955,3091,5410,1492,2961,4583,7330,397060,15.038320263,7.5115342086,7.8572427204,-214,3.7926257324,7.5267860547,11.649868453
32,31,2007,6033,3116,3402,5410,1359,2917,4761,7650,404710,15.049203637,7.7728026741,8.4862242289,-28,3.3899996258,7.2764009629,11.876223855
32,31,2008,6016,3193,1481,5410,1364,2823,2845,5733,410443,14.76041921,7.8341121237,3.6336736784,65,3.3466110043,6.9263070859,6.9802846828
32,33,2001,64,77,-341,1241,6,-13,-335,-349,8679,7.2287795787,8.6971254306,-38.51584119,-1,0.6776980855,-1.468345852,-37.83814311
32,33,2002,78,101,-104,1241,6,-23,-98,-126,8553,9.0529247911,11.722376973,-12.07056639,-5,0.6963788301,-2.669452182,-11.37418756
32,33,2003,81,90,-106,1241,6,-9,-100,-113,8440,9.5333372565,10.592596952,-12.4757253,-4,0.7061731301,-1.059259695,-11.76955217
32,33,2004,74,98,13,1241,5,-24,18,-11,8429,8.7734898334,11.618945996,1.5412887545,-5,0.5928033671,-2.845456162,2.1340921216
32,33,2005,77,89,383,1241,6,-12,389,368,8797,8.9399744572,10.33321723,44.467665157,-9,0.6966213863,-1.393242773,45.164286544
32,33,2006,99,87,254,1241,5,12,259,266,9063,11.086226204,9.7424412094,28.443449048,-5,0.5599104143,1.3437849944,29.003359462
32,33,2007,111,104,37,1241,6,7,43,49,9112,12.214580468,11.444291609,4.0715268226,-1,0.6602475928,0.7702888583,4.7317744154
32,33,2008,111,83,48,1241,5,28,53,87,9199,12.123859975,9.0655889902,5.2427502594,6,0.5461198187,3.0582709847,5.7888700781
32,510,2001,742,561,524,3223,210,181,734,857,53403,14.006739091,10.590000849,9.8915515956,-58,3.964171441,3.416738242,13.855723037
32,510,2002,738,656,731,3223,197,82,928,964,54367,13.69583372,12.174074418,13.565927438,-46,3.6559339334,1.5217593022,17.221861371
32,510,2003,703,657,470,3223,169,46,639,626,54993,12.856620337,12.015362107,8.5954645208,-59,3.090709583,0.8412582297,11.686174104
32,510,2004,746,633,447,3223,163,113,610,677,55670,13.482374416,11.440138077,8.0785809168,-46,2.945880737,2.0422363392,11.024461654
32,510,2005,745,660,-306,3223,169,85,-137,-104,55566,13.394944083,11.866661872,-5.501815959,-52,3.0385846309,1.5282822108,-2.463231328
32,510,2006,766,622,-875,3223,168,144,-707,-583,54983,13.858108169,11.252928566,-15.8300844,-20,3.0393762042,2.6051796036,-12.79070819
32,510,2007,747,671,-501,3223,146,76,-355,-259,54724,13.618091826,12.232583153,-9.133419016,20,2.6616350825,1.3855086731,-6.471783934
32,510,2008,738,627,-151,3223,146,111,-5,143,54867,13.468259255,11.442545464,-2.755700742,37,2.6644523729,2.0257137904,-0.091248369
33,0,2001,14514,9838,10507,35809,2083,4676,12590,16264,1256625,11.62521536,7.8799000074,8.4157460234,-1002,1.6684114368,3.7453153522,10.08415746
33,0,2002,14651,9853,8365,36488,1908,4798,10273,14076,1270701,11.594072154,7.7971737718,6.6196446363,-995,1.5098962302,3.7968983819,8.1295408665
33,0,2003,14522,9629,5499,36794,1559,4893,7058,10559,1281260,11.38105167,7.5463535689,4.3096269888,-1392,1.2218055056,3.8346981008,5.5314324945
33,0,2004,14667,10031,5454,37133,1652,4636,7106,10804,1292064,11.399264142,7.7961422658,4.2388754778,-938,1.2839424806,3.6031218766,5.5228179584
33,0,2005,15482,10174,2722,37841,1639,5308,4361,8466,1300530,11.943250659,7.8485100251,2.0998274315,-1203,1.2643707422,4.0947406343,3.3641981737
33,0,2006,15406,10030,1790,38656,1750,5376,3540,8294,1308824,11.808286649,7.6877265407,1.3719870895,-622,1.3413281601,4.120560108,2.7133152497
33,0,2007,14463,10248,-2374,38651,1550,4215,-824,3432,1312256,11.035908862,7.8196773849,-1.811467029,41,1.182718574,3.2162314771,-0.628748455
33,0,2008,14447,10168,-2473,38651,1561,4279,-912,3553,1315809,10.994400823,7.7380125682,-1.881993025,186,1.1879462646,3.2563882552,-0.694046761
33,1,2001,587,532,1196,1211,44,55,1240,1262,57844,10.259905965,9.2985859857,20.904339923,-33,0.7690559838,0.9613199797,21.673395907
33,1,2002,540,592,1178,1230,43,-52,1221,1140,58984,9.244359229,10.134556784,20.166398466,-29,0.7361249016,-0.890197555,20.902523368
33,1,2003,577,570,942,1218,37,7,979,976,59960,9.7020446597,9.5843422115,15.839386602,-10,0.622141512,0.1177024482,16.461528114
33,1,2004,666,597,750,1247,41,69,791,800,60760,11.033797217,9.8906560636,12.425447316,-60,0.6792577866,1.1431411531,13.104705103
33,1,2005,550,575,259,1261,40,-25,299,215,60975,9.036020865,9.4467490861,4.255144371,-59,0.6571651538,-0.410728221,4.9123095248
33,1,2006,603,581,-51,1274,43,22,-8,-13,60962,9.8903532152,9.529511141,-0.836497536,-27,0.7052822359,0.3608420742,-0.1312153
33,1,2007,616,601,36,1274,38,15,74,103,61065,10.096126267,9.8502790366,0.5900333533,14,0.622812984,0.2458472305,1.2128463373
33,1,2008,613,604,142,1274,38,9,180,216,61281,10.020760793,9.8736370621,2.3212855345,27,0.6211890867,0.1471237311,2.9424746212
33,3,2001,386,427,357,558,29,-41,386,312,44221,8.7597866788,9.6902303415,8.1016679905,-33,0.6581186883,-0.930443663,8.7597866788
33,3,2002,392,448,939,616,28,-56,967,890,45111,8.7762503918,10.030000448,21.022701831,-21,0.626875028,-1.253750056,21.649576859
33,3,2003,409,442,635,614,21,-33,656,613,45724,9.0053393516,9.7319315242,13.981394837,-10,0.4623768371,-0.726592173,14.443771674
33,3,2004,395,438,891,624,23,-43,914,816,46540,8.5623861961,9.4944940605,19.314142027,-55,0.4985693228,-0.932107864,19.81271135
33,3,2005,423,500,238,617,21,-77,259,145,46685,9.0748189863,10.72673639,5.1059265219,-37,0.4505229284,-1.651917404,5.5564494503
33,3,2006,415,481,471,629,22,-66,493,401,47086,8.8513506308,10.259035309,10.045749752,-26,0.4692282262,-1.407684679,10.514977978
33,3,2007,401,486,249,629,18,-85,267,163,47249,8.5016165792,10.303704882,5.2790586739,-19,0.3816186993,-1.802088302,5.6606773732
33,3,2008,439,487,218,629,18,-48,236,159,47408,9.2755950432,10.289783112,4.6061041444,-29,0.3803205257,-1.014188068,4.9864246701
33,5,2001,782,680,325,4145,36,102,361,396,74384,10.54107244,9.1661499474,4.3808804896,-67,0.4852667619,1.3749224921,4.8661472515
33,5,2002,757,705,598,4302,35,52,633,631,75015,10.133936639,9.4378141755,8.0054083361,-54,0.4685439662,0.696122464,8.4739523022
33,5,2003,732,645,921,4233,26,87,947,991,76006,9.694016064,8.541858417,12.196979228,-43,0.344322975,1.1521576469,12.541302203
33,5,2004,737,634,466,4268,28,103,494,539,76545,9.6623424297,8.3119743561,6.1094322554,-58,0.3670903501,1.3503680736,6.4765226056
33,5,2005,819,644,152,4258,27,175,179,281,76826,10.679985134,8.3979370285,1.9821217831,-73,0.352087422,2.2820481056,2.3342092051
33,5,2006,817,653,275,4381,31,164,306,434,77260,10.604467635,8.4757862492,3.5694352504,-36,0.402372701,2.1286813857,3.9718079514
33,5,2007,772,659,-99,4381,27,113,-72,44,77304,9.9893895086,8.5272120287,-1.281022748,3,0.3493698403,1.4621774799,-0.931652908
33,5,2008,773,661,-293,4381,27,112,-266,-134,77170,10.008156712,8.558074498,-3.79351865,20,0.349573391,1.4500822145,-3.443945259
33,7,2001,303,423,-97,655,12,-120,-85,-234,32910,9.1743119266,12.807702789,-2.936990947,-29,0.3633390862,-3.633390862,-2.573651861
33,7,2002,295,423,67,655,11,-128,78,-79,32831,8.9746124945,12.868681645,2.0383018208,-29,0.3346465676,-3.89406915,2.3729483884
33,7,2003,300,409,138,642,6,-109,144,-2,32829,9.1379835516,12.458117575,4.2034724337,-37,0.182759671,-3.320134024,4.3862321048
33,7,2004,286,446,98,630,11,-160,109,-75,32754,8.7217724105,13.601085647,2.9885793575,-24,0.335452785,-4.879313237,3.3240321425
33,7,2005,302,404,175,641,9,-102,184,50,32804,9.2132157784,12.324964154,5.3387839775,-32,0.2745660331,-3.111748375,5.6133500107
33,7,2006,308,395,-126,662,11,-87,-115,-215,32589,9.4199684982,12.080803756,-3.853623477,-13,0.3364274464,-2.660835258,-3.51719603
33,7,2007,307,412,-163,662,9,-105,-154,-244,32345,9.4557550744,12.689808113,-5.020482336,15,0.2772045462,-3.234053038,-4.74327779
33,7,2008,295,398,-304,662,9,-103,-295,-374,31971,9.1734560607,12.376391567,-9.453324212,24,0.279868151,-3.202935506,-9.173456061
33,9,2001,757,678,-16,6388,110,79,94,91,81887,9.2495860902,8.2843056396,-0.195499838,-82,1.3440613869,0.9652804506,1.1485615488
33,9,2002,816,665,438,6349,101,151,539,615,82502,9.9276715595,8.0905656705,5.3288237047,-75,1.2287926808,1.8371058891,6.5576163855
33,9,2003,832,668,568,6645,81,164,649,737,83239,10.039760832,8.0607695139,6.8540674908,-76,0.9774286387,1.9789913178,7.8314961295
33,9,2004,819,716,674,6733,87,103,761,797,84036,9.7922582574,8.5607532506,8.0585861605,-67,1.0402032581,1.2315050067,9.0987894186
33,9,2005,795,749,569,6879,86,46,655,635,84671,9.424623756,8.8792996141,6.7454225373,-66,1.0195190478,0.5453241419,7.7649415851
33,9,2006,809,644,304,6905,88,165,392,515,85186,9.5256598197,7.5828491025,3.5794815639,-42,1.0361657159,1.9428107173,4.6156472798
33,9,2007,819,736,1,6905,80,83,81,145,85331,9.6060803322,8.6325703596,0.0117290358,-19,0.9383228652,0.9735099726,0.950051901
33,9,2008,826,742,426,6905,80,84,506,590,85921,9.6466026674,8.6655922267,4.9751243781,0,0.9342956579,0.9810104408,5.909420036
33,11,2001,5038,2784,2473,7767,1296,2254,3769,5703,388064,13.078495636,7.2271798034,6.4198332089,-320,3.364376805,5.8513158322,9.784210014
33,11,2002,5006,2751,-461,7782,1195,2255,734,2618,390682,12.85656684,7.0652048293,-1.183954717,-371,3.0690366307,5.7913620102,1.8850819137
33,11,2003,4932,2676,-770,7915,1025,2256,255,1959,392641,12.592506539,6.8324305555,-1.965983381,-552,2.6170557995,5.760075984,0.6510724184
33,11,2004,5008,2775,415,8077,982,2233,1397,3379,396020,12.70000672,7.0372441391,1.0524166911,-251,2.4902968449,5.6627625811,3.542713536
33,11,2005,5286,2821,-929,8046,1020,2465,91,2173,398193,13.311290548,7.103887748,-2.3394228,-383,2.568580469,6.2074028,0.2291576693
33,11,2006,5245,2880,-1450,8051,1076,2365,-374,1809,400002,13.14215198,7.2162817357,-3.633197402,-182,2.6960830374,5.9258702447,-0.937114364
33,11,2007,4975,2922,-2045,8046,964,2053,-1081,1058,401060,12.421011108,7.2953154687,-5.105722154,86,2.4068049664,5.125695639,-2.698917187
33,11,2008,4845,2802,-2118,8046,968,2043,-1150,982,402042,12.065715189,6.9779430259,-5.27454794,89,2.4106526942,5.0877721634,-2.863895246
33,13,2001,1498,1148,1547,6260,159,350,1706,1959,138597,10.885243519,8.3419623231,11.241302887,-97,1.1553763148,2.5432811961,12.396679201
33,13,2002,1624,1109,2207,6512,147,515,2354,2807,141404,11.599958572,7.9214002807,15.764229413,-62,1.04999625,3.6785582909,16.814225663
33,13,2003,1504,1179,1460,6654,122,325,1582,1799,143203,10.568960004,8.2851089397,10.259761706,-108,0.8573225536,2.2838510648,11.11708426
33,13,2004,1563,1230,1127,6570,132,333,1259,1476,144679,10.858615683,8.5451678118,7.8295968487,-116,0.9170423993,2.313447871,8.746639248
33,13,2005,1530,1245,1242,6909,129,285,1371,1528,146207,10.519584992,8.5600544543,8.5394278171,-128,0.8869454013,1.9595305377,9.4263732184
33,13,2006,1537,1195,930,7077,135,342,1065,1334,147541,10.4647521,8.1362256083,6.3319580048,-73,0.9191551942,2.3285264921,7.2511131991
33,13,2007,1594,1200,12,7077,122,394,134,532,148073,10.784333624,8.1186953257,0.0811869533,4,0.8254006914,2.6656382986,0.9065876447
33,13,2008,1581,1207,-473,7077,123,374,-350,88,148161,10.673994207,8.1489633195,-3.193421417,64,0.8304245968,2.5250308877,-2.36299682
33,15,2001,3343,1901,3203,2573,245,1442,3448,4670,283380,11.894892277,6.7640413457,11.39675141,-220,0.8717465175,5.1308509313,12.268497927
33,15,2002,3296,1894,2234,2748,218,1402,2452,3625,287005,11.557106165,6.6411283607,7.8333055743,-229,0.7643959782,4.9159778045,8.5977015525
33,15,2003,3379,1816,563,2792,157,1563,720,1886,288891,11.734757665,6.3066942642,1.9552141359,-397,0.5452373345,5.4280634003,2.5004514704
33,15,2004,3284,1942,214,2724,209,1342,423,1580,290471,11.3366082,6.7039260428,0.7387436525,-185,0.7214832868,4.6326821573,1.4602269393
33,15,2005,3910,1956,546,2704,189,1954,735,2406,292877,13.405377236,6.7061171033,1.8719529338,-283,0.6479837078,6.6992601329,2.5199366416
33,15,2006,3720,1947,461,2796,210,1773,671,2303,295180,12.651834771,6.6218070697,1.567875223,-141,0.714216479,6.0300277014,2.282091702
33,15,2007,3112,1945,-477,2796,181,1167,-296,862,296042,10.527348441,6.5795927756,-1.613607071,-9,0.6122911529,3.9477556654,-1.001315919
33,15,2008,3125,1982,-36,2796,185,1143,149,1308,297350,10.532666433,6.6802383585,-0.121336317,16,0.6235338528,3.8524280745,0.5021975355
33,17,2001,1369,855,1238,5694,127,514,1365,1792,114472,12.053602874,7.527998873,10.900190181,-87,1.1181939846,4.5256040008,12.018384166
33,17,2002,1449,852,898,5724,106,597,1004,1507,115979,12.575341396,7.3941965971,7.7934137843,-94,0.9199352574,5.1811447987,8.7133490417
33,17,2003,1389,830,569,5512,69,559,638,1059,117038,11.921876945,7.1239437466,4.8837638456,-138,0.5922314681,4.797933198,5.4759953136
33,17,2004,1390,888,612,5694,122,502,734,1148,118186,11.81852192,7.5502499745,5.2035506581,-88,1.0373091181,4.268271945,6.2408597762
33,17,2005,1386,853,270,5961,103,533,373,795,118981,11.687966707,7.1932435794,2.2768766312,-111,0.8685862704,4.4947231276,3.1454629017
33,17,2006,1498,849,808,6278,117,649,925,1515,120496,12.510596007,7.0904512751,6.7480384338,-59,0.9771293277,5.4201447321,7.7251677614
33,17,2007,1378,889,135,6278,96,489,231,715,121211,11.402234937,7.356013686,1.1170549467,-5,0.7943501843,4.0462212513,1.911405131
33,17,2008,1458,878,15,6278,99,580,114,703,121914,11.993830334,7.222622108,0.1233933162,9,0.8143958869,4.7712082262,0.9377892031
33,19,2001,451,410,281,558,25,41,306,313,40866,11.078495192,10.071359265,6.9025657402,-34,0.6141072723,1.0071359265,7.5166730124
33,19,2002,476,414,267,570,24,62,291,322,41188,11.60211568,10.090915738,6.5079094255,-31,0.5849806225,1.5111999415,7.092890048
33,19,2003,468,394,473,569,15,74,488,541,41729,11.288396831,9.503479383,11.408999361,-21,0.3618075907,1.7849174476,11.770806952
33,19,2004,519,365,207,566,17,154,224,344,42073,12.386339228,8.7110092838,4.940216224,-34,0.4057182406,3.6753299444,5.3459344646
33,19,2005,481,427,200,565,15,54,215,238,42311,11.400265453,10.120401972,4.7402351157,-31,0.3555176337,1.2798634812,5.0957527493
33,19,2006,454,405,168,603,17,49,185,211,42522,10.703381939,9.5481711127,3.9607228319,-23,0.4007874294,1.155210826,4.3615102613
33,19,2007,489,398,-23,603,15,91,-8,54,42576,11.492632024,9.3539213613,-0.540553244,-29,0.3525347247,2.138710663,-0.18801852
33,19,2008,492,407,-50,603,14,85,-36,15,42591,11.553770827,9.5576925335,-1.174163702,-34,0.3287658365,1.9960782932,-0.845397865
34,0,2001,112168,72782,-32148,194765,55813,39386,23665,60029,8490942,13.25717541,8.6021302038,-3.799583438,-3022,6.5965581197,4.6550452063,2.7969746816
34,0,2002,112854,74829,-31049,194223,52214,38025,21165,56468,8547410,13.247055819,8.7835959722,-3.644601309,-2722,6.1289965133,4.4634598464,2.4843952044
34,0,2003,115968,73374,-42275,194424,45346,42594,3071,42152,8589562,13.534246307,8.5632397602,-4.933777099,-3513,5.2921834733,4.9710065465,0.3584063742
34,0,2004,116466,73662,-51221,194134,42799,42804,-8422,31208,8620770,13.53442804,8.5602067409,-5.952354667,-3174,4.9736402528,4.9742212992,-0.978714414
34,0,2005,112044,72187,-67340,195019,44393,39857,-22947,13887,8634657,12.986523023,8.3668749548,-7.805080686,-3023,5.1453957065,4.6196480678,-2.659684979
34,0,2006,109251,69588,-77639,196222,46205,39663,-31434,5561,8640218,12.648543043,8.0565561256,-8.988661278,-2668,5.3493874775,4.5919869174,-3.639273801
34,0,2007,112351,67475,-72370,196481,41607,44876,-30763,12908,8653126,12.993554052,7.8035803833,-8.369694144,-1205,4.8119091368,5.1899736685,-3.557785007
34,0,2008,114805,68533,-56208,196339,41796,46272,-14412,29535,8682661,13.244855858,7.9065346154,-6.484620514,-2325,4.8219328029,5.3383212426,-1.662687711
34,1,2001,3389,2496,-162,6494,1324,893,1162,1803,254783,13.348747349,9.8313583306,-0.638092969,-252,5.2150314221,3.5173890181,4.5769384536
34,1,2002,3498,2714,1431,6494,1236,784,2667,3226,258009,13.642958548,10.585188536,5.5812103153,-225,4.8206680291,3.057770012,10.401878344
34,1,2003,3551,2850,2081,6582,1093,701,3174,3612,261621,13.667417201,10.969343571,8.0095452534,-263,4.2068394819,2.6980736293,12.216384735
34,1,2004,3493,2683,2587,6630,1047,810,3634,4199,265820,13.245083336,10.173649754,9.8096279963,-245,3.9701122969,3.0714335821,13.779740293
34,1,2005,3613,2513,383,6612,1072,1100,1455,2300,268120,13.533355808,9.413042664,1.4346181219,-255,4.0154324456,4.1203131438,5.4500505675
34,1,2006,3551,2535,-864,6649,1182,1016,318,1209,269329,13.214277076,9.4334532207,-3.21518879,-125,4.3985568863,3.7808238549,1.1833680963
34,1,2007,3620,2446,-1697,6757,1073,1174,-624,641,269970,13.424834832,9.0710348063,-6.293354892,91,3.9792397167,4.3538000256,-2.314115175
34,1,2008,3681,2550,-1672,6978,1078,1131,-594,711,270681,13.616917383,9.4330723517,-6.185136067,174,3.9877850961,4.1838450313,-2.197350971
34,3,2001,10060,7158,-6178,11349,7547,2902,1369,3395,888875,11.339331757,8.068283968,-6.963657216,-876,8.5067531582,3.2710477892,1.5430959419
34,3,2002,10199,7682,-7304,11325,7136,2517,-168,1582,890457,11.463852727,8.6347011126,-8.209822563,-767,8.0209876515,2.8291516142,-0.188834911
34,3,2003,10564,7562,-7477,11327,6289,3002,-1188,860,891317,11.857845047,8.4881696556,-8.392759127,-954,7.0592566734,3.3696753909,-1.333502453
34,3,2004,10792,7459,-7119,11336,5635,3333,-1484,1112,892429,12.10037752,8.363298362,-7.982078166,-737,6.3181641332,3.7370791581,-1.663914033
34,3,2005,9707,7303,-9892,11324,5963,2404,-3929,-2192,890237,10.8904304,8.19334637,-11.0979847,-667,6.6899800636,2.6970840303,-4.40800464
34,3,2006,9119,6821,-9203,11324,5936,2298,-3267,-1403,888834,10.251417734,7.6680469751,-10.34584904,-434,6.6731457036,2.5833707592,-3.672703338
34,3,2007,9347,6599,-6380,11324,5433,2748,-947,1230,890064,10.508753172,7.4191999766,-7.172980126,-571,6.1082760226,3.0895531953,-1.064704103
34,3,2008,9720,6792,-2819,11324,5435,2928,2616,4776,894840,10.891342055,7.6104933375,-3.158713298,-768,6.0899633818,3.2808487179,2.931250084
34,5,2001,4888,3531,3461,14162,651,1357,4112,5097,429576,11.4465696,8.2687883099,8.1048644408,-372,1.5244919824,3.1777812904,9.6293564232
34,5,2002,5265,3737,5078,13927,340,1528,5418,6654,436230,12.162077879,8.6324188098,11.73011044,-292,0.7853953426,3.5296590691,12.515505783
34,5,2003,5431,3756,5163,14202,-236,1675,4927,6293,442523,12.360697488,8.5484772171,11.750742245,-309,-0.537124767,3.8122202712,11.213617478
34,5,2004,5470,3715,1229,14037,848,1755,2077,3520,446043,12.311972324,8.3617874193,2.7662548421,-312,1.9086933329,3.9501849047,4.6749481749
34,5,2005,5285,3720,-1119,14016,462,1565,-657,491,446534,11.842115582,8.3354153199,-2.507346705,-417,1.0352048059,3.5067002623,-1.472141899
34,5,2006,5090,3574,-1471,14008,720,1516,-751,557,447091,11.391803049,7.9988809624,-3.292208701,-208,1.6114141838,3.392922087,-1.680794517
34,5,2007,5242,3500,-3061,14011,442,1742,-2619,-871,446220,11.736114298,7.8360167959,-6.853156404,6,0.9895769782,3.9000975024,-5.863579425
34,5,2008,5442,3643,-3125,13990,528,1799,-2597,-745,445475,12.205967287,8.1709553154,-7.009123075,53,1.1842614347,4.0350119716,-5.82486164
34,7,2001,6733,4775,-3267,10406,1130,1958,-2137,90,507683,13.263388478,9.4063092203,-6.435688424,269,2.2259956898,3.8570792573,-4.209692734
34,7,2002,6850,4710,-1453,10406,1065,2140,-388,1885,509568,13.467669238,9.260251403,-2.856718745,133,2.093878502,4.2074178349,-0.762840243
34,7,2003,6784,4796,-2148,10406,929,1988,-1219,770,510338,13.303186764,9.4047882844,-4.212152885,1,1.821736513,3.8983984799,-2.390416372
34,7,2004,6971,4705,-1398,10288,883,2266,-515,2110,512448,13.631395033,9.2003605837,-2.733709691,359,1.7266564071,4.431034449,-1.007053284
34,7,2005,6898,4702,-1039,10289,919,2196,-120,2254,514702,13.431339142,9.1554300735,-2.023073553,178,1.7894173198,4.2759090688,-0.233656233
34,7,2006,6832,4517,-1921,10278,1123,2315,-798,1759,516461,13.251057301,8.7609815325,-3.725890087,242,2.1781231483,4.4900757688,-1.547766939
34,7,2007,7290,4439,-3350,10572,986,2851,-2364,826,517287,14.104017614,8.5881665551,-6.481270097,339,1.9076215867,5.5158510585,-4.57364851
34,7,2008,7470,4426,-4176,10572,991,3044,-3185,-53,517234,14.441466147,8.5566170237,-8.073301557,88,1.9158625103,5.8848491234,-6.157439047
34,9,2001,979,1273,-100,2656,55,-294,-45,-447,101861,9.5900944806,12.470061567,-0.979580642,-108,0.5387693528,-2.879967086,-0.440811289
34,9,2002,1054,1376,-51,2656,20,-322,-31,-446,101415,10.370137153,13.53824357,-0.50178083,-93,0.1967767961,-3.168106417,-0.305004034
34,9,2003,1019,1243,304,2656,-52,-224,252,-86,101329,10.052085388,12.261768536,2.9988556998,-114,-0.512962159,-2.209683147,2.4858935406
34,9,2004,963,1355,-1029,2656,97,-392,-932,-1414,99915,9.5704716662,13.466239987,-10.22639184,-90,0.9640038958,-3.895768321,-9.262387947
34,9,2005,898,1327,-899,2656,42,-429,-857,-1358,98557,9.0491353944,13.372163328,-9.059212383,-72,0.423233504,-4.323027933,-8.635978879
34,9,2006,922,1285,-711,2816,102,-363,-609,-1019,97538,9.4036053953,13.105892552,-7.251587241,-47,1.0403120936,-3.702287157,-6.211275147
34,9,2007,953,1215,-943,2816,62,-262,-881,-1210,96328,9.8315331208,12.534430999,-9.72836908,-67,0.6396170551,-2.702897878,-9.088752025
34,9,2008,993,1193,-266,2816,74,-200,-192,-490,95838,10.334814691,12.416348365,-2.768439786,-98,0.7701674594,-2.081533674,-1.998272327
34,11,2001,2075,1462,-691,12474,488,613,-203,284,146635,14.164499328,9.9799990443,-4.716948933,-126,3.3312171913,4.1845002833,-1.385731741
34,11,2002,2146,1575,0,12680,466,571,466,890,147525,14.590698939,10.708457982,0,-147,3.1683437585,3.8822409573,3.1683437585
34,11,2003,2088,1473,289,12786,427,615,716,1131,148656,14.099486463,9.9466204787,1.9515093811,-200,2.8833719921,4.152865984,4.8348813732
34,11,2004,2214,1624,635,12695,391,590,1026,1504,150160,14.818483615,10.869565217,4.2501070893,-112,2.6169950739,3.9489183979,6.8671021632
34,11,2005,2332,1422,1102,13596,414,910,1516,2280,152440,15.413086583,9.3985459352,7.2835426305,-146,2.7362855254,6.0145406477,10.019828156
34,11,2006,2352,1492,209,13601,492,860,701,1486,153926,15.354184211,9.7399842019,1.364381165,-75,3.2118446564,5.6142000091,4.5762258214
34,11,2007,2551,1337,-173,13663,418,1214,245,1481,155407,16.493552256,8.6444058668,-1.118535688,22,2.7025891192,7.8491463892,1.5840534311
34,11,2008,2582,1410,-240,13670,419,1172,179,1423,156830,16.538718986,9.0316009954,-1.537293786,72,2.6838587355,7.5071179905,1.1465649491
34,13,2001,11977,7196,-9600,21447,6442,4781,-3158,919,793238,15.107624639,9.07693637,-12.10930922,-704,8.1258510416,6.0306882692,-3.983458179
34,13,2002,12054,7216,-10279,21436,6089,4838,-4190,42,793280,15.195541431,9.0966506526,-12.95793682,-606,7.6759292993,6.0988907784,-5.282007516
34,13,2003,12183,6812,-12402,21432,5413,5371,-6989,-2077,791203,15.377886667,8.598388244,-15.65431753,-459,6.8325125609,6.7794984231,-8.821804967
34,13,2004,12114,6763,-14206,21446,4879,5351,-9327,-4857,786346,15.358001558,8.5740601401,-18.01021712,-881,6.1855447913,6.783941418,-11.82467232
34,13,2005,11584,6523,-15853,21406,5158,5061,-10695,-6157,780189,14.789328039,8.3279339434,-20.23957333,-523,6.585234291,6.4613940959,-13.65433903
34,13,2006,11275,6176,-15297,21553,5393,5099,-9904,-5148,775041,14.499463102,7.9422336246,-19.67168843,-343,6.9353086039,6.5572294773,-12.73637983
34,13,2007,11776,5923,-13187,21558,4895,5853,-8292,-2768,772273,15.221215603,7.655847488,-17.04502124,-329,6.3270932726,7.5653681153,-10.71792797
34,13,2008,11758,6099,-11515,21597,4898,5659,-6617,-1598,770675,15.240954329,7.9056455564,-14.92597288,-640,6.3488853805,7.3353087726,-8.577087497
34,15,2001,2920,2073,1536,5206,155,847,1691,2659,258985,11.332962037,8.0456268157,5.9614485233,121,0.6015784643,3.2873352209,6.5630269876
34,15,2002,3061,2351,3442,5203,148,710,3590,4428,263413,11.719034146,9.0008001562,13.177692104,128,0.5666177895,2.7182339902,13.744309894
34,15,2003,3202,2383,3586,5204,129,819,3715,4710,268123,12.048102104,8.9664669938,13.492971313,176,0.48538575,3.0816351103,13.978357063
34,15,2004,3345,2371,3469,5204,131,974,3600,4743,272866,12.366240349,8.7654277629,12.824660021,169,0.484298202,3.6008125858,13.308958223
34,15,2005,3140,2344,2660,5204,131,796,2791,3638,276504,11.431275825,8.5334109981,9.683819648,51,0.476909915,2.897864827,10.160729563
34,15,2006,3180,2398,3671,5204,145,782,3816,4765,281269,11.402488109,8.5984800268,13.163060958,167,0.5199247723,2.8040080821,13.682985731
34,15,2007,3322,2208,2952,5204,129,1114,3081,4259,285528,11.72200982,7.7911492122,10.416427751,64,0.4551894241,3.9308606079,10.871617175
34,15,2008,3686,2310,762,5204,130,1376,892,2332,287860,12.856913643,8.0573712739,2.6578861085,64,0.4534451366,4.7995423692,3.1113312452
34,17,2001,8421,4609,-9412,9450,9474,3812,62,3363,612847,13.778591887,7.5413288217,-15.40008394,-511,15.501529455,6.2372630654,0.1014455168
34,17,2002,8412,4712,-16683,9450,8959,3700,-7724,-4224,608623,13.773567914,7.7152938672,-27.31626647,-200,14.66921005,6.0582740468,-12.64705642
34,17,2003,8771,4525,-16418,9450,7954,4246,-8464,-4097,604526,14.459889099,7.4599245435,-27.06674943,121,13.112981175,6.9999645551,-13.95376825
34,17,2004,8932,4384,-14046,9450,7176,4548,-6870,-3096,601430,14.813144095,7.2705803528,-23.29438222,-774,11.900931709,7.542563742,-11.39345051
34,17,2005,8575,4309,-14421,9450,7573,4266,-6848,-2934,598496,14.29254804,7.1821095634,-24.03648225,-352,12.622445051,7.110438477,-11.4140372
34,17,2006,8083,4094,-14741,9450,7749,3989,-6992,-3276,595220,13.542584668,6.8592529546,-24.69766678,-273,12.982987578,6.6833317137,-11.7146792
34,17,2007,8415,3825,-14135,9450,7045,4590,-7090,-2856,592364,14.171629123,6.4416496012,-23.80463192,-356,11.864423906,7.7299795214,-11.94020802
34,17,2008,8610,3875,-7907,9450,7049,4735,-858,3055,595419,14.497597625,6.5247608359,-13.31387972,-822,11.869171389,7.9728367892,-1.444708335
34,19,2001,1434,771,1360,4346,240,663,1600,2077,124619,11.60377244,6.238848362,11.004972467,-186,1.9420539648,5.3649240778,12.947026432
34,19,2002,1463,798,733,4346,231,665,964,1525,126144,11.66838808,6.3645753161,5.8461575272,-104,1.8423770652,5.3038127634,7.6885345924
34,19,2003,1446,824,441,4337,193,622,634,1104,127248,11.413146429,6.5037570247,3.4807728737,-152,1.523331439,4.9093894046,5.0041043127
34,19,2004,1364,810,172,4341,176,554,348,813,128061,10.685091399,6.3452522238,1.347386892,-89,1.3787214708,4.3398391753,2.7261083628
34,19,2005,1356,829,-60,4261,183,527,123,544,128605,10.566261211,6.4597570383,-0.467533682,-106,1.4259777298,4.1065041727,0.9584440479
34,19,2006,1231,760,-196,4294,181,471,-15,392,128997,9.5573792129,5.9005753061,-1.521727316,-64,1.4052685926,3.6568039068,-0.116458723
34,19,2007,1224,776,-570,4186,165,448,-405,-24,128973,9.4894755204,6.0162034345,-4.419118502,-67,1.2792185138,3.4732720859,-3.139899988
34,19,2008,1240,768,-485,4175,166,472,-319,58,129031,9.6122540736,5.9533960714,-3.759631634,-95,1.286801755,3.6588580022,-2.472829879
34,21,2001,4745,2950,-1287,21092,2287,1795,1000,2460,353994,13.450919028,8.3625313241,-3.648331462,-335,6.4830878434,5.088387704,2.834756381
34,21,2002,4447,2927,-1139,21092,2164,1520,1025,2219,356213,12.52310946,8.2426672787,-3.207515555,-326,6.0939979471,4.2804421809,2.8864823918
34,21,2003,4650,2805,-539,21092,1918,1845,1379,2684,358897,13.004992239,7.8449469312,-1.507460391,-540,5.364209702,5.1600453077,3.8567493113
34,21,2004,4584,2931,-493,21124,1759,1653,1266,2686,361583,12.7248501,8.136242505,-1.36853209,-233,4.8828558739,4.5886075949,3.5143237841
34,21,2005,4435,2906,-2262,20954,1838,1529,-424,785,362368,12.25221044,8.0281676522,-6.249041717,-320,5.0776917222,4.2240427874,-1.171349995
34,21,2006,4599,2874,-2578,21555,1917,1725,-661,895,363263,12.675864179,7.9213815286,-7.105539868,-169,5.2836772409,4.7544826503,-1.821862627
34,21,2007,4737,2870,-3062,21301,1753,1867,-1309,494,363757,13.031278369,7.8952435972,-8.423427141,-64,4.822425793,5.1360347721,-3.601001348
34,21,2008,4757,2744,-2589,20972,1756,2013,-833,1126,364883,13.057202459,7.5318401405,-7.106389987,-54,4.8199385156,5.5253623188,-2.286451471
34,23,2001,10267,5730,-4515,20820,8415,4537,3900,7751,760553,13.568528204,7.5725788067,-5.966874924,-686,11.120986153,5.9959493972,5.1541112297
34,23,2002,10367,5575,-5866,20820,7948,4792,2082,6237,766790,13.575208712,7.3002593393,-7.681313235,-637,10.407616364,6.2749493729,2.726303129
34,23,2003,10890,5443,-6743,20820,7015,5447,272,4954,771744,14.156333237,7.0755667408,-8.765487146,-765,9.1190704918,7.0807664959,0.3535833462
34,23,2004,10799,5707,-6341,20615,6311,5092,-30,4391,776135,13.953287046,7.3739614014,-8.19314688,-671,8.1543841605,6.579325645,-0.03876272
34,23,2005,10384,5625,-6351,20629,6677,4759,326,4394,780529,13.341350478,7.2269931083,-8.159757019,-691,8.5786014194,6.1143573693,0.4188444006
34,23,2006,10242,5438,-12930,20649,6737,4804,-6193,-1723,778806,13.136369029,6.9747680902,-16.58399254,-334,8.640862932,6.1616009389,-7.943129603
34,23,2007,10667,5225,-7282,20610,6143,5442,-1139,4223,783029,13.659573514,6.6908476247,-9.32492869,-80,7.8663879347,6.9687258897,-1.458540755
34,23,2008,10733,5283,-5400,20597,6146,5450,746,6073,789102,13.654078445,6.720813978,-6.869656536,-123,7.8186868652,6.9332644671,0.9490303289
34,25,2001,7778,5258,-265,9803,2074,2520,1809,6872,623962,12.534527159,8.4734563902,-0.427057045,2543,3.3423257043,4.061070769,2.9152686592
34,25,2002,7789,5607,609,9269,1824,2182,2433,6581,630543,12.417646801,8.938983902,0.9709008733,1966,2.9079198568,3.4786628989,3.8788207301
34,25,2003,7976,5327,-266,9004,1371,2649,1105,5507,636050,12.594416675,8.4115418291,-0.420024428,1753,2.164862746,4.1828748461,1.7448383182
34,25,2004,8026,5295,-2865,8996,1715,2731,-1150,3880,639930,12.580134485,8.299503127,-4.490665998,2299,2.688129908,4.2806313579,-1.80253609
34,25,2005,7370,5199,-3986,9145,1604,2171,-2382,1893,641823,11.499875561,8.1123274141,-6.219607054,2104,2.5028223066,3.387548147,-3.716784747
34,25,2006,7247,5145,-4480,9152,1753,2102,-2727,-618,641205,11.296713712,8.0200899747,-6.983479706,7,2.7325981974,3.276623737,-4.250881508
34,25,2007,7139,5030,-3498,9177,1497,2109,-2001,160,641365,11.132335857,7.8436264687,-5.454673039,52,2.3343755117,3.2887093882,-3.120297528
34,25,2008,7449,5133,-2883,9177,1538,2316,-1345,1083,642448,11.604493801,7.9964917009,-4.491308314,112,2.3959875776,3.6080021,-2.095320736
34,27,2001,6415,3479,-3478,9186,2855,2936,-623,1933,473281,13.58205179,7.365854743,-7.36373751,-380,6.0447011472,6.2161970467,-1.319036362
34,27,2002,6252,3452,-1638,9186,2671,2800,1033,3411,476692,13.162479355,7.2675749732,-3.448519063,-422,5.6233177153,5.8949043815,2.1747986522
34,27,2003,6329,3350,-1467,9311,2355,2979,888,3252,479944,13.23178304,7.0037088297,-3.06699727,-615,4.9235027743,6.22807421,1.8565055047
34,27,2004,6292,3431,-1813,9431,2135,2861,322,2818,482762,13.071488076,7.1278251096,-3.766466606,-365,4.4354143425,5.9436629667,0.6689477369
34,27,2005,5948,3454,-3075,9454,2252,2494,-823,1241,484003,12.304955186,7.1454800288,-6.361421855,-430,4.6588364287,5.1594751568,-1.702585427
34,27,2006,5632,3319,-2714,9700,2284,2313,-430,1655,485658,11.616430897,6.8456914324,-5.597832645,-228,4.7109247459,4.7707394646,-0.886907899
34,27,2007,5523,3290,-3711,9643,2077,2233,-1634,514,486172,11.366185444,6.7707315065,-7.637138183,-85,4.2744101335,4.5954539374,-3.362728049
34,27,2008,5559,3394,-2782,9643,2081,2165,-701,1376,487548,11.418066795,6.9712032206,-5.714168344,-88,4.274329376,4.4468635747,-1.439838968
34,29,2001,6524,6837,9536,7878,715,-313,10251,10021,523675,12.578458715,13.181931673,18.385680917,83,1.3785404631,-0.603472958,19.76422138
34,29,2002,6798,7058,12378,7937,643,-260,13021,12927,536602,12.823064162,13.313502038,23.348615503,166,1.2128905937,-0.490437876,24.561506097
34,29,2003,7264,6896,7916,7886,504,368,8420,8924,545526,13.425398844,12.745257493,14.63043189,136,0.9314979374,0.6801413511,15.561929827
34,29,2004,7638,7190,5359,7894,552,448,5911,6378,551904,13.919794429,13.103341443,9.7664543524,19,1.0059867144,0.8164529856,10.772441067
34,29,2005,7608,6965,3648,7883,546,643,4194,4792,556696,13.725419448,12.565397799,6.5812736785,-45,0.9850261591,1.1600216489,7.5662998376
34,29,2006,7609,6844,2893,7883,615,765,3508,4256,560952,13.616093797,12.247147581,5.1769430089,-17,1.100525389,1.3689462156,6.2774683979
34,29,2007,7793,6617,2071,7860,518,1176,2589,3839,564791,13.845078317,11.755791508,3.679347773,74,0.9202810944,2.0892868088,4.5996288673
34,29,2008,8144,6801,2284,7860,529,1343,2813,4320,569111,14.364557078,11.995745664,4.0285668426,164,0.9330612346,2.368811414,4.9616280772
34,31,2001,7834,4060,-5987,11304,4594,3774,-1393,2008,492832,15.928332669,8.2549183861,-12.17295477,-373,9.3406638093,7.673414283,-2.832290964
34,31,2002,7655,4049,-6914,11304,4324,3606,-2590,705,493537,15.521574583,8.2099092733,-14.01909427,-311,8.7675099278,7.3116653098,-5.251584346
34,31,2003,7716,4143,-7669,11304,3863,3573,-3806,-471,493066,15.641549843,8.3985149042,-15.54627343,-238,7.8309107108,7.2430349391,-7.715362714
34,31,2004,7712,4073,-7947,11304,3480,3639,-4467,-1370,491696,15.662667731,8.2720494901,-16.13994041,-542,7.0676975757,7.3906182408,-9.072242836
34,31,2005,7675,3872,-8017,11304,3669,3803,-4348,-947,490749,15.624284311,7.8823750948,-16.32050649,-402,7.4691204088,7.7419092163,-8.851386083
34,31,2006,7526,3580,-8530,11304,3844,3946,-4686,-953,489796,15.350646834,7.3020616086,-17.39848758,-213,7.8405376602,8.0485852256,-9.557949916
34,31,2007,7644,3595,-7868,11304,3500,4049,-4368,-286,489510,15.611055176,7.3419339818,-16.06852199,33,7.1479190365,8.269121194,-8.920602958
34,31,2008,7764,3593,-6149,11304,3502,4171,-2647,1438,490948,15.837496354,7.3292277691,-12.5431176,-86,7.1436002358,8.5082685847,-5.399517368
34,33,2001,686,650,-131,1222,71,36,-60,-84,64132,10.689687412,10.128712563,-2.041325147,-60,1.1063670645,0.5609748496,-0.934958083
34,33,2002,791,700,283,1222,68,91,351,379,64511,12.297598781,10.88283078,4.3997730152,-63,1.0571892757,1.4147680014,5.456962291
34,33,2003,707,714,-72,1222,52,-7,-20,-114,64397,10.969063208,11.077667794,-1.117075744,-87,0.8067769262,-0.108604586,-0.310298818
34,33,2004,865,703,336,1222,57,162,393,506,64903,13.379737046,10.873936582,5.1972157773,-49,0.8816705336,2.505800464,6.0788863109
34,33,2005,736,731,551,1222,56,5,607,550,65453,11.292153794,11.215440793,8.4537727454,-62,0.8591856148,0.0767130013,9.3129583602
34,33,2006,699,706,315,1222,75,-7,390,351,65804,10.650860526,10.757521504,4.7997440137,-32,1.1427961937,-0.106660978,5.9425402074
34,33,2007,690,706,43,1222,64,-16,107,106,65910,10.477246155,10.72019679,0.6529298328,15,0.9718025419,-0.242950635,1.6247323747
34,33,2008,814,674,-9,1222,65,140,56,231,66141,12.328570022,10.208177144,-0.136310971,35,0.9844681222,2.1203928785,0.8481571514
34,35,2001,4354,2030,-715,4509,2272,2324,1557,3514,302400,14.482292952,6.7521944632,-2.378235981,-367,7.5571358721,7.7300984889,5.1788998912
34,35,2002,4388,2039,-25,4509,2127,2349,2102,4147,306547,14.411763257,6.696806126,-0.082108952,-304,6.9858296371,7.7149571309,6.9037206851
34,35,2003,4538,2146,-848,4442,1904,2392,1056,3043,309590,14.730490134,6.9659832148,-2.75263456,-405,6.1804436351,7.7645069197,3.4278090749
34,35,2004,4358,2126,-506,4504,1710,2232,1204,3207,312797,14.004148544,6.8317622315,-1.625997972,-229,5.4949733847,7.1723863127,3.8689754124
34,35,2005,4213,2117,-823,4653,1814,2096,991,2823,315620,13.408294174,6.737564388,-2.619279873,-264,5.7732365611,6.6707297861,3.153956688
34,35,2006,3983,1974,-851,4619,1831,2009,980,2834,318454,12.563202402,6.2264025965,-2.684229286,-155,5.775351142,6.3367998057,3.0911218564
34,35,2007,3985,2053,-266,4862,1657,1932,1391,3297,321751,12.449137386,6.4135706532,-0.830983825,-26,5.1764669129,6.0355667325,4.3454830874
34,35,2008,4067,2100,-925,4827,1658,1967,733,2812,324563,12.585213998,6.4983893278,-2.862385775,112,5.1306330978,6.0868246704,2.2682473225
34,37,2001,1768,976,618,1687,157,792,775,1436,146046,12.165584058,6.7158427832,4.2524496312,-131,1.0803148739,5.4497412749,5.3327645051
34,37,2002,1669,979,1131,1687,149,690,1280,1845,147891,11.356174963,6.6612913652,7.6955265924,-125,1.0138226899,4.6948835975,8.7093492823
34,37,2003,1741,1040,948,1687,128,701,1076,1615,149506,11.708255295,6.994018097,6.3753164961,-162,0.8608022273,4.7142371981,7.2361187235
34,37,2004,1663,1020,129,1687,132,643,261,812,150318,11.093174662,6.8039916751,0.8605048295,-92,0.8805165697,4.2891829874,1.7410213992
34,37,2005,1587,1050,-126,1687,135,537,9,411,150729,10.543204217,6.9756549642,-0.837078596,-135,0.896869924,3.5675492531,0.0597913283
34,37,2006,1587,953,-406,1687,141,634,-265,301,151030,10.51832754,6.3162987682,-2.690889087,-68,0.9345205942,4.2020287713,-1.756368493
34,37,2007,1604,974,-527,1687,116,630,-411,227,151257,10.612431233,6.4442069953,-3.486752656,8,0.767482558,4.1682242372,-2.719270098
34,37,2008,1619,959,-1137,1687,117,660,-1020,-348,150909,10.715964073,6.3475043519,-7.525664701,12,0.7744087687,4.3684597208,-6.751255932
34,39,2001,7630,4698,-4520,7808,4654,2932,134,2555,525695,14.549476324,8.9585111099,-8.619086892,-511,8.8746084942,5.5909652138,0.2555216025
34,39,2002,7369,4675,-5826,7808,4401,2694,-1425,854,526549,14.006257104,8.8857717412,-11.07347725,-415,8.3649799856,5.1204853627,-2.708497269
34,39,2003,7718,4407,-7717,7808,3917,3311,-3800,-823,525726,14.669169181,8.3761374165,-14.66726854,-334,7.4448219334,6.2930317645,-7.222446604
34,39,2004,7596,4360,-7332,7808,3515,3236,-3817,-1109,524617,14.463846572,8.3020499018,-13.96115364,-528,6.6930516983,6.1617966702,-7.268101944
34,39,2005,7406,4384,-7674,7808,3709,3022,-3965,-1314,523303,14.134666768,8.3670509199,-14.6461562,-371,7.07878464,5.7676158485,-7.567371555
34,39,2006,7247,4228,-7593,7808,3797,3019,-3796,-1024,522279,13.862136112,8.0873618712,-14.52396847,-247,7.2629406398,5.7747742406,-7.261027829
34,39,2007,7563,3984,-7371,7808,3471,3579,-3900,-601,521678,14.489102521,7.6324982734,-14.12127128,-280,6.6496991734,6.8566042471,-7.471572105
34,39,2008,7405,3930,-4883,7808,3472,3475,-1411,1571,523249,14.173238896,7.5220565647,-9.346107431,-493,6.6454403035,6.6511823314,-2.700667128
34,41,2001,1291,770,1649,1466,213,521,1862,2323,105270,12.400524453,7.396129999,15.839244634,-60,2.0459424543,5.0043944539,17.885187088
34,41,2002,1327,897,1044,1466,205,430,1249,1601,106871,12.51054723,8.4566396878,9.8425104058,-78,1.9326768517,4.0539075426,11.775187258
34,41,2003,1400,879,763,1466,180,521,943,1361,108232,13.017019753,8.1728288308,7.0942757656,-103,1.6736168254,4.8441909225,8.767892591
34,41,2004,1275,957,-42,1466,170,318,128,375,108607,11.759877144,8.8268254327,-0.387384188,-71,1.5679836192,2.9330517112,1.1805994309
34,41,2005,1294,892,-87,1466,176,402,89,393,109000,11.892999766,8.1982656808,-0.79960663,-98,1.6175950222,3.6947340848,0.8179883919
34,41,2006,1245,875,-241,1466,188,370,-53,265,109265,11.408150643,8.017776556,-2.208324743,-52,1.7226765629,3.3903740865,-0.48564818
34,41,2007,1266,863,-355,1466,163,403,-192,227,109492,11.574486759,7.8900332332,-3.245610426,16,1.4902380267,3.6844535261,-1.7553724
34,41,2008,1312,856,-292,1466,164,456,-128,384,109876,11.961635243,7.8042376281,-2.66219321,56,1.4952044054,4.157397615,-1.166988804
35,0,2001,27276,13898,-9406,40180,5190,13378,-4216,7626,1828330,14.949709978,7.6173584571,-5.155337002,-1536,2.8445884582,7.332351521,-2.310748543
35,0,2002,27352,14335,4542,40708,4360,13017,8902,20656,1848986,14.876067219,7.7964471914,2.4702799542,-1263,2.371294716,7.0796200272,4.8415746702
35,0,2003,27802,14313,4383,42108,2625,13489,7008,18923,1867909,14.959798434,7.7015896333,2.3584201329,-1574,1.4124692788,7.2582088006,3.7708894117
35,0,2004,28045,14740,4966,41464,4715,13305,9681,21357,1889266,14.928769621,7.8463207064,2.6434754836,-1629,2.5098644593,7.0824489144,5.1533399429
35,0,2005,28837,14627,6981,41699,4045,14210,11026,23618,1912884,15.168786082,7.69406783,3.6721328722,-1618,2.1277435135,7.4747182515,5.7998763857
35,0,2006,29079,15250,7703,41639,4496,13829,12199,25032,1937916,15.102835774,7.920432118,4.0007271216,-996,2.3350992002,7.1824036564,6.3358263218
35,0,2007,30107,15178,8082,42337,3637,14929,11719,26486,1964402,15.430316033,7.7789662452,4.1421534585,-162,1.8640203079,7.6513497875,6.0061737665
35,0,2008,30502,15484,1032,42337,3891,15018,4923,19954,1984356,15.448908239,7.8424659095,0.5226959971,13,1.9707462448,7.6064423295,2.4934422418
35,1,2001,8352,4235,-182,10847,1877,4117,1695,5255,562388,14.920666964,7.565735703,-0.325139055,-557,3.3532198145,7.3549312608,3.0280807595
35,1,2002,8426,4453,5823,11163,1581,3973,7404,10999,573387,14.837445797,7.8413418151,10.253791464,-378,2.7840021131,6.9961039819,13.037793577
35,1,2003,8870,4393,4118,11109,988,4477,5106,8991,582378,15.349141045,7.601891388,7.1260161019,-592,1.7096901187,7.7472496572,8.8357062206
35,1,2004,8779,4563,6008,10982,1696,4216,7704,11356,593734,14.928850314,7.759465085,10.216714054,-564,2.8840790673,7.1693852286,13.100793122
35,1,2005,9349,4557,7001,10928,1474,4792,8475,12768,606502,15.578602875,7.5935066104,11.666039012,-499,2.4561836172,7.9850962644,14.12222263
35,1,2006,9290,4786,5752,10896,1632,4504,7384,11546,618048,15.172920665,7.8167490098,9.3944714385,-342,2.6654689478,7.3561716549,12.059940386
35,1,2007,9766,4803,3640,10960,1335,4963,4975,9737,627785,15.677863727,7.7105037353,5.8434798243,-201,2.1431443861,7.9673599913,7.9866242105
35,1,2008,9827,4888,1079,10960,1414,4939,2493,7354,635139,15.562298286,7.7407666653,1.7087330671,-78,2.2392479674,7.8215316203,3.9479810345
35,3,2001,16,27,-89,10,0,-11,-89,-102,3464,4.5519203414,7.6813655761,-25.3200569,-2,0,-3.129445235,-25.3200569
35,3,2002,30,47,8,10,0,-17,8,-13,3451,8.6767895879,13.593637021,2.3138105568,-4,0,-4.916847433,2.3138105568
35,3,2003,19,31,-54,10,-1,-12,-55,-71,3380,5.5628751281,9.0762699458,-15.81027668,-4,-0.292782901,-3.513394818,-16.10305958
35,3,2004,28,41,5,10,0,-13,5,-12,3368,8.2987551867,12.151748666,1.4819205691,-4,0,-3.85299348,1.4819205691
35,3,2005,17,35,-51,10,0,-18,-51,-68,3300,5.098980204,10.49790042,-15.29694061,1,0,-5.398920216,-15.29694061
35,3,2006,24,30,113,10,0,-6,113,105,3405,7.158836689,8.9485458613,33.706189411,-2,0,-1.789709172,33.706189411
35,3,2007,27,15,19,10,0,12,19,9,3414,7.919049714,4.3994720634,5.5726646136,-22,0,3.5195776507,5.5726646136
35,3,2008,25,24,19,10,0,1,19,-9,3405,7.3324534389,7.0391553014,5.5726646136,-29,0,0.2932981376,5.5726646136
35,5,2001,944,599,-946,1826,160,345,-786,-487,60792,15.466408893,9.8139607278,-15.49917671,-46,2.6214252361,5.6524481654,-12.87775147
35,5,2002,889,596,-765,1918,152,293,-613,-359,60433,14.666941637,9.8329552485,-12.621159,-39,2.5077335533,4.8339863889,-10.11342545
35,5,2003,941,650,-77,1943,125,291,48,247,60680,15.539207187,10.733777547,-1.271539802,-92,2.0641879897,4.8054296401,0.7926481881
35,5,2004,963,630,-369,1922,126,333,-243,42,60722,15.864648029,10.378741701,-6.078977282,-48,2.0757483402,5.4859063277,-4.003228942
35,5,2005,992,596,2,2013,129,396,131,467,61189,16.27416722,9.7776246606,0.032810821,-60,2.1162979551,6.4965425597,2.1491087761
35,5,2006,978,640,-129,2013,130,338,1,309,61498,15.943009447,10.433053217,-2.102912289,-30,2.1192139346,5.5099562301,0.0163016457
35,5,2007,1012,622,433,2094,119,390,552,962,62460,16.328111134,10.035657239,6.9862372739,20,1.920005163,6.2924538957,8.906242437
35,5,2008,1014,630,57,2094,121,384,178,600,63060,16.156787763,10.038240918,0.9082217973,38,1.9279796048,6.1185468451,2.8362014022
35,6,2001,445,194,732,1977,13,251,745,984,26629,17.025672418,7.4224279757,28.00627463,-12,0.4973791942,9.6032444427,28.503653824
35,6,2002,378,220,-88,1851,13,158,-75,59,26688,14.179342424,8.2525273365,-3.301010935,-24,0.4876493426,5.9268150871,-2.813361592
35,6,2003,385,182,106,1881,9,203,115,283,26971,14.349876069,6.7835777782,3.9508749697,-35,0.3354516484,7.5662982911,4.2863266181
35,6,2004,444,222,-26,1898,11,222,-15,190,27161,16.404344935,8.2021724673,-0.960614793,-17,0.4064139511,8.2021724673,-0.554200842
35,6,2005,420,207,-205,1882,10,213,-195,-4,27157,15.46448691,7.6217828344,-7.548142421,-22,0.3682020693,7.842704076,-7.179940351
35,6,2006,417,222,-375,1882,11,195,-364,-181,26976,15.406498808,8.2020209484,-13.85476512,-12,0.4064064434,7.2044778601,-13.44835867
35,6,2007,458,182,-22,1865,9,276,-13,254,27230,16.898498321,6.715123787,-0.81171826,-9,0.3320665609,10.183374534,-0.479651699
35,6,2008,444,235,-163,1865,11,209,-152,55,27285,16.289094745,8.6214803265,-5.980005503,-2,0.4035586536,7.6676144181,-5.576446849
35,7,2001,155,156,-146,389,6,-1,-140,-153,14055,10.96840392,11.039167817,-10.33152885,-12,0.4245833776,-0.070763896,-9.906945476
35,7,2002,180,156,-27,400,6,24,-21,-10,14045,12.8113879,11.103202847,-1.921708185,-13,0.4270462633,1.7081850534,-1.494661922
35,7,2003,152,138,-291,329,1,14,-290,-278,13767,10.930533583,9.9237739105,-20.9262189,-2,0.0719114051,1.0067596721,-20.85430749
35,7,2004,172,152,-111,338,4,20,-107,-99,13668,12.538727902,11.080736286,-8.091853472,-12,0.2915983233,1.4579916165,-7.800255149
35,7,2005,142,127,-184,338,3,15,-181,-176,13492,10.456553756,9.351988218,-13.54933726,-10,0.2209131075,1.1045655376,-13.32842415
35,7,2006,143,162,-149,338,4,-19,-145,-168,13324,10.665274463,12.082338902,-11.1127685,-4,0.2983293556,-1.417064439,-10.81443914
35,7,2007,153,131,-161,331,1,22,-160,-141,13183,11.544120421,9.884181537,-12.14773456,-3,0.0754517675,1.6599388841,-12.07228279
35,7,2008,147,143,-226,331,3,4,-223,-221,12962,11.24497992,10.938994072,-17.28820042,-2,0.2294893861,0.3059858482,-17.05871103
35,9,2001,774,334,-752,1231,75,440,-677,-264,44631,17.291066282,7.4615195586,-16.79958895,-27,1.6754909188,9.8295467239,-15.12409803
35,9,2002,815,417,-286,1249,-61,398,-347,17,44648,18.257372954,9.341502481,-6.406881798,-34,-1.366502761,8.9158704735,-7.773384559
35,9,2003,866,372,179,1219,-310,494,-131,311,44959,19.328847077,8.3029227627,3.9952235874,-52,-6.919102302,11.025924314,-2.923878715
35,9,2004,891,364,36,1226,241,527,277,774,45733,19.648921625,8.0271688793,0.7938958232,-30,5.3146914833,11.621752746,6.1085873065
35,9,2005,946,398,-493,1061,47,548,-446,59,45792,20.671947555,8.6970773013,-10.77301284,-43,1.0270417919,11.974870254,-9.745971046
35,9,2006,890,371,-903,1095,148,519,-755,-254,45538,19.4897624,8.1243841016,-19.77444432,-18,3.2409941969,11.365378298,-16.53345013
35,9,2007,904,367,-1130,851,30,537,-1100,-531,45007,19.967971727,8.1064663979,-24.95996466,32,0.662653929,11.861505329,-24.29731073
35,9,2008,871,370,-1865,851,81,501,-1784,-1252,43755,19.625515423,8.3369009261,-42.0224871,31,1.8251053379,11.288614497,-40.19738176
35,11,2001,22,29,-57,71,1,-7,-56,-63,2151,10.080183276,13.287514318,-26.11683849,0,0.4581901489,-3.207331042,-25.65864834
35,11,2002,16,32,-20,71,1,-16,-19,-37,2114,7.5029308324,15.005861665,-9.37866354,-2,0.468933177,-7.502930832,-8.909730363
35,11,2003,22,33,-33,71,1,-11,-32,-47,2067,10.523798134,15.785697202,-15.7856972,-4,0.4783544607,-5.261899067,-15.30734274
35,11,2004,19,28,-74,71,0,-9,-74,-85,1982,9.3850333416,13.830575451,-36.55223512,-2,0,-4.445542109,-36.55223512
35,11,2005,20,20,14,71,1,0,15,14,1996,10.055304173,10.055304173,7.0387129211,-1,0.5027652086,0,7.5414781297
35,11,2006,14,32,-66,71,0,-18,-66,-84,1912,7.164790174,16.376663255,-33.77686796,0,0,-9.211873081,-33.77686796
35,11,2007,17,15,-8,71,1,2,-7,-9,1903,8.9121887287,7.8636959371,-4.193971166,-4,0.5242463958,1.0484927916,-3.669724771
35,11,2008,17,18,8,71,0,-1,8,4,1907,8.9238845144,9.4488188976,4.1994750656,-3,0,-0.524934383,4.1994750656
35,13,2001,3015,1048,-1074,5482,801,1967,-273,1544,176536,17.153683348,5.9625406795,-6.110466307,-150,4.5572472179,11.191142669,-1.553219089
35,13,2002,3028,1157,-396,5337,731,1871,335,2038,178574,17.053870632,6.5162907268,-2.230294838,-168,4.1170341584,10.537579905,1.8867393202
35,13,2003,3165,1170,1262,5938,605,1995,1867,3690,182264,17.542498296,6.4849045832,6.9948287043,-172,3.3533053614,11.057593712,10.348134066
35,13,2004,3164,1269,380,5370,633,1895,1013,2781,185045,17.228001492,6.9097136199,2.0691025812,-127,3.4466892997,10.318287872,5.515791881
35,13,2005,3362,1236,1701,5753,626,2126,2327,4285,189330,17.960601002,6.6030050083,9.0871452421,-168,3.3442404007,11.357595993,12.431385643
35,13,2006,3387,1211,1409,5753,645,2176,2054,4125,193455,17.696618206,6.3273116763,7.3618349726,-105,3.3700380109,11.36930653,10.731872984
35,13,2007,3452,1309,1879,6151,575,2143,2454,4593,198048,17.634603055,6.6870496522,9.5989047338,-4,2.93739767,10.947553403,12.536302404
35,13,2008,3691,1366,599,6151,584,2325,1183,3555,201603,18.471116049,6.8359643789,2.9976154195,47,2.9225499248,11.63515167,5.9201653443
35,15,2001,731,562,-919,753,44,169,-875,-738,50676,14.320697424,11.009893231,-18.00372221,-32,0.8619845235,3.3108041924,-17.14173768
35,15,2002,778,550,-92,753,43,228,-49,129,50805,15.332919463,10.839467487,-1.813147289,-50,0.8474492762,4.4934519762,-0.965698012
35,15,2003,737,556,-258,753,34,181,-224,-105,50700,14.521452145,10.955125363,-5.083493424,-62,0.669917738,3.5663267819,-4.413575686
35,15,2004,739,540,-99,753,37,199,-62,103,50803,14.561145976,10.640079604,-1.950681261,-34,0.7290424914,3.9210663724,-1.221638769
35,15,2005,686,547,-767,753,36,139,-731,-630,50173,13.587387102,10.834257645,-15.19172873,-38,0.7130407225,2.7531294565,-14.47868801
35,15,2006,720,539,272,753,38,181,310,465,50638,14.284155499,10.693277519,5.3962365218,-26,0.7538859847,3.5908779796,6.1501225065
35,15,2007,737,514,89,755,33,223,122,322,50960,14.508159609,10.118309416,1.7520029922,-23,0.649619087,4.3898501939,2.4016220792
35,15,2008,754,537,167,755,35,217,202,400,51360,14.738076622,10.496481626,3.2642689601,-19,0.6841282252,4.2415949961,3.9483971853
35,17,2001,396,312,-256,734,9,84,-247,-186,30704,12.858395298,10.130856902,-8.312497971,-23,0.2922362568,2.7275383966,-8.020261714
35,17,2002,397,314,-603,719,8,83,-595,-522,30182,13.040764708,10.31435798,-19.80750912,-10,0.2627861906,2.7264067273,-19.54472292
35,17,2003,367,317,-772,611,6,50,-766,-700,29482,12.302225798,10.626173237,-25.87825154,16,0.2011263073,1.676052561,-25.67712523
35,17,2004,323,322,-427,638,9,1,-418,-450,29032,11.040092969,11.005913115,-14.59479783,-33,0.3076186895,0.0341798544,-14.28717914
35,17,2005,375,311,190,638,7,64,197,232,29264,12.865376698,10.669685742,6.5184575271,-29,0.2401536984,2.1956909565,6.7586112255
35,17,2006,375,288,17,638,8,87,25,99,29363,12.792740546,9.8248247395,0.5799375714,-13,0.2729117983,2.9679158067,0.8528493697
35,17,2007,389,319,239,665,7,70,246,325,29688,13.175052074,10.804220081,8.0946978036,9,0.2370831993,2.3708319927,8.3317810029
35,17,2008,374,317,80,665,9,57,89,156,29844,12.564671101,10.649734597,2.6876301821,10,0.3023583955,1.9149365047,2.9899885776
35,19,2001,64,54,15,619,11,10,26,31,4715,13.61847005,11.490584105,3.191828918,-5,2.3406745398,2.1278859453,5.5325034578
35,19,2002,67,34,-95,591,11,33,-84,-53,4662,14.290284739,7.2517862856,-20.26234403,-2,2.3461661512,7.0384984537,-17.91617788
35,19,2003,57,48,26,618,3,9,29,34,4696,12.18209019,10.258602265,5.5567428938,-4,0.6411626416,1.9234879248,6.1979055354
35,19,2004,44,52,-169,568,2,-8,-167,-182,4514,9.5548317047,11.292073833,-36.69923996,-7,0.434310532,-1.737242128,-36.26492942
35,19,2005,47,55,-68,591,3,-8,-65,-77,4437,10.501619931,12.289129706,-15.19383309,-4,0.6703161658,-1.787509775,-14.52351693
35,19,2006,42,41,-42,591,2,1,-40,-42,4395,9.5108695652,9.2844202899,-9.510869565,-3,0.4528985507,0.2264492754,-9.057971014
35,19,2007,47,34,10,614,3,13,13,21,4416,10.668482579,7.7176256952,2.2698899103,-5,0.6809669731,2.9508568834,2.9508568834
35,19,2008,45,34,-80,614,2,11,-78,-70,4346,10.271627482,7.7607852089,-18.26067108,-3,0.456516777,2.5108422735,-17.8041543
35,21,2001,4,10,-18,0,1,-6,-17,-23,780,5.0536955148,12.634238787,-22.74162982,0,1.2634238787,-7.580543272,-21.47820594
35,21,2002,3,11,-32,0,1,-8,-31,-40,740,3.9473684211,14.473684211,-42.10526316,-1,1.3157894737,-10.52631579,-40.78947368
35,21,2003,2,7,16,0,1,-5,17,14,754,2.6773761714,9.3708165997,21.419009371,2,1.3386880857,-6.693440428,22.757697456
35,21,2004,2,6,22,0,0,-4,22,16,770,2.624671916,7.874015748,28.871391076,-2,0,-5.249343832,28.871391076
35,21,2005,5,6,-30,0,1,-1,-29,-30,740,6.6225165563,7.9470198675,-39.73509934,0,1.3245033113,-1.324503311,-38.41059603
35,21,2006,6,9,-1,0,0,-3,-1,-4,736,8.1300813008,12.195121951,-1.35501355,0,0,-4.06504065,-1.35501355
35,21,2007,3,5,-18,0,1,-2,-17,-20,716,4.132231405,6.8870523416,-24.79338843,-1,1.3774104683,-2.754820937,-23.41597796
35,21,2008,4,3,-30,0,0,1,-30,-32,684,5.7142857143,4.2857142857,-42.85714286,-3,0,1.4285714286,-42.85714286
35,23,2001,74,44,-359,85,20,30,-339,-307,5448,13.210747121,7.8550388289,-64.0899759,2,3.5704721949,5.3557082924,-60.5195037
35,23,2002,61,50,-198,85,20,11,-178,-168,5280,11.372110365,9.3214019389,-36.91275168,-1,3.7285607755,2.0507084265,-33.1841909
35,23,2003,58,45,-179,85,11,13,-168,-151,5129,11.144202133,8.6463637237,-34.39331348,4,2.1135555769,2.4978384091,-32.2797579
35,23,2004,62,54,-122,85,12,8,-110,-107,5022,12.215545266,10.639345877,-24.03704069,-5,2.3642990838,1.5761993892,-21.6727416
35,23,2005,66,53,-107,85,12,13,-95,-84,4938,13.253012048,10.642570281,-21.48594378,-2,2.4096385542,2.6104417671,-19.07630522
35,23,2006,57,58,-100,85,12,-1,-88,-91,4847,11.650485437,11.854879918,-20.43944813,-2,2.4527337762,-0.204394481,-17.98671436
35,23,2007,62,28,37,85,6,34,43,66,4913,12.704918033,5.737704918,7.5819672131,-11,1.2295081967,6.9672131148,8.8114754098
35,23,2008,65,37,-20,85,6,28,-14,-3,4910,13.234246157,7.5333401201,-4.072075741,-17,1.2216227222,5.7009060369,-2.850453018
35,25,2001,927,505,-788,1853,98,422,-690,-307,54841,16.856231078,9.1827364555,-14.3287056,-39,1.7819963815,7.6734946222,-12.54670922
35,25,2002,903,494,83,1886,94,409,177,534,55375,16.386005662,8.9642157219,1.5061334108,-52,1.7057414531,7.4217899398,3.2118748639
35,25,2003,917,477,-626,1931,77,440,-549,-150,55225,16.582278481,8.6256781193,-11.32007233,-41,1.3924050633,7.9566003617,-9.927667269
35,25,2004,981,476,-159,1871,75,505,-84,383,55608,17.702308879,8.5894995173,-2.869181561,-38,1.353387529,9.1128093618,-1.515794032
35,25,2005,953,475,-120,1882,76,478,-44,382,55990,17.079159125,8.5126973602,-2.150576175,-52,1.3620315776,8.5664617645,-0.788544598
35,25,2006,1078,501,179,1882,75,577,254,803,56793,19.116356188,8.884317672,3.1742372521,-28,1.3299876754,10.232038516,4.5042249275
35,25,2007,1110,502,505,1892,71,608,576,1199,57992,19.340506164,8.7467874722,8.7990591105,15,1.2370954393,10.593718691,10.03615455
35,25,2008,1080,498,491,1892,73,582,564,1163,59155,18.438372301,8.502138339,8.3826303704,17,1.246297387,9.9362339625,9.6289277574
35,27,2001,226,160,-188,219,37,66,-151,-106,19425,11.602833967,8.2143957285,-9.651914981,-21,1.8995790122,3.388438238,-7.752335969
35,27,2002,206,165,105,219,36,41,141,166,19591,10.559770351,8.4580684847,5.3824072176,-16,1.8453967603,2.1017018659,7.2278039779
35,27,2003,211,176,411,219,25,35,436,479,20070,10.640175487,8.875217468,20.725649883,8,1.2606842994,1.7649580192,21.986334182
35,27,2004,246,157,243,219,28,89,271,335,20405,12.155651637,7.7578752316,12.007411983,-25,1.383570105,4.3977764052,13.390982088
35,27,2005,236,163,148,232,26,73,174,233,20638,11.500134006,7.942889165,7.2119484443,-14,1.2669639159,3.5572448408,8.4789123602
35,27,2006,195,157,110,232,27,38,137,164,20802,9.4111969112,7.5772200772,5.3088803089,-11,1.3030888031,1.833976834,6.611969112
35,27,2007,228,159,-173,244,24,69,-149,-100,20702,10.98689283,7.6619121049,-8.336545875,-20,1.1565150347,3.3249807247,-7.18003084
35,27,2008,232,175,36,244,26,57,62,91,20793,11.182070129,8.4347511748,1.7351488131,-28,1.2531630317,2.7473189541,2.9883118448
35,28,2001,200,144,-743,92,65,56,-678,-622,17650,11.135237459,8.0173709704,-41.36740716,0,3.6189521742,3.1178664885,-37.74845499
35,28,2002,181,96,334,93,65,85,399,476,18126,10.118515206,5.366726297,18.671735242,-8,3.6337209302,4.7517889088,22.305456172
35,28,2003,176,103,238,93,59,73,297,364,18490,9.6132838104,5.6259558663,12.999781516,-6,3.2226349137,3.9873279441,16.22241643
35,28,2004,203,101,-102,93,54,102,-48,41,18531,10.966748602,5.456362605,-5.510385997,-13,2.917263175,5.5103859971,-2.593122822
35,28,2005,192,97,-124,93,56,95,-68,12,18543,10.357663052,5.2327776879,-6.689324055,-15,3.0209850569,5.1248853644,-3.668338998
35,28,2006,198,104,-9,93,55,94,46,130,18673,10.640584695,5.5889939811,-0.483662941,-10,2.9557179708,5.0515907137,2.4720550301
35,28,2007,164,95,-298,93,52,69,-246,-176,18497,8.8243206887,5.1116491794,-16.03443637,1,2.7979553403,3.7126715093,-13.23648103
35,28,2008,162,100,-450,93,51,62,-399,-347,18150,8.841105684,5.4574726444,-24.5586269,-10,2.7833110487,3.3836330395,-21.77531585
35,29,2001,392,251,-440,253,174,141,-266,-138,24840,15.737283713,10.076679112,-17.66429804,-13,6.9854269541,5.6606046007,-10.67887109
35,29,2002,406,245,-94,253,165,161,71,211,25051,16.275480548,9.8214106753,-3.768214708,-21,6.6144194344,6.4540698723,2.8462047263
35,29,2003,388,237,27,253,141,151,168,286,25337,15.400492181,9.4070016671,1.0716837342,-33,5.5965706121,5.9934905136,6.6682543463
35,29,2004,417,273,-27,253,124,144,97,224,25561,16.385712602,10.727337027,-1.06094542,-17,4.8724900782,5.6583755747,3.8115446579
35,29,2005,408,238,165,253,138,170,303,449,26010,15.822846173,9.2299936011,6.3989451436,-24,5.3518450292,6.5928525722,11.750790173
35,29,2006,402,306,200,253,136,96,336,417,26427,15.332684936,11.671148235,7.6282014608,-15,5.1871769933,3.6615367012,12.815378454
35,29,2007,435,287,121,253,120,148,241,378,26805,16.34355275,10.782987677,4.5461376616,-11,4.5085662759,5.5605650736,9.0547039375
35,29,2008,451,296,144,253,119,155,263,422,27227,16.693811075,10.95647024,5.3301747113,4,4.4047971572,5.7373408351,9.7349718685
35,31,2001,1357,499,-1020,859,47,858,-973,-171,74412,18.215376355,6.6982113494,-13.69173462,-56,0.6308936541,11.517165006,-13.06084097
35,31,2002,1365,444,-2505,859,46,921,-2459,-1533,72879,18.534737357,6.0288816017,-34.01429823,5,0.6246138596,12.505855755,-33.38968437
35,31,2003,1351,453,-2392,859,37,898,-2355,-1395,71484,18.71670719,6.2758463041,-33.13868512,62,0.512596718,12.440860885,-32.6260884
35,31,2004,1381,467,-944,859,38,914,-906,-64,71420,19.327660527,6.5358562392,-13.21166657,-72,0.5318255612,12.791804288,-12.67984101
35,31,2005,1335,468,-1731,859,37,867,-1694,-879,70541,18.807982474,6.5933601482,-24.38697952,-52,0.5212699262,12.214622326,-23.8657096
35,31,2006,1401,510,-982,859,38,891,-944,-84,70457,19.872622307,7.2341451652,-13.92927559,-31,0.5390147378,12.638477142,-13.39026085
35,31,2007,1375,473,-1456,859,35,902,-1421,-478,69979,19.581873594,6.7361645162,-20.73542397,41,0.4984476915,12.845709077,-20.23697627
35,31,2008,1387,493,-206,859,37,894,-169,745,70724,19.71528681,7.0076686354,-2.928153629,20,0.5259305061,12.707618174,-2.402223122
35,33,2001,51,50,-15,56,1,1,-14,-19,5183,9.8218584497,9.6292729899,-2.888781897,-6,0.1925854598,0.1925854598,-2.696196437
35,33,2002,46,50,3,56,0,-4,3,-6,5177,8.8803088803,9.6525096525,0.5791505792,-5,0,-0.772200772,0.5791505792
35,33,2003,43,38,2,56,-1,5,1,-1,5176,8.3067709843,7.3408673814,0.3863614411,-7,-0.193180721,0.9659036028,0.1931807206
35,33,2004,47,40,-82,56,2,7,-80,-78,5098,9.1493089352,7.7866459023,-15.9626241,-5,0.3893322951,1.3626630329,-15.5732918
35,33,2005,46,43,-56,56,0,3,-56,-57,5041,9.073873163,8.4820988263,-11.04645429,-4,0,0.5917743367,-11.04645429
35,33,2006,43,45,10,56,1,-2,11,7,5048,8.5241351967,8.9206066012,1.9823570225,-2,0.1982357022,-0.396471404,2.1805927247
35,33,2007,50,32,-15,56,0,18,-15,5,5053,9.9000099,6.336006336,-2.97000297,2,0,3.564003564,-2.97000297
35,33,2008,45,24,-25,56,2,21,-23,-1,5052,8.9064819396,4.7501237011,-4.948045522,1,0.3958436418,4.1563582385,-4.55220188
35,35,2001,854,448,-1594,1244,367,406,-1227,-843,61373,13.820000162,7.2498361505,-25.79517595,-22,5.9390398822,6.5701640114,-19.85613606
35,35,2002,896,473,-428,1232,156,423,-272,105,61478,14.58677585,7.7003850193,-6.96779025,-46,2.5396618668,6.8863908312,-4.428128383
35,35,2003,858,484,628,1713,-231,374,397,723,62201,13.874627059,7.8267126998,10.155321437,-48,-3.735476516,6.0479143589,6.4198449211
35,35,2004,860,491,163,1770,540,369,703,1024,63225,13.713265192,7.8293176853,2.5991421236,-48,8.6106548881,5.8839475069,11.209797012
35,35,2005,863,528,-664,1885,276,335,-388,-106,63119,13.661115684,8.3581333502,-10.51098588,-53,4.3690242513,5.3029823339,-6.141961629
35,35,2006,848,518,-1304,1823,419,330,-885,-580,62539,13.496952044,8.2446004234,-20.75474701,-25,6.6688949371,5.2523516211,-14.08585207
35,35,2007,847,511,-321,2098,232,336,-89,229,62768,13.518797833,8.1559689403,-5.123416888,-18,3.7029056637,5.3628288922,-1.420511224
35,35,2008,859,522,-607,2098,306,337,-301,8,62776,13.684445294,8.3158095966,-9.669916523,-28,4.874784936,5.3686356974,-4.795131587
35,37,2001,102,130,-213,188,12,-28,-201,-234,9849,10.234798314,13.044350793,-21.37266707,-5,1.2040939193,-2.809552478,-20.16857315
35,37,2002,114,146,-140,188,11,-32,-129,-165,9684,11.672554139,14.949060564,-14.33471561,-4,1.1262990836,-3.276506425,-13.20841653
35,37,2003,96,111,-98,188,8,-15,-90,-111,9573,9.9704003739,11.528275432,-10.17811705,-6,0.8308666978,-1.557875058,-9.347250351
35,37,2004,110,134,-223,188,11,-24,-212,-247,9326,11.640827557,14.180644479,-23.59913223,-11,1.1640827557,-2.539816922,-22.43504947
35,37,2005,120,140,-172,188,9,-20,-163,-190,9136,12.999675008,15.166287509,-18.63286751,-7,0.9749756256,-2.166612501,-17.65789189
35,37,2006,112,117,-132,188,10,-5,-122,-132,9004,12.348401323,12.899669239,-14.55347299,-5,1.1025358324,-0.551267916,-13.45093716
35,37,2007,122,117,-61,188,8,5,-53,-54,8950,13.590286287,13.033307341,-6.795143144,-6,0.8911663139,0.5569789462,-5.90397683
35,37,2008,118,110,-30,188,10,8,-20,-21,8929,13.199843392,12.304938755,-3.355892388,-9,1.1186307959,0.8949046367,-2.237261592
35,39,2001,704,319,-710,465,97,385,-613,-255,40981,17.125412019,7.7599523213,-17.27136724,-27,2.3596093265,9.3654596981,-14.91175791
35,39,2002,696,342,-517,465,94,354,-423,-93,40888,17.002772722,8.3548107342,-12.62993319,-24,2.2963514884,8.6479619881,-10.3335817
35,39,2003,665,335,-664,465,68,330,-596,-281,40607,16.320019633,8.2213632738,-16.29547825,-15,1.6688140377,8.0986563593,-14.62666421
35,39,2004,716,348,-428,465,65,368,-363,-33,40574,17.639595472,8.5734346707,-10.54433919,-38,1.6013599241,9.0661608012,-8.942979269
35,39,2005,667,350,-468,465,66,317,-402,-120,40454,16.463444735,8.6389889915,-11.55156242,-35,1.6290664955,7.8244557437,-9.922495927
35,39,2006,720,371,-198,465,66,349,-132,198,40652,17.754543437,9.1485216877,-4.882499445,-19,1.6274998151,8.6060217493,-3.25499963
35,39,2007,739,351,-404,465,56,388,-348,55,40707,18.166398309,8.6284246365,-9.931292174,15,1.3766147568,9.5379736722,-8.554677417
35,39,2008,732,334,-489,465,58,398,-431,-15,40692,17.985478937,8.2064890232,-12.01488962,18,1.4250789322,9.7789899139,-10.58981069
35,41,2001,286,137,152,972,22,149,174,308,18292,15.768000882,7.5532032198,8.380196273,-15,1.2129231448,8.2147976624,9.5931194178
35,41,2002,329,155,59,1189,14,174,73,229,18521,17.874120555,8.4209382555,3.2053894005,-18,0.7606008747,9.4531822997,3.9659902752
35,41,2003,315,168,-74,1189,-10,147,-84,37,18558,16.990749481,9.0617330564,-3.991477656,-26,-0.539388872,7.9290164244,-4.530866528
35,41,2004,302,141,-114,1189,26,161,-88,58,18616,16.24791521,7.5859471674,-6.133318986,-15,1.3988271372,8.6619680422,-4.734491849
35,41,2005,327,138,-25,1189,13,189,-12,158,18774,17.491307836,7.3816528484,-1.337255951,-19,0.6953730944,10.109654988,-0.641882856
35,41,2006,307,175,-40,1189,22,132,-18,104,18878,16.307234675,9.2956549453,-2.12472113,-10,1.1685966217,7.0115797302,-0.956124509
35,41,2007,358,150,29,1405,13,208,42,248,19126,18.840122092,7.8939059046,1.5261551416,-2,0.6841385117,10.946216188,2.2102936533
35,41,2008,364,144,-479,1405,17,220,-462,-237,18889,19.150335394,7.5759568591,-25.20057872,5,0.8943837959,11.574378535,-24.30619492
35,43,2001,1262,583,1207,695,78,679,1285,1887,93134,13.689046051,6.3238620031,13.092455296,-77,0.8460741617,7.3651840482,13.938529458
35,43,2002,1303,629,1812,695,67,674,1879,2498,95632,13.805452253,6.6643357384,19.198372588,-55,0.7098736001,7.1411165146,19.908246188
35,43,2003,1325,614,1955,695,42,711,1997,2703,98335,13.662117783,6.3309738254,20.158068125,-5,0.4330633561,7.3311439575,20.591131481
35,43,2004,1248,676,2360,695,73,572,2433,2871,101206,12.508707484,6.775549887,23.654286588,-134,0.7316792038,5.7331575967,24.385965791
35,43,2005,1308,656,3786,695,63,652,3849,4419,105625,12.64800731,6.3433431159,36.609599141,-82,0.6091930127,6.3046641944,37.218792154
35,43,2006,1401,725,5555,695,70,676,5625,6230,111855,12.883943351,6.6672797499,51.085157256,-71,0.6437373552,6.2166636013,51.728894611
35,43,2007,1531,759,4864,695,59,772,4923,5728,117583,13.345653292,6.6161664589,42.399253829,33,0.5143001595,6.729486833,42.913553988
35,43,2008,1688,750,3729,695,63,938,3792,4715,122298,14.073644849,6.2531004957,31.090415664,-15,0.5252604416,7.8205443532,31.615676106
35,45,2001,1945,760,-119,1214,134,1185,15,1086,115128,16.974298556,6.6326307981,-1.038530349,-114,1.1694375355,10.341667758,0.1309071868
35,45,2002,1982,765,1842,1214,127,1217,1969,3128,118256,16.984883282,6.5557193295,15.785143797,-58,1.0883351044,10.429163953,16.873478902
35,45,2003,1948,824,403,1214,108,1124,511,1486,119742,16.369885461,6.9244279364,3.3865830805,-149,0.9075706519,9.4454575249,4.2941537324
35,45,2004,1980,756,-169,1214,101,1224,-68,1075,120817,16.461658055,6.2853603482,-1.405060713,-81,0.8397108402,10.176297707,-0.565349873
35,45,2005,2052,775,-246,1214,108,1277,-138,1026,121843,16.912552543,6.3875381192,-2.027528229,-113,0.8901343444,10.525014423,-1.137393884
35,45,2006,2107,805,-1582,1214,109,1302,-1473,-223,121620,17.308584877,6.612914488,-12.99581456,-52,0.8954132661,10.695670389,-12.10040129
35,45,2007,2116,865,-737,1214,93,1251,-644,619,122239,17.354290799,7.0942634883,-6.044476521,12,0.7627358433,10.260027311,-5.281740678
35,45,2008,2018,868,-991,1214,95,1150,-896,261,122500,16.491037391,7.0932707905,-8.098423218,7,0.7763372409,9.3977666003,-7.322085977
35,47,2001,385,285,-461,1371,11,100,-450,-373,29699,12.882501548,9.5363972495,-15.42554081,-23,0.3680714728,3.3461042981,-15.05746934
35,47,2002,394,245,-357,1278,10,149,-347,-215,29484,13.31463427,8.2794045587,-12.06427521,-17,0.3379348799,5.0352297112,-11.72634033
35,47,2003,349,266,-386,1259,7,83,-379,-313,29171,11.900093769,9.0699855085,-13.16170829,-17,0.2386838292,2.8301082602,-12.92302447
35,47,2004,367,254,-170,1263,7,113,-163,-74,29097,12.596965744,8.7183359649,-5.835106748,-24,0.2402691014,3.8786297796,-5.594837647
35,47,2005,384,278,-134,1263,8,106,-126,-44,29053,13.2072227,9.5614789338,-4.608770421,-24,0.2751504729,3.6457437661,-4.333619948
35,47,2006,369,256,-379,1263,8,113,-371,-270,28783,12.760218549,8.8526177467,-13.10602393,-12,0.2766443046,3.9076008023,-12.82937963
35,47,2007,367,280,-250,1274,5,87,-245,-154,28629,12.784783669,9.754058385,-8.708980701,4,0.174179614,3.0307252839,-8.534801087
35,47,2008,364,279,-170,1274,6,85,-164,-71,28558,12.730165947,9.7574623603,-5.945407173,8,0.2098379002,2.9727035865,-5.735569273
35,49,2001,1611,785,299,2971,740,826,1039,1741,131563,12.326644605,6.0064655585,2.2878129962,-124,5.6621458768,6.3201790462,7.9499588729
35,49,2002,1529,802,1492,3091,698,727,2190,2827,134390,11.498272251,6.0311408407,11.220027599,-90,5.2490477641,5.4671314104,16.469075363
35,49,2003,1667,840,615,3086,611,827,1226,1885,136275,12.317809839,6.2069347718,4.5443629579,-168,4.5148061257,6.110875067,9.0591690836
35,49,2004,1634,868,250,3113,568,766,818,1492,137767,11.925179352,6.3347953963,1.8245378446,-92,4.1453499828,5.5903839557,5.9698878274
35,49,2005,1614,845,183,3112,592,769,775,1423,139190,11.6552389,6.1020302791,1.3215047823,-121,4.2750318642,5.5532086208,5.5965366465
35,49,2006,1690,892,137,3112,595,798,732,1458,140648,12.078416798,6.375117032,0.9791379298,-72,4.2524603521,5.7032997663,5.2315982819
35,49,2007,1656,956,511,3126,537,700,1048,1721,142369,11.702477236,6.7557779215,3.6110904999,-27,3.7948250458,4.9466993149,7.4059155457
35,49,2008,1677,969,273,3126,540,708,813,1568,143937,11.714738776,6.7689814394,1.9070504984,47,3.7721877991,4.9457573366,5.6792382975
35,51,2001,103,213,-61,266,26,-110,-35,-157,13086,7.8240723157,16.179877701,-4.633673896,-12,1.9750085457,-8.355805386,-2.65866535
35,51,2002,104,206,-116,266,25,-102,-91,-202,12884,8.0092414324,15.864458991,-8.933384675,-9,1.9252984213,-7.855217559,-7.008086253
35,51,2003,107,236,221,266,21,-129,242,115,12999,8.2679751188,18.235907739,17.076845806,2,1.6226867056,-9.96793262,18.699532512
35,51,2004,115,247,-122,266,21,-132,-101,-245,12754,8.9309983303,19.182231196,-9.474624316,-12,1.630877956,-10.25123287,-7.84374636
35,51,2005,116,199,-124,266,22,-83,-102,-193,12561,9.1645269603,15.721904009,-9.796563302,-8,1.7380999407,-6.557377049,-8.058463362
35,51,2006,97,220,-81,266,22,-123,-59,-188,12373,7.7805406273,17.64658699,-6.497152483,-6,1.764658699,-9.866046362,-4.732493784
35,51,2007,111,207,-34,266,19,-96,-15,-121,12252,9.0152284264,16.812182741,-2.76142132,-10,1.5431472081,-7.796954315,-1.218274112
35,51,2008,114,217,274,266,20,-103,294,185,12437,9.2348819312,17.578678764,22.196119729,-6,1.6201547248,-8.343796833,23.816274454
35,53,2001,279,127,-258,661,49,152,-209,-75,17977,15.487523939,7.0498764884,-14.32179633,-18,2.7200310861,8.4376474507,-11.60176524
35,53,2002,217,135,-251,661,47,82,-204,-133,17844,12.115797996,7.5374780157,-14.01412579,-11,2.6241590129,4.5783199799,-11.38996678
35,53,2003,211,139,127,748,40,72,167,224,18068,11.750946759,7.7411450212,7.0728447316,-15,2.227667632,4.0098017376,9.3005123636
35,53,2004,232,153,-156,683,39,79,-117,-53,18015,12.859241194,8.4804478563,-8.646731148,-15,2.1616827869,4.3787933376,-6.485048361
35,53,2005,281,140,-65,675,40,141,-25,100,18115,15.554940493,7.7497924163,-3.598117908,-16,2.2142264046,7.8051480764,-1.383891503
35,53,2006,284,151,-178,675,40,133,-138,-13,18102,15.683242676,8.3386255074,-9.829638015,-8,2.2089074192,7.3446171687,-7.620730596
35,53,2007,249,134,-179,666,39,115,-140,-20,18082,13.762989166,7.4065885474,-9.893875746,5,2.1556489056,6.3564006191,-7.738226841
35,53,2008,259,156,-55,666,40,103,-15,98,18180,14.284926369,8.604048315,-3.033478573,10,2.2061662346,5.6808780542,-0.827312338
35,55,2001,358,239,-128,300,66,119,-62,31,30094,11.902189271,7.9458749605,-4.25553136,-26,2.1942583573,3.9563143109,-2.061273002
35,55,2002,384,232,289,300,63,152,352,478,30572,12.659479775,7.6484356971,9.5275772261,-26,2.0769459005,5.0110440774,11.604523127
35,55,2003,370,221,151,300,47,149,198,311,30883,12.041331055,7.1922544952,4.9141648361,-36,1.5295744854,4.8490765601,6.4437393215
35,55,2004,384,246,65,300,47,138,112,229,31112,12.388095814,7.936123881,2.0969433019,-21,1.5162513106,4.4519719332,3.6131946125
35,55,2005,358,228,-116,300,47,130,-69,30,31142,11.501268995,7.324830533,-3.726668166,-31,1.5099431362,4.1764384618,-2.21672503
35,55,2006,350,276,45,300,49,74,94,153,31295,11.211300991,8.8409116389,1.4414529846,-15,1.5695821388,2.3703893525,3.0110351234
35,55,2007,384,225,9,300,44,159,53,213,31508,12.228715189,7.1652628059,0.2866105122,1,1.4012069487,5.0634523828,1.6878174609
35,55,2008,380,263,-135,300,46,117,-89,38,31546,12.053160783,8.3420560155,-4.282043962,10,1.4590668316,3.7111047673,-2.822977131
35,57,2001,208,116,-358,534,13,92,-345,-265,16673,12.37690042,6.902502157,-21.30254976,-12,0.7735562762,5.4743982625,-20.52899348
35,57,2002,179,112,-210,600,12,67,-198,-139,16534,10.780859457,6.745565694,-12.64793568,-8,0.7227391815,4.0352937634,-11.92519649
35,57,2003,175,133,299,977,8,42,307,349,16883,10.473710985,7.9600203489,17.895083341,0,0.4787982165,2.5136906365,18.373881557
35,57,2004,198,115,243,1227,10,83,253,317,17200,11.618695537,6.7482322566,14.259308159,-19,0.5868028049,4.8704632808,14.846110964
35,57,2005,177,120,-586,900,9,57,-577,-528,16672,10.451110061,7.0854983467,-34.60085026,-8,0.531412376,3.3656117147,-34.06943788
35,57,2006,171,144,-21,900,9,27,-12,6,16678,10.254872564,8.6356821589,-1.259370315,-9,0.5397301349,1.6191904048,-0.71964018
35,57,2007,187,139,-208,572,8,48,-200,-149,16529,11.262685578,8.3717288524,-12.52747915,3,0.481826121,2.890956726,-12.04565302
35,57,2008,191,116,-336,572,9,75,-327,-260,16269,11.647051649,7.0736020489,-20.48905421,-8,0.5488139521,4.5734496006,-19.94024026
35,59,2001,43,51,-127,16,7,-8,-120,-129,4029,10.504458288,12.458776108,-31.02479541,-1,1.7100280933,-1.954317821,-29.31476731
35,59,2002,43,68,-52,16,6,-25,-46,-75,3954,10.772892396,17.036201929,-13.02768383,-4,1.5031942879,-6.263309533,-11.52448954
35,59,2003,49,42,-149,16,4,7,-145,-134,3820,12.606122974,10.805248263,-38.33290455,4,1.0290712632,1.8008747106,-37.30383329
35,59,2004,39,45,-47,16,5,-6,-42,-51,3769,10.278033997,11.859269996,-12.38634866,-3,1.3176966662,-1.581235999,-11.068652
35,59,2005,47,53,14,16,5,-6,19,11,3780,12.451980395,14.041594913,3.7091005431,-2,1.3246787654,-1.589614518,5.0337793085
35,59,2006,47,70,-3,16,5,-23,2,-24,3756,12.473460722,18.577494692,-0.796178344,-3,1.3269639066,-6.10403397,0.5307855626
35,59,2007,46,36,0,16,3,10,3,6,3762,12.237297153,9.5770151636,0,-7,0.798084597,2.6602819899,0.798084597
35,59,2008,56,44,7,16,4,12,11,15,3777,14.856081708,11.672635628,1.8570102136,-8,1.0611486935,3.1834460804,2.918158907
35,61,2001,991,492,210,1927,128,499,338,776,67132,14.847776579,7.371449119,3.1463502337,-61,1.9177753806,7.4763274601,5.0641256143
35,61,2002,1007,494,-36,2000,118,513,82,525,67657,14.941872111,7.329974998,-0.534168218,-70,1.7508847161,7.6118971133,1.2167164976
35,61,2003,940,474,-348,2014,91,466,-257,128,67785,13.880480206,6.999305976,-5.13873097,-81,1.3437486156,6.8811742296,-3.794982354
35,61,2004,955,509,-669,1863,110,446,-559,-174,67611,14.106768294,7.5186859287,-9.882123549,-61,1.6248633638,6.5880823658,-8.257260185
35,61,2005,926,545,313,2033,105,381,418,736,68347,13.621853808,8.0171817767,4.6043631121,-63,1.5445946542,5.6046720311,6.1489577664
35,61,2006,916,518,578,2033,110,398,688,1051,69398,13.299938292,7.5211441432,8.3923191404,-35,1.5971541617,5.7787941486,9.9894733021
35,61,2007,1005,556,1172,2203,99,449,1271,1749,71147,14.30146928,7.9120566367,16.677932335,29,1.4088014515,6.3894126436,18.086733786
35,61,2008,1047,524,426,2203,103,523,529,1060,72207,14.607196172,7.3105738242,5.9433291014,8,1.4370021067,7.2966223475,7.3803312081
36,0,2001,256445,157302,-165928,594567,127769,99143,-38159,89791,19088220,13.466398685,8.2602173796,-8.713184507,28807,6.7093852232,5.2061813052,-2.003799284
36,0,2002,251988,158752,-180276,596806,119930,93236,-60346,73353,19161573,13.175914442,8.3008030919,-9.426247091,40463,6.2708836097,4.8751113503,-3.155363481
36,0,2003,252303,156000,-188515,599437,103739,96303,-84776,69304,19230877,13.143365427,8.1265978076,-9.820420421,57777,5.4041354485,5.0167676197,-4.416284973
36,0,2004,252897,154857,-209755,603139,97573,98040,-112182,70236,19301113,13.126599483,8.0378407656,-10.88731727,84378,5.0645191178,5.0887587171,-5.822798148
36,0,2005,247194,152694,-248647,602741,101494,94500,-147153,35263,19336376,12.795552009,7.9039297818,-12.87076394,87916,5.2536540353,4.8916222273,-7.617109901
36,0,2006,245939,146567,-233306,603919,104709,99372,-128597,30652,19367028,12.708907981,7.5738557776,-12.05609718,59877,5.4108418991,5.1350522037,-6.645255286
36,0,2007,250286,152037,-185638,608735,94288,98249,-91350,62288,19429316,12.902555973,7.8376972841,-9.569870811,55389,4.8606641904,5.0648586887,-4.70920662
36,0,2008,251952,153852,-126209,608760,94797,98100,-31412,60981,19490297,12.947302431,7.906142335,-6.485624613,-5707,4.8714256229,5.0411600958,-1.61419899
36,1,2001,3200,2905,-310,16280,675,295,365,380,295285,10.843965503,9.8442874329,-1.050509158,-280,2.2873989732,0.9996780698,1.2368898151
36,1,2002,3257,2841,459,16323,635,416,1094,1240,296525,11.006911002,9.6010543925,1.5511735185,-270,2.1459590071,1.4058566094,3.6971325256
36,1,2003,3238,2832,1258,16939,536,406,1794,1863,298388,10.885625293,9.5207198363,4.2291898143,-337,1.8019441498,1.3649054568,6.0311339641
36,1,2004,3166,2847,-300,17021,544,319,244,370,298758,10.603771942,9.5353565125,-1.004779401,-193,1.8219999799,1.0684154294,0.8172205792
36,1,2005,3106,2845,-695,17414,553,261,-142,-164,298594,10.399228596,9.525371975,-2.326936212,-283,1.8515046405,0.8738566206,-0.475431571
36,1,2006,3212,2702,-363,17658,579,510,216,589,299183,10.746482384,9.0401604612,-1.214499721,-137,1.9371772417,1.7063219227,0.7226775202
36,1,2007,3141,2681,-1668,17570,524,460,-1144,-604,298579,10.509199313,8.9701252338,-5.580816445,80,1.7532061255,1.5390740797,-3.82761032
36,1,2008,3309,2689,-1783,17570,530,620,-1253,-449,298130,11.09083322,9.0127683678,-5.976112309,184,1.776410277,2.0780648524,-4.199702032
36,3,2001,570,461,169,4810,37,109,206,269,50184,11.388725162,9.2108812276,3.3766571095,-46,0.7392681246,2.1778439345,4.115925234
36,3,2002,532,484,-98,4909,36,48,-62,-60,50124,10.607329425,9.6502771464,-1.953981736,-46,0.7177892092,0.957052279,-1.236192527
36,3,2003,560,533,145,4998,18,27,163,124,50248,11.158490416,10.620491771,2.8892519826,-66,0.3586657634,0.537998645,3.247917746
36,3,2004,523,449,127,5302,23,74,150,186,50434,10.389146024,8.9191712521,2.5227945412,-38,0.4568840508,1.4699747721,2.979678592
36,3,2005,535,474,-607,5005,21,61,-586,-570,49864,10.668208738,9.4518335361,-12.10393029,-45,0.4187521187,1.2163752019,-11.68517817
36,3,2006,505,473,-259,5009,23,32,-236,-224,49640,10.150345715,9.5071554912,-5.205820872,-20,0.4622929731,0.6431902235,-4.743527898
36,3,2007,540,454,-208,4983,15,86,-193,-90,49550,10.888194374,9.1541486037,-4.193971166,17,0.3024498437,1.7340457707,-3.891521323
36,3,2008,579,491,-33,4983,17,88,-16,99,49649,11.673504773,9.8992933397,-0.665329288,27,0.3427453906,1.7742114336,-0.322583897
36,5,2001,23026,10099,-17893,47202,13354,12927,-4539,8463,1342182,17.209904253,7.5481118322,-13.37343945,75,9.9809372619,9.6617924206,-3.392502189
36,5,2002,22925,10434,-17269,47662,12642,12491,-4627,7932,1350114,17.030073959,7.7510050901,-12.82845571,68,9.3912407848,9.2790688691,-3.437214927
36,5,2003,22459,9897,-25196,48360,11239,12562,-13957,4821,1354935,16.605244489,7.3174275216,-18.62886772,6216,8.3096461469,9.2878169675,-10.31922157
36,5,2004,22599,9928,-28884,48168,10194,12671,-18690,4816,1359751,16.649439383,7.3142897558,-21.27980916,10835,7.5102608552,9.3351496269,-13.7695483
36,5,2005,22045,9482,-33760,47575,10729,12563,-23031,4815,1364566,16.183872875,6.9610107781,-24.78419362,15283,7.8764695885,9.2228620972,-16.90772403
36,5,2006,22040,9392,-29682,47813,11735,12648,-17947,6787,1371353,16.111588099,6.8657003369,-21.6980108,12086,8.5784703421,9.245887762,-13.11954045
36,5,2007,22917,9695,-21634,48254,10554,13222,-11080,13769,1385122,16.627758278,7.0343464026,-15.69685921,11627,7.6576061818,9.5934118757,-8.039253031
36,5,2008,23097,9974,-16339,48254,10562,13123,-5777,6781,1391903,16.634347908,7.1832266544,-11.76726893,-565,7.6067014161,9.4511212539,-4.160567514
36,7,2001,2197,2247,-465,9659,366,-50,-99,-341,199958,10.977946669,11.227786147,-2.323507147,-192,1.82882498,-0.249839478,-0.494682167
36,7,2002,2102,2028,-533,9565,349,74,-184,-288,199670,10.519783399,10.149438978,-2.667480757,-178,1.7466243607,0.3703444203,-0.920856396
36,7,2003,2048,2119,-1381,9748,309,-71,-1072,-1344,198326,10.291560719,10.648348225,-6.939768239,-201,1.5527794249,-0.356787505,-5.386988814
36,7,2004,2108,2081,-1042,10254,293,27,-749,-873,197453,10.652409552,10.515969771,-5.265564873,-151,1.4806242878,0.1364397808,-3.784940586
36,7,2005,2038,2099,-1393,10115,304,-61,-1089,-1326,196127,10.356217287,10.666192388,-7.078611718,-176,1.5447939428,-0.3099751,-5.533817775
36,7,2006,2041,2004,-444,10309,313,37,-131,-185,195942,10.411432681,10.222690394,-2.264907453,-91,1.5966577312,0.1887422877,-0.668249721
36,7,2007,2177,2101,-859,10257,286,76,-573,-465,195477,11.123629665,10.735299002,-4.389158421,32,1.4613496023,0.3883306636,-2.927808819
36,7,2008,2206,1969,-1016,10257,288,237,-728,-459,195018,11.298480134,10.084636167,-5.203651775,32,1.4750508969,1.2138439673,-3.728600878
36,9,2001,1004,817,-849,3346,15,187,-834,-716,83300,12.001243157,9.7659518516,-10.14846159,-69,0.1793014416,2.2352913051,-9.969160152
36,9,2002,957,846,-214,3415,14,111,-200,-166,83134,11.500054075,10.166192004,-2.57158994,-77,0.1682348559,1.3338620715,-2.403355084
36,9,2003,1031,840,-232,3419,7,191,-225,-151,82983,12.412937869,10.113353841,-2.793212013,-117,0.0842779487,2.2995840281,-2.708934065
36,9,2004,986,918,-601,3429,12,68,-589,-589,82394,11.924270001,11.101906553,-7.268241654,-68,0.1451229615,0.8223634484,-7.123118692
36,9,2005,993,885,-1018,3204,10,108,-1008,-967,81427,12.122987895,10.804475617,-12.42819907,-67,0.1220844702,1.3185122786,-12.3061146
36,9,2006,944,775,-911,3114,12,169,-899,-765,80662,11.647921821,9.5626476812,-11.24073811,-35,0.1480668028,2.0852741395,-11.09267131
36,9,2007,1043,838,-692,3148,8,205,-684,-479,80183,12.96900743,10.419969536,-8.604557182,0,0.0994746495,2.5490378936,-8.505082533
36,9,2008,1021,798,-720,3148,10,223,-710,-495,79688,12.772798068,9.9830488331,-9.007262105,-8,0.1251008626,2.7897492353,-8.882161243
36,11,2001,920,739,-794,4480,33,181,-761,-645,81280,11.274164394,9.0560950951,-9.730094053,-65,0.404399375,2.2180692993,-9.325694678
36,11,2002,914,724,-177,4436,33,190,-144,-27,81253,11.246946774,8.9089600266,-2.178019233,-73,0.4060713824,2.3379867473,-1.771947851
36,11,2003,784,719,-129,4436,22,65,-107,-156,81097,9.6581459809,8.8574068371,-1.589159224,-114,0.2710194025,0.8007391438,-1.318139821
36,11,2004,852,765,-270,4459,25,87,-245,-217,80880,10.5200121,9.4457855128,-3.333806652,-59,0.3086858011,1.0742265877,-3.02512085
36,11,2005,816,763,-304,4430,23,53,-281,-299,80581,10.107704028,9.4511987415,-3.765615226,-71,0.2848985204,0.6565052861,-3.480716706
36,11,2006,837,754,-314,4509,24,83,-290,-242,80339,10.402684564,9.3711160825,-3.902560278,-35,0.298284862,1.0315684812,-3.604275416
36,11,2007,868,791,-426,4522,17,77,-409,-315,80024,10.825439783,9.8651185124,-5.312946253,17,0.2120189819,0.9603212711,-5.100927271
36,11,2008,859,738,-357,4522,19,121,-338,-201,79823,10.747777562,9.2338298498,-4.46677135,16,0.2377273268,1.5139477125,-4.229044023
36,13,2001,1580,1510,-1078,6560,62,70,-1016,-1057,138604,11.356081433,10.852963901,-7.74800999,-111,0.4456183854,0.5031175318,-7.302391605
36,13,2002,1547,1533,-532,6586,50,14,-482,-596,138008,11.185342646,11.084117826,-3.846543172,-128,0.3615172154,0.1012248203,-3.485025957
36,13,2003,1460,1522,-888,6433,24,-62,-864,-1063,136945,10.619996872,11.070983041,-6.459285769,-137,0.174575291,-0.450986169,-6.284710478
36,13,2004,1468,1429,-613,6631,72,39,-541,-607,136338,10.74344178,10.458023368,-4.486191969,-105,0.5269262998,0.2854184124,-3.95926567
36,13,2005,1426,1449,-1163,6646,57,-23,-1106,-1246,135092,10.507313119,10.676785912,-8.569428582,-117,0.4199977895,-0.169472792,-8.149430792
36,13,2006,1478,1345,-940,6679,110,133,-830,-756,134336,10.971391244,9.9841144944,-6.977745446,-59,0.8165446798,0.9872767493,-6.161200766
36,13,2007,1548,1427,-597,6729,81,121,-516,-383,133953,11.539794774,10.637782391,-4.450424729,12,0.6038264707,0.9020123822,-3.846598258
36,13,2008,1577,1400,-458,6729,87,177,-371,-164,133789,11.779997161,10.457828805,-3.421203995,30,0.6498793615,1.3221683561,-2.771324633
36,15,2001,1130,910,-598,5440,45,220,-553,-406,90671,12.434799833,10.013865352,-6.580540088,-73,0.4951911438,2.4209344807,-6.085348945
36,15,2002,1083,916,-399,5401,43,167,-356,-263,90408,11.961630007,10.117131197,-4.406916318,-74,0.4749308313,1.8444988099,-3.931985487
36,15,2003,1058,946,-646,5429,34,112,-612,-586,89822,11.740553737,10.497697387,-7.168617877,-86,0.3772956777,1.2428563502,-6.791322199
36,15,2004,1041,931,-508,5459,35,110,-473,-436,89386,11.61778492,10.390161154,-5.669389759,-73,0.3906075622,1.2276237668,-5.278782197
36,15,2005,1013,975,-1004,5348,35,38,-969,-1005,88381,11.39694094,10.969415021,-11.2956848,-74,0.3937738725,0.4275259188,-10.90191093
36,15,2006,967,950,-308,5519,38,17,-270,-292,88089,10.959369865,10.766702556,-3.490678302,-39,0.4306681022,0.1926673089,-3.0600102
36,15,2007,1082,881,-393,5514,33,201,-360,-176,87913,12.295314826,10.011249872,-4.465858343,-17,0.3749957387,2.2840649538,-4.090862604
36,15,2008,1081,909,-303,5514,34,172,-269,-100,87813,12.303244824,10.345651753,-3.448550584,-3,0.3869660722,1.957593071,-3.061584512
36,17,2001,573,524,-293,1262,11,49,-282,-276,51105,11.182015105,10.225786937,-5.717854146,-43,0.2146634662,0.9562281677,-5.50319068
36,17,2002,561,540,90,1313,11,21,101,76,51181,10.969243103,10.558629724,1.7597716207,-46,0.2150831981,0.4106133782,1.9748548188
36,17,2003,537,556,176,1316,5,-19,181,96,51277,10.482343985,10.853227664,3.4355540807,-66,0.0976009682,-0.370883679,3.5331550489
36,17,2004,533,573,-65,1300,9,-40,-56,-131,51146,10.407818556,11.18889312,-1.269246165,-35,0.1757417767,-0.781074563,-1.093504389
36,17,2005,539,535,-70,1307,7,4,-63,-108,51038,10.549596806,10.471306662,-1.370077507,-49,0.1370077507,0.0782901433,-1.233069757
36,17,2006,518,459,-5,1332,8,59,3,37,51075,10.145622986,8.9900404454,-0.097930724,-25,0.1566891581,1.1555825409,0.0587584343
36,17,2007,575,532,-29,1325,4,43,-25,22,51097,11.255529891,10.413812003,-0.567670203,4,0.0782993384,0.8417178875,-0.489370865
36,17,2008,580,518,-283,1325,6,62,-277,-199,50898,11.373106525,10.157360655,-5.549291632,16,0.1176528261,1.2157458699,-5.431638806
36,19,2001,774,662,256,7206,56,112,312,347,80244,9.6664814133,8.267714077,3.1971824829,-77,0.6993836681,1.3987673363,3.8965661511
36,19,2002,725,623,194,7076,55,102,249,281,80525,9.0191517021,7.7502503592,2.4134005934,-70,0.6842115084,1.2689013429,3.0976121018
36,19,2003,778,695,497,7088,43,83,540,538,81063,9.6294279278,8.6021239201,6.1514468896,-85,0.5322177389,1.0273040077,6.6836646286
36,19,2004,825,621,126,6950,44,204,170,319,81382,10.157284004,7.6456646865,1.5512942842,-55,0.5417218135,2.5116193173,2.0930160978
36,19,2005,753,623,217,7051,43,130,260,316,81698,9.2347314202,7.6404218788,2.6612705421,-74,0.5273485406,1.5943095413,3.1886190827
36,19,2006,770,641,128,7230,45,129,173,264,81962,9.4097519247,7.8333129659,1.5642185018,-38,0.549920567,1.5764389588,2.1141390688
36,19,2007,814,626,-139,7259,41,188,-98,98,82060,9.9254977991,7.633122386,-1.694894587,8,0.4999329358,2.2923754131,-1.194961651
36,19,2008,853,662,-379,7259,43,191,-336,-113,81947,10.401995037,8.0728261599,-4.62175395,32,0.5243678623,2.3291688769,-4.097386087
36,21,2001,598,702,-141,2707,68,-104,-73,-245,62813,9.5017915167,11.154276998,-2.24038897,-68,1.0804712761,-1.652485481,-1.159917694
36,21,2002,599,689,126,2613,67,-90,193,46,62859,9.5327519256,10.965051881,2.0052199376,-57,1.0662677446,-1.432299955,3.0714876822
36,21,2003,629,681,34,2486,48,-52,82,-57,62802,10.011061507,10.838685034,0.5411384598,-87,0.7639601786,-0.827623527,1.3050986384
36,21,2004,609,707,255,2520,52,-98,307,160,62962,9.6848064629,11.243281066,4.0552145288,-49,0.8269457078,-1.558474603,4.8821602366
36,21,2005,607,693,13,2477,53,-86,66,-82,62880,9.6470176888,11.013810969,0.2066082866,-62,0.8423260914,-1.36679328,1.048934378
36,21,2006,596,602,-438,2484,60,-6,-378,-411,62469,9.5094496167,9.6051823309,-6.988488141,-27,0.9573271426,-0.095732714,-6.031160998
36,21,2007,596,645,-250,2510,43,-49,-207,-244,62225,9.5594014147,10.345325356,-4.00981603,12,0.6896883571,-0.785923942,-3.320127673
36,21,2008,628,644,-269,2510,45,-16,-224,-219,62006,10.110197938,10.367782599,-4.33064211,21,0.7244568586,-0.257584661,-3.606185252
36,23,2001,537,443,-42,3335,34,94,-8,35,48609,11.051315559,9.1168208432,-0.864348703,-51,0.6997108548,1.9344947162,-0.164637848
36,23,2002,550,410,-316,3010,33,140,-283,-184,48425,11.336232661,8.4506461653,-6.513180947,-41,0.6801739596,2.8855864955,-5.833006987
36,23,2003,564,460,317,3273,26,104,343,400,48825,11.598971722,9.4601542416,6.5192802057,-47,0.5347043702,2.1388174807,7.0539845758
36,23,2004,529,418,-117,3343,30,111,-87,-9,48816,10.835612089,8.5619770383,-2.396534243,-33,0.6144959597,2.2736350508,-1.782038283
36,23,2005,525,437,-531,3283,28,88,-503,-453,48363,10.804803507,8.9937126334,-10.92828698,-38,0.576256187,1.8110908735,-10.35203079
36,23,2006,556,446,-106,3349,29,110,-77,11,48374,11.495084611,9.2208772238,-2.191508937,-22,0.5995637657,2.274207387,-1.591945171
36,23,2007,527,421,-85,3501,25,106,-60,41,48415,10.889667214,8.6993356683,-1.756397938,-5,0.5165876288,2.1903315459,-1.239810309
36,23,2008,575,429,-287,3501,27,146,-260,-113,48302,11.890360536,8.8712429046,-5.934840824,1,0.558329973,3.0191176319,-5.376510851
36,25,2001,441,508,-331,2018,18,-67,-313,-426,47541,9.234828496,10.637852327,-6.931356536,-46,0.3769317753,-1.40302383,-6.55442476
36,25,2002,406,583,-227,1996,18,-177,-209,-432,47109,8.5789751717,12.319070259,-4.796619123,-46,0.3803486529,-3.740095087,-4.41627047
36,25,2003,443,567,90,1985,6,-124,96,-86,47023,9.412314622,12.046912846,1.9122083882,-58,0.1274805592,-2.634598224,2.0396889474
36,25,2004,446,540,172,2134,9,-94,181,50,47073,9.4796803265,11.477639857,3.6558408434,-37,0.1912939976,-1.997959531,3.847134841
36,25,2005,417,561,-56,2124,7,-144,-49,-232,46841,8.8804651064,11.947100539,-1.192580446,-39,0.1490725557,-3.066635432,-1.04350789
36,25,2006,471,539,-295,2153,8,-68,-287,-374,46467,10.095597376,11.553135851,-6.323144854,-19,0.1714751147,-1.457538475,-6.151669739
36,25,2007,474,550,-63,2235,7,-76,-56,-143,46324,10.216508067,11.854597967,-1.357890313,-11,0.1508767014,-1.638089901,-1.207013611
36,25,2008,477,534,-186,2235,9,-57,-177,-239,46085,10.323669772,11.557315846,-4.025581924,-5,0.1947862221,-1.233646073,-3.830795702
36,27,2001,3334,2229,1775,18583,725,1105,2500,3365,284332,11.795527677,7.8860921389,6.2798625152,-240,2.5650142668,3.9094355377,8.844876782
36,27,2002,3165,2268,1181,18287,672,897,1853,2496,286828,11.082708873,7.9417326143,4.1354436585,-254,2.3531059598,3.1409762588,6.4885496183
36,27,2003,3238,2260,1157,18215,589,978,1746,2372,289200,11.242509045,7.8468407786,4.0171658322,-352,2.0450394772,3.3956682661,6.0622053095
36,27,2004,3259,2218,216,18172,545,1041,761,1612,290812,11.23769853,7.6481176252,0.7448121763,-190,1.8792714633,3.5895809052,2.6240836396
36,27,2005,3152,2190,-234,18532,568,962,334,1023,291835,10.81958716,7.5174162057,-0.803230773,-273,1.9497225593,3.3021709543,1.1464917866
36,27,2006,3114,2126,-1387,18627,591,988,-796,62,291897,10.669279738,7.2841646509,-4.752180795,-130,2.0249018385,3.3851150871,-2.727278957
36,27,2007,3138,2249,-1120,18716,534,889,-586,327,292224,10.744349202,7.7004593226,-3.834821895,24,1.8283882963,3.043889879,-2.006433599
36,27,2008,3209,2239,-893,18716,537,970,-356,654,292878,10.969027623,7.6533664216,-3.052459229,40,1.8355773865,3.315661201,-1.216881843
36,29,2001,11011,10205,-5557,31826,1315,806,-4242,-4256,945205,11.623156799,10.772347211,-5.865941543,-820,1.3881074554,0.8508095886,-4.477834088
36,29,2002,10675,10033,-5459,31930,1220,642,-4239,-4405,940800,11.320224496,10.639420362,-5.788956021,-808,1.2937399424,0.6808041336,-4.495216078
36,29,2003,10672,10018,-3975,32172,1030,654,-2945,-3502,937298,11.36468917,10.66823989,-4.233005945,-1211,1.0968543708,0.6964492801,-3.136151575
36,29,2004,10417,9842,-5510,32047,1004,575,-4506,-4661,932637,11.141563744,10.526569105,-5.893252974,-730,1.0738341172,0.6149946389,-4.819418857
36,29,2005,9952,9982,-8126,31686,1034,-30,-7092,-7889,924748,10.716141242,10.748444722,-8.749936066,-767,1.1133932922,-0.03230348,-7.636542774
36,29,2006,9845,9308,-8878,31669,1204,537,-7674,-7539,917209,10.689717512,10.106642012,-9.639747291,-402,1.3073052194,0.5830755007,-8.332442071
36,29,2007,10147,9573,-6600,31789,1048,574,-5552,-5051,912158,11.093454731,10.465915259,-7.215610646,-73,1.1457515086,0.6275394713,-6.069859137
36,29,2008,10270,9470,-4127,31789,1057,800,-3070,-2313,909845,11.273307453,10.395153027,-4.530179149,-43,1.1602615363,0.8781544267,-3.369917613
36,31,2001,349,435,-84,2927,19,-86,-65,-187,38635,9.011451515,11.232038421,-2.16894535,-36,0.4905947816,-2.220586906,-1.678350569
36,31,2002,342,404,174,2921,17,-62,191,96,38731,8.8410929866,10.44386423,4.4980999405,-33,0.4394695344,-1.602771243,4.937569475
36,31,2003,354,402,10,2863,5,-48,15,-87,38644,9.1502423263,10.39095315,0.2584814216,-54,0.1292407108,-1.240710824,0.3877221325
36,31,2004,336,394,-159,2905,13,-58,-146,-232,38412,8.7209302326,10.226328904,-4.126868771,-28,0.3374169435,-1.505398671,-3.789451827
36,31,2005,403,414,-150,2825,10,-11,-140,-187,38225,10.517113144,10.804180748,-3.914558242,-36,0.2609705495,-0.287067604,-3.653587693
36,31,2006,370,373,-26,2811,12,-3,-14,-36,38189,9.684089303,9.762608946,-0.680503573,-19,0.314078572,-0.078519643,-0.366425001
36,31,2007,365,408,-263,2755,5,-43,-258,-284,37905,9.5933976398,10.723578732,-6.912502957,17,0.131416406,-1.130181092,-6.781086551
36,31,2008,391,389,-101,2755,7,2,-94,-79,37826,10.326022369,10.27320384,-2.667335701,13,0.1848648506,0.0528185287,-2.482470851
36,33,2001,452,451,-219,6883,9,1,-210,-259,50789,8.8769307815,8.8572915542,-4.300990799,-50,0.1767530465,0.0196392274,-4.124237752
36,33,2002,463,427,-230,6647,8,36,-222,-227,50562,9.1365650068,8.426162544,-4.538682401,-41,0.1578672139,0.7104024627,-4.380815187
36,33,2003,479,442,128,6722,3,37,131,103,50665,9.4638782143,8.7328479556,2.5289695437,-65,0.0592727237,0.7310302587,2.5882422674
36,33,2004,466,436,-221,6689,8,30,-213,-220,50445,9.2176837108,8.6242705964,-4.37147661,-37,0.1582434972,0.5934131144,-4.213233112
36,33,2005,491,429,-137,6564,6,62,-131,-115,50330,9.7444802778,8.5140163731,-2.718928306,-46,0.1190771521,1.2304639047,-2.599851154
36,33,2006,528,411,-82,6571,8,117,-74,20,50350,10.488676996,8.1644815256,-1.628923321,-23,0.1589193484,2.3241954708,-1.470003973
36,33,2007,511,439,21,6681,6,72,27,99,50449,10.138989474,8.7104038731,0.4166708003,0,0.1190488001,1.428585601,0.5357196004
36,33,2008,517,410,-50,6681,8,107,-42,72,50521,10.240665544,8.121224126,-0.990393186,7,0.1584629098,2.1194414182,-0.831930276
36,35,2001,631,630,-126,1807,32,1,-94,-143,54864,11.48619745,11.467994284,-2.293598857,-50,0.582501297,0.0182031655,-1.71109756
36,35,2002,631,590,-11,1735,31,41,20,6,54870,11.500537664,10.753276104,-0.200484809,-55,0.5650026428,0.7472615598,0.364517834
36,35,2003,572,590,76,1807,20,-18,96,5,54875,10.42416511,10.752198278,1.3850289307,-73,0.3644812976,-0.328033168,1.7495102283
36,35,2004,563,569,110,1748,26,-6,136,92,54967,10.251087926,10.360335755,2.0028768595,-38,0.4734072577,-0.109247829,2.4762841172
36,35,2005,554,622,91,1747,23,-68,114,-9,54958,10.079599727,11.316806914,1.6556743234,-55,0.4184671367,-1.237207187,2.0741414601
36,35,2006,549,558,-68,1729,29,-9,-39,-73,54885,9.9960853218,10.159955573,-1.238130787,-25,0.5280263649,-0.163870251,-0.710104422
36,35,2007,586,570,29,1658,24,16,53,74,54959,10.669676996,10.378354758,0.5280215578,5,0.4369833582,0.2913222388,0.9650049161
36,35,2008,598,571,-14,1658,26,27,12,65,55024,10.874407863,10.383422893,-0.254584799,26,0.4728003419,0.4909849704,0.2182155424
36,37,2001,737,576,-580,1440,34,161,-546,-431,59898,12.260141233,9.5818742878,-9.648415081,-46,0.5655967462,2.678266945,-9.082818335
36,37,2002,634,569,-282,1462,31,65,-251,-237,59661,10.605642402,9.5183131341,-4.717336211,-51,0.5185724203,1.0873292684,-4.19876379
36,37,2003,687,609,-154,1435,19,78,-135,-135,59526,11.528102897,10.219235319,-2.584174449,-78,0.3188267177,1.3088675778,-2.265347731
36,37,2004,610,595,-394,1431,31,15,-363,-396,59130,10.281823085,10.02899137,-6.641046386,-48,0.5225188781,0.2528317152,-6.118527508
36,37,2005,669,552,-472,1402,27,117,-445,-382,58748,11.35071854,9.3656152972,-8.008279747,-54,0.4581007482,1.9851032423,-7.550178999
36,37,2006,646,548,-477,1443,29,98,-448,-374,58374,11.03123239,9.3577636994,-8.145352709,-24,0.4952101228,1.6734686908,-7.650142586
36,37,2007,644,552,-365,1520,20,92,-345,-241,58133,11.055129735,9.4758254869,-6.26571794,12,0.3433270104,1.5793042478,-5.922390929
36,37,2008,655,561,-457,1522,22,94,-435,-312,57821,11.297583525,9.6762509271,-7.882436138,29,0.3794608207,1.6213325974,-7.502975318
36,39,2001,434,530,52,3832,26,-96,78,-66,48086,9.0193063031,11.014360232,1.0806542114,-48,0.5403271057,-1.995053929,1.6209813172
36,39,2002,451,532,251,3877,22,-81,273,152,48238,9.3642290603,11.046052905,5.2115775923,-40,0.4567916615,-1.681823845,5.6683692538
36,39,2003,454,547,266,3837,7,-93,273,135,48373,9.398515697,11.323762304,5.5066193291,-45,0.144911035,-1.925246608,5.651530364
36,39,2004,436,532,392,3868,24,-96,416,276,48649,8.987652285,10.966584898,8.080641504,-44,0.4947331533,-1.978932613,8.5753746573
36,39,2005,458,551,413,3879,18,-93,431,295,48944,9.3859190721,11.291793469,8.4637217833,-43,0.3688789155,-1.905874397,8.8326006988
36,39,2006,448,477,222,3874,23,-29,245,190,49134,9.1355859622,9.7269520178,4.5270091152,-26,0.4690144579,-0.591366056,4.9960235731
36,39,2007,457,528,-16,3891,17,-71,1,-81,49053,9.3087679632,10.754987931,-0.325908725,-11,0.3462780205,-1.446219968,0.0203692953
36,39,2008,482,509,-36,3891,20,-27,-16,-61,48992,9.832219899,10.382987404,-0.734356673,-18,0.4079759294,-0.550767505,-0.326380744
36,41,2001,44,73,-22,97,0,-29,-22,-57,5326,8.2173872444,13.633392474,-4.108693622,-6,0,-5.416005229,-4.108693622
36,41,2002,43,68,-40,98,-1,-25,-41,-73,5253,8.1293127895,12.855657435,-7.562151432,-7,-0.189053786,-4.726344645,-7.751205218
36,41,2003,42,68,-12,97,-1,-26,-13,-45,5208,8.0298250645,13.000669152,-2.294235733,-6,-0.191186311,-4.970844088,-2.485422044
36,41,2004,42,62,7,95,0,-20,7,-17,5191,8.0776997788,11.924223483,1.3462832965,-4,0,-3.846523704,1.3462832965
36,41,2005,40,69,-27,96,0,-29,-27,-61,5130,7.7511869005,13.370797403,-5.232051158,-5,0,-5.619610503,-5.232051158
36,41,2006,32,61,-26,97,0,-29,-26,-58,5072,6.2732797491,11.958439522,-5.097039796,-3,0,-5.685159773,-5.097039796
36,41,2007,35,58,7,97,0,-23,7,-18,5054,6.9128974916,11.4556587,1.3825794983,-2,0,-4.542761209,1.3825794983
36,41,2008,41,62,-10,97,1,-21,-9,-33,5021,8.1389578164,12.307692308,-1.985111663,-3,0.1985111663,-4.168734491,-1.786600496
36,43,2001,675,752,-312,1118,19,-77,-293,-426,63957,10.518934081,11.718871747,-4.862085086,-56,0.2960885149,-1.199937666,-4.565996572
36,43,2002,653,710,-472,1103,17,-57,-455,-562,63395,10.255041146,11.150197877,-7.412525912,-50,0.2669765689,-0.895156731,-7.145549344
36,43,2003,711,740,-59,1111,9,-29,-50,-173,63222,11.230719414,11.688793764,-0.931944368,-94,0.1421610052,-0.45807435,-0.789783362
36,43,2004,693,784,116,1105,18,-91,134,-1,63221,10.961460895,12.400844649,1.8348188512,-44,0.28471327,-1.439383754,2.1195321212
36,43,2005,691,714,-252,1091,14,-23,-238,-315,62906,10.957209796,11.321921555,-3.995972314,-54,0.2219984619,-0.364711759,-3.773973852
36,43,2006,671,707,-408,1065,16,-36,-392,-456,62450,10.705510706,11.279874916,-6.509461055,-28,0.2552729825,-0.574364211,-6.254188072
36,43,2007,676,669,-67,1071,13,7,-54,-62,62388,10.830035726,10.717890386,-1.073391115,-15,0.2082699178,0.1121453404,-0.865121197
36,43,2008,751,692,-262,1071,15,59,-247,-188,62200,12.055735705,11.108613992,-4.205862523,0,0.2407936559,0.9471217132,-3.965068867
36,45,2001,1655,866,-1825,8100,-17,789,-1842,348,111839,14.821116733,7.7553396319,-16.34352752,1401,-0.152241078,7.0657771012,-16.49576859
36,45,2002,1687,896,-741,9232,-477,791,-1218,2097,113936,14.944081497,7.9371055254,-6.564057137,2524,-4.225445687,7.0069759717,-10.78950282
36,45,2003,1598,868,454,8157,-1400,730,-946,-576,113360,14.060960158,7.6376179079,3.9947909334,-360,-12.31873856,6.4233422498,-8.323947628
36,45,2004,1652,885,-2974,7871,637,767,-2337,1064,114424,14.50496962,7.7705194395,-26.11245742,2634,5.5930179468,6.7344501809,-20.51943947
36,45,2005,1615,922,2321,8622,-62,693,2259,2597,117021,13.955799434,7.9673356521,20.05660092,-355,-0.535764436,5.9884637819,19.520836484
36,45,2006,1744,779,-2245,8084,317,965,-1928,141,117162,14.894334772,6.6529167361,-19.17303989,1104,2.7072844741,8.2414180363,-16.46575541
36,45,2007,1807,876,-43,8854,-89,931,-132,764,117926,15.372966719,7.4525284149,-0.365820459,-35,-0.757163275,7.920438304,-1.122983734
36,45,2008,1896,842,-1005,8854,95,1054,-910,120,118046,16.069703185,7.1364399166,-8.517959758,-24,0.8051802756,8.9332632685,-7.712779482
36,47,2001,40149,18206,-47852,40001,30963,21943,-16889,5802,2471559,16.263492148,7.3748571086,-19.38381096,748,12.542442088,8.8886350398,-6.841368873
36,47,2002,39806,18429,-52858,40547,29277,21377,-23581,5803,2477362,16.086738907,7.4476840507,-21.36142404,8007,11.831669974,8.6390548566,-9.529754062
36,47,2003,39350,17952,-61951,40261,25767,21398,-36184,5802,2483164,15.865252999,7.2379421053,-24.9775931,20588,10.388817637,8.627310894,-14.58877546
36,47,2004,39779,17752,-60461,40177,23300,22027,-37161,14695,2497859,15.972220967,7.1278530535,-24.27653918,29829,9.3555078947,8.844367914,-14.92103128
36,47,2005,39645,17371,-62650,40616,24589,22274,-38061,13549,2511408,15.828663156,6.9355456597,-25.01363972,29336,9.8174044226,8.893117496,-15.1962353
36,47,2006,39552,16470,-55490,39877,24934,23082,-30556,11639,2523047,15.71252499,6.542912788,-22.04409415,19113,9.9053422863,9.1696122023,-12.13875186
36,47,2007,40654,17286,-42862,39695,22687,23368,-20175,16159,2539206,16.061623155,6.8293702429,-16.93396201,12966,8.9632027479,9.2322529119,-7.970759265
36,47,2008,40744,18149,-25696,39695,22706,22595,-2990,17392,2556598,15.991195894,7.1231154102,-10.08516026,-2213,8.9116457383,8.8680804835,-1.173514523
36,49,2001,330,235,-213,268,1,95,-212,-138,26829,12.268570154,8.736709049,-7.918804372,-21,0.0371774853,3.5318611049,-7.881626887
36,49,2002,320,229,-486,271,-6,91,-492,-411,26418,12.019456495,8.6014235544,-18.25454955,-10,-0.225364809,3.4180329408,-18.47991436
36,49,2003,345,215,-129,266,-21,130,-150,-53,26365,13.072390732,8.1465623401,-4.887937404,-33,-0.79571074,4.9258283917,-5.683648144
36,49,2004,278,251,-146,280,9,27,-137,-131,26234,10.570543166,9.5439076789,-5.551436339,-21,0.3422118291,1.0266354874,-5.20922451
36,49,2005,322,225,-88,264,-1,97,-89,-16,26218,12.277892168,8.5792724777,-3.355448791,-24,-0.0381301,3.6986196904,-3.393578891
36,49,2006,352,236,41,274,4,116,45,149,26367,13.387848246,8.9759437102,1.5593800513,-12,0.1521346392,4.4119045355,1.7115146905
36,49,2007,345,237,-73,273,-2,108,-75,33,26400,13.07635454,8.9828870317,-2.766880816,0,-0.075804954,4.0934675081,-2.84268577
36,49,2008,360,239,-356,273,2,121,-354,-224,26176,13.694461351,9.0916007304,-13.54230067,9,0.0760803408,4.6028606208,-13.46622033
36,51,2001,633,504,20,6876,10,129,30,95,64455,9.8280479758,7.8251756395,0.3105228428,-64,0.1552614214,2.0028723363,0.4657842643
36,51,2002,659,506,-371,6736,9,153,-362,-261,64194,10.244930003,7.8663650709,-5.767631307,-52,0.1399155843,2.3785649325,-5.627715723
36,51,2003,661,499,-410,6637,6,162,-404,-307,63887,10.321593367,7.7919441603,-6.402198609,-65,0.0936907113,2.5296492064,-6.308507897
36,51,2004,635,525,-9,6614,7,110,-2,69,63956,9.9340597452,8.2131990019,-0.140797697,-39,0.10950932,1.7208607433,-0.031288377
36,51,2005,611,466,-534,6640,7,145,-527,-438,63518,9.5862685724,7.3112948523,-8.37817908,-56,0.1098263175,2.2749737201,-8.268352762
36,51,2006,647,499,-367,6690,7,148,-360,-240,63278,10.205369255,7.8709107543,-5.788826146,-28,0.1104135777,2.3344585003,-5.678412568
36,51,2007,645,507,-263,6750,6,138,-257,-109,63169,10.201902773,8.0191700871,-4.159845627,10,0.0949014211,2.1827326864,-4.064944206
36,51,2008,649,511,-173,6750,7,138,-166,-15,63154,10.275246788,8.090371508,-2.739010315,13,0.110827007,2.18487528,-2.628183308
36,53,2001,780,569,-154,4633,31,211,-123,24,69445,11.233851339,8.1949505278,-2.217965521,-64,0.4464735788,3.0389008109,-1.771491942
36,53,2002,767,560,-127,4774,30,207,-97,44,69489,11.041213814,8.0613816632,-1.828206199,-66,0.431859732,2.9798321505,-1.396346467
36,53,2003,705,603,299,4914,20,102,319,339,69828,10.120803635,8.6565171515,4.2923692012,-82,0.2871149967,1.4642864833,4.5794841979
36,53,2004,714,609,-49,5056,21,105,-28,33,69861,10.222709018,8.7193694564,-0.701558462,-44,0.3006679123,1.5033395615,-0.40089055
36,53,2005,750,579,-455,4888,21,171,-434,-322,69539,10.760401722,8.3070301291,-6.527977044,-59,0.3012912482,2.4533715925,-6.226685796
36,53,2006,708,522,-84,5094,22,186,-62,91,69630,10.174679706,7.5016706307,-1.207165389,-33,0.3161623637,2.6730090753,-0.891003025
36,53,2007,757,570,37,5253,19,187,56,232,69862,10.853669028,8.1725116853,0.5304963726,-11,0.2724170562,2.6811573424,0.8029134287
36,53,2008,768,573,-306,5253,21,195,-285,-96,69766,11.000658894,8.2075228464,-4.383075028,-6,0.3007992666,2.7931360472,-4.082275761
36,55,2001,9206,6395,-4297,30685,1854,2811,-2443,-248,738766,12.459229385,8.6548742032,-5.815479977,-616,2.5091691591,3.8043551814,-3.306310818
36,55,2002,8915,6242,-3419,31226,1746,2673,-1673,393,739159,12.064211648,8.4469780266,-4.626757109,-607,2.3627721298,3.6172336215,-2.263984979
36,55,2003,8935,6262,-4576,31210,1528,2673,-3048,-1165,737994,12.097595848,8.4784717629,-6.195702138,-790,2.068844595,3.6191240853,-4.126857543
36,55,2004,8771,6367,-4617,31765,1426,2404,-3191,-1394,736600,11.896155823,8.6355973237,-6.262062642,-607,1.934091689,3.2605584995,-4.327970953
36,55,2005,8477,6431,-6493,31854,1490,2046,-5003,-3608,732992,11.53653531,8.7520890152,-8.836466176,-651,2.027773695,2.7844462953,-6.808692481
36,55,2006,8726,6030,-5077,32124,1686,2696,-3391,-1009,731983,11.912831277,8.2322223929,-6.9311763,-314,2.3017457636,3.6806088841,-4.629430536
36,55,2007,8706,6269,-4377,32363,1487,2437,-2890,-203,731780,11.895368308,8.5655942936,-5.980476348,250,2.0317496753,3.329774014,-3.948726672
36,55,2008,8677,6231,-3325,32363,1494,2446,-1831,982,732762,11.849438254,8.5091448385,-4.540668687,367,2.0402282761,3.340293416,-2.500440411
36,57,2001,572,613,-250,1193,20,-41,-230,-317,49339,11.556139199,12.384463862,-5.050760139,-46,0.4040608112,-0.828324663,-4.646699328
36,57,2002,586,649,-242,1199,18,-63,-224,-327,49012,11.916503137,13.197628901,-4.92114976,-40,0.3660359325,-1.281125764,-4.555113827
36,57,2003,600,651,47,1178,11,-51,58,-63,48949,12.249772869,13.291003563,0.9595655414,-70,0.2245791693,-1.041230694,1.1841447107
36,57,2004,587,675,-60,1163,18,-88,-42,-162,48787,12.011950561,13.81271998,-1.227797332,-32,0.3683391995,-1.80076942,-0.859458132
36,57,2005,610,583,-118,1145,17,27,-101,-119,48668,12.518598327,11.964496434,-2.421630496,-45,0.3488789698,0.5541018932,-2.072751526
36,57,2006,614,631,126,1167,43,-17,169,129,48797,12.599394654,12.948237829,2.5855435284,-23,0.8823680295,-0.348843174,3.467911558
36,57,2007,619,607,-216,1148,37,12,-179,-147,48650,12.704341847,12.458054122,-4.433179061,20,0.759387154,0.2462877256,-3.673791907
36,57,2008,637,595,-84,1148,39,42,-45,29,48679,13.089623853,12.226571731,-1.726104244,32,0.801405542,0.8630521222,-0.924698702
36,59,2001,16705,11317,-11406,21979,5055,5388,-6351,6497,1342570,12.472733395,8.449800888,-8.516252446,7460,3.7742991507,4.0229325072,-4.741953295
36,59,2002,16034,11532,-8056,22536,4729,4502,-3327,7035,1349605,11.911558498,8.5670508046,-5.984752106,5860,3.5131445764,3.3445076936,-2.471607529
36,59,2003,16253,11267,-10809,22675,4144,4986,-6665,3981,1353586,12.025047435,8.3360739215,-7.997215143,5660,3.0660060647,3.6889735132,-4.931209078
36,59,2004,16044,11015,-11744,23308,3778,5029,-7966,3281,1356867,11.838611479,8.1277926605,-8.665710123,6218,2.7877258894,3.7108188188,-5.877984234
36,59,2005,15185,10582,-15770,23574,3981,4603,-11789,-1073,1355794,11.195648848,7.8019332309,-11.62695965,6113,2.9351253253,3.3937156172,-8.691834328
36,59,2006,15251,10464,-16715,23752,4012,4787,-12703,-2028,1353766,11.257178287,7.7237632678,-12.33779654,5888,2.9613664211,3.5334150194,-9.376430121
36,59,2007,14462,10646,-13500,23919,3641,3816,-9859,-705,1353061,10.685573921,7.866036507,-9.974778588,5338,2.6902347287,2.8195374141,-7.284543859
36,59,2008,13830,10798,-7242,23919,3650,3032,-3592,-1436,1351625,10.226695446,7.9846606963,-5.355150284,-876,2.6990194056,2.2420347501,-2.656130878
36,61,2001,20171,11359,-8411,62253,17241,8812,8830,20662,1561272,13.005652697,7.323940756,-5.42315923,3020,11.116477029,5.6817119413,5.6933177987
36,61,2002,19939,11684,-23149,62244,16336,8255,-6813,4205,1565477,12.753821941,7.4735771883,-14.80707278,2763,10.449191796,5.2802447526,-4.357880981
36,61,2003,20243,11148,-14701,63085,14434,9095,-267,11144,1576621,12.885021409,7.0958957996,-9.357442066,2316,9.1874919242,5.7891256097,-0.169950142
36,61,2004,20717,10755,-11832,63364,12956,9962,1124,14290,1590911,13.080846539,6.7907759101,-7.470800611,3204,8.1805014125,6.2900706291,0.7097008018
36,61,2005,20430,10908,-16416,62137,13704,9522,-2712,15364,1606275,12.779988402,6.8235004157,-10.26903033,8554,8.572538476,5.9564879866,-1.696491853
36,61,2006,20149,10412,-13812,61982,13830,9737,18,6355,1612630,12.519164126,6.4692807026,-8.581800333,-3400,8.5929842602,6.0498834231,0.0111839275
36,61,2007,20724,10869,-14568,63707,12603,9855,-1965,12621,1625251,12.800964581,6.7136500693,-8.998477708,4731,7.7847209332,6.0873145122,-1.213756775
36,61,2008,21296,11174,-12355,63707,12607,10122,252,9544,1634795,13.064846324,6.8551179953,-7.579647649,-830,7.7342466947,6.209728329,0.1545990455
36,63,2001,2551,2344,-1506,4257,167,207,-1339,-1312,218339,11.648667778,10.703440718,-6.876869335,-180,0.762574488,0.94522706,-6.114294847
36,63,2002,2423,2368,-659,4533,150,55,-509,-641,217698,11.113735761,10.861463591,-3.022679268,-187,0.6880150079,0.2522721696,-2.33466426
36,63,2003,2420,2388,-273,4510,112,32,-161,-427,217271,11.127229757,10.980092834,-1.255261869,-298,0.5149792284,0.1471369224,-0.740282641
36,63,2004,2400,2376,-561,4580,153,24,-408,-539,216732,11.059831384,10.94923307,-2.585235586,-155,0.7050642507,0.1105983138,-1.880171335
36,63,2005,2243,2291,-1059,4624,142,-48,-917,-1171,215561,10.377221005,10.599292609,-4.899454768,-206,0.6569618291,-0.222071604,-4.242492939
36,63,2006,2171,2187,-835,4708,162,-16,-673,-781,214780,10.089673073,10.164032709,-3.88064349,-92,0.7528913118,-0.074359636,-3.127752178
36,63,2007,2368,2295,-682,4507,141,73,-541,-425,214355,11.036154124,10.695934846,-3.178486956,43,0.6571358663,0.3402192783,-2.52135109
36,63,2008,2447,2263,-358,4507,146,184,-212,109,214464,11.412740574,10.554569644,-1.669702135,137,0.680939977,0.8581709299,-0.988762158
36,65,2001,2483,2661,-1727,15026,767,-178,-960,-1331,233701,10.594517561,11.354011772,-7.368800575,-193,3.2726520215,-0.759494211,-4.096148554
36,65,2002,2498,2692,-942,14961,706,-194,-236,-633,233068,10.70336719,11.534613481,-4.036257763,-203,3.0250509353,-0.831246291,-1.011206828
36,65,2003,2553,2475,-723,14805,601,78,-122,-337,232731,10.961809708,10.626901303,-3.10434329,-293,2.5805121952,0.3349084047,-0.523831095
36,65,2004,2635,2567,-482,14764,605,68,123,30,232761,11.32135461,11.02919062,-2.070927105,-161,2.5994002045,0.2921639899,0.5284730994
36,65,2005,2531,2442,-1246,14801,618,89,-628,-759,232002,10.891572694,10.508581793,-5.36187261,-220,2.6594199624,0.3829909007,-2.702452648
36,65,2006,2569,2398,-1132,14736,654,171,-478,-407,231595,11.082901744,10.345192053,-4.883551878,-100,2.8214160143,0.7377096918,-2.062135864
36,65,2007,2579,2439,-711,14951,576,140,-135,75,231670,11.134016168,10.529610482,-3.069517447,70,2.4866976784,0.6044056857,-0.582819768
36,65,2008,2685,2414,-1107,14951,583,271,-524,-80,231590,11.591762725,10.421793377,-4.779173682,173,2.516945128,1.1699693477,-2.262228554
36,67,2001,5909,4055,-3081,13027,1039,1854,-2042,-591,457283,12.913631213,8.8618674173,-6.733270903,-403,2.2706486428,4.0517637957,-4.46262226
36,67,2002,5645,4121,-2338,13148,960,1524,-1378,-250,457033,12.348028472,9.0143888984,-5.114205592,-396,2.0999304398,3.3336395732,-3.014275152
36,67,2003,5649,4026,-1733,13188,819,1623,-914,131,457164,12.35838665,8.807729625,-3.791305375,-578,1.7917363544,3.5506570247,-1.999569021
36,67,2004,5655,4019,-2686,13207,803,1636,-1883,-611,456553,12.37801201,8.7970345304,-5.879282097,-364,1.7576558168,3.5809774799,-4.12162628
36,67,2005,5543,4086,-3560,13576,835,1457,-2725,-1653,454900,12.162996885,8.9659038919,-7.811702852,-385,1.8322392926,3.1970929933,-5.97946356
36,67,2006,5343,3980,-3335,13427,926,1363,-2409,-1253,453647,11.761636987,8.761241851,-7.341392355,-207,2.0384195864,3.0003951364,-5.302972769
36,67,2007,5568,3976,-3375,13731,811,1592,-2564,-994,452653,12.287322079,8.7741365994,-7.447864945,-22,1.7896943617,3.5131854794,-5.658170584
36,67,2008,5720,3963,-2557,13731,819,1757,-1738,-20,452633,12.636890441,8.7552441991,-5.649043507,-39,1.8093729495,3.8816462422,-3.839670557
36,69,2001,1160,860,220,2984,69,300,289,487,100773,11.538901516,8.5547028484,2.1884123566,-102,0.6863656937,2.9841986681,2.8747780502
36,69,2002,1132,938,571,3056,68,194,639,739,101512,11.192129916,9.2740440468,5.6455001607,-94,0.6723187582,1.9180858689,6.3178189189
36,69,2003,1151,933,451,3091,57,218,508,582,102094,11.306150113,9.1647593882,4.430124849,-144,0.5599049144,2.1413907252,4.9900297634
36,69,2004,1134,951,373,3072,60,183,433,545,102639,11.077842849,9.2901486326,3.6437701787,-71,0.5861292513,1.7876942164,4.22989943
36,69,2005,1084,946,552,3188,63,138,615,660,103299,10.527440298,9.1872311084,5.3608367567,-93,0.6118346298,1.3402091892,5.9726713865
36,69,2006,1111,918,-197,3144,85,193,-112,35,103334,10.753364661,8.8853184148,-1.906762231,-46,0.822714668,1.8680462462,-1.084047563
36,69,2007,1152,914,74,3156,76,238,150,406,103740,11.126457209,8.8277620561,0.7147203415,18,0.7340371075,2.2986951525,1.448757449
36,69,2008,1183,927,339,3156,78,256,417,735,104475,11.363254328,8.9042576183,3.2562495497,62,0.7492255601,2.4589967101,4.0054751099
36,71,2001,4917,2498,2823,13895,795,2419,3618,5765,348884,14.210921051,7.2196218803,8.1589241665,-272,2.2976779002,6.9912991707,10.456602067
36,71,2002,4916,2543,3686,13627,530,2373,4216,6363,355247,13.963310804,7.2230877493,10.469642723,-226,1.5054016937,6.7402230551,11.975044416
36,71,2003,5070,2493,5028,13982,-25,2577,5003,7431,362678,14.124038026,6.9450151478,14.007034161,-149,-0.069645158,7.1790228784,13.937389003
36,71,2004,5275,2629,1754,13969,912,2646,2666,5026,367704,14.444496168,7.1989725924,4.8029661191,-286,2.4973233185,7.2455235753,7.3002894376
36,71,2005,5203,2425,-432,13845,603,2778,171,2601,370305,14.10009905,6.571735575,-1.17071743,-348,1.6341264131,7.5283634752,0.4634089828
36,71,2006,5356,2431,-229,13945,820,2925,591,3334,373639,14.398933253,6.5354381513,-0.615637736,-182,2.2044670029,7.8634951018,1.5888292667
36,71,2007,5389,2463,-740,13954,562,2926,-178,2766,376405,14.369823637,6.5676146999,-1.973217571,18,1.49857875,7.8022089371,-0.474638821
36,71,2008,5585,2513,-563,13954,653,3072,90,3242,379647,14.774116066,6.6476908996,-1.48931555,80,1.727394412,8.1264251665,0.2380788623
36,73,2001,477,416,-511,3181,17,61,-494,-464,43685,10.861397636,9.4724138716,-11.63558531,-31,0.3870938361,1.3889837648,-11.24849147
36,73,2002,476,389,-350,3139,16,87,-334,-278,43407,10.930969549,8.9330822578,-8.03747761,-31,0.3674275479,1.9978872916,-7.670050062
36,73,2003,465,379,-244,3090,12,86,-232,-193,43214,10.736426502,8.7507648261,-5.633737777,-47,0.277069071,1.9856616756,-5.356668706
36,73,2004,449,365,-143,2917,13,84,-130,-77,43137,10.399416336,8.4538685134,-3.312063555,-31,0.3010966868,1.9455478223,-3.010966868
36,73,2005,453,393,-425,2885,13,60,-412,-390,42747,10.549112757,9.151879279,-9.897070467,-38,0.3027339202,1.3972334777,-9.594336547
36,73,2006,426,335,-315,2891,13,91,-302,-230,42517,9.9924939013,7.857947082,-7.388815913,-19,0.3049352599,2.1345468193,-7.083880653
36,73,2007,470,375,-322,2885,12,95,-310,-209,42308,11.081638668,8.8417329797,-7.592101385,6,0.2829354553,2.2399056882,-7.30916593
36,73,2008,459,366,-283,2885,13,93,-270,-173,42135,10.871238587,8.6685693308,-6.702746231,4,0.3079000036,2.2026692562,-6.394846228
36,75,2001,1399,1042,-593,4333,30,357,-563,-313,122174,11.436232174,8.5179084529,-4.847523716,-107,0.2452372875,2.9183237214,-4.602286429
36,75,2002,1405,1015,-192,4424,25,390,-167,109,122283,11.494864127,8.3041189248,-1.570828407,-114,0.2045349489,3.1907452026,-1.366293459
36,75,2003,1372,1080,311,4554,9,292,320,444,122727,11.199542876,8.8159666952,2.5386718909,-168,0.0734663891,2.3835761806,2.6121382801
36,75,2004,1383,1047,-181,4793,28,336,-153,102,122829,11.264233006,8.5275863754,-1.474205477,-81,0.2280538859,2.7366466305,-1.246151591
36,75,2005,1357,1022,-1066,4867,21,335,-1045,-816,122013,11.084699521,8.3482409064,-8.707656366,-106,0.1715391967,2.7364586141,-8.536117169
36,75,2006,1347,1023,-722,4821,32,324,-690,-418,121595,11.058750123,8.3987389577,-5.927555745,-52,0.2627171521,2.6600111655,-5.664838593
36,75,2007,1406,1072,-501,4986,20,334,-481,-136,121459,11.569445473,8.8210850264,-4.12254067,11,0.1645724818,2.7483604466,-3.957968188
36,75,2008,1418,1020,-497,4986,23,398,-474,-64,121395,11.677798183,8.4001087073,-4.092994145,12,0.1894142159,3.277689476,-3.903579929
36,77,2001,533,545,62,5298,19,-12,81,12,61683,8.6417951586,8.836357151,1.0052369603,-57,0.3080564878,-0.194561992,1.3132934481
36,77,2002,560,596,171,5131,18,-36,189,98,61781,9.0714702261,9.6546361692,2.7700382298,-55,0.2915829716,-0.583165943,3.0616212013
36,77,2003,566,640,474,5433,10,-74,484,358,62139,9.1349257586,10.329244674,7.6500968367,-52,0.161394448,-1.194318915,7.8114912847
36,77,2004,525,622,440,5587,14,-97,454,307,62446,8.4279808966,9.9851507003,7.0634506562,-50,0.2247461572,-1.557169804,7.2881968134
36,77,2005,559,569,108,5703,13,-10,121,53,62499,8.9479370923,9.1080075233,1.7287606547,-58,0.2080915603,-0.160070431,1.936852215
36,77,2006,507,587,-60,5741,15,-80,-45,-154,62345,8.1221364263,9.4037358624,-0.961199577,-29,0.2402998943,-1.281599436,-0.720899683
36,77,2007,580,603,-104,5807,11,-23,-93,-110,62235,9.3112859207,9.6805265693,-1.669609889,6,0.1765933537,-0.369240649,-1.493016536
36,77,2008,590,626,-272,5807,13,-36,-259,-273,61962,9.5010346466,10.080758794,-4.380138007,22,0.2093448312,-0.579724148,-4.170793175
36,79,2001,1151,559,187,2173,244,592,431,928,96995,11.923630751,5.7908858294,1.9372015208,-95,2.5276854068,6.1327449213,4.4648869275
36,79,2002,1218,592,417,2220,235,626,652,1192,98187,12.480659077,6.0661331475,4.2729350043,-86,2.4080089353,6.4145259296,6.6809439395
36,79,2003,1182,622,-54,2183,197,560,143,553,98740,12.004448349,6.3170616523,-0.548426574,-150,2.0007413915,5.6873866966,1.4523148172
36,79,2004,1189,635,-188,2212,179,554,-9,483,99223,12.012345741,6.4153402403,-1.899344827,-62,1.8084187449,5.597005501,-0.090926082
36,79,2005,1103,587,-566,2223,187,516,-379,47,99270,11.113742046,5.9145662567,-5.702971893,-90,1.8841974276,5.1991757896,-3.818774466
36,79,2006,1045,581,-747,2225,190,464,-557,-137,99133,10.534114908,5.8567662787,-7.530128073,-44,1.9152936196,4.6773486288,-5.614834453
36,79,2007,995,606,-482,2202,172,389,-310,74,99207,10.033276192,6.1107189674,-4.860340829,-5,1.7343954825,3.922557225,-3.125945346
36,79,2008,1006,581,-539,2202,174,425,-365,37,99244,10.13852286,5.8553496833,-5.432071393,-23,1.7535814886,4.2831731763,-3.678489904
36,81,2001,31608,16103,-52801,26899,35133,15505,-17668,4685,2234868,14.157956986,7.2129075345,-23.65079369,6848,15.73688632,6.9450494518,-7.913907366
36,81,2002,30735,16134,-58037,26708,33240,14601,-24797,4685,2239553,13.738090359,7.211659341,-25.9416805,14881,14.857788304,6.5264310176,-11.0838922
36,81,2003,30581,15570,-59354,26300,29310,15011,-30044,4685,2244238,13.640689318,6.9450159474,-26.47491821,19718,13.073758344,6.695673371,-13.40115987
36,81,2004,30786,15270,-56974,26298,26351,15516,-30623,6480,2250718,13.698020626,6.7942823022,-25.35019253,21587,11.724697639,6.9037383236,-13.62549489
36,81,2005,30240,15338,-56785,26099,27868,14902,-28917,5858,2256576,13.418250507,6.8058573503,-25.19693634,19873,12.365734296,6.6123931565,-12.83120205
36,81,2006,29945,14469,-51299,25969,27874,15476,-23425,8085,2264661,13.246374831,6.4004607589,-22.69246226,16034,12.330253866,6.8459140717,-10.3622084
36,81,2007,30340,15271,-37781,25938,25442,15069,-12339,13118,2277779,13.35845933,6.7236991573,-16.63467211,10388,11.201909106,6.6347601729,-5.432763008
36,81,2008,30226,15785,-22262,25941,25449,14441,3187,15228,2293007,13.225734042,6.9069083523,-9.740994218,-2400,11.135502734,6.3188256899,1.3945085156
36,83,2001,1753,1497,-748,5143,260,256,-488,-376,152245,11.500134485,9.8207081144,-4.907073928,-144,1.705667408,1.6794263709,-3.20140652
36,83,2002,1647,1493,-303,4959,247,154,-56,-41,152204,10.819546131,9.8078824368,-1.990481164,-139,1.6226034574,1.0116636941,-0.367877707
36,83,2003,1731,1472,415,5296,214,259,629,699,152903,11.346838978,9.6490739314,2.7203571206,-189,1.4027865634,1.6977650464,4.123143684
36,83,2004,1739,1448,553,5206,210,291,763,943,153846,11.338260271,9.4409435728,3.6055537263,-111,1.3691976176,1.8973166987,4.9747513439
36,83,2005,1779,1436,-256,5170,218,343,-38,161,154007,11.557464114,9.329127863,-1.66313143,-144,1.416260358,2.2283362514,-0.246871072
36,83,2006,1733,1385,88,5239,232,348,320,594,154601,11.231076317,8.9757880547,0.5703027789,-74,1.5035255081,2.2552882621,2.073828287
36,83,2007,1746,1444,-156,5153,205,302,49,354,154955,11.280672964,9.3294912714,-1.007895179,3,1.3244776389,1.9511816925,0.31658246
36,83,2008,1856,1401,-380,5153,208,455,-172,306,155261,11.965856049,9.032416123,-2.449905872,23,1.3410011089,2.9334399257,-1.108904763
36,85,2001,5706,3506,306,9222,2029,2200,2335,7642,453054,12.701649256,7.8044133,0.6811610011,3107,4.5165871608,4.8972359555,5.1977481619
36,85,2002,5726,3734,713,9178,1876,1992,2589,7079,460133,12.540695389,8.177952599,1.5615640608,2498,4.1086874868,4.3627427898,5.6702515476
36,85,2003,5861,3581,127,9233,1647,2280,1774,6406,466539,12.649567485,7.7287324965,0.2740991419,2352,3.5546558005,4.920834988,3.8287549424
36,85,2004,5969,3561,-2173,9242,1568,2408,-605,4573,471112,12.731815996,7.5955766058,-4.634986791,2770,3.3445279747,5.1362393897,-1.290458817
36,85,2005,5689,3592,-2692,9065,1615,2097,-1077,3902,475014,12.025882388,7.5930689993,-5.690573983,2882,3.413921613,4.4328133885,-2.27665237
36,85,2006,5707,3405,-2609,9122,1662,2302,-947,3862,478876,11.965740285,7.1391879567,-5.470232417,2507,3.4846785269,4.8265523278,-1.98555389
36,85,2007,5897,3679,-1317,9175,1516,2218,199,3978,482854,12.263317147,7.6507959614,-2.738814428,1561,3.1526519917,4.6125211858,0.4138375636
36,85,2008,6006,3664,634,9175,1526,2342,2160,4553,487407,12.380173994,7.5526069789,1.3068648539,51,3.1455453739,4.8275670155,4.4524102278
36,87,2001,4552,2071,-2799,7591,1564,2481,-1235,1247,288656,15.803772144,7.1901608325,-9.71765339,1,5.4299428016,8.6136113112,-4.287710588
36,87,2002,4464,2098,-2283,7764,1475,2366,-808,1544,290200,15.423525022,7.248780353,-7.887972138,-14,5.0962588278,8.1747446688,-2.79171331
36,87,2003,4551,2091,-2986,7690,1318,2460,-1668,748,290948,15.662103285,7.1961015094,-10.27621191,-44,4.5358497319,8.4660017758,-5.74036218
36,87,2004,4554,2081,-3688,7754,1182,2473,-2506,1845,292793,15.60281015,7.1298743792,-12.63574085,1878,4.049741238,8.4729357712,-8.585999613
36,87,2005,4648,1912,-4369,7853,1258,2736,-3111,1843,294636,15.824891178,6.5097228771,-14.87498915,2218,4.2830708052,9.3151683012,-10.59191834
36,87,2006,4521,1952,-4537,7785,1261,2569,-3276,1291,295927,15.31081358,6.6106410324,-15.36499916,1998,4.2705011997,8.7001725472,-11.09449796
36,87,2007,4652,2028,-3322,7749,1163,2624,-2159,1078,297005,15.691512686,6.8405820566,-11.20533215,613,3.9228781715,8.8509306295,-7.282453974
36,87,2008,4666,2136,-1970,7749,1165,2530,-805,1540,298545,15.669549156,7.1732012425,-6.615733356,-185,3.9123499286,8.4963479137,-2.703383427
36,89,2001,1240,1037,-875,11402,84,203,-791,-675,111192,11.118134664,9.2979884246,-7.845457928,-87,0.7531639611,1.8201462393,-7.092293967
36,89,2002,1239,1132,-616,11382,75,107,-541,-523,110669,11.169155462,10.204587557,-5.553026444,-89,0.6760989989,0.9645679051,-4.876927446
36,89,2003,1198,1031,-361,11468,49,167,-312,-299,110370,10.839716068,9.3286705061,-3.266391904,-154,0.4433606739,1.5110455621,-2.82303123
36,89,2004,1262,1067,-339,11342,76,195,-263,-144,110226,11.441730584,9.6737928158,-3.073491813,-76,0.6890424124,1.7679377686,-2.384449401
36,89,2005,1208,1048,-280,11359,68,160,-212,-150,110076,10.966763806,9.5142123086,-2.541965121,-98,0.6173343864,1.4525514975,-1.924630734
36,89,2006,1258,1020,-433,11439,74,238,-359,-170,109906,11.437299415,9.2734860125,-3.936685729,-49,0.6727823186,2.1638134029,-3.26390341
36,89,2007,1279,1062,-412,11491,60,217,-352,-134,109772,11.644315771,9.6686969109,-3.750944564,1,0.5462540628,1.9756188603,-3.204690502
36,89,2008,1310,1041,-409,11491,64,269,-345,-71,109701,11.937687096,9.486360509,-3.727109941,5,0.5832152474,2.4513265869,-3.143894693
36,91,2001,2477,1429,1507,4370,146,1048,1653,2518,204076,12.212980174,7.0457604639,7.4303436102,-183,0.7198607612,5.1672197104,8.1502043714
36,91,2002,2358,1538,1815,4364,88,820,1903,2559,206635,11.482526643,7.48945122,8.8383315762,-164,0.4285251673,3.9930754229,9.2668567435
36,91,2003,2511,1426,2172,4368,-41,1085,2131,3043,209678,12.063039108,6.8506148018,10.434456767,-173,-0.196967186,5.2124243058,10.237489581
36,91,2004,2385,1471,1111,4398,184,914,1295,2046,211724,11.319357763,6.9814571359,5.2728748321,-163,0.8732753997,4.337900627,6.1461502318
36,91,2005,2362,1610,859,4243,112,752,971,1522,213246,11.116078782,7.5770054357,4.0426383039,-201,0.5270960303,3.5390733464,4.5697343342
36,91,2006,2373,1502,382,4511,154,871,536,1306,214552,11.09402101,7.022005713,1.7858896021,-101,0.7199659652,4.0720152969,2.5058555673
36,91,2007,2393,1520,97,4550,95,873,192,1079,215631,11.125497753,7.0667599603,0.4509708659,14,0.4416724975,4.058737793,0.8926433634
36,91,2008,2467,1539,458,4550,117,928,575,1560,217191,11.399605381,7.1114684559,2.1163434391,57,0.5406379528,4.2881369246,2.6569813919
36,93,2001,1700,1571,-765,4634,242,129,-523,-525,145953,11.626674327,10.744414922,-5.232003447,-131,1.6550912865,0.8822594048,-3.57691216
36,93,2002,1692,1559,353,4577,226,133,579,581,146534,11.56974498,10.660302851,2.4137824929,-131,1.5453678283,0.9094421291,3.9591503212
36,93,2003,1807,1582,133,4604,185,225,318,338,146872,12.317403189,10.783692222,0.9065935939,-205,1.2610512396,1.5337109671,2.1676448334
36,93,2004,1881,1619,382,4766,194,262,576,729,147601,12.775364804,10.995914736,2.5944653669,-109,1.3176080659,1.7794500684,3.9120734329
36,93,2005,1793,1474,611,4787,199,319,810,982,148583,12.107338681,9.9532722902,4.1258136834,-147,1.3437592848,2.1540663912,5.4695729682
36,93,2006,1870,1516,969,4816,223,354,1192,1472,150055,12.523523463,10.152760198,6.4894621582,-74,1.4934469157,2.3707632652,7.9829090739
36,93,2007,1896,1506,-196,4745,199,390,3,418,150473,12.617792685,10.022360645,-1.304370974,25,1.3243358356,2.5954320396,0.0199648618
36,93,2008,1989,1512,209,4745,203,477,412,954,151427,13.176548526,10.016561775,1.3845644253,65,1.3448161643,3.1599867506,2.7293805896
36,95,2001,307,305,193,1973,4,2,197,172,31762,9.6918802879,9.6287410027,6.0929410279,-27,0.1262785705,0.0631392853,6.2192195984
36,95,2002,297,317,-91,1745,3,-20,-88,-135,31627,9.3707110066,10.001735317,-2.871160611,-27,0.0946536465,-0.63102431,-2.776506965
36,95,2003,295,288,108,1866,-1,7,107,77,31704,9.3161326996,9.0950719237,3.4106519714,-37,-0.031580111,0.2210607759,3.3790718605
36,95,2004,296,298,206,1907,2,-2,208,178,31882,9.3102255213,9.3731324505,6.4794137074,-28,0.0629069292,-0.062906929,6.5423206366
36,95,2005,293,301,85,1757,1,-8,86,49,31931,9.1830818172,9.4338144265,2.6640339743,-29,0.0313415762,-0.250732609,2.6953755504
36,95,2006,279,286,-10,1757,1,-7,-9,-31,31900,8.7418339052,8.9611630712,-0.31332738,-15,0.031332738,-0.219329166,-0.281994642
36,95,2007,305,300,37,1688,0,5,37,26,31926,9.5572337292,9.4005577664,1.1594021245,-16,0,0.1566759628,1.1594021245
36,95,2008,316,293,-54,1688,2,23,-52,-16,31910,9.9003696973,9.1797731687,-1.691835328,13,0.0626605677,0.7205965286,-1.62917476
36,97,2001,212,188,-35,627,1,24,-34,-28,19253,11.00326984,9.7576166502,-1.816577568,-18,0.0519022162,1.2456531894,-1.764675352
36,97,2002,209,167,-4,616,1,42,-3,18,19271,10.850378985,8.6699200498,-0.207662756,-21,0.0519156889,2.1804589347,-0.155747067
36,97,2003,193,206,38,625,0,-13,38,-2,19269,10.015568241,10.690192008,1.9719771666,-27,0,-0.674623768,1.9719771666
36,97,2004,179,191,-60,634,3,-12,-57,-81,19188,9.3090984736,9.9331721143,-3.120368203,-12,0.1560184102,-0.624073641,-2.964349793
36,97,2005,186,175,-131,630,1,11,-130,-135,19053,9.7277790853,9.1524803222,-6.85128527,-16,0.0522998876,0.5752987631,-6.798985382
36,97,2006,135,193,9,630,2,-58,11,-56,18997,7.0959264126,10.144546649,0.4730617608,-9,0.1051248357,-3.048620237,0.5781865966
36,97,2007,180,171,-25,630,-1,9,-26,-25,18972,9.4814190524,9.0073480998,-1.316863757,-8,-0.05267455,0.4740709526,-1.369538308
36,97,2008,184,187,-83,630,1,-3,-82,-84,18888,9.7200211305,9.8784997359,-4.384574749,1,0.0528262018,-0.158478605,-4.331748547
36,99,2001,359,316,1225,2941,24,43,1249,1291,34634,10.562396105,9.2972623093,36.041602307,-1,0.706121188,1.2651337953,36.747723495
36,99,2002,362,315,57,3003,24,47,81,96,34730,10.437691021,9.0825211925,1.6435038348,-32,0.6920016147,1.3551698287,2.3355054495
36,99,2003,391,354,-20,2823,20,37,0,-14,34716,11.260547764,10.194971633,-0.575987098,-51,0.5759870979,1.0655761311,0
36,99,2004,334,320,-78,2912,21,14,-57,-67,34649,9.6302169682,9.2265551791,-2.248972825,-24,0.6054926836,0.4036617891,-1.643480141
36,99,2005,367,337,-339,2976,21,30,-318,-314,34335,10.64014844,9.7703815377,-9.828365998,-26,0.6088368317,0.8697669025,-9.219529166
36,99,2006,357,316,-202,2955,23,41,-179,-155,34180,10.421075677,9.2242574619,-5.89651901,-17,0.6713858279,1.196818215,-5.225133183
36,99,2007,370,335,21,3048,17,35,38,61,34241,10.815392935,9.7923152249,0.613846626,-12,0.4969234592,1.0230777101,1.1107700852
36,99,2008,380,324,-212,3048,19,56,-193,-155,34086,11.12298213,9.4838058161,-6.205453188,-18,0.5561491065,1.6391763139,-5.649304082
36,101,2001,1189,1065,82,1517,53,124,135,162,98939,12.027352364,10.77302798,0.8294725768,-97,0.5361225192,1.2543243845,1.365595096
36,101,2002,1151,1053,17,1555,49,98,66,68,99007,11.62943429,10.639265254,0.1717640164,-96,0.495084518,0.990169036,0.6668485344
36,101,2003,1157,1030,-810,1584,38,127,-772,-730,98277,11.729283672,10.441799639,-8.211512338,-85,0.385231443,1.2874840332,-7.826280895
36,101,2004,1098,1001,-564,1584,44,97,-520,-502,97775,11.20110991,10.211576521,-5.753575582,-79,0.4488605064,0.9895333891,-5.304715076
36,101,2005,1130,1012,-500,1590,42,118,-458,-430,97345,11.582615826,10.373103731,-5.125051251,-90,0.430504305,1.2095120951,-4.694546945
36,101,2006,1100,939,-661,1485,43,161,-618,-501,96844,11.329169005,9.6709906328,-6.807800648,-44,0.4428675157,1.6581783726,-6.364933132
36,101,2007,1126,989,-404,1480,34,137,-370,-224,96620,11.640408551,10.224124385,-4.176487615,9,0.3514865815,1.4162841666,-3.825001034
36,101,2008,1167,981,-288,1480,36,186,-252,-47,96573,12.081183066,10.155647461,-2.981474484,19,0.3726843105,1.9255356043,-2.608790174
36,103,2001,20220,11213,2505,29163,4535,9007,7040,25142,1448806,14.078476015,7.8072181781,1.744143542,9095,3.1575612626,6.2712578373,4.9017048046
36,103,2002,19980,11594,-841,29405,4279,8386,3438,19083,1467889,13.700438339,7.9500941991,-0.576680112,7259,2.9341429255,5.7503441395,2.3574628132
36,103,2003,19936,11552,-501,30072,3718,8384,3217,18367,1486256,13.49696782,7.820875414,-0.339184434,6766,2.5171411694,5.6760924058,2.1779567354
36,103,2004,19862,11548,-6651,29969,3440,8314,-3211,13150,1499406,13.30492199,7.7356378585,-4.455293332,8047,2.3043465737,5.569284132,-2.150946758
36,103,2005,19314,11336,-14128,29995,3576,7978,-10552,5041,1504447,12.859484136,7.5476396481,-9.406585475,7615,2.3809420767,5.3118444877,-7.025643399
36,103,2006,18906,11097,-15447,30352,3715,7809,-11732,3745,1508192,12.551122122,7.3669629849,-10.25479654,7668,2.4662762448,5.1841591376,-7.788520297
36,103,2007,18444,11311,-14709,30681,3339,7133,-11370,3540,1511732,12.214876931,7.49091699,-9.741304748,7777,2.2113139271,4.7239599407,-7.529990821
36,103,2008,18019,11428,-9482,30681,3351,6591,-6131,492,1512224,11.917501445,7.5583110336,-6.27125527,32,2.2163020891,4.3591904115,-4.054953181
36,105,2001,847,770,-377,5029,126,77,-251,-252,73980,11.429573854,10.390521685,-5.087307371,-78,1.7002671848,1.0390521685,-3.387040186
36,105,2002,785,737,-47,4881,119,48,72,46,74026,10.607678067,9.959055714,-0.635109387,-74,1.6080429172,0.6486223531,0.9729335297
36,105,2003,869,685,487,4865,95,184,582,696,74722,11.684190712,9.2102078683,6.5479871998,-70,1.2773280985,2.4739828435,7.8253152984
36,105,2004,877,746,415,4878,95,131,510,577,75299,11.691696496,9.9452743283,5.5325587751,-64,1.2664893582,1.7464221676,6.7990481333
36,105,2005,880,699,31,4784,95,181,126,240,75539,11.668147284,9.2682215357,0.4110370066,-67,1.2596295363,2.3999257482,1.6706665429
36,105,2006,922,660,43,4867,105,262,148,372,75911,12.175635523,8.7157477715,0.567844173,-38,1.3865962364,3.4598877517,1.9544404094
36,105,2007,950,686,168,4890,89,264,257,507,76418,12.473002514,9.006820763,2.2057520236,-14,1.1685233934,3.4661817513,3.374275417
36,105,2008,981,668,-624,4890,91,313,-533,-229,76189,12.856553107,8.7545132268,-8.177868643,-9,1.1926058438,4.1020398802,-6.985262799
36,107,2001,598,403,-444,520,20,195,-424,-272,51454,11.591393681,7.8115913937,-8.606319054,-43,0.3876720295,3.7798022873,-8.218647025
36,107,2002,596,415,-17,528,20,181,3,131,51585,11.568435253,8.0552023991,-0.329972146,-53,0.3882025253,3.5132328536,0.0582303788
36,107,2003,589,433,-405,520,17,156,-388,-289,51296,11.450121986,8.4174920539,-7.873173861,-57,0.3304789028,3.0326299317,-7.542694958
36,107,2004,587,452,-504,528,16,135,-488,-397,50899,11.487841871,8.8458339449,-9.863496257,-44,0.3131268653,2.642007926,-9.550369392
36,107,2005,555,369,-365,495,18,186,-347,-191,50708,10.924444182,7.2632791048,-7.184544372,-30,0.3543062978,3.6611650772,-6.830238074
36,107,2006,540,408,-334,470,18,132,-316,-210,50498,10.671304073,8.0627630773,-6.600399186,-26,0.3557101358,2.6085409956,-6.24468905
36,107,2007,611,445,-265,479,16,166,-249,-125,50373,12.114482854,8.8231503604,-5.254235608,-42,0.3172368669,3.291332494,-4.936998741
36,107,2008,613,433,-335,479,16,180,-319,-202,50171,12.193666454,8.613144494,-6.663749204,-63,0.3182686187,3.5805219605,-6.345480586
36,109,2001,828,610,69,12521,730,218,799,916,97572,8.5260621538,6.2812776737,0.7105051795,-101,7.5169388554,2.2447844801,8.2274440348
36,109,2002,867,576,-40,12824,692,291,652,846,98418,8.847390173,5.8778509108,-0.408184091,-97,7.0615847747,2.9695392622,6.6534006837
36,109,2003,891,585,93,13132,608,306,701,854,99272,9.0141130052,5.9183570236,0.940867014,-153,6.1510445647,3.0957559816,7.0919115787
36,109,2004,954,556,-289,12976,559,398,270,598,99870,9.5811029316,5.5839551677,-2.902451517,-70,5.6140844222,3.9971477639,2.7116329052
36,109,2005,914,633,-761,13226,586,281,-175,17,99887,9.1511186091,6.3377003059,-7.619257398,-89,5.8671285612,2.8134183032,-1.752128837
36,109,2006,808,546,-629,13245,592,262,-37,180,100067,8.0818588275,5.4612560889,-6.291447033,-45,5.9213619132,2.6206027386,-0.37008512
36,109,2007,959,587,-562,13211,530,372,-32,334,100401,9.5676117884,5.8562962667,-5.606879901,-6,5.2876269529,3.7113155217,-0.319252948
36,109,2008,1017,560,-250,13211,532,457,282,735,101136,10.092439602,5.5572922094,-2.480934022,-4,5.2794275989,4.5351473923,2.7984935769
36,111,2001,1746,1610,257,11444,207,136,464,431,178312,9.803673851,9.0400428981,1.4430379036,-169,1.1622912298,0.7636309529,2.6053291334
36,111,2002,1805,1646,1231,11499,191,159,1422,1448,179760,10.081771264,9.1936817176,6.8757121473,-133,1.0668245493,0.8880895462,7.9425366965
36,111,2003,1785,1562,377,11302,155,223,532,522,180282,9.9155098572,8.6767654885,2.0942001211,-233,0.8610106599,1.2387443687,2.955210781
36,111,2004,1921,1520,299,11771,178,401,477,752,181034,10.633351415,8.4136877415,1.6550609439,-126,0.9852871171,2.2196636739,2.640348061
36,111,2005,1728,1569,230,11706,175,159,405,387,181421,9.5349767557,8.657626464,1.2691230636,-177,0.9656371136,0.8773502918,2.2347601771
36,111,2006,1831,1436,-277,11761,196,395,-81,231,181652,10.086125931,7.9102549625,-1.525863945,-83,1.0796726829,2.1758709681,-0.446191262
36,111,2007,1888,1508,-632,11727,169,380,-463,-59,181593,10.395187821,8.3029360349,-3.479745076,24,0.9305014522,2.092251786,-2.549243623
36,111,2008,1883,1536,-516,11727,174,347,-342,77,181670,10.367144466,8.4566828992,-2.840916911,72,0.9579836097,1.9104615664,-1.882933302
36,113,2001,642,648,239,1277,29,-6,268,201,63566,10.115732169,10.210271722,3.7658255273,-61,0.4569411728,-0.094539553,4.2227667
36,113,2002,665,552,319,1291,28,113,347,410,63976,10.427937464,8.6559721504,5.0022737608,-50,0.4390710511,1.7719653134,5.4413448119
36,113,2003,657,625,514,1272,25,32,539,518,64494,10.22806881,9.7298980307,8.0018681404,-53,0.3891959212,0.4981707792,8.3910640616
36,113,2004,637,594,237,1280,29,43,266,263,64757,9.8567902763,9.1914182482,3.6672830384,-46,0.4487392747,0.6653720281,4.1160223132
36,113,2005,642,587,570,1355,28,55,598,593,65350,9.8688002951,9.0233423259,8.7620189536,-60,0.4304149661,0.8454579692,9.1924339198
36,113,2006,639,636,372,1369,30,3,402,374,65724,9.7502174344,9.7044417657,5.6761829196,-31,0.4577566871,0.0457756687,6.1339396066
36,113,2007,635,653,173,1349,21,-18,194,177,65901,9.648622982,9.9221272555,2.628679962,1,0.3190883191,-0.273504274,2.9477682811
36,113,2008,696,636,-46,1349,23,60,-23,70,65971,10.555690366,9.645717059,-0.697646202,33,0.3488231012,0.9099733074,-0.348823101
36,115,2001,607,591,138,3711,12,16,150,103,61087,9.9450319896,9.682889466,2.2609792662,-63,0.1966068927,0.2621425236,2.4575861589
36,115,2002,641,609,-43,3700,9,32,-34,-63,61024,10.498644676,9.974531369,-0.704277256,-61,0.1474068675,0.5241133067,-0.556870388
36,115,2003,599,568,388,3668,0,31,388,354,61378,9.7874217742,9.280894103,6.3397656901,-65,0,0.5065276711,6.3397656901
36,115,2004,646,649,659,3822,11,-3,670,607,61985,10.473156457,10.521793406,10.683916571,-60,0.1783354815,-0.048636949,10.862252053
36,115,2005,651,558,54,3760,7,93,61,94,62079,10.494583441,8.995357235,0.8705184421,-60,0.1128449832,1.4992262058,0.9833634253
36,115,2006,589,546,189,3796,9,43,198,213,62292,9.4716614002,8.7801818752,3.039293726,-28,0.1447282727,0.691479525,3.1840219987
36,115,2007,695,602,162,3790,5,93,167,277,62569,11.132379206,9.6427227077,2.5948855127,17,0.080089059,1.489656498,2.6749745717
36,115,2008,707,626,107,3790,7,81,114,235,62804,11.278345417,9.9862011757,1.7069065907,40,0.1116667863,1.2921442416,1.818573377
36,117,2001,1161,813,-597,1969,35,348,-562,-292,93704,12.370804475,8.662759723,-6.361214704,-78,0.3729355354,3.7080447523,-5.988279169
36,117,2002,1064,789,-827,1658,35,275,-792,-585,93119,11.390460489,8.4464974869,-8.853299647,-68,0.3746862003,2.9439630024,-8.478613447
36,117,2003,1145,825,-277,1740,29,320,-248,-49,93070,12.29933025,8.8619628442,-2.975471161,-121,0.3115114212,3.4373674062,-2.66395974
36,117,2004,1168,841,-708,1704,30,327,-678,-429,92641,12.578684084,9.0570833176,-7.624750284,-78,0.3230826392,3.5216007668,-7.301667645
36,117,2005,1076,799,-650,1610,30,277,-620,-425,92216,11.641430944,8.644519818,-7.032462931,-82,0.3245752122,2.9969111259,-6.707887719
36,117,2006,1062,716,-817,1620,40,346,-777,-471,91745,11.545925495,7.78425862,-8.882317448,-40,0.4348747832,3.761666875,-8.447442664
36,117,2007,1152,826,-620,1698,34,326,-586,-254,91491,12.573948351,9.0156956057,-6.767229147,6,0.3711061145,3.5582527451,-6.396123033
36,117,2008,1135,773,-308,1698,36,362,-272,73,91564,12.400644615,8.4455491519,-3.365108847,-17,0.3933244107,3.9550954631,-2.971784436
36,119,2001,12972,7503,-6467,23876,7256,5469,789,9368,935039,13.943064744,8.0646634887,-6.95111006,3110,7.7991734338,5.8784012554,0.8480633737
36,119,2002,12777,7435,-8390,24217,6859,5342,-1531,6332,941371,13.618558844,7.9247072868,-8.942608492,2521,7.3107689684,5.693851557,-1.631839523
36,119,2003,12898,7368,-11495,24063,6062,5530,-5433,2717,944088,13.681549161,7.8156035215,-12.19331738,2620,6.4302644608,5.8659456398,-5.763052922
36,119,2004,12754,7340,-10643,24786,5435,5414,-5208,2782,946870,13.489458782,7.7632607387,-11.25672807,2576,5.7484090075,5.7261980435,-5.508319064
36,119,2005,12101,7133,-12454,25285,5751,4968,-6703,849,947719,12.774274526,7.5298653164,-13.14691471,2584,6.0709737046,5.2444092096,-7.075941009
36,119,2006,11925,6829,-11399,25237,5793,5096,-5606,-520,947199,12.58629661,7.2076997527,-12.03112747,-10,6.1142487432,5.3785968575,-5.916878725
36,119,2007,11931,7219,-7492,25406,5269,4712,-2223,2370,949569,12.580347201,7.6118956035,-7.899753686,-119,5.5557664406,4.9684515977,-2.343987246
36,119,2008,11873,7268,-5323,25426,5272,4605,-51,4374,953943,12.474835987,7.6364110129,-5.592820008,-180,5.5392348459,4.8384249745,-0.053585163
36,121,2001,425,328,-465,4436,9,97,-456,-392,42972,9.845255745,7.5982209044,-10.77186805,-33,0.2084877687,2.2470348406,-10.56338028
36,121,2002,436,364,-224,4299,9,72,-215,-180,42792,10.16743622,8.4884100555,-5.223636957,-37,0.2098782706,1.6790261648,-5.013758687
36,121,2003,444,387,-159,4321,3,57,-156,-153,42639,10.394353338,9.059943112,-3.722302209,-54,0.0702321171,1.3344102258,-3.652070092
36,121,2004,422,368,-221,4317,7,54,-214,-192,42447,9.9193756905,8.6500716922,-5.194744141,-32,0.1645394072,1.2693039983,-5.030204734
36,121,2005,427,375,-195,4348,5,52,-190,-177,42270,10.080621363,8.8530047098,-4.603562449,-39,0.1180400628,1.2276166531,-4.485522386
36,121,2006,383,338,-237,4345,6,45,-231,-205,42065,9.0828244501,8.0156518646,-5.620442284,-19,0.1422896781,1.0671725855,-5.478152606
36,121,2007,427,362,-320,4339,3,65,-317,-239,41826,10.179876268,8.6302463912,-7.628947086,13,0.0715213789,1.5496298769,-7.557425707
36,121,2008,446,366,-272,4339,5,80,-267,-174,41652,10.685450059,8.7687774024,-6.516687031,13,0.119792041,1.9166726563,-6.39689499
36,123,2001,298,273,-120,1322,12,25,-108,-103,24637,12.070397148,11.057779938,-4.86056261,-20,0.486056261,1.0126172104,-4.374506349
36,123,2002,291,262,-149,1284,12,29,-137,-128,24509,11.842265902,10.662108819,-6.063565702,-20,0.4883408619,1.180157083,-5.57522484
36,123,2003,298,235,58,1237,9,63,67,100,24609,12.134044546,9.5687935177,2.3616596767,-30,0.3664644326,2.5652510281,2.7281241093
36,123,2004,257,232,4,1336,8,25,12,22,24631,10.43866775,9.4232331438,0.162469537,-15,0.3249390739,1.015434606,0.4874086109
36,123,2005,267,229,-20,1395,9,38,-11,2,24633,10.839558298,9.2968496265,-0.811951932,-25,0.3653783696,1.5427086716,-0.446573563
36,123,2006,300,238,-205,1423,8,62,-197,-145,24488,12.214735042,9.6903564667,-8.346735612,-10,0.3257262678,2.5243785754,-8.021009344
36,123,2007,323,235,42,1392,8,88,50,145,24633,13.151198062,9.5682091163,1.7100629059,7,0.3257262678,3.5829889457,2.0357891737
36,123,2008,309,252,-61,1392,7,57,-54,19,24652,12.539312164,10.226235163,-2.475398194,16,0.2840620879,2.3130770011,-2.191336106
37,0,2001,119914,71905,46295,257529,29010,48009,75305,121089,8199913,14.732592584,8.8342234413,5.6877876951,-2225,3.5641585708,5.8983691425,9.2519462659
37,0,2002,118074,71162,43785,262903,23031,46912,66816,111350,8311263,14.302312567,8.6198584522,5.3036803678,-2378,2.7897467752,5.6824541147,8.0934271429
37,0,2003,117443,72244,47499,271177,9256,45199,56755,98397,8409660,14.047430276,8.6411497738,5.6813849331,-3557,1.107115917,5.4062805026,6.7885008501
37,0,2004,119027,73685,44338,271262,28941,45342,73279,113539,8523199,14.058700896,8.7031965482,5.2369183491,-5082,3.4183240999,5.3555043481,8.655242449
37,0,2005,121614,74541,73418,270596,23342,47073,96760,137862,8661061,14.154115452,8.6754972283,8.5447962263,-5971,2.7166721174,5.4786182239,11.261468344
37,0,2006,124801,73787,110632,274467,26620,51014,137252,184282,8845343,14.257753905,8.4297152059,12.639031979,-3984,3.0411728188,5.8280386994,15.680204798
37,0,2007,131915,73552,116245,282129,20114,58363,136359,196251,9041594,14.749870254,8.2241023156,12.997753612,1529,2.2490155805,6.5257679389,15.246769193
37,0,2008,133646,74635,98074,282129,22502,59011,120576,180820,9222414,14.634903795,8.1729048739,10.739592317,1233,2.4640812685,6.4619989216,13.203673586
37,1,2001,1878,1363,876,3936,688,515,1564,1962,133464,14.175403637,10.288112437,6.6121691085,-117,5.1931191172,3.8872911996,11.805288226
37,1,2002,1874,1247,673,4004,653,627,1326,1844,135308,13.944904975,9.2792403971,5.0079621389,-109,4.8591371125,4.6656645782,9.8670992514
37,1,2003,1827,1358,-105,4001,574,469,469,742,136050,13.465606321,10.008918108,-0.773885421,-196,4.2305736334,3.4566882126,3.4566882126
37,1,2004,1834,1314,773,4001,516,520,1289,1697,137747,13.39678667,9.5983520638,5.6465191364,-112,3.7692158789,3.7984346067,9.4157350154
37,1,2005,1793,1366,885,3998,549,427,1434,1733,139480,12.93524801,9.8547399784,6.3846595029,-128,3.9606531831,3.0805080313,10.345312686
37,1,2006,1849,1320,1007,3840,548,529,1555,2012,141492,13.16145381,9.3959540452,7.167974033,-72,3.9007445582,3.7654997651,11.068718591
37,1,2007,1992,1373,2124,3870,497,619,2621,3298,144790,13.916348216,9.5919408136,14.838515869,58,3.4721009354,4.3244074025,18.310616804
37,1,2008,2038,1349,1997,3870,499,689,2496,3263,148053,13.918720953,9.2131278535,13.63870743,78,3.407969458,4.7055930994,17.046676888
37,3,2001,439,298,150,236,49,141,199,310,33982,12.9777988,8.8095308481,4.4343276081,-30,1.4485470187,4.1682679516,5.8828746268
37,3,2002,443,268,197,233,48,175,245,387,34369,12.962502377,7.8418750274,5.7643633597,-33,1.4045149303,5.12062735,7.16887829
37,3,2003,362,273,130,242,29,89,159,205,34574,10.501428716,7.9195857447,3.771231307,-43,0.8412746762,2.5818429717,4.6125059832
37,3,2004,435,304,478,733,30,131,508,603,35177,12.472939456,8.7167209072,13.70589669,-36,0.8602027211,3.7562185488,14.566099411
37,3,2005,417,312,310,1185,30,105,340,413,35590,11.785154097,8.8176692526,8.7611457318,-32,0.8478528128,2.9674848446,9.6089985445
37,3,2006,414,320,232,1184,31,94,263,340,35930,11.577181208,8.9485458613,6.4876957494,-17,0.8668903803,2.6286353468,7.3545861298
37,3,2007,435,319,216,1173,28,116,244,368,36298,12.045190231,8.8331395027,5.9810599767,8,0.7753225896,3.2120507282,6.7563825663
37,3,2008,436,294,53,1173,30,142,83,239,36537,11.972266081,8.0730418068,1.4553442713,14,0.8237797762,3.899224274,2.2791240475
37,5,2001,121,141,36,218,50,-20,86,55,10743,11.292053567,13.158508702,3.3596192432,-11,4.6661378377,-1.866455135,8.0257570809
37,5,2002,102,141,-18,221,48,-39,30,-18,10725,9.5025153717,13.135830073,-1.676914477,-9,4.4717719396,-3.633314701,2.7948574623
37,5,2003,88,145,33,229,43,-57,76,7,10732,8.2024514145,13.515402899,3.0759192804,-12,4.0080160321,-5.312951484,7.0839353125
37,5,2004,95,126,-4,224,40,-31,36,-2,10730,8.852856211,11.741682975,-0.37275184,-7,3.7275184046,-2.888826764,3.3547665642
37,5,2005,93,141,-27,205,42,-48,15,-41,10689,8.6838787992,13.16588076,-2.521126103,-8,3.9217517158,-4.482001961,1.4006256128
37,5,2006,108,143,109,223,41,-35,150,110,10799,10.052122115,13.309754281,10.145197319,-5,3.8160833954,-3.257632167,13.961280715
37,5,2007,107,124,62,219,32,-17,94,75,10874,9.87403682,11.442809025,5.7214045125,-2,2.9529829742,-1.568772205,8.6743874867
37,5,2008,106,145,85,219,31,-39,116,77,10951,9.7136311569,13.287514318,7.7892325315,0,2.8407789233,-3.573883162,10.630011455
37,7,2001,356,283,-52,1454,12,73,-40,7,25318,14.063086373,11.179363606,-2.054158684,-26,0.4740366193,2.8837227676,-1.580122064
37,7,2002,286,301,-18,1456,12,-15,-6,-43,25275,11.305911885,11.898879292,-0.711560888,-22,0.4743739252,-0.592967407,-0.237186963
37,7,2003,355,292,-245,1464,7,63,-238,-197,25078,14.100450817,11.598117292,-9.731297043,-22,0.2780370584,2.5023335253,-9.453259985
37,7,2004,329,295,392,2086,6,34,398,404,25482,13.014240506,11.669303797,15.506329114,-28,0.2373417722,1.3449367089,15.743670886
37,7,2005,285,266,-3,2419,7,19,4,-2,25480,11.184804364,10.43915074,-0.117734783,-25,0.2747144932,0.7456536243,0.1569797104
37,7,2006,321,272,-211,2425,6,49,-205,-166,25314,12.639288105,10.709926369,-8.308067882,-10,0.2362483758,1.9293617356,-8.071819506
37,7,2007,316,289,-135,2426,6,27,-129,-96,25218,12.506926304,11.438296525,-5.343148896,6,0.2374732843,1.0686297791,-5.105675611
37,7,2008,312,293,-93,2426,5,19,-88,-56,25162,12.385867408,11.631599841,-3.691941247,13,0.1984914649,0.7542675665,-3.493449782
37,9,2001,279,274,127,304,35,5,162,147,24593,11.378698587,11.174779257,5.1795509696,-20,1.4274353066,0.2039193295,6.6069862762
37,9,2002,220,295,213,313,35,-75,248,155,24748,8.9175330861,11.957601184,8.633793397,-18,1.4186984455,-3.040068098,10.052491842
37,9,2003,278,319,155,312,21,-41,176,108,24856,11.208773486,12.861865979,6.2494960084,-27,0.8467059108,-1.653092493,7.0962019192
37,9,2004,250,287,285,293,18,-37,303,241,25097,10.009408844,11.490801353,11.410726083,-25,0.7206774368,-1.481392509,12.131403519
37,9,2005,275,321,61,299,20,-46,81,11,25108,10.955084155,12.787570959,2.4300368489,-24,0.7967333931,-1.832486804,3.226770242
37,9,2006,270,298,171,300,19,-28,190,150,25258,10.721518485,11.833379661,6.7902950403,-12,0.7544772267,-1.111861176,7.544772267
37,9,2007,302,285,197,286,18,17,215,227,25485,11.903119642,11.233076483,7.7646177798,-5,0.7094574621,0.6700431587,8.4740752419
37,9,2008,292,296,204,286,19,-4,223,217,25702,11.409146854,11.565436537,7.9707738293,-2,0.7423759939,-0.156289683,8.7131498232
37,11,2001,192,169,310,2215,24,23,334,343,17671,10.97174205,9.6574187834,17.714791851,-14,1.3714677562,1.3143232664,19.086259607
37,11,2002,163,197,108,2299,23,-34,131,84,17755,9.2022808107,11.121774968,6.0972167335,-13,1.2984813414,-1.919494157,7.3956980749
37,11,2003,186,188,4,2279,17,-2,21,-6,17749,10.477692654,10.590356016,0.2253267237,-25,0.9576385759,-0.112663362,1.1829652997
37,11,2004,157,201,97,2272,19,-44,116,57,17806,8.8313879904,11.306426663,5.4563352552,-15,1.0687666995,-2.475038672,6.5251019547
37,11,2005,151,210,38,2422,17,-59,55,-19,17787,8.4848144298,11.800073048,2.1352513135,-15,0.9552440087,-3.315258618,3.0904953221
37,11,2006,183,188,187,2617,19,-5,206,192,17979,10.233182352,10.512777498,10.456858469,-9,1.0624615557,-0.279595146,11.519320025
37,11,2007,190,177,-171,2565,15,13,-156,-137,17842,10.608302392,9.8824711761,-9.547472153,6,0.8374975573,0.7258312163,-8.709974596
37,11,2008,183,191,27,2565,17,-8,44,42,17884,10.244639758,10.692492862,1.5115042266,6,0.9516878464,-0.447853104,2.463192073
37,13,2001,635,587,-89,561,71,48,-18,-11,44962,14.121309835,13.053872241,-1.979207205,-41,1.5789181075,1.0674375938,-0.400289098
37,13,2002,631,532,-129,565,70,99,-59,1,44963,14.033917153,11.832082291,-2.869057548,-39,1.556852933,2.2018348624,-1.312204615
37,13,2003,594,525,-19,558,57,69,38,43,45006,13.204548233,11.67068657,-0.422367704,-64,1.2671031133,1.5338616635,0.8447354089
37,13,2004,559,560,50,572,54,-1,104,74,45080,12.41036343,12.432564438,1.1100503963,-29,1.198854428,-0.022201008,2.3089048243
37,13,2005,609,536,202,574,56,73,258,288,45368,13.466301079,11.852113922,4.4666548735,-43,1.238280559,1.6141871573,5.7049354325
37,13,2006,595,552,267,559,56,43,323,344,45712,13.065436978,12.121212121,5.8629776021,-22,1.2296881862,0.9442248573,7.0926657883
37,13,2007,582,525,-194,528,50,57,-144,-76,45636,12.74247931,11.494504532,-4.247493103,11,1.0947147173,1.2479747778,-3.152778386
37,13,2008,608,511,230,528,52,97,282,399,46035,13.264827481,11.148563886,5.0179446063,20,1.134491824,2.1162635948,6.1524364303
37,15,2001,262,290,-97,180,2,-28,-95,-143,19568,13.340461824,14.766160035,-4.939025943,-20,0.1018355864,-1.42569821,-4.837190356
37,15,2002,284,273,-186,190,2,11,-184,-186,19382,14.58279846,14.017971759,-9.550706033,-13,0.1026957638,0.5648267009,-9.44801027
37,15,2003,231,228,-131,193,-1,3,-132,-150,19232,11.964572435,11.809188377,-6.785103848,-21,-0.051794686,0.1553840576,-6.836898534
37,15,2004,253,231,-98,178,3,22,-95,-86,19146,13.184637032,12.038146855,-5.107092605,-13,0.1563395695,1.1464901767,-4.950753036
37,15,2005,215,261,-103,183,1,-46,-102,-165,18981,11.278096887,13.691085058,-5.402995253,-17,0.0524562646,-2.412988171,-5.350538988
37,15,2006,242,244,-317,178,2,-2,-315,-324,18657,12.85934428,12.965619852,-16.84467825,-7,0.1062755726,-0.106275573,-16.73840268
37,15,2007,243,243,787,1049,0,0,787,793,19450,12.753562338,12.753562338,41.304747159,6,0,0,41.304747159
37,15,2008,234,244,-92,1049,2,-10,-90,-113,19337,12.065898368,12.58153505,-4.743857478,-13,0.1031273365,-0.515636682,-4.640730142
37,17,2001,478,392,73,704,58,86,131,186,32425,14.784114809,12.124211308,2.257825065,-31,1.7938884078,2.6599035012,4.0517134727
37,17,2002,470,384,-308,715,52,86,-256,-199,32226,14.539604956,11.879166602,-9.528081546,-29,1.6086371441,2.6604383536,-7.919444401
37,17,2003,448,393,-5,734,45,55,40,49,32275,13.8912575,12.185857584,-0.155036356,-46,1.3953272042,1.7053999163,1.2402908482
37,17,2004,448,401,230,761,47,47,277,294,32569,13.817778052,12.368145087,7.0939485535,-30,1.4496329653,1.4496329653,8.5435815187
37,17,2005,459,426,-78,762,49,33,-29,-24,32545,14.098350585,13.08474368,-2.395798139,-28,1.5050526768,1.0136069048,-0.890745462
37,17,2006,476,365,-323,757,51,111,-272,-176,32369,14.665557507,11.245648088,-9.951628308,-15,1.5713097329,3.4199094186,-8.380318575
37,17,2007,434,375,-238,740,44,59,-194,-159,32210,13.440901841,11.613682466,-7.370817139,-24,1.3626720761,1.8272193747,-6.008145063
37,17,2008,446,365,9,740,46,81,55,102,32312,13.824741948,11.313970429,0.2789746133,-34,1.4258702458,2.5107715198,1.7048448591
37,19,2001,863,738,2144,751,119,125,2263,2367,76137,11.513805226,9.8461045848,28.604401396,-21,1.5876510103,1.6677006411,30.192052406
37,19,2002,893,723,2121,763,102,170,2223,2391,78528,11.547538228,9.3492386771,27.427019688,-2,1.3189797304,2.1982995506,28.745999418
37,19,2003,856,754,2174,777,38,102,2212,2373,80901,10.738322388,9.4587559352,27.272328121,59,0.4767012275,1.2795664528,27.749029348
37,19,2004,854,852,2841,766,106,2,2947,2801,83702,10.376481595,10.352180701,34.519419452,-148,1.2879473643,0.0243008937,35.807366816
37,19,2005,957,860,4468,762,90,97,4558,4585,88287,11.128618691,10.000639576,51.956811191,-70,1.0465785603,1.1279791149,53.003389752
37,19,2006,1010,888,5419,777,105,122,5524,5587,93874,11.089091518,9.749617097,59.496818748,-59,1.1528263459,1.339474421,60.649645094
37,19,2007,1139,890,4644,774,78,249,4722,5092,98966,11.812901888,9.2304501141,48.164281269,121,0.8089607965,2.5824517735,48.973242066
37,19,2008,1221,940,3791,774,87,281,3878,4194,103160,12.08157288,9.3011289987,37.511255356,35,0.8608491733,2.7804438815,38.372104529
37,21,2001,2594,2283,817,6820,485,311,1302,1424,208432,12.487964568,10.990756788,3.9331792798,-189,2.3348738687,1.4972077797,6.2680531485
37,21,2002,2534,2182,1539,6815,453,352,1992,2191,210623,12.093877892,10.413907482,7.3450978988,-153,2.1620073737,1.6799704096,9.5071052726
37,21,2003,2457,2224,2021,7022,390,233,2411,2491,213114,11.59681595,10.497077196,9.5389357078,-153,1.8407644364,1.099738753,11.379700144
37,21,2004,2591,2140,2031,7135,382,451,2413,2663,215777,12.082323947,9.9792254909,9.4709378374,-201,1.781338382,2.1030984563,11.252276219
37,21,2005,2605,2251,2280,6917,394,354,2674,2828,218605,11.994051319,10.364149527,10.497672555,-200,1.8140714855,1.6299017915,12.311744041
37,21,2006,2665,2142,3117,6981,400,523,3517,3923,222528,12.082523865,9.7113568924,14.131792453,-117,1.8135120247,2.3711669723,15.945304477
37,21,2007,2881,2206,2779,7022,358,675,3137,3872,226400,12.835020315,9.8278565828,12.380604462,60,1.5949105424,3.0071637323,13.975515005
37,21,2008,2881,2239,1534,7022,362,642,1896,2647,229047,12.651307397,9.8320990148,6.7362393429,109,1.589647094,2.8192083821,8.3258864368
37,23,2001,1089,809,-461,3509,228,280,-233,-31,89285,12.194780544,9.05929978,-5.162345116,-78,2.5531771939,3.1354807644,-2.609167922
37,23,2002,1049,788,-659,3580,216,261,-443,-247,89038,11.765167701,8.8378952799,-7.391082474,-65,2.4225702798,2.9272724214,-4.968512194
37,23,2003,1015,818,-413,3501,178,197,-235,-146,88892,11.40898106,9.1946271005,-4.642275052,-108,2.0007868263,2.2143539594,-2.641488226
37,23,2004,1008,885,-453,3694,166,123,-287,-234,88658,11.354548015,9.9690228105,-5.102787947,-70,1.869895804,1.3855252042,-3.232892143
37,23,2005,1010,901,-281,3761,177,109,-104,-75,88583,11.39691155,10.166947828,-3.170823906,-80,1.9972805389,1.2299637217,-1.173543368
37,23,2006,984,871,-173,3585,177,113,4,76,88659,11.103463062,9.8283702508,-1.952133242,-41,1.9972692703,1.275092811,0.0451360287
37,23,2007,1026,804,-270,3602,159,222,-111,128,88787,11.564081467,9.0619117929,-3.043179333,17,1.7920944964,2.5021696742,-1.251084837
37,23,2008,1018,827,196,3602,161,191,357,574,89361,11.428699733,9.2844152053,2.2004176303,26,1.8074859106,2.1442845275,4.0079035409
37,25,2001,2199,1115,2524,2184,429,1084,2953,3972,136190,16.385502668,8.3082471461,18.807189055,-65,3.196626032,8.0772555214,22.003815087
37,25,2002,2154,1141,1894,2078,405,1013,2299,3235,139425,15.630499066,8.2796654754,13.743809299,-77,2.9388821363,7.3508335903,16.682691436
37,25,2003,2225,1204,1819,2326,350,1021,2169,3100,142525,15.782940238,8.540521369,12.902996985,-90,2.4827097003,7.2424188686,15.385706686
37,25,2004,2200,1211,1337,2063,330,989,1667,2525,145050,15.300356429,8.4221507433,9.2984438842,-131,2.2950534643,6.8782056855,11.593497349
37,25,2005,2384,1231,2424,1851,340,1153,2764,3784,148834,16.224088416,8.3774550503,16.496304664,-133,2.313838113,7.8466333655,18.810142777
37,25,2006,2409,1329,4966,1865,342,1080,5308,6296,155130,15.850561251,8.7444565804,32.67492203,-92,2.2502664789,7.1061046703,34.925188509
37,25,2007,2630,1221,5851,1881,316,1409,6167,7668,162798,16.544626456,7.6809843738,36.807075816,92,1.9878714678,8.8636420825,38.794947284
37,25,2008,2761,1250,4052,1881,319,1511,4371,5942,168740,16.655707641,7.5406137456,24.443653518,60,1.9243646279,9.1150938957,26.368018146
37,27,2001,1024,763,-17,1167,102,261,85,542,78156,13.147589395,9.7964948321,-0.218270527,196,1.3096231624,3.3510945625,1.0913526353
37,27,2002,967,776,-60,1164,96,191,36,374,78530,12.343157653,9.9051606398,-0.765862936,147,1.2253806977,2.4379970131,0.4595177616
37,27,2003,918,749,-133,1204,74,169,-59,65,78595,11.6849642,9.5338106603,-1.69291965,-45,0.9419252188,2.1511535402,-0.750994431
37,27,2004,926,797,-454,1202,79,129,-375,-233,78362,11.799410029,10.155647725,-5.785023924,13,1.0066451321,1.6437623043,-4.778378792
37,27,2005,947,757,113,1199,80,190,193,372,78734,12.056322249,9.6374191577,1.4386107858,-11,1.018485512,2.4189030911,2.4570962978
37,27,2006,915,858,121,1189,82,57,203,260,78994,11.602251978,10.87948874,1.5342868736,0,1.0397646581,0.722763238,2.5740515318
37,27,2007,962,786,110,1183,73,176,183,367,79361,12.149916327,9.9270626125,1.3892835717,8,0.9219790976,2.2228537148,2.3112626693
37,27,2008,950,772,429,1183,75,178,504,698,80059,11.918203488,9.6851085184,5.3820097855,16,0.9409108017,2.2330949693,6.3229205871
37,29,2001,73,61,152,4,-2,12,150,159,7081,10.426337213,8.7124187674,21.70963365,-3,-0.285653074,1.713918446,21.423980576
37,29,2002,78,72,297,4,-6,6,291,301,7382,10.786143954,9.9564405725,41.070317362,4,-0.829703381,0.829703381,40.240613981
37,29,2003,99,56,423,4,-17,43,406,472,7854,12.995536886,7.351010764,55.526384878,23,-2.231556839,5.6445261223,53.294828039
37,29,2004,92,74,494,4,6,18,500,494,8348,11.356622639,9.1346747315,60.98012591,-24,0.7406493026,2.2219479077,61.720775213
37,29,2005,107,50,500,4,-1,57,499,548,8896,12.410113663,5.799118534,57.99118534,-8,-0.115982371,6.6109951287,57.875202969
37,29,2006,101,75,269,4,2,26,271,292,9188,11.170095112,8.2946250829,29.750055298,-5,0.2211900022,2.8754700288,29.9712453
37,29,2007,115,70,225,4,-2,45,223,273,9461,12.333100971,7.5071049386,24.12998016,5,-0.214488713,4.825996032,23.915491447
37,29,2008,120,75,171,4,1,45,172,221,9682,12.537219871,7.8357624197,17.865538317,4,0.1044768323,4.7014574518,17.970015149
37,31,2001,630,678,319,1105,30,-48,349,333,59737,10.575704417,11.381472373,5.3549995384,32,0.5036049723,-0.805767956,5.8586045106
37,31,2002,576,688,594,1209,-5,-112,589,510,60247,9.6012801707,11.468195759,9.901320176,33,-0.083344446,-1.866915589,9.8179757301
37,31,2003,574,712,877,1204,-93,-138,784,711,60958,9.4715564539,11.748690236,14.471350192,65,-1.534590157,-2.277133782,12.936760035
37,31,2004,637,701,859,1208,79,-64,938,888,61846,10.37425491,11.416566236,13.98977232,14,1.2866030422,-1.042311325,15.276375362
37,31,2005,644,704,555,1205,27,-60,582,559,62405,10.366113754,11.331900749,8.93352971,37,0.4346041481,-0.965786996,9.3681338581
37,31,2006,669,682,762,1207,51,-13,813,797,63202,10.652272564,10.859267398,12.133081755,-3,0.8120566529,-0.206994833,12.945138408
37,31,2007,674,652,-21,1192,14,22,-7,-48,63154,10.668270601,10.320048118,-0.332394188,-63,0.2215961252,0.3482224825,-0.110798063
37,31,2008,680,653,72,1192,33,27,105,41,63195,10.763836675,10.336449042,1.1397003538,-91,0.5223626622,0.4273876327,1.6620630159
37,33,2001,265,232,-62,1316,20,33,-42,-30,23520,11.259825791,9.857658806,-2.634374336,-21,0.8497981729,1.4021669853,-1.784576163
37,33,2002,254,281,90,1386,18,-27,108,60,23580,10.785562633,11.932059448,3.821656051,-21,0.7643312102,-1.146496815,4.5859872611
37,33,2003,250,241,-39,1381,17,9,-22,-49,23531,10.613232578,10.231156206,-1.655664282,-36,0.7216998153,0.3820763728,-0.933964467
37,33,2004,242,256,-106,1380,18,-14,-88,-118,23413,10.310156783,10.906612134,-4.516019087,-16,0.7668711656,-0.596455351,-3.749147921
37,33,2005,227,265,-28,1383,18,-38,-10,-69,23344,9.7097760763,11.335201146,-1.197681631,-21,0.7699381911,-1.62542507,-0.427743439
37,33,2006,249,223,13,1380,18,26,31,46,23390,10.656053409,9.5433731331,0.5563401378,-11,0.7703171139,1.1126802756,1.3266572517
37,33,2007,197,218,-77,1444,17,-21,-60,-87,23303,8.438095646,9.3375880753,-3.298138907,-6,0.728160538,-0.899492429,-2.569978369
37,33,2008,232,247,-55,1444,18,-15,-37,-55,23248,9.9675624584,10.612016928,-2.362999721,-3,0.7733453632,-0.644454469,-1.589654358
37,35,2001,2107,1345,1493,2191,658,762,2151,2798,145299,14.642112578,9.3467685893,10.375260598,-115,4.5726198749,5.2953439889,14.947880473
37,35,2002,2098,1279,-434,2269,619,819,185,874,146173,14.395893945,8.776143163,-2.977987594,-130,4.2474062689,5.6197507822,1.2694186749
37,35,2003,2053,1310,-505,2314,532,743,27,582,146755,14.017096351,8.9441774088,-3.447946253,-188,3.6322918943,5.0729189425,0.1843456412
37,35,2004,1922,1317,841,2348,500,605,1341,1827,148582,13.015639761,8.9186251638,5.6951888859,-119,3.3859624768,4.0970145969,9.0811513627
37,35,2005,2032,1361,987,2290,527,671,1514,2043,150625,13.582569927,9.0973807431,6.597439231,-142,3.5226448579,4.4851891834,10.120084089
37,35,2006,2012,1333,890,2309,530,679,1420,2023,152648,13.2685732,8.7907594807,5.8692992782,-76,3.4952006938,4.477813719,9.364499972
37,35,2007,2126,1347,1174,2327,480,779,1654,2475,155123,13.815466694,8.7532613534,7.6290488708,42,3.119202264,5.062205341,10.748251135
37,35,2008,2138,1352,637,2327,484,786,1121,1956,157079,13.696260754,8.661059186,4.0806913473,49,3.1005566909,5.0352015682,7.1812480381
37,37,2001,682,468,1343,618,388,214,1731,1919,51644,13.455790232,9.2335921238,26.497252612,-26,7.6552003078,4.2221981079,34.15245292
37,37,2002,663,491,1999,623,371,172,2370,2557,54201,12.527752846,9.277717417,37.772214087,15,7.0102508385,3.2500354292,44.782464925
37,37,2003,712,487,836,614,321,225,1157,1360,55561,12.973524535,8.8737450119,15.232958583,-22,5.8490187861,4.099779523,21.081977369
37,37,2004,693,501,954,613,293,192,1247,1371,56932,12.320766625,8.9072208937,16.961055355,-68,5.2092130177,3.4135457317,22.170268372
37,37,2005,748,508,507,612,309,240,816,1003,57935,13.023757911,8.8450120574,8.8276006164,-53,5.3801352869,4.1787458539,14.207735903
37,37,2006,749,490,1091,636,309,259,1400,1626,59561,12.749370191,8.340709471,18.570844965,-33,5.2597535235,4.4086607204,23.830598488
37,37,2007,745,528,952,606,278,217,1230,1468,61029,12.355916743,8.7569450203,15.789037234,21,4.6106642342,3.5989717224,20.399701468
37,37,2008,779,540,1518,606,280,239,1798,2048,63077,12.553784668,8.7022384091,24.462959083,11,4.5122717677,3.8515462588,28.975230851
37,39,2001,265,324,231,270,9,-59,240,161,24534,10.836894514,13.249637066,9.446500501,-20,0.3680454741,-2.412742552,9.814545975
37,39,2002,283,306,176,272,6,-23,182,142,24676,11.501727291,12.436496647,7.1530176793,-17,0.2438528754,-0.934769356,7.3968705548
37,39,2003,258,329,304,272,-3,-71,301,221,24897,10.408891937,13.273354447,12.264740887,-9,-0.121033627,-2.86446251,12.14370726
37,39,2004,255,314,385,271,7,-59,392,306,25203,10.179640719,12.53493014,15.369261477,-27,0.2794411178,-2.355289421,15.648702595
37,39,2005,265,320,370,281,3,-55,373,294,25497,10.453648915,12.623274162,14.59566075,-24,0.1183431953,-2.169625247,14.714003945
37,39,2006,303,338,639,268,5,-35,644,594,26091,11.746917888,13.103822594,24.77320307,-15,0.1938435295,-1.356904707,24.9670466
37,39,2007,255,295,364,272,3,-40,367,345,26436,9.7092923639,11.232318617,13.859538904,18,0.114226969,-1.523026253,13.973765873
37,39,2008,264,326,164,272,5,-62,169,132,26568,9.9615123387,12.300958418,6.1882122104,25,0.1886650064,-2.33944608,6.3768772168
37,41,2001,202,188,33,321,4,14,37,37,14153,14.291273126,13.30078885,2.3347129364,-14,0.2829955074,0.9904842761,2.6177084439
37,41,2002,203,169,63,316,4,34,67,89,14242,14.298291953,11.903504138,4.4374009509,-12,0.2817397429,2.3947878148,4.7191406938
37,41,2003,156,202,42,297,1,-46,43,-20,14222,10.961214165,14.19336706,2.9510961214,-17,0.0702641934,-3.232152895,3.0213603148
37,41,2004,160,184,99,291,5,-24,104,68,14290,11.223344557,12.90684624,6.9444444444,-12,0.3507295174,-1.683501684,7.2951739618
37,41,2005,180,191,91,289,4,-11,95,71,14361,12.565006457,13.332867963,6.3523088199,-13,0.2792223657,-0.767861506,6.6315311856
37,41,2006,190,187,161,291,4,3,165,160,14521,13.156983588,12.949241742,11.148812409,-8,0.2769891282,0.2077418461,11.425801537
37,41,2007,187,162,91,290,2,25,93,114,14635,12.827548361,11.112635478,6.242282892,-4,0.1371930306,1.7149128824,6.3794759226
37,41,2008,195,179,-87,290,4,16,-83,-70,14565,13.356164384,12.260273973,-5.95890411,-3,0.2739726027,1.095890411,-5.684931507
37,43,2001,82,110,268,121,2,-28,270,241,9058,9.1748251748,12.307692308,29.986013986,-1,0.2237762238,-3.132867133,30.20979021
37,43,2002,66,118,217,121,1,-52,218,164,9222,7.2210065646,12.910284464,23.741794311,-2,0.1094091904,-5.689277899,23.851203501
37,43,2003,104,112,140,124,-1,-8,139,130,9352,11.198449445,12.059868634,15.074835792,-1,-0.107677399,-0.861419188,14.967158393
37,43,2004,90,111,157,123,2,-21,159,128,9480,9.5581988105,11.7884452,16.673746814,-10,0.212404418,-2.230246389,16.886151232
37,43,2005,86,117,256,119,1,-31,257,219,9699,8.9681422389,12.200844674,26.695865269,-7,0.1042807237,-3.232702435,26.800145993
37,43,2006,96,148,356,110,1,-52,357,298,9997,9.7481722177,15.028432169,36.149471974,-7,0.1015434606,-5.280259951,36.251015435
37,43,2007,67,94,240,108,1,-27,241,213,10210,6.6313653684,9.3037066363,23.754144603,-1,0.0989756025,-2.672341268,23.853120206
37,43,2008,86,113,212,108,2,-27,214,179,10389,8.349919899,10.971406379,20.583523472,-8,0.1941841837,-2.62148648,20.777707656
37,45,2001,1307,1042,334,2474,77,265,411,586,97057,13.507089413,10.768467612,3.4516969121,-90,0.7957504857,2.7386218015,4.2474473978
37,45,2002,1249,976,87,2510,74,273,161,338,97395,12.84635797,10.038467077,0.8948223726,-96,0.7611132825,2.8078908934,1.6559356551
37,45,2003,1215,1000,90,2477,54,215,144,216,97611,12.461155041,10.256094684,0.9230485216,-143,0.553829113,2.2050603571,1.4768776345
37,45,2004,1221,1049,-150,2528,62,172,-88,15,97626,12.507875044,10.74591394,-1.536593986,-69,0.6351255141,1.7619611037,-0.901468472
37,45,2005,1171,987,-383,2516,60,184,-323,-228,97398,12.008778407,10.121831159,-3.927721716,-89,0.6153088851,1.8869472475,-3.312412831
37,45,2006,1120,1010,11,2483,61,110,72,137,97535,11.491127721,10.36253482,0.1128592901,-45,0.6258560634,1.1285929012,0.7387153535
37,45,2007,1220,1054,513,2544,54,166,567,744,98279,12.460804641,10.765318108,5.2396662139,11,0.551543812,1.6954865331,5.7912100258
37,45,2008,1235,993,376,2544,56,242,432,736,99015,12.51938731,10.066195627,3.8115705495,62,0.5676807201,2.4531916835,4.3792512697
37,47,2001,822,673,-308,1381,30,149,-278,-177,54536,15.048192661,12.320478906,-5.638495547,-48,0.5492041117,2.7277137548,-5.089291435
37,47,2002,797,660,-198,1380,28,137,-170,-83,54453,14.625329162,12.111313986,-3.633394196,-50,0.5138133206,2.5140151758,-3.119580875
37,47,2003,771,586,-436,1394,13,185,-423,-284,54169,14.196019223,10.789711108,-8.027839664,-46,0.2393621918,3.4063081144,-7.788477472
37,47,2004,743,647,-210,1400,24,96,-186,-131,54038,13.732937795,11.958560906,-3.881449444,-41,0.4435942222,1.7743768887,-3.437855222
37,47,2005,759,651,-327,1399,20,108,-307,-244,53794,14.077453817,12.074337859,-6.064989984,-45,0.3709473997,2.0031159582,-5.694042585
37,47,2006,716,618,81,1401,22,98,103,175,53969,13.288419959,11.469613875,1.5032989059,-26,0.4083034065,1.8188060837,1.9116023125
37,47,2007,776,704,-81,1390,16,72,-65,-3,53966,14.379024413,13.044888127,-1.500903321,-10,0.2964747302,1.3341362857,-1.204428591
37,47,2008,803,629,81,1390,18,174,99,246,54212,14.845902124,11.628981863,1.4975318457,-27,0.3327848546,3.2169202611,1.8303167003
37,49,2001,1668,854,0,5493,4,814,4,1419,93070,18.059668365,9.2463769685,0,601,0.0433085572,8.8132913962,0.0433085572
37,49,2002,1529,850,-1314,4941,-339,679,-1653,-466,92604,16.46972651,9.1558322652,-14.15383953,508,-3.651561339,7.3138942448,-17.80540086
37,49,2003,1535,864,1294,5307,-1151,671,143,1369,93973,16.454332528,9.2615917289,13.870948724,555,-12.33806954,7.1927407987,1.5328791866
37,49,2004,1536,894,-1770,4387,577,642,-1193,-92,93881,16.353125299,9.5180299594,-18.84442173,459,6.1430685532,6.83509534,-12.70135318
37,49,2005,1580,925,-134,4670,43,655,-91,1072,94953,16.734274548,9.7969645297,-1.419235943,508,0.4554264592,6.9373100183,-0.963809483
37,49,2006,1592,903,169,4643,296,689,465,1154,96107,16.664922014,9.4525280017,1.7690777766,0,3.098503088,7.2123940124,4.8675808646
37,49,2007,1631,908,-495,4317,-52,723,-547,195,96302,16.953468913,9.4382279415,-5.145289462,19,-0.540515257,7.5152409711,-5.685804718
37,49,2008,1645,923,-288,4317,128,722,-160,590,96892,17.029514374,9.5551621686,-2.981459052,28,1.3250929118,7.4743522056,-1.65636614
37,51,2001,5545,1982,-2779,19220,-87,3563,-2866,461,303479,18.285333646,6.5358938296,-9.164101389,-236,-0.286893422,11.749439816,-9.450994811
37,51,2002,5356,2047,1928,19716,-1871,3309,57,3122,306601,17.558353003,6.7105953318,6.3204825597,-244,-6.13362182,10.847757671,0.1868607396
37,51,2003,5378,2019,6235,21358,-6033,3359,202,3622,310223,17.437713189,6.5464378818,20.216463691,61,-19.56149566,10.891275307,0.6549680298
37,51,2004,5215,2120,-4862,20367,2865,3095,-1997,753,310976,16.790110737,6.8255100217,-15.65359893,-345,9.22409727,9.9646007157,-6.429501657
37,51,2005,5545,1995,-9220,16000,116,3550,-9104,-5767,305209,17.997841557,6.4753280265,-29.9260774,-213,0.3765103013,11.522513531,-29.54956709
37,51,2006,5295,2110,-2739,16561,1470,3185,-1269,1775,306984,17.298466333,6.8932509846,-8.948158506,-141,4.802407084,10.405215349,-4.145751422
37,51,2007,5833,1946,-1552,18984,-336,3887,-1888,1963,308947,18.940433263,6.3188896159,-5.039525531,-36,-1.091031301,12.621543647,-6.130556832
37,51,2008,5561,2056,-286,18984,586,3505,300,3749,312696,17.891297738,6.6147290326,-0.920142268,-56,1.8853264655,11.276568706,0.9651841974
37,53,2001,234,164,402,91,0,70,402,463,18757,12.631238023,8.8526625462,21.699819168,-9,0,3.778575477,21.699819168
37,53,2002,208,161,682,109,-10,47,672,718,19475,10.880937435,8.422264072,35.676919858,-1,-0.523121992,2.4586733626,35.153797866
37,53,2003,218,153,998,106,-33,65,965,1084,20559,10.890742869,7.6435030224,49.857621022,54,-1.648598691,3.2472398461,48.209022331
37,53,2004,251,180,1222,100,19,71,1241,1257,21816,11.84660767,8.4955752212,57.675516224,-55,0.8967551622,3.3510324484,58.572271386
37,53,2005,254,186,1007,105,2,68,1009,1058,22874,11.367196241,8.3240098456,45.066010293,-19,0.0895054822,3.0431863952,45.155515775
37,53,2006,256,165,481,108,11,91,492,572,23446,11.053540587,7.1243523316,20.768566494,-11,0.4749568221,3.9291882556,21.243523316
37,53,2007,256,185,340,101,0,71,340,413,23859,10.823380192,7.8215833421,14.374801818,2,0,3.0017968502,14.374801818
37,53,2008,285,183,215,101,6,102,221,324,24183,11.864618459,7.6183339578,8.9505016444,1,0.2497814412,4.2462845011,9.2002830856
37,55,2001,337,243,612,232,40,94,652,731,30924,11.028028208,7.9519609928,20.027161019,-15,1.3089647725,3.0760672153,21.336125792
37,55,2002,366,264,991,232,35,102,1026,1127,32051,11.623660183,8.384279476,31.472806669,-1,1.1115522033,3.2393807066,32.584358873
37,55,2003,370,275,727,232,16,95,743,850,32901,11.393028698,8.4677916,22.385761793,12,0.4926715113,2.9252370982,22.878433305
37,55,2004,468,273,376,244,36,195,412,571,33472,14.102119838,8.2262365721,11.329908246,-36,1.0847784491,5.8758832658,12.414686695
37,55,2005,487,268,-45,232,31,219,-14,191,33663,14.508080733,7.9839130111,-1.340582409,-14,0.9235123259,6.5241677218,-0.417070083
37,55,2006,446,257,-111,232,34,189,-77,91,33754,13.231084148,7.6241897444,-3.292937983,-21,1.0086476705,5.6068944035,-2.284290313
37,55,2007,451,251,-228,232,25,200,-203,-61,33693,13.373463608,7.442881077,-6.760864086,-58,0.7413228164,5.9305825315,-6.019541269
37,55,2008,427,262,-220,232,28,165,-192,-109,33584,12.693788367,7.7886945018,-6.540125154,-82,0.8323795651,4.9050938657,-5.707745589
37,57,2001,1983,1391,671,1987,409,592,1080,1542,149199,13.360012936,9.3715471474,4.5207103781,-130,2.7555447759,3.9884657881,7.276255154
37,57,2002,1891,1369,401,1980,389,522,790,1178,150377,12.624509306,9.1395839453,2.677116992,-134,2.5970037653,3.4849253612,5.2741207573
37,57,2003,1874,1439,424,1981,337,435,761,995,151372,12.420919373,9.5377283769,2.8102827184,-201,2.2336445191,2.8831909965,5.0439272375
37,57,2004,1996,1430,182,1961,317,566,499,959,152331,13.1444207,9.4170949908,1.1985393625,-106,2.0875658127,3.7273257097,3.2861051751
37,57,2005,1847,1447,204,1991,329,400,533,785,153116,12.093751125,9.474638808,1.3357472819,-148,2.154219881,2.6191123174,3.4899671629
37,57,2006,1915,1509,710,1982,336,406,1046,1378,154494,12.450830597,9.8111244758,4.6162348428,-74,2.1845843763,2.6397061214,6.8008192191
37,57,2007,1974,1446,732,1965,306,528,1038,1580,156074,12.712191855,9.3119703253,4.7139434842,14,1.9705829319,3.4002215296,6.6845264161
37,57,2008,1993,1440,1215,1965,308,553,1523,2092,158166,12.684572301,9.1649694501,7.7329429735,16,1.9602851324,3.5196028513,9.6932281059
37,59,2001,462,338,708,370,79,124,787,890,35948,13.012984818,9.5203222263,19.941976734,-21,2.2251640706,3.4926625919,22.167140805
37,59,2002,469,359,415,377,76,110,491,575,36523,12.943108278,9.9074112404,11.452857005,-26,2.0973906804,3.0356970374,13.550247685
37,59,2003,397,341,333,370,64,56,397,412,36935,10.808897601,9.2842168314,9.0664052928,-41,1.7424923085,1.52468077,10.808897601
37,59,2004,423,308,586,360,61,115,647,721,37656,11.341850894,8.2583689721,15.712351356,-41,1.6355860627,3.0834819214,17.347937419
37,59,2005,433,364,937,364,64,69,1001,1038,38694,11.342501637,9.5350360183,24.544859201,-32,1.6764898494,1.8074656189,26.22134905
37,59,2006,478,326,695,290,62,152,757,889,39583,12.213038313,8.3293943304,17.757451103,-20,1.5841179401,3.8836439823,19.341569043
37,59,2007,456,363,620,279,56,93,676,781,40364,11.407557507,9.0810161732,15.510275558,12,1.4009281149,2.3265413336,16.911203672
37,59,2008,474,345,398,279,55,129,453,607,40971,11.655498863,8.4834327165,9.7866846991,25,1.3524313026,3.1720661462,11.139116002
37,61,2001,809,513,-55,1057,469,296,414,661,49833,16.342608959,10.363112974,-1.111054997,-49,9.4742689763,5.9794959851,8.3632139791
37,61,2002,791,461,-173,1046,441,330,268,550,50383,15.785902451,9.2001277241,-3.452542508,-48,8.8009898619,6.5857747266,5.3484473537
37,61,2003,764,532,-198,1083,376,232,178,340,50723,15.112851858,10.523608886,-3.916681503,-70,7.437738611,4.5892429727,3.5210571084
37,61,2004,769,519,-135,1081,353,250,218,433,51156,15.096339776,10.188557014,-2.650202691,-35,6.9297892598,4.9077827619,4.2795865684
37,61,2005,825,525,-337,1086,367,300,30,287,51443,16.08202809,10.234017875,-6.569264808,-43,7.1540658291,5.8480102145,0.5848010215
37,61,2006,839,500,64,1081,370,339,434,744,52187,16.192222329,9.6497153334,1.2351635627,-29,7.1407893467,6.542506996,8.3759529094
37,61,2007,838,506,-208,1063,336,332,128,425,52612,15.992519013,9.6565806926,-3.969503526,-35,6.4122749263,6.33593832,2.4427714005
37,61,2008,857,493,94,1063,339,364,433,750,53362,16.173778474,9.3041689471,1.7740200427,-47,6.3977956857,6.8696095269,8.1718157284
37,63,2001,3910,1698,730,9804,2129,2212,2859,4857,229475,17.221141925,7.4786442425,3.2152004105,-214,9.3769337999,9.7424976822,12.59213421
37,63,2002,3878,1672,857,9960,2009,2206,2866,4856,234331,16.72250898,7.2099110404,3.695510623,-216,8.6631048326,9.5125979397,12.358615456
37,63,2003,3847,1703,-1349,9937,1769,2144,420,2301,236632,16.336739829,7.2319906235,-5.728687816,-263,7.512267418,9.1047492054,1.7835796018
37,63,2004,3864,1672,-473,9869,1615,2192,1142,3166,239798,16.220641018,7.0188695086,-1.985601243,-168,6.7795898663,9.2017715089,4.7939886237
37,63,2005,3954,1698,17,10179,1690,2256,1707,3736,243534,16.361424445,7.0262262792,0.0703450216,-227,6.9931227396,9.3351981661,7.0634677613
37,63,2006,4126,1674,1314,10387,1690,2452,3004,5323,248857,16.759039056,6.7994744014,5.337221842,-133,6.8644634041,9.9595646549,12.201685246
37,63,2007,4365,1685,2248,10630,1540,2680,3788,6503,255360,17.313973944,6.6836302624,8.9167957447,35,6.1084810707,10.630343681,15.025276815
37,63,2008,4315,1685,3096,10630,1544,2630,4640,7355,262715,16.657819814,6.5048496839,11.951937461,85,5.9605269507,10.15297013,17.912464412
37,65,2001,794,611,-381,1290,94,183,-287,-214,55124,14.375984501,11.062627872,-6.898299868,-110,1.7019427495,3.3133566294,-5.196357118
37,65,2002,815,636,-656,1316,88,179,-568,-478,54646,14.849230209,11.587865537,-11.95226382,-89,1.6033524642,3.2613646716,-10.34891136
37,65,2003,711,603,-511,1341,72,108,-439,-424,54222,13.061689385,11.077635301,-9.387515156,-93,1.3227027226,1.9840540838,-8.064812433
37,65,2004,768,588,-606,1360,71,180,-535,-436,53786,14.221168802,10.888082364,-11.22139101,-81,1.3147174283,3.333086438,-9.90667358
37,65,2005,742,603,-610,1405,72,139,-538,-392,53394,13.845866766,11.252099272,-11.38272066,7,1.3435342415,2.5937674939,-10.03918642
37,65,2006,710,572,-496,1403,73,138,-423,-288,53106,13.333333333,10.741784038,-9.314553991,-3,1.3708920188,2.5915492958,-7.943661972
37,65,2007,771,596,-683,1395,63,175,-620,-478,52628,14.583766811,11.273573307,-12.91921236,-33,1.1916696616,3.3101935045,-11.7275427
37,65,2008,798,581,-168,1395,65,217,-103,54,52682,15.155255911,11.03408983,-3.190580192,-60,1.2344506695,4.1211660811,-1.956129522
37,67,2001,4593,2757,554,9787,1478,1836,2032,3573,310506,14.877583049,8.9304368529,1.7945092552,-295,4.7875174714,5.9471461958,6.5820267265
37,67,2002,4594,2766,470,10119,1397,1828,1867,3391,313897,14.71485563,8.8596627499,1.5054379944,-304,4.4746742088,5.8551928802,5.9801122032
37,67,2003,4559,2769,-323,10117,1223,1790,900,2209,316106,14.472946954,8.7904343313,-1.025391943,-481,3.8825211943,5.682512623,2.8571292518
37,67,2004,4597,2849,685,10101,1130,1748,1815,3335,319441,14.466278654,8.9655053049,2.1556234236,-228,3.5559919251,5.5007733496,5.7116153487
37,67,2005,4686,2848,2281,10492,1188,1838,3469,4989,324430,14.555710694,8.8464925428,7.0852701861,-318,3.6901801758,5.7092181508,10.775450362
37,67,2006,4839,2826,3459,10584,1193,2013,4652,6496,330926,14.767546189,8.6243202168,10.556094703,-169,3.6407692918,6.1432259718,14.196863995
37,67,2007,5171,2714,3120,10521,1081,2457,4201,6713,337639,15.468952159,8.118881485,9.3334230778,55,3.2337917779,7.3500706738,12.567214856
37,67,2008,5153,2791,1877,10521,1085,2362,2962,5389,343028,15.141030783,8.2007795295,5.515178494,65,3.1880493692,6.9402512535,8.7032278633
37,69,2001,671,448,838,1165,148,223,986,1183,48784,13.923328319,9.2960522903,17.388597811,-26,3.0710172745,4.6272760284,20.459615085
37,69,2002,645,403,1458,1123,142,242,1600,1837,50621,12.977214426,8.1082440521,29.334540516,-5,2.8569991449,4.8689703737,32.191539661
37,69,2003,656,432,961,1201,121,224,1082,1307,51928,12.793883899,8.4252406167,18.742259798,1,2.3598474875,4.3686432827,21.102107285
37,69,2004,671,471,917,1255,111,200,1028,1167,53095,12.778153357,8.9694638317,17.462841473,-61,2.1138226865,3.8086895252,19.576664159
37,69,2005,692,426,802,1508,120,266,922,1138,54233,12.895050686,7.9382826476,14.94484198,-50,2.2361359571,4.9567680382,17.180977937
37,69,2006,743,464,713,1442,119,279,832,1082,55315,13.564830029,8.4711724541,13.017124913,-29,2.1725636251,5.0936575748,15.189688538
37,69,2007,734,464,1339,1464,101,270,1440,1737,57052,13.064333835,8.2586524513,23.832619897,27,1.7976808138,4.8056813833,25.630300711
37,69,2008,742,477,1478,1464,103,265,1581,1875,58927,12.79541986,8.2256270532,25.487372714,29,1.7761836194,4.5697928073,27.263556333
37,71,2001,2686,2017,-78,3074,563,669,485,964,191740,14.043856989,10.54596409,-0.407826078,-190,2.9436677159,3.4978928986,2.535841638
37,71,2002,2532,1936,-216,3072,532,596,316,722,192462,13.180566473,10.078031869,-1.124408514,-190,2.7693765259,3.1025346042,1.6449680116
37,71,2003,2548,1924,-1122,3031,462,624,-660,-256,192206,13.247787703,10.003431531,-5.833601963,-220,2.4020713966,3.2443561721,-3.431530567
37,71,2004,2528,2010,-454,2997,432,518,-22,365,192571,13.140078539,10.447609914,-2.359808409,-131,2.2454564592,2.6924686247,-0.114351949
37,71,2005,2558,1894,1170,3114,448,664,1618,2097,194668,13.211479216,9.7820725702,6.042779782,-185,2.3138165319,3.4294066455,8.3565963139
37,71,2006,2651,1947,1855,3200,452,704,2307,2911,197579,13.516993119,9.9274181829,9.4583260038,-100,2.3046702715,3.5895749362,11.762996275
37,71,2007,2910,1907,3081,3202,410,1003,3491,4587,202166,14.559281542,9.5410824401,15.414826952,93,2.0513077087,5.0181991019,17.466134661
37,71,2008,2867,1950,3089,3202,413,917,3502,4513,206679,14.024874953,9.5390673727,15.110861084,94,2.0203255512,4.4858075799,17.131186636
37,73,2001,114,131,28,161,7,-17,35,8,10502,10.859211278,12.478567346,2.6671746999,-10,0.666793675,-1.619356068,3.3339683749
37,73,2002,111,127,56,167,6,-16,62,38,10540,10.550327916,12.071095903,5.3226879574,-8,0.5702879954,-1.520767988,5.8929759529
37,73,2003,108,128,151,157,3,-20,154,130,10670,10.18387553,12.069778406,14.238566714,-4,0.2828854314,-1.885902876,14.521452145
37,73,2004,101,106,44,163,9,-5,53,39,10709,9.4485242528,9.9162729782,4.1161887834,-9,0.8419477057,-0.467748725,4.9581364891
37,73,2005,124,111,355,161,6,13,361,365,11074,11.38502502,10.191433687,32.594224854,-9,0.5508883074,1.1935913327,33.145113162
37,73,2006,136,114,304,158,8,22,312,328,11402,12.101797473,10.144153764,27.051076704,-6,0.7118704396,1.9576437088,27.762947144
37,73,2007,126,106,271,170,4,20,275,301,11703,10.906730145,9.1755031378,23.458125947,6,0.3462454014,1.7312270071,23.804371348
37,73,2008,133,119,-19,170,6,14,-13,5,11708,11.362180172,10.166161206,-1.623168596,4,0.5125795566,1.1960189654,-1.110589039
37,75,2001,97,105,-15,128,6,-8,-9,-24,7972,12.149298597,13.151302605,-1.878757515,-7,0.751503006,-1.002004008,-1.127254509
37,75,2002,88,90,58,135,6,-2,64,55,8027,11.000687543,11.250703169,7.2504531533,-7,0.7500468779,-0.250015626,8.0005000313
37,75,2003,103,109,-69,117,5,-6,-64,-82,7945,12.897570749,13.64888555,-8.64012021,-12,0.6260956674,-0.751314801,-8.014024543
37,75,2004,104,94,50,112,4,10,54,56,8001,13.04402358,11.789790543,6.2711651825,-8,0.5016932146,1.2542330365,6.7728583971
37,75,2005,106,98,-58,118,5,8,-53,-48,7953,13.288203585,12.285320296,-7.270903849,-3,0.6268020559,1.0028832895,-6.644101793
37,75,2006,102,96,-27,118,5,6,-22,-21,7932,12.84230406,12.08687441,-3.399433428,-5,0.6295247088,0.7554296506,-2.769908719
37,75,2007,102,90,-100,117,3,12,-97,-99,7833,12.940057088,11.417697431,-12.68633048,-14,0.3805899144,1.5223596575,-12.30574056
37,75,2008,101,77,-9,117,3,24,-6,-8,7825,12.900753608,9.8352279985,-1.149572104,-26,0.3831907012,3.0655256099,-0.766381402
37,77,2001,621,415,818,5766,162,206,980,1158,49994,12.567034301,8.3982596378,16.553678033,-28,3.2783567743,4.1687746636,19.832034807
37,77,2002,606,459,1349,6267,153,147,1502,1645,51639,11.925260496,9.0324992866,26.546495725,-4,3.0108330955,2.8927612094,29.55732882
37,77,2003,597,422,440,6358,127,175,567,697,52336,11.483529695,8.1173358981,8.4635729743,-45,2.4428949267,3.3661937966,10.906467901
37,77,2004,615,484,84,6454,121,131,205,300,52636,11.717410357,9.2215066875,1.6004267805,-36,2.3053766719,2.4959036695,3.9058034523
37,77,2005,636,449,355,6386,126,187,481,621,53257,12.012125447,8.480258374,6.7048813425,-47,2.3797607018,3.5318670734,9.0846420443
37,77,2006,641,456,474,6275,129,185,603,760,54017,11.95070567,8.5015940489,8.8371832877,-28,2.4050562112,3.4491116207,11.242239499
37,77,2007,650,508,1744,7315,119,142,1863,2038,56055,11.810451341,9.2303219711,31.688349444,33,2.1622210916,2.5801293699,33.850570536
37,77,2008,678,479,664,7315,121,199,785,989,57044,11.989495928,8.470455088,11.741925216,5,2.1397182999,3.5190408403,13.881643516
37,79,2001,244,173,5,1232,95,71,100,151,19172,12.777210484,9.0592516953,0.2618280837,-20,4.9747335899,3.7179587883,5.2365616736
37,79,2002,244,150,19,1301,89,94,108,183,19355,12.666441716,7.7867469567,0.9863212812,-19,4.6201365276,4.8796947595,5.6064578088
37,79,2003,241,214,146,1300,73,27,219,232,19587,12.377381747,10.990704124,7.498330851,-14,3.7491654255,1.3866776231,11.247496277
37,79,2004,263,196,83,1251,66,67,149,198,19785,13.359748044,9.9563141319,4.2161942497,-18,3.3526363913,3.4034339124,7.5688306411
37,79,2005,258,176,-213,1300,73,82,-140,-72,19713,13.063952605,8.9118436377,-10.78535622,-14,3.6963896906,4.1521089675,-7.08896653
37,79,2006,242,180,414,1838,72,62,486,537,20250,12.111202863,9.0083327078,20.719165228,-11,3.6033330831,3.1028701549,24.322498311
37,79,2007,269,168,285,2257,64,101,349,450,20700,13.137973138,8.2051282051,13.919413919,0,3.1257631258,4.9328449328,17.045177045
37,79,2008,262,186,-156,2257,66,76,-90,-23,20677,12.664040409,8.9905019697,-7.540421007,-9,3.1901781183,3.6735384392,-4.350242889
37,81,2001,6016,3459,1275,14028,2095,2557,3370,5522,427979,14.148037007,8.134650932,2.9984619654,-405,4.9268845627,6.0133860749,7.9253465281
37,81,2002,5934,3499,-1037,14256,1960,2435,923,2967,430946,13.817271589,8.1473935443,-2.414646215,-391,4.5638443403,5.6698780452,2.1491981256
37,81,2003,5899,3433,-113,14444,1740,2466,1627,3439,434385,13.634089152,7.934536033,-0.261171737,-654,4.0215824927,5.699553119,3.7604107561
37,81,2004,5837,3548,22,13915,1585,2289,1607,3619,438004,13.381645115,8.1339861002,0.050436216,-277,3.633700104,5.2476590145,3.6841363199
37,81,2005,5897,3680,3460,14703,1669,2217,5129,6940,444944,13.357525018,8.3357117293,7.8373811368,-406,3.7805170859,5.0218132891,11.617898223
37,81,2006,5988,3573,5556,15151,1671,2415,7227,9407,454351,13.317098394,7.9462245426,12.356345804,-235,3.7162443914,5.3708738512,16.072590196
37,81,2007,6411,3482,5100,14963,1518,2929,6618,9683,464034,13.961464963,7.5828764625,11.106453176,136,3.3058031218,6.3785885005,14.412256298
37,81,2008,6492,3595,3577,14963,1523,2897,5100,8182,472216,13.868090788,7.6795727637,7.6411214953,185,3.2534045394,6.188518024,10.894526035
37,83,2001,780,632,-674,1762,31,148,-643,-541,56700,13.691296373,11.093460651,-11.8306843,-46,0.5441412661,2.597835722,-11.28654304
37,83,2002,758,710,-386,1763,29,48,-357,-355,56345,13.410588704,12.561369366,-6.829138839,-46,0.5130700164,0.8492193374,-6.316068822
37,83,2003,743,646,-359,1765,23,97,-336,-303,56042,13.222169824,11.495991529,-6.388639255,-64,0.409300008,1.7261782946,-5.979339247
37,83,2004,758,676,-415,1752,25,82,-390,-357,55685,13.568788207,12.100924575,-7.428822039,-49,0.4475194,1.4678636319,-6.981302639
37,83,2005,712,631,-281,1739,25,81,-256,-222,55463,12.8117465,11.354230396,-5.056321301,-47,0.4498506496,1.4575161047,-4.606470652
37,83,2006,672,648,-318,1760,25,24,-293,-294,55169,12.148383831,11.71451298,-5.748788777,-25,0.4519488032,0.4338708511,-5.296839974
37,83,2007,729,653,-294,1780,22,76,-272,-197,54972,13.237577287,11.857528078,-5.338611416,-1,0.3994879291,1.3800492096,-4.939123487
37,83,2008,748,652,-107,1780,24,96,-83,11,54983,13.605565913,11.859397026,-1.946250739,-2,0.4365422218,1.7461688873,-1.509708517
37,85,2001,1478,786,1248,3020,247,692,1495,2127,93590,15.9738021,8.4948636337,13.488027754,-60,2.669505493,7.4789384663,16.157533247
37,85,2002,1456,711,2138,3046,115,745,2253,2976,96566,15.313742401,7.4780706367,22.486800311,-22,1.2095332254,7.8356717642,23.696333537
37,85,2003,1407,763,1349,2954,-188,644,1161,1769,98335,14.438099343,7.8296160615,13.842925383,-36,-1.92918456,6.6084832813,11.913740822
37,85,2004,1422,791,1020,2968,384,631,1404,1938,100273,14.319664867,7.9654394586,10.271489567,-97,3.8669137195,6.3542254088,14.138403287
37,85,2005,1482,835,1743,3220,209,647,1952,2509,102782,14.597030361,8.2243727069,17.167762429,-90,2.0585555638,6.3726576543,19.226317993
37,85,2006,1521,752,1510,3306,296,769,1806,2519,105301,14.61916639,7.2278850266,14.513439349,-56,2.8450185743,7.3912813637,17.358457923
37,85,2007,1627,775,2202,3535,159,852,2361,3241,108542,15.216771183,7.2483083384,20.594548337,28,1.4870722914,7.9684628442,22.081620628
37,85,2008,1631,765,2360,3535,221,866,2581,3488,112030,14.788821791,6.9365105272,21.398908293,41,2.003880819,7.8523112634,23.402789112
37,87,2001,554,636,549,982,31,-82,580,456,54562,10.196193912,11.705377848,10.104170501,-42,0.5705451467,-1.509183936,10.674715648
37,87,2002,566,674,475,973,28,-108,503,355,54917,10.339882535,12.312863654,8.6774632578,-40,0.5115136236,-1.97298112,9.1889768814
37,87,2003,575,612,492,991,21,-37,513,430,55347,10.429514619,11.100631212,8.924036857,-46,0.3809040122,-0.671116593,9.3049408692
37,87,2004,559,669,615,988,21,-110,636,467,55814,10.05748419,12.036595569,11.065031801,-59,0.3778303542,-1.979111379,11.442862155
37,87,2005,555,721,211,953,21,-166,232,23,55837,9.9416933122,12.915244825,3.7796347547,-43,0.3761721794,-2.973551513,4.1558069341
37,87,2006,581,655,339,949,21,-74,360,256,56093,10.38148843,11.703743411,6.0573572769,-30,0.3752345216,-1.322254981,6.4325917984
37,87,2007,592,680,397,979,21,-88,418,312,56405,10.524631549,12.089103806,7.0579032516,-18,0.3733399705,-1.564472257,7.4312432221
37,87,2008,615,670,271,979,22,-55,293,185,56590,10.885437409,11.858931811,4.7966724191,-53,0.389397761,-0.973494402,5.1860701801
37,89,2001,1088,1083,1022,1887,344,5,1366,1297,90944,12.049326932,11.993953187,11.318393497,-74,3.8097136624,0.0553737451,15.128107159
37,89,2002,1065,1119,1097,1899,327,-54,1424,1314,92258,11.626510628,12.216023843,11.975851792,-56,3.5698300237,-0.589513215,15.545681816
37,89,2003,1137,1162,1058,1831,286,-25,1344,1256,93514,12.240811317,12.509958444,11.390306397,-63,3.0790431281,-0.269147127,14.469349525
37,89,2004,1148,1186,1202,1855,252,-38,1454,1319,94833,12.190265839,12.593776381,12.763675556,-97,2.6759120135,-0.403510542,15.43958757
37,89,2005,1109,1235,1457,1866,272,-126,1729,1526,96359,11.600903804,12.918950584,15.241223482,-77,2.845307335,-1.31804678,18.086530817
37,89,2006,1190,1273,1792,1872,268,-83,2060,1920,98279,12.227828071,13.08069339,18.413670506,-57,2.7538301873,-0.852865319,21.167500694
37,89,2007,1292,1239,1869,1852,241,53,2110,2166,100445,13.002958878,12.469555766,18.81000785,3,2.4254745275,0.5334031119,21.235482378
37,89,2008,1292,1247,1632,1852,243,45,1875,1922,102367,12.74086346,12.297102736,16.093722265,2,2.3963079108,0.4437607242,18.490030176
37,91,2001,277,319,99,1403,19,-42,118,56,22997,12.059732683,13.888284209,4.3101571684,-20,0.8272018808,-1.828551526,5.1373590492
37,91,2002,279,275,610,2193,19,4,629,632,23629,11.967571741,11.795993652,26.165658645,-1,0.814995925,0.1715780895,26.98065457
37,91,2003,290,310,-295,2114,14,-20,-281,-316,23313,12.355672958,13.207788335,-12.5687018,-15,0.5964807635,-0.852115376,-11.97222104
37,91,2004,309,311,-83,2052,15,-2,-68,-87,23226,13.2791852,13.365134618,-3.566900879,-17,0.6446206408,-0.085949419,-2.922280238
37,91,2005,310,290,2,2139,15,20,17,15,23241,13.342802419,12.481976456,0.0860825963,-22,0.6456194719,0.8608259625,0.7317020681
37,91,2006,318,279,-116,2152,15,39,-101,-72,23169,13.703943116,12.023270847,-4.998922646,-10,0.6464124111,1.6806722689,-4.352510235
37,91,2007,304,258,15,2246,12,46,27,73,23242,13.100342591,11.11805391,0.6463984831,0,0.5171187865,1.9822886816,1.1635172696
37,91,2008,319,282,-79,2246,14,37,-65,-18,23224,13.730469591,12.137907287,-3.400335729,10,0.6025911419,1.5925623036,-2.797744587
37,93,2001,695,252,217,1167,126,443,343,754,34601,20.307386629,7.3632538569,6.3405797101,-32,3.6816269285,12.944132772,10.022206639
37,93,2002,653,241,658,1379,51,412,709,1107,35708,18.575146852,6.8554523603,18.717376154,-14,1.4507388812,11.719694491,20.168115035
37,93,2003,668,254,616,1090,-135,414,481,890,36598,18.477028186,7.0256963461,17.03869665,-5,-3.734129948,11.45133184,13.304566703
37,93,2004,737,267,792,969,211,470,1003,1423,38021,19.753682038,7.1563542797,21.227837414,-50,5.6553960787,12.597327758,26.883233493
37,93,2005,762,269,1063,1076,105,493,1168,1625,39646,19.622233381,6.927008897,27.373273076,-36,2.7038510564,12.695224484,30.077124133
37,93,2006,777,252,767,1101,155,525,922,1423,41069,19.252926965,6.2441925293,19.005141547,-24,3.8406739763,13.008734436,22.845815524
37,93,2007,868,267,390,953,78,601,468,1066,42135,20.86438152,6.417960675,9.3745493005,-3,1.8749098601,14.446420845,11.249459161
37,93,2008,814,269,621,953,116,545,737,1274,43409,19.031141869,6.2891611335,14.518844104,-8,2.7120546152,12.741980735,17.230898719
37,95,2001,59,79,-139,673,5,-20,-134,-158,5670,10.262654375,13.741520264,-24.17811793,-4,0.8697164724,-3.47886589,-23.30840146
37,95,2002,64,59,29,702,5,5,34,36,5706,11.251758087,10.372714487,5.0984528833,-3,0.8790436006,0.8790436006,5.9774964838
37,95,2003,59,65,-159,706,4,-6,-155,-161,5545,10.487956626,11.554528486,-28.2641543,0,0.7110479069,-1.06657186,-27.55310639
37,95,2004,52,69,-86,674,3,-17,-83,-105,5440,9.4674556213,12.562585344,-15.65771507,-5,0.5461993628,-3.095129722,-15.1115157
37,95,2005,58,78,-20,714,4,-20,-16,-41,5399,10.702094289,14.39247163,-3.690377341,-5,0.7380754682,-3.690377341,-2.952301873
37,95,2006,64,62,-165,690,3,2,-162,-162,5237,12.034599473,11.65851824,-31.02670177,-2,0.5641218503,0.3760812335,-30.46257992
37,95,2007,65,47,-33,724,4,18,-29,-21,5216,12.436621066,8.9926336937,-6.313976849,-10,0.7653305271,3.443987372,-5.548646322
37,95,2008,57,57,-33,724,3,0,-30,-35,5181,10.964701356,10.964701356,-6.347984996,-5,0.5770895451,0,-5.770895451
37,97,2001,1859,1091,2465,1580,339,768,2804,3495,127104,14.829705679,8.7031785348,19.663918504,-77,2.7042873724,6.1265271446,22.368205877
37,97,2002,1838,1085,2141,1662,322,753,2463,3137,130241,14.284326488,8.4322601955,16.639142008,-79,2.5024772193,5.8520662923,19.141619227
37,97,2003,1859,1171,1705,1671,277,688,1982,2592,132833,14.13290557,8.9024380973,12.962132328,-78,2.1058713518,5.230467473,15.06800368
37,97,2004,1767,1103,2570,1675,263,664,2833,3329,136162,13.137790665,8.2008959274,19.108161862,-168,1.9554266808,4.9368947378,21.063588543
37,97,2005,1824,1255,3135,1658,275,569,3410,3860,140022,13.208585581,9.0881441358,22.702256467,-119,1.9914260059,4.1204414448,24.693682473
37,97,2006,2053,1276,4899,1677,278,777,5177,5868,145890,14.361062145,8.9258233303,34.269285654,-86,1.9446542992,5.4352388147,36.213939954
37,97,2007,2016,1223,4020,1698,245,793,4265,5116,151006,13.580513042,8.2385751239,27.080189696,58,1.650409571,5.3419379177,28.730599267
37,97,2008,2152,1270,3161,1698,247,882,3408,4353,155359,14.048602158,8.2907642844,20.635516459,63,1.6124557309,5.7578378731,22.24797219
37,99,2001,380,284,260,2769,19,96,279,347,33618,11.362107372,8.4916802464,7.774073465,-28,0.5681053686,2.8704271255,8.3421788336
37,99,2002,361,315,397,2879,18,46,415,441,34059,10.668321586,9.3089232679,11.732198531,-20,0.5319384725,1.3593983185,12.264137004
37,99,2003,355,336,773,3219,8,19,781,813,34872,10.300155228,9.7488793141,22.428225327,13,0.2321161741,0.5512759136,22.660341501
37,99,2004,332,310,580,3493,12,22,592,572,35444,9.4430854997,8.8173388702,16.496956596,-42,0.3413163434,0.6257466295,16.838272939
37,99,2005,394,335,162,3472,11,59,173,202,35646,11.084540723,9.4246729498,4.5576030384,-30,0.309466873,1.6598677732,4.8670699114
37,99,2006,419,303,518,3521,11,116,529,625,36271,11.652321426,8.4263804108,14.405495224,-20,0.3059081997,3.2259410153,14.711403423
37,99,2007,417,318,-89,3100,9,99,-80,1,36272,11.496629585,8.7672139283,-2.453717106,-18,0.2481286961,2.7294156569,-2.20558841
37,99,2008,428,304,357,3100,11,124,368,467,36739,11.724260728,8.3275122927,9.7793483174,-25,0.301324458,3.3967484352,10.080672775
37,101,2001,2077,948,2754,1789,556,1129,3310,4382,127682,16.55098772,7.5543266051,21.94579691,-57,4.4305966165,8.9966611151,26.376393526
37,101,2002,2148,983,3108,1789,519,1165,3627,4763,132445,16.515009976,7.5578467441,23.896020021,-29,3.9903585556,8.9571632318,27.886378577
37,101,2003,2131,953,2077,1865,439,1178,2516,3647,136092,15.871183487,7.0977183777,15.469004271,-47,3.269568067,8.7734651091,18.738572338
37,101,2004,2246,1119,3259,1859,427,1127,3686,4621,140713,16.228030563,8.0851140695,23.547262513,-192,3.0852043858,8.1429164936,26.632466899
37,101,2005,2352,1089,2986,1867,437,1263,3423,4558,145271,16.448472642,7.6158106747,20.882287121,-128,3.0561150274,8.8326619671,23.938402148
37,101,2006,2287,1009,3671,1854,450,1278,4121,5315,150586,15.460171637,6.8208627817,24.816042886,-84,3.0420101603,8.6393088553,27.858053046
37,101,2007,2476,1030,4350,1834,412,1446,4762,6294,156880,16.10584585,6.6999277969,28.295811569,86,2.6799711188,9.4059180527,30.975782688
37,101,2008,2602,1073,4552,1834,417,1529,4969,6548,163428,16.246862395,6.6998014411,28.422643206,50,2.6037438965,9.5470609538,31.026387102
37,103,2001,88,121,-53,113,8,-33,-45,-92,10284,8.5188770571,11.713455954,-5.130687318,-14,0.7744433688,-3.194578896,-4.35624395
37,103,2002,93,125,-82,102,6,-32,-76,-117,10167,9.0949097844,12.224341108,-8.019167767,-9,0.5867683732,-3.129431324,-7.432399394
37,103,2003,92,124,-115,120,0,-32,-115,-154,10013,9.117938553,12.289395441,-11.39742319,-7,0,-3.171456888,-11.39742319
37,103,2004,96,106,157,113,11,-10,168,145,10158,9.5186158346,10.510138317,15.56690298,-13,1.090674731,-0.991522483,16.657577711
37,103,2005,86,98,-68,110,7,-12,-61,-81,10077,8.5001235483,9.6861872992,-6.721027922,-8,0.6918705214,-1.186063751,-6.029157401
37,103,2006,106,97,-77,108,9,9,-68,-65,10012,10.553038977,9.6570262333,-7.665886804,-6,0.8960127433,0.8960127433,-6.76987406
37,103,2007,97,104,74,105,6,-7,80,76,10088,9.6517412935,10.348258706,7.3631840796,3,0.5970149254,-0.696517413,7.960199005
37,103,2008,97,116,29,105,8,-19,37,25,10113,9.603484976,11.484579971,2.8711449928,7,0.792039998,-1.881094995,3.6631849908
37,105,2001,800,502,-524,883,322,298,-202,1759,51166,15.908842333,9.9827985642,-10.42029173,1663,6.4033090392,5.9260437692,-4.016982689
37,105,2002,830,459,-1503,865,297,371,-1206,518,51684,16.140009723,8.9256198347,-29.22702965,1353,5.7754010695,7.2143898882,-23.45162859
37,105,2003,810,450,-808,878,244,360,-564,1188,52872,15.494089292,8.6078273844,-15.45583228,1392,4.6673552929,6.8862619075,-10.78847699
37,105,2004,877,501,-520,880,267,376,-253,1545,54417,16.348367493,9.3392612477,-9.693444808,1422,4.9772110841,7.0091062457,-4.716233724
37,105,2005,782,503,506,923,264,279,770,1053,55470,14.232802788,9.1548590825,9.2094606277,4,4.8049359797,5.0779437058,14.014396607
37,105,2006,937,459,504,951,277,478,781,1259,56729,16.702466154,8.1818911042,8.9840372909,0,4.9376554158,8.5205750497,13.921692707
37,105,2007,961,476,360,956,244,485,604,1086,57815,16.779578153,8.3112166504,6.2857941053,-3,4.2603715603,8.468361503,10.546165666
37,105,2008,973,523,573,956,250,450,823,1276,59091,16.645852223,8.947359417,9.8027475065,3,4.2769404479,7.6984928062,14.079687954
37,107,2001,834,707,-683,1711,81,127,-602,-515,58978,14.079394957,11.935410354,-11.53024791,-40,1.3674232513,2.1439846038,-10.16282466
37,107,2002,823,726,-622,1654,76,97,-546,-488,58490,14.012326761,12.360813158,-10.59011816,-39,1.2939694215,1.6515136037,-9.296148738
37,107,2003,744,694,-562,1655,56,50,-506,-508,57982,12.77560272,11.917027268,-9.650388076,-52,0.9616045058,0.8585754516,-8.68878357
37,107,2004,771,732,-481,1609,71,39,-410,-422,57560,13.345796334,12.670717142,-8.325976701,-51,1.2289903239,0.675079192,-7.096986377
37,107,2005,781,692,-330,1599,66,89,-264,-230,57330,13.595613195,12.046305161,-5.744625294,-55,1.1489250588,1.5493080338,-4.595700235
37,107,2006,841,678,-531,1571,70,163,-461,-321,57009,14.710641164,11.859470522,-9.288169391,-23,1.2244291099,2.8511706417,-8.063740281
37,107,2007,788,673,-517,1574,64,115,-453,-324,56685,13.861769311,11.838795363,-9.094587225,14,1.1258289795,2.0229739476,-7.968758246
37,107,2008,792,693,-41,1574,67,99,26,141,56826,13.954594709,12.21027037,-0.722396948,16,1.1805023302,1.7443243386,0.4581053819
37,109,2001,904,568,476,886,284,336,760,1036,65125,13.992291857,8.7916170074,7.3676227034,-60,4.3958085037,5.2006748495,11.763431207
37,109,2002,881,587,388,900,270,294,658,897,66022,13.435305421,8.9517869261,5.9170244077,-55,4.1175169848,4.4835184945,10.034541392
37,109,2003,842,574,418,889,235,268,653,846,66868,12.672134848,8.6387237565,6.2909173,-75,3.5367597261,4.0334110919,9.8276770261
37,109,2004,912,603,202,903,218,309,420,682,67550,13.569611213,8.9720126769,3.005549852,-47,3.2436132066,4.5975985359,6.2491630585
37,109,2005,801,629,1109,890,229,172,1338,1449,68999,11.73205223,9.2128100535,16.243253338,-61,3.3541073168,2.5192421768,19.597360654
37,109,2006,918,601,1457,894,229,317,1686,1965,70964,13.117752549,8.5879839672,20.819788087,-38,3.2722933918,4.5297685817,24.092081479
37,109,2007,899,616,1294,892,211,283,1505,1804,72768,12.50939248,8.5715080845,18.005732892,16,2.9360198147,3.937884396,20.941752706
37,109,2008,956,604,1379,892,213,352,1592,1978,74746,12.961481622,8.1890532424,18.696530499,34,2.8878614911,4.7724283797,21.58439199
37,111,2001,556,425,243,1480,83,131,326,420,42680,13.091594066,10.00706381,5.7216858959,-37,1.954320697,3.0845302567,7.6760065929
37,111,2002,495,479,-67,1476,80,16,13,-13,42667,11.599704735,11.224764784,-1.570061045,-42,1.8746997551,0.374939951,0.3046387102
37,111,2003,510,393,49,1479,60,117,109,165,42832,11.929964093,9.1930899777,1.1462122364,-61,1.4035251874,2.7368741155,2.5497374238
37,111,2004,492,440,-26,1424,61,52,35,58,42890,11.478966893,10.26574275,-0.606612072,-29,1.4232052449,1.2132241432,0.8165931733
37,111,2005,513,440,70,1487,62,73,132,164,43054,11.938006144,10.239225542,1.6289676999,-41,1.4427999628,1.6987806013,3.0717676627
37,111,2006,550,445,8,1465,64,105,72,156,43210,12.751553371,10.317165909,0.1854771399,-21,1.4838171195,2.4343874617,1.6692942595
37,111,2007,530,440,172,1456,49,90,221,306,43516,12.222401587,10.14689943,3.9665152319,-5,1.1299956184,2.0755021562,5.0965108503
37,111,2008,507,398,194,1456,51,109,245,327,43843,11.607275724,9.1118259138,4.4414427821,-27,1.1675957829,2.4954498106,5.609038565
37,113,2001,336,379,430,540,37,-43,467,404,30365,11.139475516,12.565063157,14.255876405,-20,1.2266684348,-1.42558764,15.48254484
37,113,2002,319,358,410,546,36,-39,446,391,30756,10.438310892,11.714468022,13.416010864,-16,1.1779911978,-1.276157131,14.594002061
37,113,2003,302,411,391,514,26,-109,417,297,31053,9.7720396706,13.299034121,12.651879176,-11,0.8413014286,-3.526994451,13.493180605
37,113,2004,318,396,442,538,27,-78,469,359,31412,10.181701753,12.679100296,14.151925078,-32,0.8644841111,-2.497398543,15.016409189
37,113,2005,357,450,397,511,27,-93,424,302,31714,11.31071191,14.257199886,12.578018566,-29,0.8554319932,-2.946487976,13.433450559
37,113,2006,364,395,465,486,27,-31,492,445,32159,11.397617147,12.368293332,14.560142783,-16,0.8454276455,-0.970676186,15.405570429
37,113,2007,390,431,446,527,22,-41,468,436,32595,12.045587917,13.311918955,13.775210798,9,0.679494703,-1.266331037,14.454705501
37,113,2008,399,422,387,527,24,-23,411,410,33005,12.164634146,12.865853659,11.798780488,22,0.7317073171,-0.701219512,12.530487805
37,115,2001,213,230,160,874,10,-17,170,138,19828,10.779897768,11.640265196,8.0975757882,-15,0.5060984868,-0.860367428,8.603674275
37,115,2002,233,199,-5,858,9,34,4,18,19846,11.745727681,10.031758835,-0.252054242,-20,0.4536976357,1.7139688461,0.2016433937
37,115,2003,212,224,-19,874,6,-12,-13,-52,19794,10.696266398,11.301715439,-0.958627649,-27,0.3027245207,-0.605449041,-0.655903128
37,115,2004,228,222,99,968,13,6,112,102,19896,11.48904006,11.186696901,4.9886621315,-16,0.6550768456,0.3023431595,5.6437389771
37,115,2005,194,233,139,962,10,-39,149,92,19988,9.7282118143,11.683883261,6.9702136195,-18,0.5014542172,-1.955671447,7.4716678367
37,115,2006,191,212,115,931,12,-21,127,97,20085,9.5326029995,10.58069024,5.7395253662,-9,0.5989069947,-1.048087241,6.3384323609
37,115,2007,205,236,208,926,8,-31,216,193,20278,10.157817803,11.693878057,10.306468796,8,0.396402646,-1.536060253,10.702871442
37,115,2008,215,245,164,926,10,-30,174,154,20432,10.562515352,12.036354704,8.0569884549,10,0.4912797838,-1.473839352,8.5482682388
37,117,2001,349,302,-437,291,24,47,-413,-382,25113,13.792285805,11.934871957,-17.26999684,-16,0.9484666456,1.8574138476,-16.32153019
37,117,2002,306,333,-238,291,22,-27,-216,-263,24850,12.249064308,13.329864099,-9.527050017,-20,0.8806516822,-1.080799792,-8.646398335
37,117,2003,303,359,-151,291,17,-56,-134,-218,24632,12.246877652,14.510326988,-6.103229457,-28,0.6871185482,-2.263449335,-5.416110909
37,117,2004,323,323,-267,291,22,0,-245,-267,24365,13.184480682,13.184480682,-10.89862645,-22,0.8980141641,0,-10.00061228
37,117,2005,275,342,-317,291,19,-67,-298,-381,23984,11.375623074,14.147138514,-13.11299096,-16,0.7859521397,-2.77151544,-12.32703882
37,117,2006,289,315,-84,291,23,-26,-61,-98,23886,12.07436808,13.160643409,-3.509504909,-11,0.960935868,-1.086275329,-2.548569041
37,117,2007,319,324,-363,291,20,-5,-343,-359,23527,13.456225086,13.667137705,-15.31225613,-11,0.8436504756,-0.210912619,-14.46860566
37,117,2008,307,328,-106,291,22,-21,-84,-129,23398,13.084709643,13.979754928,-4.517847629,-24,0.9376664891,-0.895045285,-3.58018114
37,119,2001,11997,4569,8345,15607,4723,7428,13068,19961,720675,16.880670949,6.4289226946,11.742035432,-535,6.6456121442,10.451748255,18.387647576
37,119,2002,12273,4570,4744,15505,4433,7703,9177,16289,736964,16.839560412,6.2704140051,6.5091562451,-591,6.0824387931,10.569146407,12.591595038
37,119,2003,12474,4705,6393,15557,3885,7769,10278,17373,754337,16.729017147,6.3099267016,8.573721871,-674,5.210215778,10.419090445,13.783937649
37,119,2004,12770,4744,8204,15762,3540,8026,11744,19025,773362,16.717952948,6.2106475163,10.740335629,-745,4.6344207858,10.507305431,15.374756415
37,119,2005,13259,4809,14965,16478,3724,8450,18689,26432,799794,16.856560951,6.1138246938,19.025449479,-707,4.7344319317,10.742736258,23.75988141
37,119,2006,14021,4726,19729,16394,3738,9295,23467,32284,832078,17.1839458,5.7921209507,24.179592517,-478,4.581241666,11.391824849,28.760834183
37,119,2007,14767,4791,18073,16885,3403,9976,21476,31723,863801,17.415157567,5.6501672584,21.314020635,271,4.0132580214,11.764990309,25.327278656
37,119,2008,14973,4966,13060,16885,3412,10007,16472,26714,890515,17.069900748,5.6614657793,14.888993773,235,3.8898351266,11.408434968,18.7788289
37,121,2001,158,219,179,187,20,-61,199,126,15855,10.005065856,13.867781155,11.33485309,-12,1.2664640324,-3.862715299,12.601317123
37,121,2002,177,199,8,187,20,-22,28,-9,15846,11.166840163,12.554808997,0.5047159396,-15,1.2617898489,-1.387968834,1.7665057885
37,121,2003,168,204,-7,187,17,-36,10,-49,15797,10.618462219,12.89384698,-0.442435926,-23,1.0744872484,-2.275384761,0.6320513226
37,121,2004,162,211,132,187,16,-49,148,85,15882,10.227595568,13.321127561,8.3335963888,-14,1.0101328956,-3.093531993,9.3437292844
37,121,2005,153,189,-52,187,17,-36,-35,-87,15795,9.6600056824,11.932948196,-3.283139186,-16,1.0733339647,-2.272942513,-2.209805221
37,121,2006,150,193,-98,187,17,-43,-81,-130,15665,9.5359186268,12.269548633,-6.230133503,-6,1.0807374444,-2.733630006,-5.149396058
37,121,2007,177,210,118,187,17,-33,135,105,15770,11.261332909,13.360903452,7.5075552728,3,1.0815969461,-2.099570542,8.5891522189
37,121,2008,168,200,17,187,16,-32,33,14,15784,10.648412246,12.676681245,1.0775179058,13,1.0141344996,-2.028268999,2.0916524054
37,123,2001,426,251,-266,1072,172,175,-94,56,26976,15.808223245,9.3142348226,-9.870862402,-25,6.3826629063,6.4939884221,-3.488199495
37,123,2002,399,272,-239,1087,165,127,-74,33,27009,14.781883857,10.076873206,-8.854311383,-20,6.1128091136,4.7050106511,-2.741502269
37,123,2003,356,266,21,1090,125,90,146,197,27206,13.1328968,9.8127824403,0.7746933505,-39,4.6112699437,3.3201143595,5.3859632943
37,123,2004,382,297,-361,884,117,85,-244,-187,27019,14.089442139,10.954356846,-13.31489166,-28,4.3153526971,3.1350852928,-8.999538958
37,123,2005,379,303,-112,971,121,76,9,60,27079,14.011608562,11.201892861,-4.140633665,-25,4.4733631558,2.8097157011,0.3327294909
37,123,2006,402,284,-125,954,120,118,-5,101,27180,14.817818242,10.468309405,-4.607530548,-12,4.423229326,4.3495088372,-0.184301222
37,123,2007,425,229,-148,966,100,196,-48,143,27323,15.595471809,8.4032071629,-5.430893712,-5,3.6695227786,7.192264646,-1.761370934
37,123,2008,414,245,-237,966,102,169,-135,35,27358,15.142371208,8.9610650866,-8.66845888,1,3.7307291381,6.181306121,-4.937729742
37,125,2001,906,879,963,1680,185,27,1148,1123,76304,11.961580354,11.605109417,12.714130112,-52,2.4424860547,0.3564709377,15.156616167
37,125,2002,884,872,1152,1617,153,12,1305,1274,77578,11.489322988,11.333359327,14.972511405,-43,1.988536671,0.1559636605,16.961048076
37,125,2003,915,938,859,1618,61,-23,920,861,78439,11.729491017,12.024330682,11.011620529,-36,0.7819660678,-0.294839665,11.793586596
37,125,2004,905,942,1026,1598,179,-37,1205,1081,79520,11.458669655,11.927145652,12.99071278,-87,2.2664109041,-0.468475997,15.257123684
37,125,2005,990,970,1240,1598,146,20,1386,1326,80846,12.346756794,12.097327364,15.464624671,-80,1.8208348403,0.2494294302,17.285459511
37,125,2006,961,932,1362,1569,163,29,1525,1512,82358,11.77667214,11.421288694,16.690767383,-42,1.9975000613,0.3553834465,18.688267444
37,125,2007,1016,943,1614,1586,121,73,1735,1851,84209,12.199295179,11.322771017,19.379588994,43,1.4528688156,0.8765241614,20.83245781
37,125,2008,1077,986,1124,1586,135,91,1259,1399,85608,12.684242449,11.612500515,13.237779492,49,1.5899468251,1.071741934,14.827726317
37,127,2001,1296,895,45,2138,122,401,167,472,88177,14.737153319,10.177277948,0.5117067125,-96,1.3872937538,4.559875371,1.8990004662
37,127,2002,1224,890,132,2090,113,334,245,484,88661,13.843178502,10.065709859,1.4928917993,-95,1.2780058585,3.7774686436,2.7708976577
37,127,2003,1181,870,265,2105,83,311,348,527,89188,13.280929328,9.7835804531,2.980056115,-132,0.9333760662,3.4973488746,3.9134321812
37,127,2004,1166,903,401,2217,100,263,501,699,89887,13.022476616,10.085159849,4.4785704314,-65,1.1168504816,2.9373167667,5.595420913
37,127,2005,1257,965,200,2236,98,292,298,523,90410,13.943659628,10.704559699,2.2185615956,-67,1.0870951818,3.2390999296,3.3056567774
37,127,2006,1164,904,546,2222,101,260,647,859,91269,12.813808971,9.9516179636,6.0106011152,-48,1.111851122,2.8621910072,7.1224522372
37,127,2007,1286,903,979,2128,89,383,1068,1436,92705,13.980236338,9.8166045202,10.642808223,-15,0.9675280203,4.1636318175,11.610336243
37,127,2008,1298,934,533,2128,92,364,625,969,93674,13.928607837,10.022588382,5.7195284877,-20,0.9872356864,3.906019455,6.7067641741
37,129,2001,2090,1376,2131,4478,264,714,2395,2988,163806,12.876435507,8.4775001232,13.129035438,-121,1.6264971167,4.3989353837,14.755532555
37,129,2002,1972,1442,2558,4386,227,530,2785,3217,167023,11.921566731,8.7174945365,15.464182402,-98,1.3723101663,3.2040721944,16.836492569
37,129,2003,2026,1434,2486,4617,144,592,2630,3144,170167,12.01696373,8.50559032,14.745395771,-78,0.8541178564,3.5113734097,15.599513627
37,129,2004,2141,1427,5065,4691,241,714,5306,5750,175917,12.372718762,8.24655286,29.270350551,-270,1.3927254655,4.1261659019,30.663076016
37,129,2005,2272,1544,5534,4620,217,728,5751,6329,182246,12.686960965,8.6217727683,30.902131153,-150,1.2117387893,4.0651881964,32.113869942
37,129,2006,2435,1453,3573,4755,240,982,3813,4692,186938,13.191254226,7.8714137124,19.356201786,-103,1.3001646875,5.3198405131,20.656366473
37,129,2007,2504,1522,1966,4739,198,982,2164,3166,190104,13.282339898,8.0733711364,10.428546422,20,1.0502808706,5.2089687621,11.478827292
37,129,2008,2540,1535,1153,4739,210,1005,1363,2434,192538,13.276117102,8.0231652563,6.0265208733,66,1.0976317289,5.2529518453,7.1241526022
37,131,2001,259,278,-166,879,8,-19,-158,-196,21855,11.797931946,12.663417301,-7.561608892,-19,0.3644148863,-0.865485355,-7.197194005
37,131,2002,239,278,-168,876,7,-39,-161,-215,21640,10.989768939,12.783078515,-7.725025865,-15,0.3218760777,-1.793309576,-7.403149787
37,131,2003,218,279,-133,875,3,-61,-130,-211,21429,10.123290534,12.955954399,-6.176135968,-20,0.1393113376,-2.832663865,-6.03682463
37,131,2004,249,291,-291,799,6,-42,-285,-349,21080,11.7151662,13.69121833,-13.69121833,-22,0.2822931614,-1.97605213,-13.40892517
37,131,2005,237,314,51,838,5,-77,56,-41,21039,11.253828438,14.910135568,2.4217099171,-20,0.2374225409,-3.65630713,2.659132458
37,131,2006,245,299,-153,852,5,-54,-148,-211,20828,11.703728473,14.28332577,-7.308859006,-9,0.2388516015,-2.579597296,-7.070007404
37,131,2007,262,265,-70,801,4,-3,-66,-72,20756,12.601000385,12.745286649,-3.366679492,-3,0.1923816853,-0.144286264,-3.174297807
37,131,2008,247,285,-243,801,6,-38,-237,-269,20487,11.97779017,13.82052712,-11.78381786,6,0.2909584657,-1.842736949,-11.49285939
37,133,2001,3253,830,-2041,19198,-390,2423,-2431,-112,149664,21.727224152,5.5436815389,-13.63211328,-104,-2.60486241,16.183542613,-16.23697569
37,133,2002,3087,766,3289,20897,-1954,2321,1335,3616,153280,20.380004225,5.0570402451,21.713584029,-40,-12.90007394,15.32296398,8.8135100877
37,133,2003,3168,750,5699,25824,-5607,2418,92,2759,156039,20.483707758,4.8493626321,36.848690187,249,-36.25383504,15.634345126,0.5948551495
37,133,2004,3285,763,513,26364,2297,2522,2810,5205,161244,20.707065932,4.8095863945,3.2337061866,-127,14.47918735,15.897479537,17.712893537
37,133,2005,3293,856,-4494,24793,-155,2437,-4649,-2318,158926,20.570322016,5.3471593216,-28.07258644,-106,-0.968235625,15.223162695,-29.04082206
37,133,2006,3223,819,-1326,25619,973,2404,-353,1970,160896,20.154961197,5.1215988894,-8.292112488,-81,6.084634578,15.033362308,-2.20747791
37,133,2007,3771,815,156,26741,-587,2956,-431,2440,163336,23.261121666,5.0272644279,0.9622739273,-85,-3.620864073,18.233857238,-2.658590145
37,133,2008,3556,834,-226,26741,231,2722,5,2602,165938,21.599033024,5.0656899725,-1.372716947,-125,1.4030867909,16.533343052,0.030369844
37,135,2001,1304,710,916,9962,785,594,1701,2198,118214,11.134355121,6.0624172822,7.8213721556,-97,6.7028134739,5.0719378389,14.52418563
37,135,2002,1336,685,-2703,10015,739,651,-1964,-1341,116873,11.366004926,5.8276297711,-22.995742,-28,6.2870341618,5.5383751547,-16.70870784
37,135,2003,1332,689,-527,10391,640,643,113,619,117492,11.366884987,5.8797175346,-4.49725855,-137,5.4615663602,5.4871674525,0.9643078105
37,135,2004,1330,730,-809,10279,597,600,-212,289,117781,11.306014715,6.2055569487,-6.877117221,-99,5.0749554773,5.1004577661,-1.802161744
37,135,2005,1358,722,569,10219,633,636,1202,1738,119519,11.445427729,6.0851243152,4.795617362,-100,5.3350189633,5.3603034134,10.130636325
37,135,2006,1302,705,977,10771,636,597,1613,2145,121664,10.796780868,5.8461831887,8.1017318799,-65,5.2740035575,4.9505976789,13.375735437
37,135,2007,1349,658,1386,11331,576,691,1962,2644,124308,10.968728148,5.3502024621,11.269575399,-9,4.683459906,5.6185256859,15.953035305
37,135,2008,1439,735,950,11331,579,704,1529,2224,126532,11.473449211,5.8603093605,7.5745495136,-9,4.6164885983,5.6131398501,12.191038112
37,137,2001,101,143,-104,624,6,-42,-98,-150,12785,7.8538102644,11.119751166,-8.087091757,-10,0.466562986,-3.265940902,-7.620528771
37,137,2002,109,161,49,672,6,-52,55,-8,12777,8.5282841718,12.59682341,3.8338158204,-11,0.4694468351,-4.068539238,4.3032626555
37,137,2003,98,140,-47,673,4,-42,-43,-99,12678,7.6998625025,10.999803575,-3.6927912,-14,0.3142801021,-3.299941072,-3.378511098
37,137,2004,117,139,-120,622,6,-22,-114,-146,12532,9.2820309401,11.027370091,-9.520031733,-10,0.4760015867,-1.745339151,-9.044030147
37,137,2005,119,169,115,649,6,-50,121,57,12589,9.4741451375,13.454878389,9.1556864774,-14,0.4776879901,-3.980733251,9.6333744676
37,137,2006,111,137,-34,667,6,-26,-28,-60,12529,8.8382833028,10.908511824,-2.707221913,-6,0.4777450434,-2.070228521,-2.229476869
37,137,2007,109,131,-4,631,3,-22,-1,-26,12503,8.7088526686,10.466602748,-0.319590924,-3,0.2396931927,-1.75775008,-0.079897731
37,137,2008,111,164,39,631,5,-53,44,-1,12502,8.8782243551,13.117376525,3.1193761248,8,0.399920016,-4.23915217,3.5192961408
37,139,2001,516,405,-112,2516,26,111,-86,-6,34900,14.78382947,11.603587084,-3.208893218,-31,0.74492164,3.180242386,-2.463971578
37,139,2002,448,331,501,2607,1,117,502,598,35498,12.727634308,9.4036762408,14.233358902,-21,0.028409898,3.323958067,14.2617688
37,139,2003,481,363,496,2644,-61,118,435,533,36031,13.449090579,10.14972948,13.868500888,-20,-1.705601924,3.2993610983,12.162898964
37,139,2004,504,368,744,2801,60,136,804,893,36924,13.816736344,10.088410664,20.396134604,-47,1.6448495648,3.7283256802,22.040984168
37,139,2005,528,393,1154,2919,22,135,1176,1282,38206,14.055636896,10.461866099,30.720085186,-29,0.5856515373,3.5937707973,31.305736723
37,139,2006,561,336,1021,2942,41,225,1062,1265,39471,14.44443014,8.6512094957,26.288347902,-22,1.0556535397,5.7932206445,27.344001442
37,139,2007,603,359,944,3148,16,244,960,1209,40680,15.046599543,8.9580916021,23.55553892,5,0.3992464224,6.0885079413,23.954785343
37,139,2008,612,360,158,3148,29,252,187,431,41111,14.964971696,8.8029245271,3.8635057647,-8,0.7091244758,6.162047169,4.5726302405
37,141,2001,508,385,283,1191,107,123,390,480,41732,12.243324014,9.2788971368,6.8205919213,-33,2.5788103731,2.9644268775,9.3994022944
37,141,2002,501,374,642,1224,98,127,740,849,42581,11.884288307,8.8717042449,15.228968249,-18,2.3246711658,3.0125840618,17.553639415
37,141,2003,466,362,443,1221,49,104,492,564,43145,10.871847514,8.4455124466,10.335254182,-32,1.1431770991,2.4263350675,11.478431281
37,141,2004,415,396,1195,1221,74,19,1269,1220,44365,9.484630328,9.0503942407,27.311164438,-68,1.6912352874,0.4342360873,29.002399726
37,141,2005,516,379,1204,1223,69,137,1273,1373,45738,11.453558705,8.4125944752,26.724970312,-37,1.5315805245,3.0409642298,28.256550836
37,141,2006,537,421,1881,1225,71,116,1952,2039,47777,11.484788537,9.0039031171,40.228840293,-29,1.5184729723,2.4808854195,41.747313265
37,141,2007,594,435,1700,1196,59,159,1759,1933,49710,12.186240217,8.9242668253,34.876445064,15,1.2104177993,3.2619733913,36.086862864
37,141,2008,614,451,1377,1196,63,163,1440,1604,51314,12.155527399,8.9285714286,27.260848907,1,1.2472283814,3.2269559709,28.508077289
37,143,2001,119,146,103,120,1,-27,104,67,11468,10.407101316,12.768376405,9.0078271896,-10,0.0874546329,-2.361275089,9.0952818226
37,143,2002,124,165,69,123,-2,-41,67,14,11482,10.806100218,14.379084967,6.0130718954,-12,-0.174291939,-3.572984749,5.8387799564
37,143,2003,116,150,94,119,-9,-34,85,40,11522,10.085202573,13.041210224,8.1724917406,-11,-0.782472613,-2.956007651,7.3900191271
37,143,2004,125,150,85,113,5,-25,90,54,11576,10.823447918,12.988137501,7.3599445839,-11,0.4329379167,-2.164689584,7.7928825006
37,143,2005,144,155,242,118,0,-11,242,223,11799,12.320855615,13.262032086,20.705882353,-8,0,-0.941176471,20.705882353
37,143,2006,115,141,338,120,2,-26,340,307,12106,9.6214181134,11.796695252,28.278602803,-7,0.1673290107,-2.175277139,28.445931813
37,143,2007,136,125,373,121,-1,11,372,386,12492,11.057809578,10.163427921,30.327668916,3,-0.081307423,0.894381657,30.246361493
37,143,2008,151,139,352,121,2,12,354,364,12856,11.914154963,10.967334701,27.773394351,-2,0.157803377,0.946820262,27.931197728
37,145,2001,450,369,86,401,21,81,107,152,35897,12.562463359,10.301219955,2.4008263309,-36,0.5862482901,2.2612434047,2.987074621
37,145,2002,488,396,398,406,17,92,415,481,36378,13.503977862,10.95814597,11.013490142,-26,0.4704254583,2.5458318921,11.4839156
37,145,2003,423,387,139,406,11,36,150,146,36524,11.604619901,10.616992675,3.8133384544,-40,0.3017749856,0.9876272256,4.11511344
37,145,2004,475,391,17,405,21,84,38,97,36621,12.987900745,10.691093034,0.4648301319,-25,0.5742019277,2.2968077107,1.0390320596
37,145,2005,447,380,286,408,17,67,303,334,36955,12.150701316,10.329455257,7.7742742199,-36,0.4621072089,1.8212460585,8.2363814287
37,145,2006,468,371,-2,406,19,97,17,97,37052,12.647452268,10.026078614,-0.054048941,-17,0.5134649425,2.6213736538,0.4594160012
37,145,2007,466,419,187,401,15,47,202,254,37306,12.533957342,11.269802846,5.0297210791,5,0.4034535625,1.2641544958,5.4331746416
37,145,2008,482,410,24,401,17,72,41,132,37438,12.89735631,10.970780263,0.6421920154,19,0.4548860109,1.9265760462,1.0970780263
37,147,2001,1980,1061,576,6377,319,919,895,1689,135830,14.668242145,7.8601034926,4.2671249875,-125,2.36321679,6.8081386519,6.6303417775
37,147,2002,1989,1023,725,6479,289,966,1014,1867,137697,14.543354038,7.4800659533,5.3011220099,-113,2.1131369115,7.0632880849,7.4142589214
37,147,2003,1998,1054,702,6416,244,944,946,1726,139423,14.419745958,7.606812933,5.0663972286,-164,1.7609699769,6.8129330254,6.8273672055
37,147,2004,2049,1096,1067,6297,255,953,1322,2151,141574,14.583785592,7.8007950263,7.5943871287,-124,1.8149659961,6.7829905657,9.4093531248
37,147,2005,2040,1073,1543,6132,254,967,1797,2640,144214,14.27631671,7.5090626618,10.798214061,-124,1.7775413943,6.7672540485,12.575755455
37,147,2006,2120,1109,2765,6285,258,1011,3023,3953,148167,14.501626303,7.5859922498,18.913677701,-81,1.7648205595,6.9156340528,20.678498261
37,147,2007,2313,1076,2484,6646,234,1237,2718,3971,152138,15.404338922,7.1660478514,16.543181099,16,1.5584156108,8.2382910707,18.10159671
37,147,2008,2361,1111,2424,6646,239,1250,2663,3943,156081,15.320275518,7.2091597208,15.729075755,30,1.5508453405,8.1111157975,17.279921095
37,149,2001,179,278,229,343,35,-99,264,147,18549,9.6885064004,15.046954074,12.394793104,-18,1.8944006928,-5.358447674,14.289193797
37,149,2002,187,263,158,329,34,-76,192,102,18651,10.053763441,14.139784946,8.4946236559,-14,1.8279569892,-4.086021505,10.322580645
37,149,2003,147,278,110,328,23,-131,133,-25,18626,7.8869007699,14.915363361,5.9017624809,-27,1.2340048824,-7.028462591,7.1357673633
37,149,2004,165,299,241,335,24,-134,265,112,18738,8.8320308318,16.004710416,12.90011776,-19,1.2846590301,-7.172679585,14.18477679
37,149,2005,187,278,161,339,24,-91,185,75,18813,9.9597880216,14.806529786,8.5750046603,-19,1.2782615643,-4.846741765,9.8532662246
37,149,2006,150,255,184,342,25,-105,209,96,18909,7.9529187212,13.519961826,9.755580298,-8,1.3254864535,-5.567043105,11.081066751
37,149,2007,145,303,178,334,21,-158,199,42,18951,7.6597992604,16.006339144,9.4030639197,1,1.1093502377,-8.346539884,10.512414157
37,149,2008,165,277,204,334,22,-112,226,123,19074,8.6785009862,14.569362262,10.729783037,9,1.1571334648,-5.890861275,11.886916502
37,151,2001,1908,1127,-144,1333,675,781,531,1183,132197,14.497874329,8.5634718914,-1.094179195,-129,5.1289649749,5.9344024376,4.0347857802
37,151,2002,1802,1139,-212,1344,636,663,424,964,133161,13.581651957,8.5846290671,-1.597841407,-123,4.7935242201,4.9970228898,3.1956828134
37,151,2003,1812,1127,5,1361,551,685,556,1039,134200,13.554706932,8.4305489582,0.0374026129,-202,4.1217679467,5.1241579737,4.1591705597
37,151,2004,1781,1159,-250,1414,506,622,256,782,134982,13.23268272,8.6112741565,-1.857479326,-96,3.7595381563,4.6214085637,1.9020588301
37,151,2005,1789,1144,566,1402,525,645,1091,1605,136587,13.175288785,8.4251147959,4.1683697329,-131,3.8664206887,4.7501739889,8.0347904216
37,151,2006,1742,1227,666,1408,527,515,1193,1639,138226,12.677711753,8.9297085655,4.8469322776,-69,3.8353353007,3.7480031876,8.6822675783
37,151,2007,1844,1229,164,1348,483,615,647,1286,139512,13.27870151,8.8500673296,1.1809691148,24,3.4780980636,4.4286341804,4.6590671784
37,151,2008,1907,1209,415,1348,485,698,900,1674,141186,13.587556734,8.6142402155,2.9569145487,76,3.4556712196,4.9733165181,6.4125857683
37,153,2001,701,527,-423,1594,65,174,-358,-221,46323,15.096858949,11.349564431,-9.10980219,-37,1.3998514004,3.747294518,-7.70995079
37,153,2002,651,543,68,1756,42,108,110,175,46498,14.026998201,11.699938591,1.46518568,-43,0.9049676259,2.3270596094,2.3701533058
37,153,2003,584,516,-388,1866,-20,68,-408,-384,46114,12.611756576,11.143264372,-8.379043752,-44,-0.431909472,1.468492204,-8.810953224
37,153,2004,636,536,-300,1929,84,100,-216,-152,45962,13.814674834,11.642556149,-6.516356054,-36,1.824579695,2.1721186846,-4.691776359
37,153,2005,588,496,-84,2002,54,92,-30,22,45984,12.790115938,10.788941335,-1.82715942,-40,1.1746024841,2.0011746025,-0.652556936
37,153,2006,654,540,-334,1974,70,114,-264,-170,45814,14.248676442,11.7649622,-7.27684699,-20,1.5250876925,2.4837142421,-5.751759298
37,153,2007,699,511,-120,1971,43,188,-77,109,45923,15.239216456,11.140543074,-2.616174499,-2,0.9374625288,4.0986733815,-1.67871197
37,153,2008,672,501,-134,1971,55,171,-79,82,46005,14.620137499,10.899834653,-2.915325037,-10,1.1965886346,3.7203028457,-1.718736402
37,155,2001,2081,1163,-1097,3407,488,918,-609,216,123562,16.856480956,9.4205129036,-8.885900821,-93,3.9528893353,7.4359680529,-4.933011486
37,155,2002,2041,1175,-835,3507,456,866,-379,381,123943,16.492596109,9.4947576817,-6.747338438,-106,3.684774045,6.9978384275,-3.062564393
37,155,2003,2031,1223,-493,3665,394,808,-99,540,124483,16.350945553,9.8459903553,-3.968988753,-169,3.1719707277,6.5049551979,-0.797018025
37,155,2004,1981,1186,-938,3673,376,795,-562,129,124612,15.905578193,9.5224713463,-7.531263173,-104,3.0189285212,6.3831068468,-4.512334651
37,155,2005,2129,1130,99,3881,392,999,491,1372,125984,16.991492282,9.0184998962,0.7901163626,-118,3.1285415569,7.9729923862,3.9186579195
37,155,2006,2069,1192,-497,3892,395,877,-102,714,126698,16.376314894,9.4347836411,-3.933798213,-61,3.1264593442,6.9415312527,-0.807338869
37,155,2007,2272,1187,-55,4173,349,1085,294,1368,128066,17.836114993,9.3184280354,-0.43177215,-11,2.7397905513,8.5176869573,2.3080184013
37,155,2008,2243,1202,-334,4173,352,1041,18,1057,129123,17.442425609,9.3472115837,-2.597311705,-2,2.7372865869,8.0952140255,0.1399748823
37,157,2001,1187,1020,-235,1202,210,167,-25,58,92017,12.903857025,11.088402835,-2.554681045,-84,2.2829064661,1.8154541897,-0.271774579
37,157,2002,1151,1032,144,1198,199,119,343,378,92395,12.482918682,11.192330217,1.5617204954,-84,2.1582109624,1.290588465,3.7199314578
37,157,2003,1104,1046,-324,1212,171,58,-153,-209,92186,11.962227965,11.333777583,-3.510653859,-114,1.8528450924,0.6284503822,-1.657808767
37,157,2004,1076,1059,-628,1195,155,17,-473,-529,91657,11.705640139,11.520699727,-6.831916363,-73,1.6862213954,0.1849404111,-5.145694968
37,157,2005,1065,1041,-20,1291,165,24,145,80,91737,11.614338528,11.352606956,-0.218109644,-89,1.7994045607,0.2617315725,1.581294917
37,157,2006,1072,1075,123,1284,166,-3,289,244,91981,11.670059548,11.702718297,1.3390086981,-42,1.80711743,-0.032658749,3.1461261281
37,157,2007,1105,1076,38,1273,145,29,183,211,92192,11.999587345,11.684666048,0.4126554924,-1,1.5746064841,0.3149212968,1.9872619765
37,157,2008,1116,1038,-133,1273,147,78,14,90,92282,12.099266021,11.253618396,-1.441937617,-2,1.5937205243,0.8456476251,0.1517829071
37,159,2001,1723,1358,851,4766,387,365,1238,1483,132158,13.110986824,10.33355781,6.4755947693,-120,2.9448356941,2.7774290139,9.4204304635
37,159,2002,1666,1333,582,4850,361,333,943,1160,133318,12.551040395,10.042339044,4.3845771369,-116,2.7196432069,2.5087013515,7.1042203438
37,159,2003,1673,1329,-575,4748,315,344,-260,-72,133246,12.552332648,9.9713389655,-4.314160952,-156,2.3634099128,2.5809936826,-1.950751039
37,159,2004,1647,1269,-698,4647,297,378,-401,-127,133119,12.366489591,9.5282788655,-5.240928801,-104,2.2300227132,2.8382107259,-3.010906088
37,159,2005,1617,1372,122,4547,308,245,430,552,133671,12.121893624,10.285243075,0.9145770081,-123,2.3089321189,1.8366505491,3.223509127
37,159,2006,1690,1298,873,4632,312,392,1185,1510,135181,12.571972684,9.6558701442,6.4942793805,-67,2.3209795724,2.9161025397,8.8152589529
37,159,2007,1839,1367,1055,4627,285,472,1340,1857,137038,13.511180336,10.043384187,7.751112156,45,2.093902336,3.4677961494,9.845014492
37,159,2008,1810,1313,1318,4627,288,497,1606,2187,139225,13.103455765,9.5054350384,9.54163243,84,2.0849697571,3.5980207266,11.626602187
37,161,2001,907,758,82,1537,30,149,112,197,63155,14.383925527,12.020965325,1.300421051,-64,0.4757637991,2.3629602024,1.7761848501
37,161,2002,788,751,-193,1540,28,37,-165,-183,62972,12.495341997,11.908631776,-3.060407367,-55,0.4439969237,0.5867102207,-2.616410443
37,161,2003,746,750,148,1584,22,-4,170,77,63049,11.839296625,11.902778108,2.3488148801,-89,0.3491481578,-0.063481483,2.6979630379
37,161,2004,790,756,-224,1557,24,34,-200,-214,62835,12.551237647,12.011057799,-3.558831941,-48,0.3813034222,0.5401798481,-3.177528518
37,161,2005,742,781,41,1577,23,-39,64,-33,62802,11.811807031,12.43264325,0.6526739734,-58,0.3661341802,-0.620836219,1.0188081536
37,161,2006,719,815,211,1577,23,-96,234,107,62909,11.438935336,12.966247981,3.3569059191,-31,0.3659186547,-1.527312646,3.7228245738
37,161,2007,813,797,-20,1584,20,16,0,19,62928,12.921477785,12.667180559,-0.317871532,3,0.3178715322,0.2542972258,0
37,161,2008,781,776,443,1584,22,5,465,496,63424,12.362289477,12.283145498,7.0121565151,26,0.3482335064,0.0791439787,7.3603900215
37,163,2001,902,661,-102,1346,352,241,250,432,60714,14.909583788,10.925981024,-1.686006149,-59,5.8183741611,3.9836027637,4.1323680122
37,163,2002,932,604,-256,1350,328,328,72,346,61060,15.307044197,9.9200157669,-4.204509994,-54,5.3870284297,5.3870284297,1.1825184358
37,163,2003,880,660,76,1348,277,220,353,489,61549,14.354574297,10.765930723,1.2397132348,-84,4.5184285004,3.5886435743,5.7581417351
37,163,2004,902,613,-182,1346,270,289,88,333,61882,14.615453168,9.9326749358,-2.949016049,-44,4.3749139195,4.6827782324,1.4258978701
37,163,2005,902,619,-85,1327,275,283,190,414,62296,14.527533057,9.9695598254,-1.369002561,-59,4.4291259321,4.557973232,3.0601233713
37,163,2006,926,593,-79,1350,281,333,202,504,62800,14.804630044,9.480718808,-1.263029993,-31,4.4925497218,5.3239112362,3.2295197288
37,163,2007,962,585,-61,1335,253,377,192,555,63355,15.251080021,9.2743054179,-0.967064326,-14,4.0109389243,5.9767746027,3.0438745987
37,163,2008,968,596,-57,1335,256,372,199,572,63927,15.210320391,9.3650319762,-0.895649031,1,4.0225640703,5.8452884147,3.126915039
37,165,2001,480,388,-160,1096,23,92,-137,-77,35933,13.343897252,10.786316945,-4.447965751,-32,0.6393950767,2.5575803066,-3.808570674
37,165,2002,475,316,-569,977,20,159,-549,-406,35527,13.294150574,8.8441085922,-15.924993,-16,0.5597537084,4.4500419815,-15.36523929
37,165,2003,464,364,-101,1020,13,100,-88,-36,35491,13.067109747,10.250922301,-2.84434932,-48,0.3661043679,2.8161874454,-2.478244952
37,165,2004,500,353,876,2003,23,147,899,993,36484,13.893713095,9.8089614449,24.341785342,-53,0.6391108024,4.0847516499,24.980896144
37,165,2005,493,370,-183,2040,20,123,-163,-72,36412,13.526119403,10.151448639,-5.020851624,-32,0.5487269535,3.3746707638,-4.472124671
37,165,2006,501,373,-296,2011,24,128,-272,-159,36253,13.789307094,10.266290511,-8.146975848,-15,0.6605656093,3.5230165829,-7.486410239
37,165,2007,571,376,-128,2009,19,195,-109,88,36341,15.731327658,10.358982836,-3.526462242,2,0.5234592391,5.3723448219,-3.003003003
37,165,2008,534,352,-53,2009,21,182,-32,167,36508,14.660462052,9.6638251726,-1.455064586,17,0.5765350245,4.996636879,-0.878529561
37,167,2001,762,613,148,2014,100,149,248,344,58590,13.043924818,10.493341093,2.5334657126,-53,1.7118011572,2.5505837242,4.2452668698
37,167,2002,757,598,-282,2055,95,159,-187,-83,58507,12.929451651,10.213754409,-4.816519638,-55,1.6225864027,2.7156972425,-3.193933235
37,167,2003,729,594,-218,2043,78,135,-140,-75,58432,12.468038892,10.159142801,-3.728439614,-70,1.3340288526,2.3088960911,-2.394410761
37,167,2004,740,611,-335,2060,71,129,-264,-183,58249,12.684155947,10.472999032,-5.742151679,-48,1.2169933408,2.211156915,-4.525158338
37,167,2005,697,550,17,2078,75,147,92,184,58433,11.947001251,9.4273324077,0.2913902744,-55,1.2855453283,2.5196688435,1.5769356027
37,167,2006,717,652,18,2073,74,65,92,130,58563,12.256829293,11.145680194,0.3077028274,-27,1.2650005128,1.1111490991,1.5727033403
37,167,2007,754,576,334,2051,62,178,396,590,59153,12.810493051,9.7862652486,5.6746746407,16,1.0533827177,3.0242278025,6.7280573584
37,167,2008,771,577,183,2051,63,194,246,461,59614,12.983404481,9.7165037426,3.0816640986,21,1.0609007553,3.2669007384,4.1425648539
37,169,2001,520,421,-63,557,48,99,-15,38,44871,11.5936859,9.3864264693,-1.404619638,-46,1.0701863908,2.207259431,-0.334433247
37,169,2002,483,403,-134,571,46,80,-88,-49,44822,10.770071243,8.9862085113,-2.987970076,-41,1.0257210708,1.7838627318,-1.962249005
37,169,2003,506,430,24,589,35,76,59,67,44889,11.280667923,9.5863383532,0.535051443,-68,0.7802833543,1.6943295694,1.3153347973
37,169,2004,514,429,180,586,34,85,214,268,45157,11.41638718,9.5284632299,3.9979566,-31,0.75516958,1.88792395,4.75312618
37,169,2005,449,444,201,583,36,5,237,204,45361,9.92067876,9.8102034954,4.4411056364,-38,0.795421905,0.1104752646,5.2365275415
37,169,2006,458,442,308,598,36,16,344,338,45699,10.059301559,9.707884911,6.764770481,-22,0.7906874588,0.3514166484,7.5554579398
37,169,2007,493,435,151,597,30,58,181,238,45937,10.759963333,9.494085294,3.2956479986,-1,0.654764503,1.2658780392,3.9504125016
37,169,2008,481,454,161,597,31,27,192,234,46171,10.444261085,9.8579927911,3.4958961219,15,0.6731228558,0.5862682937,4.1690189777
37,171,2001,941,728,0,1273,224,213,224,366,71652,13.166547734,10.186234591,0,-71,3.1342260281,2.9803131428,3.1342260281
37,171,2002,954,803,-45,1272,209,151,164,248,71900,13.291350869,11.187583593,-0.626950513,-67,2.9118368257,2.103767276,2.284886313
37,171,2003,912,750,-161,1271,185,162,24,91,71991,12.676261893,10.424557478,-2.237805005,-95,2.5713908445,2.2517044151,0.3335858393
37,171,2004,897,808,-488,1271,172,89,-316,-287,71704,12.484776784,11.246041964,-6.792163958,-60,2.393959428,1.2387348203,-4.39820453
37,171,2005,865,801,35,1272,180,64,215,208,71912,12.046011586,11.154745989,0.4874108734,-71,2.506684492,0.8912655971,2.9940953654
37,171,2006,869,815,-134,1268,180,54,46,67,71979,12.078587264,11.328019126,-1.862520936,-33,2.5018937946,0.7505681384,0.6393728586
37,171,2007,954,808,-124,1271,163,146,39,193,72172,13.236120457,11.210466802,-1.720418173,8,2.2615174366,2.0256536548,0.541099264
37,171,2008,921,778,-17,1271,165,143,148,296,72468,12.735066372,10.757743363,-0.235066372,5,2.2815265487,1.9773230088,2.046460177
37,173,2001,166,167,-39,409,6,-1,-33,-46,12985,12.761377614,12.838253383,-2.998154982,-12,0.4612546125,-0.076875769,-2.536900369
37,173,2002,175,153,21,390,6,22,27,35,13020,13.458950202,11.766967891,1.6150740242,-14,0.4614497212,1.6919823111,2.0765237454
37,173,2003,174,183,74,410,5,-9,79,57,13077,13.334866077,14.024600529,5.6711499406,-13,0.3831858068,-0.689734452,6.0543357474
37,173,2004,173,191,33,401,4,-18,37,10,13087,13.224277633,14.600214035,2.5225500688,-9,0.3057636447,-1.375936401,2.8283137135
37,173,2005,186,146,155,411,5,40,160,188,13275,14.111220696,11.076549579,11.75935058,-12,0.3793338897,3.0346711175,12.13868447
37,173,2006,198,186,189,407,4,12,193,197,13472,14.805398736,13.908101843,14.132426066,-8,0.2990989644,0.8972968931,14.431525031
37,173,2007,182,172,-72,208,3,10,-69,-56,13416,13.537637608,12.793811366,-5.355548944,3,0.2231478727,0.7438262422,-5.132401071
37,173,2008,198,168,60,208,2,30,62,96,13512,14.705882353,12.47771836,4.4563279857,4,0.1485442662,2.2281639929,4.6048722519
37,175,2001,292,352,-25,1008,32,-60,7,-82,29299,9.9522835719,11.997273347,-0.852079073,-29,1.0906612134,-2.044989775,0.2385821404
37,175,2002,257,348,190,998,30,-91,220,103,29402,8.7562392464,11.856697501,6.4734842677,-26,1.0221290949,-3.100458255,7.4956133626
37,175,2003,263,411,-68,961,28,-148,-40,-220,29182,8.9785606992,14.031134781,-2.321452956,-32,0.9558923938,-5.052574082,-1.365560563
37,175,2004,275,373,152,980,26,-98,178,57,29239,9.4144228959,12.769380873,5.2036082915,-23,0.890090892,-3.354957977,6.0936991835
37,175,2005,263,357,282,1015,27,-94,309,189,29428,8.9658581485,12.170385396,9.613581741,-26,0.9204493156,-3.204527247,10.534031057
37,175,2006,327,334,226,1041,26,-7,252,230,29658,11.068611854,11.305554615,7.6498662966,-15,0.8800731138,-0.236942761,8.5299394104
37,175,2007,296,353,307,1054,26,-57,333,295,29953,9.9310529936,11.843451712,10.300112395,19,0.8723222224,-1.912398718,11.172434618
37,175,2008,307,393,281,1054,25,-86,306,234,30187,10.209511141,13.06950449,9.3448619887,14,0.8313934154,-2.859993349,10.176255404
37,177,2001,49,41,-11,494,16,8,5,7,4129,11.8773482,9.9381893104,-2.666343474,-6,3.8783177797,1.9391588898,1.2119743061
37,177,2002,46,57,35,529,15,-11,50,36,4165,11.09235592,13.744875814,8.439836026,-3,3.6170725826,-2.652519894,12.056908609
37,177,2003,41,44,61,570,8,-3,69,66,4231,9.7665555026,10.481181515,14.530728919,0,1.9056693664,-0.714626012,16.436398285
37,177,2004,42,38,-97,586,8,4,-89,-91,4140,10.034643412,9.0789630868,-23.17524788,-6,1.9113606499,0.9556803249,-21.26388723
37,177,2005,45,37,-61,585,9,8,-52,-46,4094,10.930289045,8.9871265485,-14.81661404,-2,2.1860578091,1.943162497,-12.63055623
37,177,2006,50,34,0,586,9,16,9,21,4115,12.181751736,8.2835911804,0,-4,2.1927153125,3.8981605555,2.1927153125
37,177,2007,59,18,-10,653,7,41,-3,32,4147,14.282256112,4.3572984749,-2.420721375,-6,1.6945049625,9.9249576374,-0.726216412
37,177,2008,52,22,-86,653,8,30,-78,-60,4087,12.63055623,5.3436968667,-20.88899684,-12,1.943162497,7.2868593636,-18.94583435
37,179,2001,2237,850,4004,1769,583,1387,4587,5933,131492,17.40510638,6.6134735908,31.153350891,-41,4.5360648276,10.791632789,35.689415719
37,179,2002,2335,887,4642,1810,549,1448,5191,6637,138129,17.3206093,6.5796061879,34.433519644,-2,4.0723830859,10.741003112,38.50590273
37,179,2003,2389,914,3778,1818,479,1475,4257,5806,143935,16.939418004,6.480798684,26.788246639,74,3.3963923081,10.45861932,30.184638947
37,179,2004,2395,947,5592,1834,434,1448,6026,7197,151132,16.233601182,6.4188811355,37.903255871,-277,2.9417047654,9.8147200466,40.844960636
37,179,2005,2572,943,7448,2435,457,1629,7905,9410,160542,16.504424495,6.0511945173,47.793527853,-124,2.9325513196,10.453229977,50.726079172
37,179,2006,2625,998,9250,2508,456,1627,9706,11218,171760,15.79888174,6.006584372,55.672249941,-115,2.7444914566,9.7922973681,58.416741398
37,179,2007,2751,1009,9843,2555,421,1742,10264,12124,183884,15.470526706,5.6742135394,55.353105915,118,2.3675360754,9.7963131671,57.72064199
37,179,2008,3141,1049,6855,2555,423,2092,7278,9371,193255,16.656988537,5.5629356815,36.352644516,1,2.24320476,11.094052856,38.595849276
37,181,2001,750,492,190,815,115,258,305,524,43642,17.289073306,11.341632089,4.3798985708,-39,2.6509912402,5.9474412172,7.030889811
37,181,2002,713,489,-430,821,110,224,-320,-125,43517,16.360903636,11.220872199,-9.867024633,-29,2.5241225806,5.1400314368,-7.342902053
37,181,2003,681,503,-542,812,97,178,-445,-292,43225,15.701736183,11.597611307,-12.49682968,-25,2.2365174886,4.1041248761,-10.26031219
37,181,2004,656,495,-388,813,88,161,-300,-180,43045,15.208067694,11.475599861,-8.995015649,-41,2.0401066419,3.7324678335,-6.954909007
37,181,2005,694,489,-450,809,96,205,-354,-185,42860,16.157383156,11.384669111,-10.47668937,-36,2.2350270648,4.7727140446,-8.241662301
37,181,2006,659,437,-178,818,95,222,-83,120,42980,15.354147251,10.181733458,-4.147250699,-19,2.2134203169,5.1724137931,-1.933830382
37,181,2007,758,451,-497,815,85,307,-412,-88,42892,17.65418297,10.504005962,-11.57536799,17,1.9796907024,7.1501770076,-9.595677287
37,181,2008,705,471,-345,815,87,234,-258,-1,42891,16.436823147,10.981196741,-8.043551753,23,2.0283739202,5.4556264062,-6.015177832
37,183,2001,10538,3373,12585,18981,4513,7165,17098,25526,658988,16.307013811,5.2195442764,19.474641185,1263,6.9836357306,11.087469535,26.458276916
37,183,2002,10829,3253,8384,19228,4205,7576,12589,21171,680159,16.172981756,4.8583165254,12.52140355,1006,6.2801171193,11.314665231,18.80152067
37,183,2003,11056,3433,8521,18974,3645,7623,12166,20899,701058,16.009070262,4.9709784922,12.338394329,1110,5.277954152,11.03809177,17.616348481
37,183,2004,11639,3637,10393,18677,3400,8002,13793,21759,722817,16.348345185,5.1085945044,14.598191555,-36,4.7757001141,11.23975068,19.373891669
37,183,2005,11846,3652,18898,19109,3547,8194,22445,30772,753589,16.047076482,4.947148684,25.600004335,133,4.8049113862,11.099927798,30.404915721
37,183,2006,12726,3664,24966,19894,3569,9062,28535,37625,791214,16.475887217,4.7436469246,32.322567991,28,4.6206538957,11.732240292,36.943221887
37,183,2007,13270,3797,25784,20653,3228,9473,29012,38815,830029,16.370155492,4.6840603167,31.807693233,330,3.9821297609,11.686095175,35.789822994
37,183,2008,13831,4020,23238,20653,3246,9811,26484,36381,866410,16.305920814,4.7393392866,27.396210533,86,3.8268396329,11.566581528,31.223050166
37,185,2001,210,233,-5,917,21,-23,16,-30,19962,10.512088902,11.663412925,-0.250287831,-23,1.0512088902,-1.151324023,0.8009210592
37,185,2002,192,234,-87,956,21,-42,-66,-127,19835,9.6489685152,11.759680378,-4.372188858,-19,1.0553559314,-2.110711863,-3.316832927
37,185,2003,206,255,27,951,14,-49,41,-35,19800,10.394853034,12.867415163,1.3624321938,-27,0.7064463227,-2.472562129,2.0688785165
37,185,2004,190,224,17,933,13,-34,30,-20,19780,9.6008084891,11.318847903,0.8590197069,-16,0.6568974229,-1.718039414,1.5159171299
37,185,2005,227,228,-25,1093,14,-1,-11,-26,19754,11.483786108,11.534375474,-1.264734153,-14,0.7082511256,-0.050589366,-0.556483027
37,185,2006,209,230,-281,1084,13,-21,-268,-298,19456,10.660545779,11.731701097,-14.3330783,-9,0.6630961489,-1.071155318,-13.66998215
37,185,2007,236,221,-58,1056,13,15,-45,-36,19420,12.141166787,11.369482457,-2.983846075,-6,0.6687930857,0.7716843297,-2.315052989
37,185,2008,227,223,-30,1056,12,4,-18,-32,19388,11.698618841,11.492475778,-1.546072975,-18,0.6184291899,0.2061430633,-0.927643785
37,187,2001,192,204,-150,165,12,-12,-138,-160,13526,14.111421432,14.993385271,-11.02454799,-10,0.8819638395,-0.881963839,-10.14258415
37,187,2002,156,164,-161,178,11,-8,-150,-167,13359,11.604984192,12.200111586,-11.97693881,-9,0.8183001674,-0.595127394,-11.15863865
37,187,2003,152,153,-20,173,8,-1,-12,-32,13327,11.391740988,11.466686652,-1.498913288,-19,0.5995653151,-0.074945664,-0.899347973
37,187,2004,185,159,-192,169,6,26,-186,-175,13152,13.973337362,12.009516976,-14.50205823,-15,0.4531893198,1.963820386,-14.04886891
37,187,2005,146,146,-38,183,8,0,-30,-43,13109,11.11915007,11.11915007,-2.894025361,-13,0.609268497,0,-2.284756864
37,187,2006,191,143,-158,179,7,48,-151,-107,13002,14.629849489,10.953238099,-12.10217916,-4,0.5361724944,3.6766113898,-11.56600666
37,187,2007,199,141,-204,174,7,58,-197,-136,12866,15.385804855,10.901499923,-15.77238287,3,0.541209216,4.4843049327,-15.23117365
37,187,2008,181,155,42,174,6,26,48,80,12946,14.024484736,12.009917868,3.2543003254,6,0.4649000465,2.0145668681,3.7192003719
37,189,2001,364,293,347,5395,49,71,396,431,43226,8.4630497204,6.8122900222,8.0677973983,-36,1.1392566931,1.6507596982,9.2070540914
37,189,2002,333,290,117,5426,48,43,165,167,43393,7.688844249,6.6959904871,2.7014858172,-41,1.1083018737,0.9928537619,3.8097876909
37,189,2003,358,280,-127,5357,43,78,-84,-65,43328,8.2563623574,6.457490112,-2.928933015,-59,0.9916859815,1.7988722455,-1.937247034
37,189,2004,332,324,-172,5369,42,8,-130,-154,43174,7.6761230954,7.4911562738,-3.976786664,-32,0.9710758133,0.1849668216,-3.005710851
37,189,2005,376,299,205,5411,44,77,249,286,43460,8.6801948427,6.9026017499,4.7325530392,-40,1.0157674816,1.7775930928,5.7483205208
37,189,2006,400,293,551,5595,43,107,594,678,44138,9.1326285988,6.6896504486,12.580195895,-23,0.9817575744,2.4429781502,13.561953469
37,189,2007,369,292,219,5582,39,77,258,335,44473,8.3285370891,6.5906038754,4.9429529065,0,0.8802518875,1.7379332137,5.823204794
37,189,2008,418,292,562,5582,40,126,602,723,45196,9.3231774638,6.5128416733,12.534989796,-5,0.8921700922,2.8103357905,13.427159888
37,191,2001,1758,1073,-1224,4636,224,685,-1000,-400,112894,15.544591225,9.4876828125,-10.82285532,-85,1.9806532619,6.0569084125,-8.842202062
37,191,2002,1734,1012,-822,4700,38,722,-784,-154,112740,15.370024021,8.9702793019,-7.286135955,-92,0.3368286694,6.3997447193,-6.949307285
37,191,2003,1663,1042,-86,4802,-387,621,-473,-24,112716,14.752324179,9.2434887517,-0.762898304,-172,-3.433042367,5.5088354269,-4.195940671
37,191,2004,1739,1093,-199,4827,441,646,242,813,113529,15.372715419,9.6620919799,-1.759154898,-75,3.8984286946,5.7106234392,2.1392737961
37,191,2005,1793,1088,-1128,4604,190,705,-938,-326,113203,15.816029497,9.5972337385,-9.950073214,-93,1.6759875095,6.2187957589,-8.274085705
37,191,2006,1806,1053,-1622,4113,318,753,-1304,-600,112603,15.996031992,9.3265900818,-14.36631445,-49,2.8165770617,6.6694419103,-11.54973739
37,191,2007,1806,1060,-59,4141,137,746,78,793,113396,15.982371603,9.3805724804,-0.522126204,-31,1.2123947451,6.601799123,0.690268541
37,191,2008,1839,1055,-692,4141,226,784,-466,275,113671,16.197862305,9.2924114909,-6.0951173,-43,1.9906018928,6.9054508141,-4.104515407
37,193,2001,932,664,170,899,178,268,348,552,66329,14.109881459,10.052533572,2.573690824,-64,2.6948056863,4.0573478873,5.2684965104
37,193,2002,876,664,-125,896,168,212,43,195,66524,13.187507998,9.9960106283,-1.881779109,-60,2.5291111228,3.1914973693,0.6473320136
37,193,2003,876,673,-186,895,139,203,-47,66,66590,13.161650916,10.111633637,-2.794597112,-90,2.0884354764,3.0500172784,-0.706161636
37,193,2004,737,661,-409,892,136,76,-273,-251,66339,11.088626259,9.9451586937,-6.153660977,-54,2.046205117,1.1434675654,-4.10745586
37,193,2005,795,688,-81,887,137,107,56,105,66444,11.974424437,10.362772343,-1.220035697,-58,2.0635171671,1.611652094,0.8434814698
37,193,2006,793,676,-198,885,139,117,-59,26,66470,11.9325278,10.171990911,-2.979370119,-32,2.0915780129,1.7605368885,-0.887792106
37,193,2007,836,653,-55,876,130,183,75,225,66695,12.555851763,9.8073818195,-0.826042879,-33,1.952464987,2.7484699433,1.1264221079
37,193,2008,825,667,-291,876,132,158,-159,-40,66655,12.373453318,10.003749531,-4.364454443,-39,1.9797525309,2.369703787,-2.384701912
37,195,2001,1091,745,-571,1783,276,346,-295,-10,73917,14.758799816,10.078190525,-7.724358107,-61,3.7336652147,4.6806092909,-3.990692893
37,195,2002,1096,739,193,1838,257,357,450,737,74654,14.753888713,9.9481056195,2.5980844176,-70,3.4596253643,4.8057830936,6.0577097819
37,195,2003,1071,727,-272,1777,218,344,-54,187,74841,14.328238403,9.7260777952,-3.63891769,-103,2.9164855012,4.6021606074,-0.722432188
37,195,2004,1012,742,-226,1773,213,270,-13,208,75049,13.503235706,9.9005937688,-3.015544733,-49,2.8420841951,3.6026419374,-0.173460538
37,195,2005,1067,823,-32,1769,215,244,183,356,75405,14.183737222,10.940220931,-0.425379186,-71,2.8580164037,3.2435162907,2.432637218
37,195,2006,1073,778,-222,1748,217,295,-5,254,75659,14.205899486,10.300270084,-2.939151618,-36,2.8729545093,3.9056294021,-0.066197109
37,195,2007,1125,795,358,1756,196,330,554,873,76532,14.784054248,10.447398335,4.7046145961,-11,2.5757107845,4.3366559126,7.2803253806
37,195,2008,1138,740,444,1756,199,398,643,995,77527,14.773560779,9.6067091179,5.7640254708,-46,2.5834258304,5.1668516607,8.3474513011
37,197,2001,506,379,76,470,103,127,179,270,36778,13.808913026,10.343039598,2.074065988,-36,2.8109052206,3.4658734274,4.8849712087
37,197,2002,463,360,232,478,99,103,331,400,37178,12.520958408,9.7355184164,6.2740007572,-34,2.6772675645,2.7854399913,8.9512683217
37,197,2003,456,403,-146,480,76,53,-70,-63,37115,12.275719112,10.84893597,-3.930383751,-46,2.0459531854,1.4267831424,-1.884430565
37,197,2004,447,352,-235,472,74,95,-161,-96,37019,12.059244072,9.4963174792,-6.339871044,-30,1.9963849246,2.5629265924,-4.34348612
37,197,2005,499,375,91,479,75,124,166,257,37276,13.432936268,10.094891985,2.4496937883,-33,2.0189783969,3.3380442829,4.4686721852
37,197,2006,453,379,107,477,75,74,182,238,37514,12.113918973,10.135044792,2.8613450996,-18,2.005615724,1.978874181,4.8669608236
37,197,2007,494,388,-8,479,64,106,56,161,37675,13.140219979,10.320658607,-0.212797085,-1,1.7023766774,2.819561372,1.4895795928
37,197,2008,473,367,84,479,66,106,150,279,37954,12.508429306,9.7052717873,2.2213701093,23,1.7453622288,2.8031575189,3.9667323381
37,199,2001,220,212,34,155,51,8,85,75,17877,12.332184198,11.883741136,1.9058830124,-18,2.8588245186,0.4484430617,4.764707531
37,199,2002,170,153,-81,155,51,17,-30,-30,17847,9.5174112641,8.5656701377,-4.534766544,-17,2.8552233792,0.9517411264,-1.679543164
37,199,2003,173,199,-2,150,40,-26,38,-14,17833,9.697309417,11.15470852,-0.112107623,-26,2.2421524664,-1.457399103,2.130044843
37,199,2004,154,199,108,146,39,-45,147,85,17918,8.6151436323,11.132555733,6.0417890409,-17,2.1817571536,-2.5174121,8.2235461945
37,199,2005,200,212,87,152,40,-12,127,98,18016,11.131518896,11.799410029,4.8422107197,-17,2.2263037792,-0.667891134,7.0685144988
37,199,2006,186,198,71,154,40,-12,111,91,18107,10.298147994,10.962544639,3.9310134817,-8,2.2146554827,-0.664396645,6.1456689644
37,199,2007,181,215,270,149,36,-34,306,281,18388,9.9191670092,11.78243595,14.796547472,9,1.9728729963,-1.863268941,16.769420469
37,199,2008,194,202,69,149,37,-8,106,115,18503,10.517470386,10.951180505,3.7407497764,17,2.0059093004,-0.433710119,5.7466590767
38,0,2001,7677,5958,-6796,23911,577,1719,-6219,-4972,636211,12.019784029,9.3283669721,-10.64041322,-472,0.9034017695,2.6914170569,-9.737011447
38,0,2002,7680,6012,-4061,24147,181,1668,-3880,-2690,633521,12.09704095,9.469714869,-6.39662543,-478,0.2850995328,2.6273260814,-6.111525897
38,0,2003,7860,5999,-1385,24576,-647,1861,-2032,-832,632689,12.415002251,9.475521438,-2.187630804,-661,-1.021947386,2.9394808128,-3.20957819
38,0,2004,8080,5867,955,26646,961,2213,1916,3507,636196,12.735590696,9.2474889371,1.5052585538,-622,1.5147156756,3.4881017586,3.0199742293
38,0,2005,8253,5748,-3390,26110,429,2505,-2961,-974,635222,12.982355134,9.0418729324,-5.332628608,-518,0.6748370717,3.9404822018,-4.657791537
38,0,2006,8628,5725,-2087,27520,715,2903,-1372,1231,636453,13.569504787,9.0038728449,-3.282285175,-300,1.1245011501,4.5656319421,-2.157784025
38,0,2007,8719,5286,-2251,27132,364,3433,-1887,1451,637904,13.683763655,8.2959484666,-3.532762013,-95,0.5712684907,5.3878151884,-2.961493522
38,0,2008,9014,5349,-381,27207,503,3665,122,3577,641481,14.091145355,8.3618300981,-0.595598667,-210,0.7863152999,5.7293152569,0.1907166334
38,1,2001,14,38,-19,79,-1,-24,-20,-45,2531,5.4826708439,14.881535148,-7.440767574,-1,-0.391619346,-9.398864304,-7.83238692
38,1,2002,15,35,-19,79,-1,-20,-20,-43,2488,5.977286312,13.947001395,-7.571229329,-3,-0.398485754,-7.969715083,-7.969715083
38,1,2003,18,46,-17,79,-2,-28,-19,-51,2437,7.3096446701,18.680203046,-6.903553299,-4,-0.812182741,-11.37055838,-7.715736041
38,1,2004,15,35,-21,79,1,-20,-20,-42,2395,6.2086092715,14.486754967,-8.69205298,-2,0.4139072848,-8.278145695,-8.278145695
38,1,2005,19,36,-23,79,-1,-17,-24,-43,2352,8.0050558247,15.167474194,-9.690330735,-2,-0.421318728,-7.162418369,-10.11164946
38,1,2006,25,35,-58,79,0,-10,-58,-68,2284,10.78515962,15.099223469,-25.02157032,0,0,-4.314063848,-25.02157032
38,1,2007,18,26,-2,79,-1,-8,-3,-17,2267,7.9103493738,11.426060207,-0.878927708,-6,-0.439463854,-3.515710833,-1.318391562
38,1,2008,22,28,-12,80,1,-6,-11,-23,2244,9.753934826,12.414098869,-5.320328087,-6,0.4433606739,-2.660164043,-4.876967413
38,3,2001,100,158,-228,535,6,-58,-222,-286,11418,8.6497707811,13.666637834,-19.72147738,-6,0.5189862469,-5.016867053,-19.20249113
38,3,2002,119,143,-174,534,5,-24,-169,-199,11219,10.513760657,12.634182975,-15.3730618,-6,0.4417546495,-2.120422317,-14.93130715
38,3,2003,121,149,-84,504,2,-28,-82,-121,11098,10.8437514,13.353049245,-7.527893534,-11,0.1792355603,-2.509297845,-7.348657974
38,3,2004,103,147,14,553,8,-44,22,-31,11067,9.2939318746,13.2641552,1.2632528762,-9,0.7218587864,-3.970223325,1.9851116625
38,3,2005,124,172,-31,538,5,-48,-26,-84,10983,11.247165533,15.600907029,-2.811791383,-10,0.4535147392,-4.353741497,-2.358276644
38,3,2006,94,121,-99,576,7,-27,-92,-124,10859,8.6072703965,11.079571468,-9.065103928,-5,0.6409669444,-2.472301071,-8.424136984
38,3,2007,102,125,-73,572,4,-23,-69,-98,10761,9.4357076781,11.563367253,-6.753006475,-6,0.3700277521,-2.127659574,-6.382978723
38,3,2008,110,123,-64,529,6,-13,-58,-79,10682,10.259758429,11.472275335,-5.969313995,-8,0.5596231871,-1.212516905,-5.409690808
38,5,2001,131,57,-84,52,3,74,-81,-12,6945,18.846209179,8.2002589555,-12.08459215,-5,0.4315925766,10.645950223,-11.65299957
38,5,2002,118,63,-195,52,2,55,-193,-141,6804,17.164884719,9.1643028584,-28.36569932,-3,0.2909302495,8.0005818605,-28.07476907
38,5,2003,148,69,-23,52,-1,79,-24,45,6849,21.680216802,10.107668644,-3.369222881,-10,-0.146487951,11.572548158,-3.515710833
38,5,2004,155,75,2,52,0,80,2,77,6926,22.504537205,10.889292196,0.2903811252,-5,0,11.615245009,0.2903811252
38,5,2005,139,69,-80,52,0,70,-80,-16,6910,20.092512287,9.9739809193,-11.56403585,-6,0,10.118531367,-11.56403585
38,5,2006,176,67,-96,52,0,109,-96,10,6920,25.451916124,9.6890817064,-13.88286334,-3,0,15.762834418,-13.88286334
38,5,2007,146,46,-84,50,0,100,-84,17,6937,21.07238219,6.6392437035,-12.12383633,1,0,14.433138486,-12.12383633
38,5,2008,155,44,-101,50,1,111,-100,16,6953,22.318214543,6.3354931605,-14.54283657,5,0.1439884809,15.982721382,-14.39884809
38,7,2001,8,5,1,0,2,3,3,6,883,9.0909090909,5.6818181818,1.1363636364,0,2.2727272727,3.4090909091,3.4090909091
38,7,2002,11,3,-31,0,2,8,-29,-23,860,12.621916236,3.4423407917,-35.57085485,-2,2.2948938612,9.1795754446,-33.27596099
38,7,2003,8,8,-33,0,2,0,-31,-30,830,9.4674556213,9.4674556213,-39.05325444,1,2.3668639053,0,-36.68639053
38,7,2004,3,5,-23,0,1,-2,-22,-25,805,3.6697247706,6.1162079511,-28.13455657,-1,1.2232415902,-2.44648318,-26.91131498
38,7,2005,10,4,-25,0,2,6,-23,-17,788,12.554927809,5.0219711237,-31.38731952,0,2.5109855618,7.5329566855,-28.87633396
38,7,2006,5,2,-19,0,1,3,-18,-15,773,6.4061499039,2.5624599616,-24.34336963,0,1.2812299808,3.8436899423,-23.06213965
38,7,2007,10,1,14,0,1,9,15,23,796,12.746972594,1.2746972594,17.845761632,-1,1.2746972594,11.472275335,19.120458891
38,7,2008,8,2,10,0,0,6,10,15,811,9.9564405725,2.4891101431,12.445550716,-1,0,7.4673304294,12.445550716
38,9,2001,51,102,-82,327,2,-51,-80,-135,6984,7.2325037226,14.465007445,-11.62873148,-4,0.283627597,-7.232503723,-11.34510388
38,9,2002,50,92,-114,339,0,-42,-114,-161,6823,7.2427029768,13.326573477,-16.51336279,-5,0,-6.0838705,-16.51336279
38,9,2003,68,94,-13,327,-4,-26,-17,-51,6772,10.003677823,13.828613461,-1.912467819,-8,-0.588451637,-3.824935638,-2.500919456
38,9,2004,55,100,-64,290,6,-45,-58,-109,6663,8.1875697804,14.88649051,-9.527353926,-6,0.8931894306,-6.698920729,-8.634164496
38,9,2005,57,69,-32,290,2,-12,-30,-48,6615,8.585630366,10.393131496,-4.820003013,-6,0.3012501883,-1.80750113,-4.518752824
38,9,2006,74,86,-118,280,4,-12,-114,-128,6487,11.295985346,13.127766753,-18.01251717,-2,0.6105938025,-1.831781407,-17.40192337
38,9,2007,62,80,-76,275,1,-18,-75,-90,6397,9.624340267,12.41850357,-11.79757839,3,0.1552312946,-2.794163303,-11.6423471
38,9,2008,64,84,-44,270,3,-20,-41,-59,6338,10.05104044,13.191990577,-6.910090302,2,0.4711425206,-3.140950137,-6.438947782
38,11,2001,29,44,-114,90,0,-15,-114,-130,3099,9.1656131479,13.906447535,-36.03034134,-1,0,-4.740834387,-36.03034134
38,11,2002,27,53,-17,90,0,-26,-17,-46,3053,8.77763329,17.230169051,-5.526657997,-3,0,-8.452535761,-5.526657997
38,11,2003,30,47,8,90,-1,-17,7,-14,3039,9.8489822718,15.430072226,2.6263952725,-4,-0.328299409,-5.581089954,2.2980958634
38,11,2004,32,44,42,90,0,-12,42,27,3066,10.483210483,14.414414414,13.759213759,-3,0,-3.931203931,13.759213759
38,11,2005,25,40,-83,90,0,-15,-83,-100,2966,8.2891246684,13.262599469,-27.5198939,-2,0,-4.973474801,-27.5198939
38,11,2006,31,42,-18,90,0,-11,-18,-30,2936,10.504913589,14.232463572,-6.099627245,-1,0,-3.727549983,-6.099627245
38,11,2007,29,35,13,88,0,-6,13,6,2942,9.8673018033,11.908812521,4.4232732222,-1,0,-2.041510718,4.4232732222
38,11,2008,37,25,67,85,0,12,67,77,3019,12.414024493,8.3878543868,22.479449757,-2,0,4.0261701057,22.479449757
38,13,2001,15,23,-57,1,1,-8,-56,-67,2165,6.8228337503,10.461678417,-25.92676825,-3,0.4548555834,-3.638844667,-25.47191267
38,13,2002,18,24,-54,1,1,-6,-53,-61,2104,8.4328882642,11.243851019,-25.29866479,-2,0.4684937925,-2.810962755,-24.830171
38,13,2003,21,24,-39,1,1,-3,-38,-43,2061,10.084033613,11.524609844,-18.727491,-2,0.4801920768,-1.44057623,-18.24729892
38,13,2004,15,20,-32,1,0,-5,-32,-40,2021,7.3493385595,9.7991180794,-15.67858893,-3,0,-2.44977952,-15.67858893
38,13,2005,16,22,-49,1,1,-6,-48,-54,1967,8.0240722166,11.033099298,-24.57372116,0,0.5015045135,-3.009027081,-24.07221665
38,13,2006,19,25,-57,1,0,-6,-57,-64,1903,9.819121447,12.919896641,-29.45736434,-1,0,-3.100775194,-29.45736434
38,13,2007,20,15,-52,1,1,5,-51,-52,1851,10.655301012,7.9914757592,-27.70378263,-6,0.5327650506,2.6638252531,-27.17101758
38,13,2008,14,19,-20,1,0,-5,-20,-31,1820,7.6273494961,10.351402887,-10.89621357,-6,0,-2.724053391,-10.89621357
38,15,2001,866,515,248,2589,35,351,283,564,70095,12.404566485,7.3768495839,3.5523469841,-70,0.5013392921,5.0277169009,4.0536862762
38,15,2002,850,551,657,2575,26,299,683,928,71023,12.04665599,7.8090675888,9.3113564535,-54,0.3684859479,4.2375884012,9.6798424014
38,15,2003,902,529,527,2700,-1,373,526,828,71851,12.626510072,7.4051261951,7.3771294987,-71,-0.013998348,5.2213838767,7.3631311505
38,15,2004,912,529,412,2668,39,383,451,775,72626,12.624846861,7.322964901,5.7033299418,-59,0.5398783197,5.3018819605,6.2432082615
38,15,2005,960,470,1061,2859,26,490,1087,1510,74136,13.082405527,6.4049277061,14.458783609,-67,0.3543151497,6.6774778212,14.813098759
38,15,2006,1014,515,1007,2988,34,499,1041,1500,75636,13.540581684,6.8771198889,13.447106268,-40,0.454023449,6.6634617953,13.901129717
38,15,2007,1037,534,1100,3143,21,503,1121,1620,77256,13.565130942,6.9853229731,14.389242079,-4,0.2747037124,6.579807969,14.663945792
38,15,2008,1091,544,862,3374,25,547,887,1433,78689,13.992112604,6.9768187502,11.055179711,-1,0.3206258617,7.0152938536,11.375805572
38,17,2001,1747,786,216,4283,337,961,553,1394,124879,14.068061394,6.3294197227,1.7393825192,-120,2.7137588378,7.7386416711,4.453141357
38,17,2002,1715,743,-82,4150,314,972,232,1081,125960,13.674109688,5.9241186578,-0.653805828,-123,2.5035979254,7.7499910301,1.8497920977
38,17,2003,1709,846,687,4159,252,863,939,1666,127626,13.478662071,6.6722926345,5.418280189,-136,1.987491423,6.8063694368,7.405771612
38,17,2004,1892,825,2166,4956,264,1067,2430,3345,130971,14.632807032,6.3805844615,16.751934477,-152,2.0417870277,8.2522225703,18.793721505
38,17,2005,1825,742,168,4596,265,1083,433,1391,132362,13.860777039,5.6354501715,1.2759509822,-125,2.0126607755,8.2253268675,3.2886117577
38,17,2006,2005,748,1062,4828,269,1257,1331,2520,134882,15.005014144,5.5978805885,7.9477930281,-68,2.0131415485,9.4071335559,9.9609345766
38,17,2007,2055,782,934,4898,249,1273,1183,2453,137335,15.098248824,5.7454163406,6.862172458,-3,1.8294228502,9.3528324829,8.6915953082
38,17,2008,2114,786,955,4856,253,1328,1208,2583,139918,15.249609562,5.669911597,6.8890147266,47,1.8250478805,9.5796979654,8.7140626071
38,19,2001,35,63,-126,119,5,-28,-121,-151,4652,7.4034902168,13.32628239,-26.65256478,-2,1.0576414595,-5.922792173,-25.59492332
38,19,2002,51,68,-96,119,5,-17,-91,-110,4542,11.094191864,14.792255819,-20.88318469,-2,1.087665869,-3.698063955,-19.79551882
38,19,2003,36,47,-104,119,5,-11,-99,-111,4431,8.0240722166,10.475872061,-23.18065307,-1,1.1144544745,-2.451799844,-22.0661986
38,19,2004,30,50,-92,119,4,-20,-88,-114,4317,6.8587105624,11.431184271,-21.03337906,-6,0.9144947417,-4.572473708,-20.11888432
38,19,2005,31,56,-82,119,5,-25,-77,-103,4214,7.2676122377,13.128589849,-19.22400656,-1,1.1721955222,-5.860977611,-18.05181104
38,19,2006,40,67,-142,119,4,-27,-138,-166,4048,9.6828854999,16.218833212,-34.37424352,-1,0.96828855,-6.535947712,-33.40595497
38,19,2007,31,51,-134,116,5,-20,-129,-153,3895,7.8056150069,12.841495657,-33.74040035,-4,1.2589701624,-5.03588065,-32.48143019
38,19,2008,26,49,-25,110,4,-23,-21,-54,3841,6.721820062,12.668045502,-6.463288521,-10,1.0341261634,-5.94622544,-5.429162358
38,21,2001,69,73,-80,374,2,-4,-78,-85,5666,12.087238329,12.787947797,-14.01418937,-3,0.3503547342,-0.700709468,-13.66383463
38,21,2002,74,62,-91,371,2,12,-89,-81,5585,13.154386277,11.021242556,-16.17633988,-4,0.3555239534,2.1331437206,-15.82081593
38,21,2003,60,76,-88,399,2,-16,-86,-104,5481,10.844026749,13.735767215,-15.90457256,-2,0.3614675583,-2.891740466,-15.54310501
38,21,2004,67,83,92,512,1,-16,93,69,5550,12.147584081,15.048499683,16.680264709,-8,0.1813072251,-2.900915601,16.861571934
38,21,2005,84,87,-89,413,2,-3,-87,-94,5456,15.264401236,15.809558423,-16.17299655,-4,0.3634381247,-0.545157187,-15.80955842
38,21,2006,68,82,-64,426,1,-14,-63,-79,5377,12.554232438,15.138927352,-11.81574818,-2,0.1846210653,-2.584694914,-11.63112711
38,21,2007,71,54,-38,447,1,17,-37,-18,5359,13.226527571,10.059612519,-7.078986587,2,0.1862891207,3.1669150522,-6.892697466
38,21,2008,71,59,-126,419,0,12,-126,-122,5237,13.401283503,11.136277841,-23.78255946,-8,0,2.2650056625,-23.78255946
38,23,2001,10,52,-50,90,1,-42,-49,-92,2172,4.5085662759,23.444544635,-22.54283138,-1,0.4508566276,-18.93597836,-22.09197475
38,23,2002,16,35,30,90,1,-19,31,9,2181,7.3512520101,16.080863772,13.783597519,-3,0.4594532506,-8.729611762,14.24305077
38,23,2003,17,43,20,90,1,-26,21,-7,2174,7.8071182549,19.747416762,9.1848450057,-2,0.4592422503,-11.94029851,9.644087256
38,23,2004,17,33,2,90,0,-16,2,-16,2158,7.8485687904,15.235457064,0.9233610342,-2,0,-7.386888273,0.9233610342
38,23,2005,12,32,-50,90,1,-20,-49,-69,2089,5.6510477984,15.069460796,-23.54603249,0,0.4709206499,-9.418412997,-23.07511184
38,23,2006,18,35,-28,90,0,-17,-28,-46,2043,8.7124878993,16.940948693,-13.55275895,-1,0,-8.228460794,-13.55275895
38,23,2007,18,27,-32,87,1,-9,-31,-44,1999,8.9064819396,13.359722909,-15.83374567,-4,0.4948045522,-4.45324097,-15.33894112
38,23,2008,17,28,-3,101,0,-11,-3,-13,1986,8.5319949812,14.052697616,-1.505646173,1,0,-5.520702635,-1.505646173
38,25,2001,30,37,-32,53,2,-7,-30,-41,3554,8.3927822073,10.351098056,-8.952301021,-4,0.5595188138,-1.958315848,-8.392782207
38,25,2002,34,38,-49,53,2,-4,-47,-54,3500,9.6399206124,10.77402892,-13.89282676,-3,0.5670541537,-1.134108307,-13.32577261
38,25,2003,29,40,-30,53,1,-11,-29,-43,3457,8.3369268363,11.499209429,-8.624407072,-3,0.2874802357,-3.162282593,-8.336926836
38,25,2004,27,30,-91,53,0,-3,-91,-99,3358,7.9236977256,8.804108584,-26.70579604,-5,0,-0.880410858,-26.70579604
38,25,2005,30,38,-32,53,1,-8,-31,-42,3316,8.990110878,11.387473779,-9.589451603,-3,0.2996703626,-2.397362901,-9.289781241
38,25,2006,34,34,-8,53,0,0,-8,-9,3307,10.267250491,10.267250491,-2.415823645,-1,0,0,-2.415823645
38,25,2007,32,24,-21,53,1,8,-20,-14,3293,9.696969697,7.2727272727,-6.363636364,-2,0.303030303,2.4242424242,-6.060606061
38,25,2008,36,21,17,50,0,15,17,25,3318,10.890939344,6.3530479504,5.1429435789,-7,0,4.5378913931,5.1429435789
38,27,2001,27,52,-45,78,1,-25,-44,-71,2670,9.9796710405,19.220107189,-16.63278507,-2,0.3696174459,-9.240436149,-16.26316762
38,27,2002,20,47,-14,78,1,-27,-13,-42,2628,7.550018875,17.742544356,-5.285013213,-2,0.3775009438,-10.19252548,-4.907512269
38,27,2003,19,38,9,78,1,-19,10,-12,2616,7.2463768116,14.492753623,3.4324942792,-3,0.3813882532,-7.246376812,3.8138825324
38,27,2004,27,43,-7,78,0,-16,-7,-25,2591,10.370654888,16.516228154,-2.688688304,-2,0,-6.145573267,-2.688688304
38,27,2005,23,46,-20,78,1,-23,-19,-43,2548,8.9511578128,17.902315626,-7.783615489,-1,0.3891807745,-8.951157813,-7.394434715
38,27,2006,21,49,-66,78,0,-28,-66,-95,2453,8.3983203359,19.596080784,-26.39472106,-1,0,-11.19776045,-26.39472106
38,27,2007,28,35,-25,77,1,-7,-24,-32,2421,11.489536315,14.361920394,-10.25851457,-1,0.4103405827,-2.872384079,-9.848173984
38,27,2008,26,29,-26,77,0,-3,-26,-33,2388,10.813058848,12.060719484,-10.81305885,-4,0,-1.247660636,-10.81305885
38,29,2001,29,65,-74,85,0,-36,-74,-115,4186,6.8339813833,15.31754448,-17.43843525,-5,0,-8.483563097,-17.43843525
38,29,2002,39,64,-96,85,0,-25,-96,-122,4064,9.4545454545,15.515151515,-23.27272727,-1,0,-6.060606061,-23.27272727
38,29,2003,34,41,-94,85,-1,-7,-95,-102,3962,8.4724644904,10.216795415,-23.42387241,0,-0.249190132,-1.744330924,-23.67306255
38,29,2004,34,43,-73,85,0,-9,-73,-87,3875,8.6767895879,10.973586832,-18.62957764,-5,0,-2.296797244,-18.62957764
38,29,2005,32,62,-118,85,0,-30,-118,-148,3727,8.4188371481,16.311496974,-31.04446198,0,0,-7.892659826,-31.04446198
38,29,2006,34,62,-89,85,0,-28,-89,-119,3608,9.2706203136,16.905248807,-24.267212,-2,0,-7.634628494,-24.267212
38,29,2007,26,52,-97,86,0,-26,-97,-135,3473,7.3435955374,14.687191075,-27.39726027,-12,0,-7.343595537,-27.39726027
38,29,2008,29,48,-55,86,0,-19,-55,-96,3377,8.4671532847,14.01459854,-16.05839416,-22,0,-5.547445255,-16.05839416
38,31,2001,34,60,-83,83,3,-26,-80,-107,3629,9.2328581127,16.293279022,-22.53903598,-1,0.8146639511,-7.06042091,-21.72437203
38,31,2002,32,66,-35,83,3,-34,-32,-68,3561,8.9012517385,18.358831711,-9.735744089,-2,0.8344923505,-9.457579972,-8.901251739
38,31,2003,33,65,-39,83,3,-32,-36,-70,3491,9.3590470788,18.43448667,-11.060692,-2,0.8508224617,-9.075439592,-10.20986954
38,31,2004,32,48,10,83,2,-16,12,-7,3484,9.1756272401,13.76344086,2.8673835125,-3,0.5734767025,-4.58781362,3.4408602151
38,31,2005,49,32,27,83,3,17,30,43,3527,13.978034517,9.1285123378,7.702182285,-4,0.8557980317,4.8495221794,8.5579803166
38,31,2006,50,38,-13,83,2,12,-11,0,3527,14.176353842,10.77402892,-3.685851999,-1,0.5670541537,3.402324922,-3.118797845
38,31,2007,41,38,-57,82,3,3,-54,-50,3477,11.70759566,10.850942319,-16.27641348,1,0.8566533409,0.8566533409,-15.41976014
38,31,2008,41,51,-19,79,2,-10,-17,-30,3447,11.842865396,14.731369151,-5.488157135,-3,0.577700751,-2.888503755,-4.910456384
38,33,2001,12,19,-46,115,1,-7,-45,-54,1862,6.352567496,10.058231869,-24.35150873,-2,0.5293806247,-3.705664373,-23.82212811
38,33,2002,18,19,-38,115,1,-1,-37,-40,1822,9.7719869707,10.314875136,-20.62975027,-2,0.542888165,-0.542888165,-20.08686211
38,33,2003,15,15,-25,115,1,0,-24,-25,1797,8.2895827577,8.2895827577,-13.81597126,-1,0.5526388505,0,-13.26333241
38,33,2004,16,17,-60,115,0,-1,-60,-63,1734,9.0625885018,9.6290002832,-33.98470688,-2,0,-0.566411781,-33.98470688
38,33,2005,11,16,-29,115,1,-5,-28,-35,1699,6.408389164,9.3212933294,-16.89484416,-2,0.5825808331,-2.912904165,-16.31226333
38,33,2006,16,15,-36,115,0,1,-36,-35,1664,9.515313708,8.9206066012,-21.40945584,0,0,0.5947071067,-21.40945584
38,33,2007,10,12,8,114,1,-2,9,2,1666,6.006006006,7.2072072072,4.8048048048,-5,0.6006006006,-1.201201201,5.4054054054
38,33,2008,12,9,-19,114,0,3,-19,-26,1640,7.2595281307,5.444646098,-11.49425287,-10,0,1.8148820327,-11.49425287
38,35,2001,853,445,-1027,4538,97,408,-930,-562,65385,12.989979594,6.7767185454,-15.63975269,-40,1.4771723571,6.2132610483,-14.16258033
38,35,2002,812,457,-423,4674,-29,355,-452,-147,65238,12.432726243,6.9972363213,-6.476654188,-50,-0.444025937,5.4354899214,-6.920680125
38,35,2003,877,399,-19,4902,-270,478,-289,89,65327,13.433921801,6.1118982882,-0.291042776,-100,-4.135871022,7.3220235132,-4.426913798
38,35,2004,898,444,1061,6011,249,454,1310,1688,67015,13.570899639,6.7098880174,16.034214384,-76,3.7629777395,6.8610116214,19.797192123
38,35,2005,897,438,-995,5900,74,459,-921,-512,66503,13.436390599,6.5609131353,-14.90435746,-50,1.1084647763,6.8754774637,-13.79589269
38,35,2006,910,414,-101,6813,172,496,71,533,67036,13.628977303,6.2004358277,-1.512666712,-34,2.5760264792,7.4285414748,1.0633597676
38,35,2007,958,440,-1621,5910,61,518,-1560,-1010,66026,14.399302581,6.6134583878,-24.36458192,32,0.9168658219,7.7858441929,-23.4477161
38,35,2008,978,418,-95,6256,104,560,9,559,66585,14.749907625,6.3041527475,-1.432761988,-10,1.5684973343,8.445754877,0.1357353462
38,37,2001,22,42,-12,123,3,-20,-9,-31,2802,7.8083407276,14.906832298,-4.259094942,-2,1.0647737356,-7.098491571,-3.194321207
38,37,2002,23,56,-60,128,3,-33,-57,-91,2711,8.3439143842,20.315617631,-21.76673318,-1,1.0883366588,-11.97170325,-20.67839652
38,37,2003,8,35,-23,117,1,-27,-22,-52,2659,2.9795158287,13.03538175,-8.566108007,-3,0.3724394786,-10.05586592,-8.193668529
38,37,2004,13,35,-37,113,0,-22,-37,-63,2596,4.9476688868,13.320647003,-14.08182683,-4,0,-8.372978116,-14.08182683
38,37,2005,19,36,-17,119,1,-17,-16,-36,2560,7.3700543057,13.964313421,-6.594259116,-3,0.387897595,-6.594259116,-6.206361521
38,37,2006,19,38,-38,131,0,-19,-38,-58,2502,7.5069142631,15.013828526,-15.01382853,-1,0,-7.506914263,-15.01382853
38,37,2007,19,26,-39,128,1,-7,-38,-49,2453,7.6690211907,10.49445005,-15.74167508,-4,0.4036326942,-2.82542886,-15.33804238
38,37,2008,14,31,-20,127,0,-17,-20,-38,2415,5.7518488085,12.736236647,-8.216926869,-1,0,-6.984387839,-8.216926869
38,39,2001,12,38,-70,57,0,-26,-70,-96,2634,4.4742729306,14.168530947,-26.09992543,0,0,-9.694258016,-26.09992543
38,39,2002,20,45,-27,57,-1,-25,-28,-55,2579,7.6731248801,17.26453098,-10.35871859,-2,-0.383656244,-9.5914061,-10.74237483
38,39,2003,19,58,14,57,-1,-39,13,-29,2550,7.408851628,22.616494443,5.4591538312,-3,-0.389939559,-15.20764282,5.0692142718
38,39,2004,17,42,-28,57,0,-25,-28,-55,2495,6.739345887,16.650148662,-11.10009911,-2,0,-9.910802775,-11.10009911
38,39,2005,23,38,-5,57,0,-15,-5,-23,2472,9.2611234145,15.300986511,-2.013287699,-3,0,-6.039863096,-2.013287699
38,39,2006,13,43,-19,57,0,-30,-19,-51,2421,5.3137134682,17.576129164,-7.766196607,-2,0,-12.2624157,-7.766196607
38,39,2007,27,35,-12,59,0,-8,-12,-21,2400,11.200995644,14.519809168,-4.978220286,-1,0,-3.318813524,-4.978220286
38,39,2008,21,34,-28,46,0,-13,-28,-41,2359,8.8253834839,14.288716117,-11.76717798,0,0,-5.463332633,-11.76717798
38,41,2001,17,39,-43,65,0,-22,-43,-67,2624,6.3969896519,14.675446849,-16.18062088,-2,0,-8.278457197,-16.18062088
38,41,2002,15,36,-22,65,-1,-21,-23,-46,2578,5.7670126874,13.84083045,-8.458285275,-2,-0.384467512,-8.073817762,-8.842752787
38,41,2003,20,45,-52,65,-1,-25,-53,-79,2499,7.878668505,17.727004136,-20.48453811,-1,-0.393933425,-9.848335631,-20.87847154
38,41,2004,15,36,46,167,0,-21,46,21,2520,5.977286312,14.345487149,18.33034469,-4,0,-8.368200837,18.33034469
38,41,2005,21,26,-26,173,0,-5,-26,-31,2489,8.3849071671,10.381313635,-10.38131364,0,0,-1.996406468,-10.38131364
38,41,2006,19,33,6,187,0,-14,6,-10,2479,7.6489533011,13.285024155,2.4154589372,-2,0,-5.636070853,2.4154589372
38,41,2007,14,27,-48,164,0,-13,-48,-64,2415,5.7212913772,11.033919085,-19.61585615,-3,0,-5.312627707,-19.61585615
38,41,2008,16,30,-23,162,1,-14,-22,-37,2378,6.6764030878,12.51825579,-9.597329439,-1,0.417275193,-5.841852702,-9.180054246
38,43,2001,30,35,-85,45,1,-5,-84,-91,2622,11.246485473,13.120899719,-31.86504217,-2,0.3748828491,-1.874414246,-31.49015933
38,43,2002,20,32,-65,45,1,-12,-64,-78,2544,7.7429345722,12.388695316,-25.16453736,-2,0.3871467286,-4.645760743,-24.77739063
38,43,2003,27,31,2,45,-1,-4,1,-6,2538,10.625737898,12.199921291,0.7870916962,-3,-0.393545848,-1.574183392,0.3935458481
38,43,2004,16,28,-19,45,0,-12,-19,-33,2505,6.345429308,11.104501289,-7.535197303,-2,0,-4.759071981,-7.535197303
38,43,2005,21,39,-94,45,0,-18,-94,-111,2394,8.5731781996,15.921616656,-38.37517861,1,0,-7.348438457,-38.37517861
38,43,2006,25,36,-2,45,0,-11,-2,-15,2379,10.475591871,15.084852294,-0.83804735,-2,0,-4.609260423,-0.83804735
38,43,2007,27,27,-54,45,0,0,-54,-59,2320,11.491806767,11.491806767,-22.98361353,-5,0,0,-22.98361353
38,43,2008,27,24,-23,41,0,3,-23,-30,2290,11.713665944,10.412147505,-9.978308026,-10,0,1.3015184382,-9.978308026
38,45,2001,43,45,-57,79,0,-2,-57,-64,4611,9.2612534999,9.6920094766,-12.27654534,-5,0,-0.430755977,-12.27654534
38,45,2002,38,50,-62,79,0,-12,-62,-78,4533,8.3114610674,10.936132983,-13.5608049,-4,0,-2.624671916,-13.5608049
38,45,2003,49,54,-50,79,-1,-5,-51,-60,4473,10.881634466,11.99200533,-11.10370864,-4,-0.222074173,-1.110370864,-11.32578281
38,45,2004,47,65,-33,79,0,-18,-33,-54,4419,10.571300045,14.619883041,-7.422402159,-3,0,-4.048582996,-7.422402159
38,45,2005,49,71,-114,79,0,-22,-114,-137,4282,11.26307321,16.319963223,-26.20388461,-1,0,-5.056890013,-26.20388461
38,45,2006,45,60,-87,79,0,-15,-87,-105,4177,10.639555503,14.186074004,-20.56980731,-3,0,-3.546518501,-20.56980731
38,45,2007,42,42,-60,78,0,0,-60,-71,4106,10.141253169,10.141253169,-14.48750453,-11,0,0,-14.48750453
38,45,2008,49,48,-107,69,0,1,-107,-120,3986,12.110726644,11.863568957,-26.44587247,-14,0,0.2471576866,-26.44587247
38,47,2001,19,37,-67,72,1,-18,-66,-85,2214,8.4201196543,16.397075116,-29.69200089,-1,0.4431641923,-7.976955462,-29.24883669
38,47,2002,20,30,-22,72,1,-10,-21,-31,2183,9.097111667,13.645667501,-10.00682283,0,0.4548555834,-4.548555834,-9.55196725
38,47,2003,16,30,-54,72,1,-14,-53,-67,2116,7.4435915329,13.956734124,-25.12212142,0,0.4652244708,-6.513142591,-24.65689695
38,47,2004,17,32,-24,72,0,-15,-24,-41,2075,8.1126222859,15.27081842,-11.45311382,-2,0,-7.158196135,-11.45311382
38,47,2005,13,30,-43,72,1,-17,-42,-60,2015,6.3569682152,14.66992665,-21.02689487,-1,0.488997555,-8.312958435,-20.53789731
38,47,2006,18,30,-39,72,0,-12,-39,-53,1962,9.0520492834,15.086748806,-19.61277345,-2,0,-6.034699522,-19.61277345
38,47,2007,15,30,12,78,1,-15,13,-2,1960,7.6491585926,15.298317185,6.119326874,0,0.5099439062,-7.649158593,6.6292707802
38,47,2008,20,27,-9,83,0,-7,-9,-17,1943,10.248526774,13.835511145,-4.611837048,-1,0,-3.586984371,-4.611837048
38,49,2001,67,60,-133,63,-1,7,-134,-132,5818,11.386811693,10.197144799,-22.60367097,-5,-0.169952413,1.1896668933,-22.77362339
38,49,2002,41,61,-72,63,-2,-20,-74,-99,5719,7.1075669585,10.574672792,-12.481581,-5,-0.346710583,-3.467105833,-12.82829158
38,49,2003,51,60,-30,63,-4,-9,-34,-51,5668,8.9575832089,10.538333187,-5.269166593,-8,-0.702555546,-1.580749978,-5.971722139
38,49,2004,61,77,-82,63,1,-16,-81,-102,5566,10.859889621,13.708385259,-14.59854015,-5,0.1780309774,-2.848495638,-14.42050917
38,49,2005,58,74,-106,63,-1,-16,-107,-125,5441,10.538748069,13.445988916,-19.26047061,-2,-0.181702553,-2.907240847,-19.44217316
38,49,2006,44,76,-43,63,1,-32,-42,-78,5363,8.1451314328,14.068863384,-7.960014809,-4,0.1851166235,-5.923731951,-7.774898186
38,49,2007,54,50,-142,64,-1,4,-143,-152,5211,10.213731795,9.4571590694,-26.85833176,-13,-0.189143181,0.7565727256,-27.04747494
38,49,2008,55,52,-27,63,1,3,-26,-43,5168,10.598323538,10.020233163,-5.202813373,-20,0.1926967916,0.5780903748,-5.010116582
38,51,2001,26,60,-35,174,1,-34,-34,-72,3304,7.7844311377,17.964071856,-10.47904192,-4,0.2994011976,-10.17964072,-10.17964072
38,51,2002,25,59,-59,174,1,-34,-58,-94,3210,7.6757752533,18.114829598,-18.1148296,-2,0.3070310101,-10.43905434,-17.80779859
38,51,2003,25,57,-11,174,1,-32,-10,-46,3164,7.844367744,17.885158456,-3.451521807,-4,0.3137747098,-10.04079071,-3.137747098
38,51,2004,15,73,-62,174,0,-58,-62,-124,3040,4.835589942,23.533204384,-19.98710509,-4,0,-18.69761444,-19.98710509
38,51,2005,39,69,-56,174,1,-30,-55,-87,2953,13.015184382,23.026864675,-18.68846988,-2,0.3337226765,-10.01168029,-18.35474721
38,51,2006,26,69,-34,174,0,-43,-34,-79,2874,8.923974601,23.682855672,-11.66981294,-2,0,-14.75888107,-11.66981294
38,51,2007,22,61,-100,156,1,-39,-99,-144,2730,7.8515346181,21.770164168,-35.68879372,-6,0.3568879372,-13.91862955,-35.33190578
38,51,2008,25,61,-46,143,0,-36,-46,-91,2639,9.3127211771,22.723039672,-17.13540697,-9,0,-13.4103185,-17.13540697
38,53,2001,56,47,-123,61,8,9,-115,-108,5606,9.8939929329,8.3038869258,-21.73144876,-2,1.4134275618,1.5901060071,-20.3180212
38,53,2002,69,57,-3,61,8,12,5,12,5618,12.295081967,10.156806842,-0.534568781,-5,1.4255167498,2.1382751247,0.8909479686
38,53,2003,53,67,-107,61,5,-14,-102,-118,5500,9.5340888649,12.052527433,-19.2480662,-2,0.8994423457,-2.518438568,-18.34862385
38,53,2004,53,63,-25,61,4,-10,-21,-35,5465,9.667122663,11.491108071,-4.55996352,-4,0.7295941632,-1.823985408,-3.830369357
38,53,2005,65,52,56,61,5,13,61,69,5534,11.819256296,9.4554050368,10.182743886,-5,0.9091735612,2.3638512592,11.091917447
38,53,2006,72,45,-25,61,4,27,-21,3,5537,13.006955108,8.1293469425,-4.516303857,-3,0.7226086171,4.8776081655,-3.79369524
38,53,2007,59,49,41,61,3,10,44,56,5593,10.60197664,8.8050314465,7.367475292,2,0.539083558,1.7969451932,7.90655885
38,53,2008,70,48,58,59,2,22,60,81,5674,12.42566788,8.5204579746,10.295553386,-1,0.3550190823,3.905209905,10.650572468
38,55,2001,86,116,-105,200,-1,-30,-106,-145,9106,9.3697227216,12.638230648,-11.43977774,-9,-0.108950264,-3.268507926,-11.54872801
38,55,2002,54,120,-89,196,-1,-66,-90,-161,8945,5.9830480306,13.29566229,-9.860949532,-5,-0.110797186,-7.31261426,-9.971746718
38,55,2003,84,133,-43,194,-2,-49,-45,-105,8840,9.4461624965,14.956423953,-4.835535564,-11,-0.224908631,-5.510261456,-5.060444195
38,55,2004,67,120,-126,205,1,-53,-125,-185,8655,7.6593312375,13.718205201,-14.40411546,-7,0.1143183767,-6.058873964,-14.28979708
38,55,2005,75,130,-154,168,-1,-55,-155,-217,8438,8.7755221436,15.210905049,-18.01907213,-7,-0.117006962,-6.435382905,-18.1360791
38,55,2006,76,121,-48,168,0,-45,-48,-96,8342,9.0584028605,14.42193087,-5.721096544,-3,0,-5.36352801,-5.721096544
38,55,2007,71,107,22,162,-1,-36,21,-21,8321,8.5218748125,12.842825422,2.6405809278,-6,-0.120026406,-4.320950609,2.520554522
38,55,2008,83,104,40,165,1,-21,41,16,8337,9.9651818946,12.486492976,4.8024972986,-4,0.1200624325,-2.521311082,4.9225597311
38,57,2001,94,82,-124,121,6,12,-118,-111,8484,11.007670238,9.6024357398,-14.52075648,-5,0.7026172493,1.4052344985,-13.81813924
38,57,2002,60,91,-23,121,5,-31,-18,-59,8425,7.0968123485,10.763498728,-2.720444734,-10,0.591401029,-3.66668638,-2.129043705
38,57,2003,71,65,-94,121,2,6,-92,-93,8332,8.4740705377,7.7579519007,-11.21919198,-7,0.2387062123,0.716118637,-10.98048577
38,57,2004,73,87,-96,121,5,-14,-91,-114,8218,8.8217522659,10.513595166,-11.60120846,-9,0.6042296073,-1.6918429,-10.99697885
38,57,2005,65,71,-112,121,4,-6,-108,-119,8099,7.9671508243,8.7025801312,-13.72801373,-5,0.4902862046,-0.735429307,-13.23772752
38,57,2006,79,67,-133,121,4,12,-129,-121,7978,9.8277041737,8.3348883498,-16.54537538,-4,0.4976052746,1.4928158238,-16.04777011
38,57,2007,83,65,-47,122,3,18,-44,-31,7947,10.423861852,8.1632653061,-5.90266876,-5,0.3767660911,2.2605965463,-5.525902669
38,57,2008,75,70,-98,123,4,5,-94,-93,7854,9.4930700589,8.8601987216,-12.40427821,-4,0.5062970698,0.6328713373,-11.89798114
38,59,2001,283,264,-250,480,10,19,-240,-239,25072,11.233947959,10.479725304,-9.923982296,-18,0.3969592918,0.7542226545,-9.527023004
38,59,2002,296,210,-77,482,8,86,-69,-5,25067,11.807176051,8.3767127386,-3.071461337,-22,0.3191128662,3.430463312,-2.752348471
38,59,2003,303,238,-104,480,2,65,-102,-67,25000,12.103780934,9.5072602712,-4.15443306,-30,0.0798929435,2.5965206623,-4.074540116
38,59,2004,328,220,16,488,11,108,27,118,25118,13.089109701,8.7792808971,0.6384931562,-17,0.4389640449,4.309828804,1.077457201
38,59,2005,309,219,60,484,7,90,67,134,25252,12.269207862,8.6956521739,2.3823704586,-23,0.2779432202,3.5735556879,2.6603136788
38,59,2006,346,251,176,492,9,95,185,267,25519,13.629828051,9.8875342223,6.9330917256,-13,0.3545330996,3.7422938292,7.2876248252
38,59,2007,374,225,192,517,7,149,199,352,25871,14.555360965,8.7565674256,7.4722708698,4,0.2724265421,5.7987935396,7.7446974119
38,59,2008,382,238,214,525,9,144,223,384,26255,14.656793155,9.1317192956,8.2108736523,17,0.3453171162,5.5250738595,8.5561907685
38,61,2001,92,95,-55,164,1,-3,-54,-62,6541,13.998782715,14.45526476,-8.368837492,-5,0.1521606817,-0.456482045,-8.216676811
38,61,2002,89,104,-44,164,1,-15,-43,-64,6477,13.673375326,15.977876786,-6.759870948,-6,0.1536334306,-2.30450146,-6.606237517
38,61,2003,86,89,-9,164,0,-3,-9,-20,6457,13.298283594,13.762177207,-1.391680841,-8,0,-0.463893614,-1.391680841
38,61,2004,110,102,45,164,0,8,45,48,6505,16.9726894,15.738311989,6.9433729363,-5,0,1.2343774109,6.9433729363
38,61,2005,91,90,-26,164,0,1,-26,-30,6475,14.021571649,13.867488444,-4.006163328,-5,0,0.1540832049,-4.006163328
38,61,2006,99,80,-115,164,0,19,-115,-99,6376,15.407361295,12.450392966,-17.89743989,-3,0,2.9569683293,-17.89743989
38,61,2007,115,55,28,166,0,60,28,80,6456,17.92394015,8.572319202,4.3640897756,-8,0,9.3516209476,4.3640897756
38,61,2008,114,73,24,156,0,41,24,55,6511,17.58309555,11.259350659,3.7017043264,-10,0,6.3237448909,3.7017043264
38,63,2001,27,72,-62,160,1,-45,-61,-109,3587,7.4145269806,19.772071948,-17.02595084,-3,0.2746121104,-12.35754497,-16.75133873
38,63,2002,34,69,-104,160,1,-35,-103,-137,3450,9.6632087537,19.61062953,-29.55805031,1,0.2842120222,-9.947420776,-29.27383828
38,63,2003,26,72,8,160,-3,-46,5,-46,3404,7.5868106215,21.009629413,2.3344032682,-5,-0.875401226,-13.42281879,1.4590020426
38,63,2004,25,61,39,160,1,-36,40,0,3404,7.3443008226,17.920094007,11.457109283,-4,0.2937720329,-10.57579318,11.750881316
38,63,2005,20,66,22,160,-1,-46,21,-28,3376,5.8997050147,19.469026549,6.4896755162,-3,-0.294985251,-13.56932153,6.1946902655
38,63,2006,22,55,-87,160,0,-33,-87,-121,3255,6.6354999246,16.588749811,-26.24038607,-1,0,-9.953249887,-26.24038607
38,63,2007,27,59,-10,163,-1,-32,-11,-42,3213,8.3487940631,18.243661101,-3.092145949,1,-0.309214595,-9.894867038,-3.401360544
38,63,2008,22,69,-1,161,1,-47,0,-47,3166,6.8976328578,21.633484872,-0.313528766,0,0.3135287663,-14.73585201,0
38,65,2001,14,14,-85,1,1,0,-84,-86,1967,6.9651741294,6.9651741294,-42.28855721,-2,0.4975124378,0,-41.79104478
38,65,2002,18,12,-51,1,1,6,-50,-45,1922,9.2568783749,6.1712522499,-26.22782206,-1,0.5142710208,3.085626125,-25.71355104
38,65,2003,13,12,-50,1,1,1,-49,-50,1872,6.8529256721,6.3257775435,-26.35740643,-2,0.5271481286,0.5271481286,-25.8302583
38,65,2004,13,10,-44,1,0,3,-44,-43,1829,7.0251283437,5.4039448798,-23.77735747,-2,0,1.6211834639,-23.77735747
38,65,2005,22,8,-56,1,1,14,-55,-42,1787,12.168141593,4.4247787611,-30.97345133,-1,0.5530973451,7.7433628319,-30.42035398
38,65,2006,14,22,-30,1,0,-8,-30,-38,1749,7.9185520362,12.443438914,-16.96832579,0,0,-4.524886878,-16.96832579
38,65,2007,12,3,-37,1,1,9,-36,-29,1720,6.918420294,1.7296050735,-21.33179591,-2,0.5765350245,5.1888152205,-20.75526088
38,65,2008,19,4,-35,1,0,15,-35,-25,1695,11.127379209,2.3426061493,-20.49780381,-5,0,8.78477306,-20.49780381
38,67,2001,79,89,-198,183,4,-10,-194,-207,8344,9.3518792542,10.535661438,-23.43888724,-3,0.4735128736,-1.183782184,-22.96537437
38,67,2002,77,99,-138,182,3,-22,-135,-160,8184,9.3175217812,11.979670862,-16.69893514,-3,0.3630203291,-2.66214908,-16.33591481
38,67,2003,90,88,-12,197,-3,2,-15,-24,8160,11.013215859,10.768477729,-1.468428781,-11,-0.367107195,0.2447381302,-1.835535977
38,67,2004,63,81,-86,188,3,-18,-83,-110,8050,7.7729796422,9.9938309685,-10.61073411,-9,0.3701418877,-2.220851326,-10.24059223
38,67,2005,79,92,-176,181,0,-13,-176,-192,7858,9.9321096304,11.566507418,-22.12723158,-3,0,-1.634397787,-22.12723158
38,67,2006,77,92,-96,186,2,-15,-94,-114,7744,9.8705294193,11.793359826,-12.3061146,-5,0.2563773875,-1.922830406,-12.04973721
38,67,2007,78,80,-171,232,0,-2,-171,-180,7564,10.190749935,10.452051215,-22.34125947,-7,0,-0.26130128,-22.34125947
38,67,2008,75,70,-136,217,2,5,-134,-145,7419,10.011346192,9.3439231129,-18.15390776,-16,0.2669692318,0.6674230795,-17.88693853
38,69,2001,42,80,-48,134,2,-38,-46,-87,4569,9.1056910569,17.344173442,-10.40650407,-3,0.433604336,-8.238482385,-9.972899729
38,69,2002,58,76,-55,134,2,-18,-53,-73,4496,12.796469939,16.767788196,-12.13458356,-2,0.4412575841,-3.971318257,-11.69332598
38,69,2003,35,79,-63,134,2,-44,-61,-107,4389,7.8784468205,17.782779966,-14.18120428,-2,0.4501969612,-9.904333146,-13.73100732
38,69,2004,46,55,-86,134,1,-9,-85,-99,4290,10.600299574,12.674271229,-19.81795138,-5,0.2304412951,-2.073971656,-19.58751008
38,69,2005,47,72,-63,134,2,-25,-61,-90,4200,11.071849234,16.961130742,-14.8409894,-4,0.4711425206,-5.889281508,-14.36984688
38,69,2006,31,66,-6,134,1,-35,-5,-42,4158,7.4180425939,15.793251974,-1.435750179,-2,0.2392916966,-8.37520938,-1.196458483
38,69,2007,39,49,-47,139,2,-10,-45,-53,4105,9.4396708217,11.860099238,-11.37601355,2,0.4840856832,-2.420428416,-10.89192787
38,69,2008,43,59,-3,139,1,-16,-2,-14,4091,10.492923377,14.397266959,-0.732064422,4,0.2440214739,-3.904343582,-0.488042948
38,71,2001,149,149,-201,422,6,0,-195,-200,11823,12.496854818,12.496854818,-16.85817328,-5,0.5032290531,0,-16.35494423
38,71,2002,168,182,-22,436,2,-14,-20,-45,11778,14.236684886,15.423075293,-1.864327783,-11,0.1694843439,-1.186390407,-1.694843439
38,71,2003,130,187,-175,454,-4,-57,-179,-239,11539,11.150662607,16.039799288,-15.01050736,-3,-0.343097311,-4.889136681,-15.35360467
38,71,2004,132,152,-101,444,10,-20,-91,-122,11417,11.50026137,13.242725213,-8.799442412,-11,0.8712319219,-1.742463844,-7.92821049
38,71,2005,140,150,-108,443,6,-10,-102,-122,11295,12.328284607,13.208876365,-9.510390983,-10,0.5283550546,-0.880591758,-8.982035928
38,71,2006,158,119,-126,425,9,39,-117,-82,11213,14.039452639,10.574018127,-11.19601919,-4,0.7997156567,3.4654345122,-10.39630354
38,71,2007,134,136,-32,423,4,-2,-28,-27,11186,11.964819858,12.143399259,-2.857270414,3,0.3571588017,-0.178579401,-2.500111612
38,71,2008,145,130,21,433,6,15,27,48,11234,12.934879572,11.596788582,1.8733273863,6,0.5352363961,1.3380909902,2.4085637823
38,73,2001,54,100,15,266,2,-46,17,-35,5850,9.2032381764,17.04303366,2.556455049,-6,0.3408606732,-7.839795484,2.8973157222
38,73,2002,48,85,6,266,2,-37,8,-35,5815,8.2297471067,14.573510502,1.0287183883,-6,0.3429061294,-6.343763395,1.3716245178
38,73,2003,78,84,22,266,2,-6,24,12,5827,13.399759491,14.430510222,3.7794193438,-6,0.3435835767,-1.03075073,4.1230029205
38,73,2004,64,87,-23,266,1,-23,-22,-49,5778,11.029728565,14.993537268,-3.963808703,-4,0.1723395088,-3.963808703,-3.791469194
38,73,2005,64,92,7,266,2,-28,9,-24,5754,11.099549081,15.955601804,1.2140131807,-5,0.3468609088,-4.856052723,1.5608740895
38,73,2006,69,65,-81,266,1,4,-80,-79,5675,12.074547204,11.374573453,-14.17446846,-3,0.1749934377,0.699973751,-13.99947502
38,73,2007,61,84,53,295,2,-23,55,29,5704,10.721504526,14.764039019,9.3154055717,-3,0.3515247386,-4.042534493,9.6669303102
38,73,2008,70,76,-65,272,1,-6,-64,-76,5628,12.354394635,13.413342746,-11.47193788,-6,0.1764913519,-1.058948112,-11.29544652
38,75,2001,14,32,-49,57,-1,-18,-50,-70,2521,5.4773082942,12.519561815,-19.17057903,-2,-0.391236307,-7.042253521,-19.56181534
38,75,2002,29,36,5,57,-2,-7,3,-7,2514,11.519364449,14.299900695,1.9860973188,-3,-0.794438928,-2.780536246,1.1916583913
38,75,2003,26,34,-36,57,-6,-8,-42,-52,2462,10.450160772,13.665594855,-14.46945338,-2,-2.411575563,-3.215434084,-16.88102894
38,75,2004,25,37,-27,57,2,-12,-25,-38,2424,10.233319689,15.14531314,-11.05198526,-1,0.8186655751,-4.911993451,-10.23331969
38,75,2005,22,21,-19,57,-1,1,-20,-22,2402,9.1172813925,8.702859511,-7.874015748,-3,-0.414421881,0.4144218815,-8.28843763
38,75,2006,20,20,-30,57,1,0,-29,-30,2372,8.3787180561,8.3787180561,-12.56807708,-1,0.4189359028,0,-12.14914118
38,75,2007,20,30,-63,53,-1,-10,-64,-73,2299,8.5634767716,12.845215157,-26.97495183,1,-0.428173839,-4.281738386,-27.40312567
38,75,2008,14,20,-46,47,1,-6,-45,-54,2245,6.161971831,8.8028169014,-20.24647887,-3,0.4401408451,-2.64084507,-19.80633803
38,77,2001,201,154,-388,1189,6,47,-382,-346,17598,11.310562152,8.6658038377,-21.83332395,-11,0.3376287209,2.6447583141,-21.49569523
38,77,2002,202,150,-265,1159,3,52,-262,-218,17380,11.550117217,8.5768197152,-15.1523815,-8,0.1715363943,2.9732975013,-14.9808451
38,77,2003,197,146,125,1286,-4,51,121,158,17538,11.28357867,8.3624491666,7.1596311358,-14,-0.229108196,2.9211295034,6.9305229395
38,77,2004,206,151,-238,1188,8,55,-230,-193,17345,11.810910759,8.6575122553,-13.64561534,-18,0.458676146,3.1533985036,-13.1869392
38,77,2005,219,151,-241,1188,4,68,-237,-182,17163,12.692708937,8.7515938333,-13.96777559,-13,0.2318303002,3.9411151037,-13.73594529
38,77,2006,214,150,-472,1049,6,64,-466,-407,16756,12.61829653,8.8446003715,-27.83100917,-5,0.3537840149,3.7736961585,-27.47722515
38,77,2007,181,123,-320,1019,4,58,-316,-266,16490,10.888527943,7.3993863923,-19.25043614,-8,0.2406304518,3.4891415509,-19.00980569
38,77,2008,205,139,-217,950,6,66,-211,-156,16334,12.490860346,8.4694126249,-13.22203266,-11,0.3655861565,4.0214477212,-12.8564465
38,79,2001,287,109,-118,162,6,178,-112,53,13731,20.942026342,7.9535918859,-8.610310482,-13,0.4378123974,12.988434456,-8.172498085
38,79,2002,276,118,-208,162,5,158,-203,-52,13679,20.138635534,8.6099963517,-15.17694272,-7,0.3648303539,11.528639183,-14.81211237
38,79,2003,268,115,-258,162,4,153,-254,-102,13577,19.665394775,8.4385089522,-18.93161139,-1,0.2935133549,11.226885823,-18.63809803
38,79,2004,305,113,-141,162,5,192,-136,43,13620,22.428944369,8.3097400449,-10.36879068,-13,0.3676876126,14.119204324,-10.00110306
38,79,2005,317,151,-165,162,5,166,-160,-5,13615,23.278869102,11.088672664,-12.11676152,-11,0.3671745915,12.190196438,-11.74958693
38,79,2006,297,123,-225,162,5,174,-220,-52,13563,21.855912871,9.0514386636,-16.55750975,-6,0.3679446611,12.804474207,-16.18956509
38,79,2007,315,99,-159,163,4,216,-155,54,13617,23.178807947,7.2847682119,-11.69977925,-7,0.2943340692,15.894039735,-11.40544518
38,79,2008,309,115,-154,158,5,194,-149,40,13657,22.658942583,8.4329397961,-11.29280634,-5,0.3666495564,14.226002787,-10.92615678
38,81,2001,50,31,-40,29,1,19,-39,-26,4329,11.515430677,7.1395670198,-9.212344542,-6,0.2303086135,4.3758636573,-8.982035928
38,81,2002,49,39,-94,29,0,10,-94,-88,4241,11.435239207,9.1015169195,-21.9369895,-4,0,2.333722287,-21.9369895
38,81,2003,36,37,-113,29,-1,-1,-114,-113,4128,8.6031783965,8.8421555741,-27.00442108,2,-0.238977178,-0.238977178,-27.24339826
38,81,2004,41,31,-70,29,0,10,-70,-64,4064,10.009765625,7.568359375,-17.08984375,-4,0,2.44140625,-17.08984375
38,81,2005,46,28,24,29,0,18,24,38,4102,11.266225814,6.8577026696,5.8780308597,-4,0,4.4085231447,5.8780308597
38,81,2006,39,51,46,29,0,-12,46,31,4133,9.4717668488,12.386156648,11.171827565,-3,0,-2.9143898,11.171827565
38,81,2007,37,27,-45,27,0,10,-45,-34,4099,8.9893100097,6.5597667638,-10.93294461,1,0,2.4295432459,-10.93294461
38,81,2008,45,33,-66,25,0,12,-66,-51,4048,11.04701117,8.1011415245,-16.20228305,3,0,2.9458696453,-16.20228305
38,83,2001,10,17,-70,20,1,-7,-69,-77,1620,6.0295447694,10.250226108,-42.20681339,-1,0.6029544769,-4.220681339,-41.60385891
38,83,2002,9,18,-45,20,1,-9,-44,-55,1565,5.6514913658,11.302982732,-28.25745683,-2,0.6279434851,-5.651491366,-27.62951334
38,83,2003,8,19,-40,20,1,-11,-39,-52,1513,5.1981806368,12.345679012,-25.99090318,-2,0.6497725796,-7.147498376,-25.3411306
38,83,2004,7,16,-62,20,0,-9,-62,-73,1440,4.7409414155,10.836437521,-41.99119539,-2,0,-6.095496106,-41.99119539
38,83,2005,5,10,-31,20,1,-5,-30,-35,1405,3.5149384886,7.0298769772,-21.79261863,0,0.7029876977,-3.514938489,-21.08963093
38,83,2006,9,23,-22,20,0,-14,-22,-36,1369,6.4888248017,16.582552271,-15.86157174,0,0,-10.09372747,-15.86157174
38,83,2007,5,7,-46,20,1,-2,-45,-53,1316,3.7243947858,5.2141527002,-34.26443203,-6,0.7448789572,-1.489757914,-33.51955307
38,83,2008,9,8,-41,20,0,1,-41,-50,1266,6.9713400465,6.196746708,-31.75832688,-10,0,0.7745933385,-31.75832688
38,85,2001,91,25,-126,66,0,66,-126,-60,3998,22.591857001,6.2065541212,-31.28103277,0,0,16.38530288,-31.28103277
38,85,2002,81,29,7,66,-1,52,6,54,4052,20.124223602,7.2049689441,1.7391304348,-4,-0.248447205,12.919254658,1.4906832298
38,85,2003,94,33,-66,68,-1,61,-67,-7,4045,23.218475979,8.1511670989,-16.3023342,-1,-0.247005064,15.06730888,-16.54933926
38,85,2004,107,38,-27,72,0,69,-27,39,4084,26.325501292,9.3492434494,-6.642883504,-3,0,16.976257842,-6.642883504
38,85,2005,99,29,-62,72,0,70,-62,6,4090,24.223146562,7.095669195,-15.17005138,-2,0,17.127477367,-15.17005138
38,85,2006,137,40,-1,76,0,97,-1,94,4184,33.115784385,9.6688421562,-0.241721054,-2,0,23.446942229,-0.241721054
38,85,2007,103,18,-71,116,0,85,-71,13,4197,24.579405799,4.2954301396,-16.94308555,-1,0,20.283975659,-16.94308555
38,85,2008,111,11,-67,112,0,100,-67,35,4232,26.337643849,2.6100367778,-15.89749674,2,0,23.727607071,-15.89749674
38,87,2001,8,2,-27,0,1,6,-26,-21,739,10.673782522,2.6684456304,-36.02401601,-1,1.3342228152,8.0053368913,-34.6897932
38,87,2002,6,3,-17,0,1,3,-16,-12,727,8.1855388813,4.0927694407,-23.19236016,1,1.3642564802,4.0927694407,-21.82810368
38,87,2003,13,5,-22,0,1,8,-21,-13,714,18.043025677,6.9396252602,-30.53435115,0,1.387925052,11.103400416,-29.14642609
38,87,2004,2,7,-13,0,0,-5,-13,-19,695,2.8388928318,9.9361249113,-18.45280341,-1,0,-7.097232079,-18.45280341
38,87,2005,5,3,-12,0,1,2,-11,-10,685,7.2463768116,4.347826087,-17.39130435,-1,1.4492753623,2.8985507246,-15.94202899
38,87,2006,2,5,7,0,0,-3,7,4,689,2.9112081514,7.2780203785,10.18922853,0,0,-4.366812227,10.18922853
38,87,2007,6,3,-35,0,1,3,-34,-31,658,8.9086859688,4.4543429844,-51.96733482,0,1.4847809948,4.4543429844,-50.48255382
38,87,2008,6,0,13,0,0,6,13,17,675,9.0022505626,0,19.504876219,-2,0,9.0022505626,19.504876219
38,89,2001,240,213,-216,872,11,27,-205,-195,22358,10.687804769,9.4854267329,-9.619024292,-17,0.4898577186,1.2023780366,-9.129166574
38,89,2002,242,215,-228,957,9,27,-219,-205,22153,10.873716609,9.6605333513,-10.24465862,-13,0.4043944194,1.2131832581,-9.840264204
38,89,2003,272,201,-113,940,6,71,-107,-60,22093,12.294896714,9.0855670569,-5.107806355,-24,0.2712109569,3.2093296569,-4.836595398
38,89,2004,278,211,-63,922,14,67,-49,2,22095,12.582601611,9.5501041007,-2.851452883,-16,0.6336561963,3.0324975106,-2.217796687
38,89,2005,277,216,-25,929,11,61,-14,25,22120,12.529684496,9.770439896,-1.130837951,-22,0.4975686984,2.7592446002,-0.633269253
38,89,2006,258,216,-55,967,13,42,-42,-10,22110,11.666289849,9.7671263848,-2.486999774,-10,0.5878363102,1.8991634637,-1.899163464
38,89,2007,286,199,218,989,9,87,227,318,22428,12.842965558,8.9361893215,9.789393327,4,0.4041492658,3.906776236,10.193542593
38,89,2008,316,210,26,960,11,106,37,147,22575,14.043508211,9.3327111526,1.1554785237,4,0.4888562985,4.710797058,1.6443348221
38,91,2001,8,31,-50,0,0,-23,-50,-75,2164,3.6338859868,14.081308199,-22.71178742,-2,0,-10.44742221,-22.71178742
38,91,2002,20,21,-66,0,-1,-1,-67,-68,2096,9.3896713615,9.8591549296,-30.98591549,0,-0.469483568,-0.469483568,-31.45539906
38,91,2003,15,14,-43,0,-1,1,-44,-47,2049,7.2376357057,6.7551266586,-20.74788902,-4,-0.482509047,0.482509047,-21.23039807
38,91,2004,16,17,-24,0,0,-1,-24,-26,2023,7.858546169,8.3497053045,-11.78781925,-1,0,-0.491159136,-11.78781925
38,91,2005,16,19,-48,0,0,-3,-48,-51,1972,8.0100125156,9.5118898623,-24.03003755,0,0,-1.501877347,-24.03003755
38,91,2006,18,14,-70,0,0,4,-70,-66,1906,9.2831356369,7.2202166065,-36.10108303,0,0,2.0629190304,-36.10108303
38,91,2007,17,11,-68,0,0,6,-68,-68,1838,9.0811965812,5.8760683761,-36.32478632,-6,0,3.2051282051,-36.32478632
38,91,2008,12,7,-39,0,1,5,-38,-43,1795,6.6061106524,3.8535645472,-21.46985962,-10,0.550509221,2.7525461051,-20.9193504
38,93,2001,198,241,-226,1569,6,-43,-220,-280,21563,9.1231626964,11.104455605,-10.41330692,-17,0.2764594756,-1.981292909,-10.13684744
38,93,2002,213,234,-159,1616,6,-21,-153,-191,21372,9.9219750786,10.900197974,-7.406544777,-17,0.2794922557,-0.978222895,-7.127052521
38,93,2003,221,245,-207,1646,2,-24,-205,-250,21122,10.401468443,11.531039676,-9.74255189,-21,0.0941309361,-1.129571234,-9.648420954
38,93,2004,190,224,-192,1598,6,-34,-186,-237,20885,9.0461113624,10.664889185,-9.141333587,-17,0.2856666746,-1.618777823,-8.855666913
38,93,2005,227,231,-87,1595,4,-4,-83,-106,20779,10.896697389,11.088709677,-4.176267281,-19,0.1920122888,-0.192012289,-3.984254992
38,93,2006,237,231,-45,1711,6,6,-39,-43,20736,11.417559918,11.128507768,-2.167891124,-10,0.2890521498,0.2890521498,-1.878838974
38,93,2007,220,228,-283,1732,4,-8,-279,-279,20457,10.681426456,11.069841963,-13.74019858,8,0.1942077537,-0.388415507,-13.54599082
38,93,2008,232,205,-92,1758,6,27,-86,-63,20394,11.358351081,10.036474015,-4.504173704,-4,0.293750459,1.3218770654,-4.210423245
38,95,2001,13,39,-61,68,0,-26,-61,-88,2769,4.6214006399,13.86420192,-21.68503377,-1,0,-9.24280128,-21.68503377
38,95,2002,19,34,-49,68,-1,-15,-50,-66,2703,6.9444444444,12.426900585,-17.90935673,-1,-0.365497076,-5.48245614,-18.2748538
38,95,2003,23,53,-54,68,-1,-30,-55,-86,2617,8.6466165414,19.92481203,-20.30075188,-1,-0.37593985,-11.27819549,-20.67669173
38,95,2004,21,41,-51,68,0,-20,-51,-75,2542,8.1411126187,15.894553208,-19.7712735,-4,0,-7.753440589,-19.7712735
38,95,2005,15,31,-60,68,0,-16,-60,-76,2466,5.9904153355,12.380191693,-23.96166134,0,0,-6.389776358,-23.96166134
38,95,2006,22,43,-58,68,0,-21,-58,-79,2387,9.066556769,17.720997321,-23.90274057,0,0,-8.654440552,-23.90274057
38,95,2007,12,26,-85,68,0,-14,-85,-100,2287,5.13478819,11.125374412,-36.37141635,-1,0,-5.990586222,-36.37141635
38,95,2008,16,31,-70,68,0,-15,-70,-85,2202,7.1285364224,13.811539318,-31.18734685,0,0,-6.683002896,-31.18734685
38,97,2001,68,102,-117,396,0,-34,-117,-157,8310,8.1063360553,12.159504083,-13.94766645,-6,0,-4.053168028,-13.94766645
38,97,2002,91,104,-46,407,-1,-13,-47,-66,8244,10.994321614,12.564938988,-5.557569168,-6,-0.120816721,-1.570617373,-5.678385889
38,97,2003,90,111,-41,424,-4,-21,-45,-75,8169,10.966916469,13.525863645,-4.996039725,-9,-0.48741851,-2.558947176,-5.483458234
38,97,2004,82,121,65,444,2,-39,67,21,8190,10.025062657,14.793080262,7.9466960083,-7,0.2445137233,-4.768017605,8.1912097316
38,97,2005,78,105,-43,445,-1,-27,-44,-79,8111,9.5699650328,12.882645236,-5.275749954,-8,-0.122691859,-3.312680204,-5.398441813
38,97,2006,94,90,-129,477,1,4,-128,-127,7984,11.680646163,11.18359739,-16.02982293,-3,0.1242621932,0.4970487729,-15.90556073
38,97,2007,97,84,21,526,-1,13,20,22,8006,12.132582864,10.506566604,2.626641651,-11,-0.125078174,1.6260162602,2.5015634772
38,97,2008,93,98,-182,378,1,-5,-181,-186,7820,11.752811829,12.384683432,-23.00012637,0,0.1263743207,-0.631871604,-22.87375205
38,99,2001,139,144,-252,380,5,-5,-247,-257,12099,11.367818442,11.776732774,-20.60928236,-5,0.4089143324,-0.408914332,-20.20036802
38,99,2002,116,186,-245,380,5,-70,-240,-314,11785,9.7136158097,15.575280523,-20.51582649,-4,0.4186903366,-5.861664713,-20.09713616
38,99,2003,132,141,-110,380,3,-9,-107,-126,11659,11.260876983,12.028664051,-9.384064153,-10,0.2559290224,-0.767787067,-9.128135131
38,99,2004,123,140,-141,380,2,-17,-139,-166,11493,10.625431928,12.09398756,-12.18037319,-10,0.1727712509,-1.468555632,-12.00760194
38,99,2005,118,178,-42,380,3,-60,-39,-110,11383,10.316488897,15.562161217,-3.671970624,-11,0.262283616,-5.24567232,-3.409687008
38,99,2006,150,159,-163,380,2,-9,-161,-175,11208,13.279624629,14.076402107,-14.43052543,-5,0.1770616617,-0.796777478,-14.25346377
38,99,2007,135,127,-199,393,3,8,-196,-190,11018,12.147934851,11.42805723,-17.90695582,-2,0.2699541078,0.7198776208,-17.63700171
38,99,2008,136,146,-120,356,2,-10,-118,-138,10880,12.421225683,13.334551101,-10.95990501,-10,0.1826650836,-0.913325418,-10.77723993
38,101,2001,814,481,-1230,2142,-10,333,-1240,-931,57754,13.981569749,8.2618366698,-21.126942,-24,-0.171763756,5.7197330791,-21.29870576
38,101,2002,904,509,-758,2246,-221,395,-979,-616,57138,15.736517773,8.8604950736,-13.19500052,-32,-3.847091181,6.8760226996,-17.0420917
38,101,2003,882,485,4,2157,-638,397,-634,-321,56817,15.479794656,8.5121319819,0.0702031504,-84,-11.19740248,6.9676626739,-11.12719933
38,101,2004,925,458,-510,2249,305,467,-205,209,57026,16.250450181,8.0461688466,-8.959707668,-53,5.3582565463,8.2042813348,-3.601451121
38,101,2005,983,468,-987,2139,-18,515,-1005,-530,56496,17.318229066,8.2450978665,-17.38869999,-40,-0.317119149,9.0731311992,-17.70581914
38,101,2006,958,504,-1051,2143,152,454,-899,-468,56028,17.027478582,8.958088941,-18.68045928,-23,2.7016458711,8.0693896413,-15.97881341
38,101,2007,1006,460,-601,2252,-36,546,-637,-81,55947,17.968296495,8.2161196696,-10.73453896,10,-0.64300067,9.7521768252,-11.37753963
38,101,2008,1004,454,-510,2241,39,550,-471,39,55986,17.939302976,8.1119955688,-9.112594141,-40,0.6968454343,9.8273074071,-8.415748707
38,103,2001,42,81,-166,118,3,-39,-163,-204,4875,8.4388185654,16.274864376,-33.35342576,-2,0.6027727547,-7.836045811,-32.750653
38,103,2002,35,67,-76,118,3,-32,-73,-107,4768,7.2591517163,13.896090428,-15.76272944,-2,0.6222130043,-6.636938712,-15.14051644
38,103,2003,34,90,-63,118,1,-56,-62,-120,4648,7.2217502124,19.116397621,-13.38147833,-2,0.212404418,-11.89464741,-13.16907392
38,103,2004,36,56,-58,118,0,-20,-58,-83,4565,7.8150439596,12.156735048,-12.59090416,-5,0,-4.341691089,-12.59090416
38,103,2005,29,58,-60,118,1,-29,-59,-89,4476,6.4152195554,12.830439111,-13.27286805,-1,0.2212144674,-6.415219555,-13.05165358
38,103,2006,41,67,-111,118,0,-26,-111,-138,4338,9.3033809848,15.203086,-25.18720218,-1,0,-5.899705015,-25.18720218
38,103,2007,35,69,-43,119,1,-34,-42,-76,4262,8.1395348837,16.046511628,-10,0,0.2325581395,-7.906976744,-9.76744186
38,103,2008,35,59,-45,121,0,-24,-45,-71,4191,8.2810836389,13.959540991,-10.64710754,-2,0,-5.678457352,-10.64710754
38,105,2001,222,198,-240,482,6,24,-234,-222,19430,11.360728724,10.132541835,-12.28186889,-12,0.3070467223,1.2281868891,-11.97482217
38,105,2002,196,212,13,488,6,-16,19,-15,19415,10.091388853,10.915175698,0.6693268117,-18,0.3089200669,-0.823786845,0.9782468786
38,105,2003,220,210,-160,481,3,10,-157,-163,19252,11.379212248,10.861975328,-8.275790726,-16,0.1551710761,0.5172369204,-8.12061965
38,105,2004,211,209,-105,502,4,2,-101,-114,19138,10.992445949,10.888252149,-5.470174525,-15,0.2083876009,0.1041938005,-5.261786924
38,105,2005,233,193,-39,502,4,40,-35,-13,19125,12.178867313,10.088074641,-2.038522855,-18,0.2090792672,2.0907926718,-1.829443588
38,105,2006,246,184,62,521,4,62,66,119,19244,12.822851781,9.5910761292,3.2317756522,-9,0.208501655,3.2317756522,3.4402773072
38,105,2007,277,188,222,524,3,89,225,315,19559,14.277246605,9.6899724248,11.442414246,1,0.1546272195,4.5872741798,11.597041466
38,105,2008,295,198,191,491,3,97,194,287,19846,14.972719198,10.049486106,9.6942012435,-4,0.152264941,4.9232330922,9.8464661845
39,0,2001,154453,109209,-37792,299415,14200,45244,-23592,27579,11391298,13.575291989,9.5986744374,-3.321641113,5927,1.2480764132,3.9766175521,-2.0735647
39,0,2002,148641,108482,-37723,300976,12929,40159,-24794,19284,11410582,13.03760918,9.5151803272,-3.30876226,3919,1.1340292993,3.5224288524,-2.174732961
39,0,2003,148591,107936,-33067,303238,10562,40655,-22505,19724,11430306,13.010965248,9.4511211648,-2.895421579,1574,0.9248326948,3.5598440831,-1.970588884
39,0,2004,150408,109786,-37675,302203,11190,40622,-26485,14789,11445095,13.150195706,9.5986076922,-3.293931328,652,0.9783435053,3.5515880137,-2.315587823
39,0,2005,148207,109533,-45033,305057,11064,38674,-33969,5859,11450954,12.946076417,9.5678516411,-3.933691791,1154,0.9664549547,3.3782247758,-2.967236836
39,0,2006,149364,105925,-50275,309504,11938,43439,-38337,7436,11458390,13.03957023,9.2473184741,-4.389038813,2334,1.0421948354,3.7922517554,-3.346843978
39,0,2007,152956,108429,-47350,314766,10396,44527,-36954,19251,11477641,13.337617132,9.4549052537,-4.128874782,11678,0.9065212721,3.8827118781,-3.22235351
39,0,2008,153760,107493,-49752,314766,10432,46267,-39320,8269,11485910,13.391657066,9.3620538043,-4.333127747,1322,0.9085702817,4.0296032613,-3.424557465
39,1,2001,404,317,79,342,3,87,82,144,27482,14.739146297,11.565122218,2.8821597957,-25,0.1094491062,3.1740240788,2.9916089019
39,1,2002,373,317,189,342,2,56,191,227,27709,13.516696563,11.487380189,6.8489427624,-20,0.0724755848,2.029316374,6.9214183472
39,1,2003,377,289,151,342,2,88,153,211,27920,13.554081504,10.390264071,5.4288230959,-30,0.0719049417,3.1638174334,5.5007280375
39,1,2004,396,316,92,342,2,80,94,152,28072,14.14487784,11.287326761,3.2861837405,-22,0.071438777,2.8575510787,3.3576225175
39,1,2005,370,275,47,342,3,95,50,119,28191,13.152515863,9.7755185468,1.670724988,-26,0.1066420205,3.3769973162,1.7773670085
39,1,2006,400,302,-84,342,3,98,-81,4,28195,14.187918987,10.711878835,-2.979462987,-13,0.1064093924,3.4760401518,-2.873053595
39,1,2007,393,308,-186,342,2,85,-184,-92,28103,13.961419589,10.941774131,-6.607694767,7,0.0710504814,3.0196454581,-6.536644286
39,1,2008,392,296,10,342,1,96,11,110,28213,13.921443284,10.512110235,0.3551388593,3,0.0355138859,3.4093330492,0.3906527452
39,3,2001,1565,1123,-765,5966,30,442,-735,-381,108196,14.439067596,10.361068952,-7.058074576,-88,0.2767872383,4.0779986437,-6.781287337
39,3,2002,1469,1110,-652,6069,29,359,-623,-349,107847,13.599144615,10.275732146,-6.035835459,-85,0.2684650741,3.3234124688,-5.767370385
39,3,2003,1480,1089,-1691,5025,21,391,-1670,-1313,106534,13.807193735,10.159482417,-15.77565176,-34,0.1959128841,3.6477113177,-15.57973888
39,3,2004,1491,1053,-1107,4615,28,438,-1079,-741,105793,14.04437495,9.918663194,-10.42731259,-100,0.2637441305,4.1257117559,-10.16356846
39,3,2005,1480,1021,-633,4655,25,459,-608,-243,105550,14.00566851,9.6620186143,-5.990262275,-94,0.2365822384,4.3436498961,-5.753680037
39,3,2006,1412,978,-766,4641,30,434,-736,-348,105202,13.399635591,9.2810507136,-7.26920741,-46,0.2846948072,4.118584877,-6.984512602
39,3,2007,1438,1082,-456,4680,22,356,-434,-69,105133,13.673425726,10.288349538,-4.335940286,9,0.2091901015,3.385076188,-4.126750184
39,3,2008,1482,1057,-459,4680,22,425,-437,35,105168,14.094084194,10.05225843,-4.365171825,47,0.2092239219,4.041825764,-4.155947903
39,5,2001,705,467,36,2227,21,238,57,243,52827,13.376213109,8.86055535,0.6830406694,-52,0.3984403905,4.5156577587,1.0814810599
39,5,2002,709,467,15,2350,20,242,35,224,53051,13.392772814,8.8214737717,0.283344982,-53,0.3777933093,4.5712990423,0.6611382912
39,5,2003,676,499,284,2410,14,177,298,413,53464,12.693047928,9.3695723607,5.3325822654,-62,0.2628737736,3.3234755668,5.5954560391
39,5,2004,623,540,97,2502,15,83,112,160,53624,11.635290602,10.085163604,1.8115942029,-35,0.2801434334,1.5501269984,2.0917376363
39,5,2005,689,459,159,2530,15,230,174,354,53978,12.806453412,8.5314399361,2.9553354027,-50,0.2788052267,4.2750134756,3.2341406294
39,5,2006,688,505,177,2517,15,183,192,349,54327,12.704861271,9.3255159042,3.2685471585,-26,0.2769955219,3.3793453672,3.5455426804
39,5,2007,698,520,327,2544,10,178,337,516,54843,12.787395805,9.526426674,5.9906567738,1,0.183200513,3.2609691307,6.1738572868
39,5,2008,725,500,24,2544,10,225,34,282,55125,13.185654008,9.0935544886,0.4364906155,23,0.1818710898,4.0920995199,0.6183617052
39,7,2001,1355,1210,-174,2128,44,145,-130,-83,102663,13.193190172,11.781372773,-1.694180878,-98,0.4284135554,1.4118173985,-1.265767323
39,7,2002,1240,1098,-153,2135,41,142,-112,-66,102597,12.082237163,10.698626133,-1.490792166,-96,0.3994933255,1.3836110299,-1.09129884
39,7,2003,1188,1094,-132,2154,34,94,-98,-144,102453,11.587417703,10.670568154,-1.287490856,-140,0.3316264326,0.9168495489,-0.955864423
39,7,2004,1240,1059,-361,2139,38,181,-323,-218,102235,12.116000938,10.34745564,-3.527319628,-76,0.3712968029,1.7685452982,-3.156022825
39,7,2005,1266,1160,-275,2144,36,106,-239,-230,102005,12.397179788,11.359185272,-2.692910302,-97,0.3525264395,1.0379945163,-2.340383862
39,7,2006,1256,1039,-768,2242,61,217,-707,-534,101471,12.345436317,10.212506635,-7.548801824,-44,0.5995793116,2.1329296821,-6.949222513
39,7,2007,1350,1082,-654,2223,50,268,-604,-320,101151,13.325305248,10.679985392,-6.455370098,16,0.493529824,2.6453198567,-5.961840274
39,7,2008,1318,1041,-852,2223,50,277,-802,-503,100648,13.062502787,10.317196815,-8.444045808,22,0.4955425944,2.7453059728,-7.948503214
39,9,2001,657,478,219,8611,174,179,393,513,62832,10.499316825,7.638772363,3.4997722751,-59,2.7806409857,2.8605444623,6.2804132608
39,9,2002,652,510,-18,8755,159,142,141,220,63052,10.35874297,8.1026977217,-0.285977567,-63,2.5261351721,2.256045248,2.2401576054
39,9,2003,612,462,25,8615,138,150,163,218,63270,9.6895235984,7.3146403635,0.3958138725,-95,2.1848925761,2.3748832349,2.5807064486
39,9,2004,630,459,-1016,7761,144,171,-872,-771,62499,10.018367006,7.2990959616,-16.15660457,-70,2.2899124586,2.7192710445,-13.86669211
39,9,2005,603,423,411,8580,143,180,554,676,63175,9.5962569824,6.7317026593,6.5407323711,-58,2.2757292678,2.8645543231,8.8164616388
39,9,2006,577,441,-237,8668,147,136,-90,18,63193,9.1320587491,6.9796150924,-3.750949607,-28,2.3265383641,2.1524436566,-1.424411243
39,9,2007,590,470,-250,8675,132,120,-118,7,63200,9.3359600611,7.4371207266,-3.95591528,5,2.0887232679,1.8988393345,-1.867192012
39,9,2008,625,468,-260,8675,132,157,-128,55,63255,9.8849393065,7.4018425527,-4.112134751,26,2.0876991815,2.4830967538,-2.02443557
39,11,2001,616,456,-163,1101,22,160,-141,-25,46568,13.224417943,9.7895041917,-3.499318384,-44,0.4723006408,3.4349137515,-3.027017743
39,11,2002,558,465,-256,1101,21,93,-235,-179,46389,12.005550954,10.004625795,-5.507923018,-37,0.4518218101,2.0009251589,-5.056101208
39,11,2003,592,450,-193,1101,18,142,-175,-85,46304,12.773348581,9.7094710496,-4.16428425,-52,0.388378842,3.0638775312,-3.775905408
39,11,2004,583,426,-61,1101,18,157,-43,80,46384,12.579837735,9.1921284309,-1.316243742,-34,0.3883997929,3.3877093043,-0.92784395
39,11,2005,640,461,85,1101,19,179,104,236,46620,13.76284891,9.9135521053,1.8278783708,-47,0.408584577,3.8492968044,2.2364629478
39,11,2006,576,439,-364,1101,19,137,-345,-228,46392,12.385498645,9.4396421967,-7.826947061,-20,0.4085494345,2.9458564486,-7.418397626
39,11,2007,654,498,-199,1101,17,156,-182,-16,46376,14.099689548,10.736460849,-4.290272508,10,0.3665056916,3.3632286996,-3.923766816
39,11,2008,632,452,-22,1101,16,180,-6,200,46576,13.598416387,9.7254496945,-0.473362596,26,0.344263706,3.8729666925,-0.12909889
39,13,2001,677,933,-240,3287,12,-256,-228,-547,69566,9.6936547369,13.359202171,-3.436450719,-63,0.171822536,-3.665547434,-3.264628183
39,13,2002,708,894,323,3327,10,-186,333,91,69657,10.170733284,12.842705587,4.6400379248,-56,0.1436544249,-2.671972303,4.7836923497
39,13,2003,671,913,-62,3367,9,-242,-53,-396,69261,9.6603751854,13.144444924,-0.892612908,-101,0.1295728415,-3.484069739,-0.763040067
39,13,2004,736,945,-15,3395,10,-209,-5,-259,69002,10.646376833,13.669600689,-0.216977789,-45,0.1446518591,-3.023223856,-0.07232593
39,13,2005,725,957,-45,3431,10,-232,-35,-327,68675,10.531897122,13.9021042,-0.653703959,-60,0.1452675465,-3.370207079,-0.508436413
39,13,2006,696,846,66,3754,10,-150,76,-108,68567,10.142667696,12.328587459,0.9618046954,-34,0.1457279841,-2.185919762,1.1075326795
39,13,2007,714,899,-88,3906,10,-185,-78,-275,68292,10.434096406,13.13760878,-1.285995075,-12,0.146135804,-2.703512374,-1.139859271
39,13,2008,735,862,-183,3906,9,-127,-174,-317,67975,10.787644844,12.651632457,-2.68590341,-16,0.1320936103,-1.863987613,-2.5538098
39,15,2001,565,367,26,453,8,198,34,189,42772,13.238826079,8.5993790639,0.6092203152,-43,0.1874524047,4.6394470154,0.7966727198
39,15,2002,543,393,317,453,7,150,324,436,43208,12.630844382,9.1416608514,7.3738078623,-38,0.1628285648,3.4891835311,7.5366364271
39,15,2003,586,413,184,453,5,173,189,303,43511,13.514915993,9.5250175855,4.2435913698,-59,0.1153149829,3.9898984075,4.3589063527
39,15,2004,569,412,-22,453,6,157,-16,112,43623,13.060343838,9.4566988776,-0.504969358,-29,0.1377189157,3.6036449606,-0.367250442
39,15,2005,562,451,-20,453,6,111,-14,58,43681,12.874553285,10.331714469,-0.458169156,-39,0.1374507468,2.5428388161,-0.320718409
39,15,2006,567,432,-87,453,6,135,-81,34,43715,12.975422216,9.8860359742,-1.9909378,-20,0.1373060552,3.0893862419,-1.853631745
39,15,2007,561,415,-15,453,6,146,-9,136,43851,12.813192335,9.4785647397,-0.342598726,-1,0.1370394902,3.3346275952,-0.205559235
39,15,2008,558,423,-42,453,5,135,-37,109,43960,12.709113892,9.6343282732,-0.95659997,11,0.1138809489,3.0747856191,-0.842719022
39,17,2001,4863,2702,665,11224,375,2161,1040,2870,336553,14.511306465,8.0628315996,1.9843756528,-331,1.1190088267,6.4484748656,3.1033844795
39,17,2002,4682,2742,377,11329,345,1940,722,2338,338891,13.863473508,8.1191038783,1.1163027579,-324,1.0215502692,5.7443696295,2.137853027
39,17,2003,4621,2696,1016,11223,284,1925,1300,2776,341667,13.580032855,7.9229103177,2.9857851939,-449,0.8346092471,5.6571225377,3.820394441
39,17,2004,4803,2757,1030,11103,285,2046,1315,3117,344784,13.993715502,8.0326199539,3.000942529,-244,0.8303578842,5.961095548,3.8313004133
39,17,2005,4853,2736,1377,10718,286,2117,1663,3459,348243,14.005226348,7.8957962677,3.9738711479,-321,0.8253646683,6.1094300799,4.7992358162
39,17,2006,4973,2728,2885,11287,291,2245,3176,5243,353486,14.173562729,7.7750812636,8.2225474507,-178,0.8293800028,6.3984814651,9.0519274535
39,17,2007,5269,2868,1740,11228,263,2401,2003,4422,357908,14.813169636,8.0630424209,4.8918039792,18,0.7393933601,6.750127215,5.6311973393
39,17,2008,5291,2867,24,11228,265,2424,289,2857,360765,14.724360036,7.9785938807,0.0667897639,144,0.7374703099,6.7457661551,0.8042600738
39,19,2001,315,255,35,366,3,60,38,67,28933,10.899842558,8.8236820706,1.2110936175,-31,0.1038080244,2.0761604872,1.3149016419
39,19,2002,361,246,74,366,3,115,77,165,29098,12.441626027,8.4782271545,2.5503610139,-27,0.1033930141,3.963398873,2.653754028
39,19,2003,343,280,60,366,3,63,63,87,29185,11.770155963,9.6082905822,2.0589194105,-39,0.1029459705,2.161865381,2.161865381
39,19,2004,310,260,-102,366,2,50,-100,-70,29115,10.63464837,8.9193825043,-3.499142367,-20,0.0686106346,1.7152658662,-3.430531732
39,19,2005,284,299,-198,366,3,-15,-195,-232,28883,9.7934411531,10.310700369,-6.827821649,-22,0.1034518432,-0.517259216,-6.724369806
39,19,2006,310,260,-141,366,2,50,-139,-102,28781,10.751942286,9.0177580466,-4.890399556,-13,0.0693673696,1.7341842397,-4.821032186
39,19,2007,342,274,-285,366,3,68,-282,-236,28545,11.931758713,9.559362244,-9.943132261,-22,0.1046645501,2.3723964693,-9.838467711
39,19,2008,340,252,-150,366,2,88,-148,-106,28439,11.933174224,8.8445879545,-5.264635687,-46,0.0701951425,3.0885862698,-5.194440545
39,21,2001,497,394,-25,672,2,103,-23,41,38966,12.761423014,10.116701544,-0.641922687,-39,0.0513538149,2.6447214697,-0.590568872
39,21,2002,485,356,75,705,1,129,76,166,39132,12.420292453,9.1167507491,1.9206637814,-39,0.0256088504,3.303541704,1.9462726318
39,21,2003,540,377,-84,688,-1,163,-85,19,39151,13.79609877,9.6317208078,-2.146059809,-59,-0.025548331,4.164377962,-2.17160814
39,21,2004,502,415,22,789,2,87,24,86,39237,12.80808287,10.588355361,0.5613104047,-25,0.0510282186,2.2197275093,0.6123386233
39,21,2005,485,356,-139,740,0,129,-139,-44,39193,12.367716435,9.0781588678,-3.54456203,-34,0,3.2895575673,-3.54456203
39,21,2006,527,369,102,786,1,158,103,242,39435,13.404893931,9.3859693748,2.5944955995,-19,0.0254362314,4.0189245561,2.6199318309
39,21,2007,499,410,-58,760,1,89,-57,30,39465,12.648922687,10.392902408,-1.470215463,-2,0.0253485425,2.2560202788,-1.44486692
39,21,2008,536,368,29,760,0,168,29,185,39650,13.549895721,9.3029134804,0.7331100297,-12,0,4.246982241,0.7331100297
39,23,2001,1997,1662,-985,3868,31,335,-954,-734,143926,13.839895213,11.518230268,-6.826387974,-115,0.2148406368,2.3216649456,-6.611547338
39,23,2002,1823,1605,-641,3910,19,218,-622,-524,143402,12.68933066,11.171901103,-4.461799755,-120,0.1322530349,1.5174295579,-4.32954672
39,23,2003,1743,1688,-1454,3291,-2,55,-1456,-1493,141909,12.218246054,11.832701859,-10.19238655,-92,-0.014019789,0.3855441956,-10.20640634
39,23,2004,1807,1633,-447,3323,42,174,-405,-341,141568,12.748829711,11.521216889,-3.153695009,-110,0.2963203364,1.2276128222,-2.857374672
39,23,2005,1747,1675,14,3836,24,72,38,-14,141554,12.340969617,11.832354957,0.0988972952,-124,0.1695382203,0.5086146608,0.2684355154
39,23,2006,1764,1581,-743,3674,35,183,-708,-588,140966,12.487611497,11.192127991,-5.259804616,-63,0.2477700694,1.2954835056,-5.012034546
39,23,2007,1904,1565,-1078,3669,26,339,-1052,-673,140293,13.539122304,11.128532776,-7.665532481,40,0.1848829726,2.4105895278,-7.480649508
39,23,2008,1880,1594,-808,3669,28,286,-780,-434,139859,13.421285588,11.379536823,-5.76829721,60,0.1998914875,2.041748765,-5.568405723
39,25,2001,2779,1345,393,1466,121,1434,514,1762,180392,15.480945457,7.4925770566,2.1892808797,-186,0.6740534006,7.9883684008,2.8633342804
39,25,2002,2631,1282,866,1465,118,1349,984,2158,182550,14.498184283,7.064489643,4.7721123485,-175,0.6502416364,7.4336946399,5.4223539849
39,25,2003,2741,1343,781,1465,97,1398,878,2040,184590,14.931633709,7.3160102413,4.2545078172,-236,0.5284087814,7.6156234679,4.7829165986
39,25,2004,2790,1298,1284,1465,84,1492,1368,2707,187297,15.004557836,6.9806150793,6.9053233912,-153,0.4517501284,8.0239427568,7.3570735196
39,25,2005,2669,1465,886,1465,92,1204,978,2016,189313,14.17381376,7.7799314941,4.7051326306,-166,0.4885690768,6.3938822655,5.1937017073
39,25,2006,2787,1402,1008,1465,92,1385,1100,2390,191703,14.629306906,7.3592710017,5.2911163836,-95,0.4829193525,7.270035904,5.774035736
39,25,2007,2898,1408,431,1465,83,1490,514,2026,193729,15.037672015,7.3060877146,2.236451566,22,0.4306855684,7.7315843002,2.6671371344
39,25,2008,2849,1444,95,1465,82,1405,177,1656,195385,14.643523492,7.4219894427,0.4882887791,74,0.4214703146,7.2215340491,0.9097590937
39,27,2001,539,357,68,1009,40,182,108,251,40913,13.214832976,8.7526815814,1.6671774441,-39,0.9806926142,4.4621513944,2.6478700582
39,27,2002,609,359,60,1007,37,250,97,308,41221,14.829425086,8.7418121606,1.4610271021,-39,0.9009667129,6.0876129252,2.361993815
39,27,2003,564,348,37,1007,35,216,72,224,41445,13.645271333,8.4194227373,0.8951685094,-64,0.8467810224,5.2258485956,1.7419495319
39,27,2004,606,411,164,1007,32,195,196,359,41804,14.558733438,9.8739924804,3.9399872671,-32,0.7687780033,4.6847409578,4.7087652705
39,27,2005,593,392,69,921,36,201,105,270,42074,14.139583681,9.3469086054,1.6452466678,-36,0.8583895658,4.7926750757,2.5036362336
39,27,2006,588,349,500,954,37,239,537,754,42828,13.85126381,8.2212433158,11.778285553,-22,0.8715931309,5.6300204942,12.649878684
39,27,2007,587,395,-94,963,31,192,-63,134,42962,13.684578622,9.208532463,-2.191397599,5,0.7226949528,4.4760461592,-1.468702646
39,27,2008,597,383,-28,963,30,214,2,238,43200,13.857617047,8.8902300318,-0.649938488,22,0.6963626657,4.9673870152,0.0464241777
39,29,2001,1306,1256,-671,3764,19,50,-652,-694,111398,11.687323818,11.239876505,-6.004742942,-92,0.170029979,0.4474473131,-5.834712963
39,29,2002,1270,1270,-247,3764,18,0,-229,-329,111069,11.417423708,11.417423708,-2.22055406,-100,0.1618217533,0,-2.058732306
39,29,2003,1242,1184,-145,3764,11,58,-134,-225,110844,11.193575861,10.670848486,-1.306818438,-149,0.0991379505,0.5227273751,-1.207680487
39,29,2004,1255,1183,-419,3764,17,72,-402,-415,110429,11.343453562,10.692673756,-3.787176926,-85,0.1536563431,0.6507798059,-3.633520583
39,29,2005,1158,1254,-717,3764,15,-96,-702,-900,109529,10.529282863,11.402176779,-6.519426436,-102,0.1363896744,-0.872893916,-6.383036762
39,29,2006,1207,1136,-379,3764,19,71,-360,-338,109191,11.036942209,10.387710315,-3.465618142,-49,0.1737381127,0.6492318947,-3.291880029
39,29,2007,1229,1208,-673,3764,13,21,-660,-604,108587,11.286723177,11.093866231,-6.180605938,35,0.1193876333,0.1928569461,-6.061218305
39,29,2008,1223,1186,-815,3764,13,37,-802,-714,107873,11.30000924,10.958144692,-7.530259632,51,0.1201145708,0.3418645477,-7.410145061
39,31,2001,489,371,17,464,27,118,44,124,36814,13.305398346,10.094688724,0.4625598607,-38,0.7346538964,3.2107096212,1.1972137571
39,31,2002,475,356,-65,464,27,119,-38,42,36856,12.895344102,9.6647210533,-1.764626035,-39,0.7329985069,3.2306230487,-1.031627528
39,31,2003,460,432,-14,464,26,28,12,-14,36842,12.483378111,11.723520313,-0.379928899,-54,0.705582241,0.759857798,0.325653342
39,31,2004,479,393,-80,464,24,86,-56,4,36846,13.000759961,10.666594289,-2.171316904,-26,0.6513950711,2.3341656715,-1.519921833
39,31,2005,473,388,-273,464,26,85,-247,-193,36653,12.870923414,10.557966775,-7.428672499,-31,0.7074926189,2.3129566389,-6.72117988
39,31,2006,434,373,-228,464,25,61,-203,-158,36495,11.866353147,10.198501668,-6.233936676,-16,0.6835456882,1.6678514792,-5.550390988
39,31,2007,460,375,-342,464,21,85,-321,-238,36257,12.645700462,10.308994942,-9.401803387,-2,0.5773037167,2.3367055201,-8.82449967
39,31,2008,466,394,-371,464,20,72,-351,-276,35981,12.901796838,10.908386168,-10.2716022,3,0.5537251862,1.9934106703,-9.717877018
39,33,2001,588,537,-388,609,4,51,-384,-372,46509,12.592354642,11.500160617,-8.309240818,-39,0.0856622765,1.0921940251,-8.223578542
39,33,2002,551,498,-358,609,3,53,-355,-339,46170,11.890503782,10.746771113,-7.725590479,-37,0.064739585,1.1437326687,-7.660850894
39,33,2003,548,495,-465,609,1,53,-464,-450,45720,11.927304386,10.773751224,-10.1207966,-39,0.021765154,1.1535531614,-10.09903145
39,33,2004,617,504,-309,609,4,113,-305,-229,45491,13.529069959,11.051298637,-6.775498569,-37,0.0877087193,2.4777713214,-6.68778985
39,33,2005,536,492,-338,609,2,44,-336,-327,45164,11.825051018,10.854337874,-7.456841873,-35,0.0441233247,0.9707131432,-7.412718548
39,33,2006,542,502,-719,609,3,40,-716,-694,44470,12.093625187,11.201106723,-16.04301939,-18,0.0669388848,0.892518464,-15.97608051
39,33,2007,498,507,-346,609,2,-9,-344,-366,44104,11.244834827,11.448054734,-7.812676406,-13,0.0451599792,-0.203219907,-7.767516427
39,33,2008,529,505,-408,609,2,24,-406,-408,43696,12.050113895,11.503416856,-9.293849658,-26,0.0455580866,0.5466970387,-9.248291572
39,35,2001,18631,15590,-15315,30128,2980,3041,-12335,-10410,1381701,13.433498737,11.240848334,-11.04256525,-1116,2.1486676098,2.1926504031,-8.89389764
39,35,2002,17596,15280,-16216,30287,2772,2316,-13444,-12063,1369638,12.790862922,11.107319018,-11.787715,-935,2.015018869,1.6835439035,-9.772696131
39,35,2003,17337,14764,-17302,30281,2392,2573,-14910,-13242,1356396,12.719577232,10.831853161,-12.6938989,-905,1.7549304227,1.8877240709,-10.93896848
39,35,2004,17326,14995,-17086,30152,2250,2331,-14836,-13827,1342569,12.838995689,11.11166688,-12.66114974,-1322,1.6673058006,1.7273288094,-10.99384394
39,35,2005,16577,14827,-20233,30398,2341,1750,-17892,-17145,1325424,12.426569335,11.114721815,-15.16720621,-1003,1.754877168,1.3118475198,-13.41232904
39,35,2006,16571,14117,-22013,30707,2607,2454,-19406,-17488,1307936,12.585442173,10.721663578,-16.71856488,-536,1.9799799496,1.8637785946,-14.73858493
39,35,2007,16706,14114,-17523,30865,2292,2592,-15231,-12749,1295187,12.835351998,10.843897887,-13.46305956,-110,1.7609617371,1.9914541111,-11.70209783
39,35,2008,16426,13857,-15757,30865,2298,2569,-13459,-11262,1283925,12.737717478,10.745558937,-12.21893427,-372,1.7820086914,1.9921585414,-10.43692558
39,37,2001,644,540,-326,954,5,104,-321,-263,53029,12.114257767,10.157918003,-6.13237272,-46,0.0940547963,1.9563397635,-6.038317924
39,37,2002,618,552,-225,954,5,66,-220,-197,52832,11.67568793,10.428769802,-4.250857256,-43,0.0944634946,1.2469181285,-4.156393762
39,37,2003,677,562,0,954,3,115,3,41,52873,12.809233243,10.633366444,0,-77,0.0567617426,2.1758667991,0.0567617426
39,37,2004,701,614,-116,954,3,87,-113,-65,52808,13.266339266,11.619874907,-2.195285813,-39,0.0567746331,1.6464643597,-2.13851118
39,37,2005,690,546,-268,954,3,144,-265,-169,52639,13.087143304,10.355913397,-5.083122327,-48,0.0569006231,2.731229907,-5.026221704
39,37,2006,680,496,-504,954,3,184,-501,-338,52301,12.959786545,9.4530207738,-9.605488851,-21,0.0571755289,3.5067657709,-9.548313322
39,37,2007,679,578,-241,954,2,101,-239,-125,52176,12.998076132,11.064636236,-4.613455593,13,0.0382859385,1.9334398959,-4.575169655
39,37,2008,691,550,-329,954,1,141,-328,-149,52027,13.262574014,10.556317956,-6.314597468,38,0.0191933054,2.7062560579,-6.295404163
39,39,2001,504,344,-224,615,17,160,-207,-81,39371,12.788145592,8.7284168327,-5.683620263,-34,0.4313461807,4.0597287594,-5.252274082
39,39,2002,487,336,-382,625,15,151,-367,-242,39129,12.407643312,8.5605095541,-9.732484076,-26,0.3821656051,3.847133758,-9.350318471
39,39,2003,511,323,-371,625,11,188,-360,-205,38924,13.093667124,8.2764275556,-9.506361062,-33,0.281859762,4.817239568,-9.2245013
39,39,2004,515,335,-328,625,15,180,-313,-170,38754,13.259867659,8.6253508072,-8.445119596,-37,0.3862097376,4.6345168516,-8.058909859
39,39,2005,505,355,-284,605,13,150,-271,-157,38597,13.057361896,9.1789375703,-7.343150056,-36,0.3361301082,3.8784243255,-7.007019948
39,39,2006,531,362,-47,668,16,169,-31,120,38717,13.736192669,9.364410068,-1.215821197,-18,0.4138965776,4.3717826008,-0.801924619
39,39,2007,529,355,-305,672,12,174,-293,-104,38613,13.681624208,9.1814302341,-7.888271046,15,0.3103582051,4.5001939739,-7.577912841
39,39,2008,531,351,-175,672,12,180,-163,24,38637,13.747572816,9.0873786408,-4.530744337,7,0.3106796117,4.6601941748,-4.220064725
39,41,2001,1829,624,5177,2680,65,1205,5242,7373,119083,15.849700814,5.4074430334,44.862712474,926,0.563275316,10.442257781,45.42598779
39,41,2002,1999,648,5590,2678,61,1351,5651,7905,126988,16.247343246,5.2667725982,45.434041395,903,0.4957918649,10.980570648,45.92983326
39,41,2003,2181,677,5159,2542,51,1504,5210,7886,134874,16.657628827,5.17066241,39.402433343,1172,0.3895181431,11.486966417,39.791951486
39,41,2004,2369,786,5540,2529,55,1583,5595,7062,141936,17.116433655,5.6789855858,40.027455656,-116,0.3973844876,11.437448069,40.424840143
39,41,2005,2374,730,5658,2667,56,1644,5714,7398,149334,16.301026539,5.0125313283,38.850551035,40,0.3845229512,11.288495211,39.235073986
39,41,2006,2455,695,4160,2555,58,1760,4218,5981,155315,16.116908311,4.562627811,27.310117545,3,0.3807660619,11.5542805,27.690883607
39,41,2007,2401,814,3428,2633,50,1587,3478,5043,160358,15.211944005,5.1572354937,21.718677239,-22,0.316783507,10.054708512,22.035460746
39,41,2008,2633,776,2788,2633,50,1857,2838,4668,165026,16.183954958,4.7697489735,17.136675436,-27,0.3073291864,11.414205984,17.444004622
39,43,2001,924,790,-473,1868,26,134,-447,-377,79228,11.634861773,9.9475549791,-5.955941146,-64,0.3273878854,1.6873067939,-5.62855326
39,43,2002,922,862,-614,1868,25,60,-589,-585,78643,11.680422624,10.920308353,-7.778502702,-56,0.3167142794,0.7601142705,-7.461788422
39,43,2003,932,799,-231,1868,20,133,-211,-171,78472,11.863921332,10.170893931,-2.940521274,-93,0.2545905865,1.6930274003,-2.685930688
39,43,2004,945,824,-190,1868,21,121,-169,-107,78365,12.050727826,10.50772458,-2.422897658,-59,0.2677939517,1.5430032454,-2.155103706
39,43,2005,869,873,-528,1868,22,-4,-506,-579,77786,11.130252128,11.181484589,-6.762684837,-69,0.2817785349,-0.051232461,-6.480906302
39,43,2006,804,773,-384,1868,23,31,-361,-363,77423,10.360223956,9.9607625846,-4.948166666,-33,0.2963745659,0.3994613714,-4.6517921
39,43,2007,886,863,-322,1868,17,23,-305,-261,77162,11.462949187,11.165378271,-4.165992819,21,0.2199437203,0.2975709157,-3.946049099
39,43,2008,911,838,-247,1868,17,73,-230,-100,77062,11.813984853,10.867309887,-3.203133105,57,0.2204585538,0.9466749663,-2.982674551
39,45,2001,1671,1041,1992,2291,19,630,2011,2551,125971,13.400643969,8.3483365478,15.974914893,-90,0.1523711762,5.0523074209,16.127286069
39,45,2002,1704,996,2242,2393,14,708,2256,2901,128872,13.372939418,7.8165772652,17.595146816,-63,0.109871568,5.5563621524,17.705018384
39,45,2003,1603,1031,2553,2522,2,572,2555,3134,132006,12.289269314,7.9040777682,19.57236716,7,0.0153328376,4.3851915455,19.587699998
39,45,2004,1667,1111,2681,2595,21,556,2702,3088,135094,12.482216398,8.3189816548,20.074878323,-170,0.1572444777,4.1632347435,20.2321228
39,45,2005,1724,1106,1903,2542,14,618,1917,2417,137511,12.648337338,8.1143045799,13.961592781,-118,0.1027127162,4.534032758,14.064305497
39,45,2006,1846,1014,1092,2426,21,832,1113,1876,139387,13.333429638,7.3239965619,7.8873809128,-69,0.1516804022,6.0094330764,8.039061315
39,45,2007,1763,1097,976,2554,14,666,990,1658,141045,12.573458093,7.8236435214,6.9606892223,2,0.099845952,4.7498145718,7.0605351743
39,45,2008,1843,1055,310,2554,15,788,325,1178,142223,13.012412274,7.4487764237,2.1887399918,65,0.1059067738,5.5636358501,2.2946467656
39,47,2001,352,347,-258,650,10,5,-248,-265,28170,12.437063864,12.260401025,-9.115802491,-22,0.3533256779,0.176662839,-8.762476813
39,47,2002,396,317,-81,650,9,79,-72,-17,28153,14.061750972,11.256502672,-2.876267244,-24,0.3195852494,2.8052483,-2.556681995
39,47,2003,365,358,8,650,8,7,16,-18,28135,12.969016487,12.720295623,0.2842524161,-41,0.2842524161,0.2487208641,0.5685048323
39,47,2004,372,349,-65,650,9,23,-56,-53,28082,13.234430866,12.416173044,-2.312467759,-20,0.3201878435,0.8182578224,-1.992279915
39,47,2005,401,317,71,650,8,84,79,135,28217,14.245368479,11.261301266,2.5222472868,-28,0.2841968774,2.9840672126,2.8064441642
39,47,2006,406,337,-69,650,9,69,-60,-4,28213,14.389509126,11.944001418,-2.445507709,-13,0.3189792663,2.4455077087,-2.126528442
39,47,2007,401,335,8,650,9,66,17,83,28296,14.192429525,11.856518431,0.2831407386,0,0.318533331,2.3359110938,0.6016740696
39,47,2008,404,344,-51,650,8,60,-43,23,28319,14.271836086,12.152256469,-1.801642674,6,0.2826106156,2.1195796167,-1.519032059
39,49,2001,17371,8290,-2594,21914,4456,9081,1862,9883,1082170,16.125640939,7.6956745946,-2.408031351,-1060,4.1365411331,8.4299663442,1.7285097823
39,49,2002,17034,8213,-7607,22059,4153,8821,-3454,4512,1086682,15.707849129,7.5735919279,-7.014770948,-855,3.8296757916,8.1342572015,-3.185095156
39,49,2003,17125,8306,-6519,22743,3619,8819,-2900,4707,1091389,15.724923568,7.6269322717,-5.986030758,-1212,3.3231239937,8.097991296,-2.662906765
39,49,2004,17344,8408,-8155,22696,3340,8936,-4815,3199,1094588,15.868419476,7.6926701425,-7.461194697,-922,3.0558418501,8.1757493331,-4.405352847
39,49,2005,17439,8530,-7177,22461,3494,8909,-3683,4230,1098818,15.901296887,7.7778578157,-6.544160087,-996,3.1859126856,8.1234390715,-3.358247402
39,49,2006,17737,8144,-4321,22969,3532,9593,-789,8272,1107090,16.081359694,7.3838074843,-3.917661117,-532,3.2023094345,8.6975522098,-0.715351683
39,49,2007,18621,8455,-3425,22998,3204,10166,-221,9859,1116949,16.745209954,7.6032839352,-3.079981961,-86,2.8812444386,9.1419260184,-0.198737522
39,49,2008,18207,8447,-826,22998,3210,9760,2384,12118,1129067,16.2127073,7.5217629794,-0.735524591,-26,2.8583945974,8.690944321,2.1228700063
39,51,2001,592,360,-184,430,10,232,-174,18,42152,14.047410009,8.5423439243,-4.366086895,-40,0.2372873312,5.5050660845,-4.128799563
39,51,2002,519,343,-93,430,9,176,-84,53,42205,12.304847256,8.1321052195,-2.204914826,-39,0.2133788542,4.1727420368,-1.991535972
39,51,2003,502,375,-28,430,6,127,-22,49,42254,11.887424668,8.8800483075,-0.663043607,-56,0.1420807729,3.0073763601,-0.520962834
39,51,2004,532,355,168,430,11,177,179,322,42576,12.542732524,8.3696805375,3.9608629023,-34,0.2593422138,4.1730519863,4.2202051161
39,51,2005,512,354,-75,430,9,158,-66,57,42633,12.017509887,8.3089814456,-1.760377425,-35,0.211245291,3.7085284418,-1.549132134
39,51,2006,569,363,-318,430,11,206,-307,-121,42512,13.365435434,8.5266310412,-7.469610664,-20,0.2583827588,4.8388043925,-7.211227905
39,51,2007,517,358,-197,430,8,159,-189,-30,42482,12.165564628,8.4241240558,-4.635621338,0,0.1882485823,3.7414405723,-4.447372756
39,51,2008,563,354,-228,430,8,209,-220,3,42485,13.252203797,8.3326467923,-5.366789459,14,0.1883084021,4.9195570045,-5.178481057
39,53,2001,424,334,-123,953,3,90,-120,-58,31036,13.648800901,10.751649767,-3.959439884,-28,0.0965717045,2.8971511347,-3.86286818
39,53,2002,354,323,40,927,2,31,42,41,31077,11.398580007,10.400399272,1.2879751421,-32,0.0643987571,0.9981807351,1.3523738992
39,53,2003,409,347,-58,898,0,62,-58,-37,31040,13.16869778,11.172464865,-1.867443695,-41,0,1.9962329153,-1.867443695
39,53,2004,383,320,-115,903,4,63,-111,-73,30967,12.353443966,10.321415324,-3.709258632,-25,0.1290176916,2.0320286419,-3.580240941
39,53,2005,393,361,-50,907,2,32,-48,-45,30922,12.700156732,11.666047278,-1.615796022,-29,0.0646318409,1.034109454,-1.551164181
39,53,2006,424,321,-172,876,4,103,-168,-79,30843,13.729458431,10.394236218,-5.569497288,-14,0.1295231927,3.3352222132,-5.439974095
39,53,2007,401,344,-87,878,2,57,-85,-27,30816,13.007022495,11.158143985,-2.821972461,1,0.0648729301,1.8488785092,-2.757099531
39,53,2008,416,334,13,878,2,82,15,96,30912,13.478486262,10.821669259,0.4212026957,-1,0.0648004147,2.6568170036,0.4860031104
39,55,2001,1123,624,-36,1047,27,499,-9,396,91605,12.28571116,6.8266106535,-0.393842922,-94,0.2953821917,5.4591005065,-0.098460731
39,55,2002,1077,673,340,1047,26,404,366,679,92284,11.713588088,7.3196330395,3.697882962,-91,0.2827792853,4.393955049,3.9806622473
39,55,2003,1085,677,832,1047,22,408,854,1170,93454,11.68312354,7.2898383745,8.958856023,-92,0.2368928275,4.3932851651,9.1957488505
39,55,2004,1083,714,5,1047,25,369,30,337,93791,11.567732116,7.6263718657,0.0534059654,-62,0.2670298272,3.9413602499,0.3204357927
39,55,2005,1119,743,217,1047,25,376,242,532,94323,11.897041156,7.8994652179,2.3071116451,-86,0.2657962725,3.997575938,2.5729079175
39,55,2006,1061,703,-86,1047,26,358,-60,254,94577,11.233456855,7.4430915828,-0.910534674,-44,0.2752779248,3.7903652726,-0.63525675
39,55,2007,995,711,-210,1047,23,284,-187,119,94696,10.513913765,7.5129574741,-2.219016975,22,0.2430351926,3.0009562906,-1.975981783
39,55,2008,1087,731,-364,1047,23,356,-341,57,94753,11.475383876,7.7171164799,-3.842722844,42,0.2428094104,3.7582673965,-3.599913433
39,57,2001,1731,1227,38,8137,212,504,250,1322,149529,11.627750759,8.2422011446,0.2552596932,568,1.4240803934,3.3855496144,1.6793400865
39,57,2002,1686,1186,868,8613,72,500,940,1918,151447,11.203551114,7.8810270586,5.7679017596,478,0.4784434639,3.3225240551,6.2463452235
39,57,2003,1793,1214,846,8842,-154,579,692,1735,153182,11.771696063,7.9703508202,5.5542971943,464,-1.01106592,3.8013452429,4.5432312748
39,57,2004,1778,1147,739,8968,324,631,1063,2230,155412,11.523231171,7.4337154967,4.7894644744,536,2.0998464001,4.0895156743,6.8893108745
39,57,2005,1753,1246,-408,8878,134,507,-274,717,156129,11.253735463,7.9989471691,-2.619237917,484,0.8602399042,3.2547882943,-1.758998013
39,57,2006,1828,1158,-14,8903,258,670,244,1432,157561,11.654818451,7.3830852115,-0.089260098,518,1.6449360834,4.2717332398,1.5556759858
39,57,2007,1817,1224,-209,8828,140,593,-69,1033,158594,11.494361943,7.7430374342,-1.322136294,509,0.8856415366,3.7513245085,-0.436494757
39,57,2008,1911,1246,-237,8828,162,665,-75,596,159190,12.027037233,7.8418044961,-1.491579186,6,1.0195604562,4.1852327367,-0.47201873
39,59,2001,528,401,-50,508,4,127,-46,42,40833,12.937371361,9.8255415074,-1.225129864,-39,0.0980103891,3.111829854,-1.127119475
39,59,2002,496,425,85,518,1,71,86,119,40952,12.129363575,10.39310387,2.078620774,-38,0.024454362,1.7362597053,2.103075136
39,59,2003,516,426,65,510,-2,90,63,98,41050,12.585058901,10.389990488,1.5853271871,-55,-0.048779298,2.195068413,1.5365478891
39,59,2004,520,443,-243,510,6,77,-237,-191,40859,12.697017422,10.81688215,-5.933413911,-31,0.1465040472,1.8801352721,-5.786909863
39,59,2005,496,441,-271,507,3,55,-268,-245,40614,12.175812846,10.825672309,-6.652510648,-32,0.0736440293,1.3501405374,-6.578866618
39,59,2006,484,444,-232,507,5,40,-227,-205,40409,11.947224862,10.959850907,-5.726768942,-18,0.1234217444,0.9873739555,-5.603347198
39,59,2007,520,443,-103,507,3,77,-100,-34,40375,12.873836403,10.96751832,-2.550009903,-11,0.0742721331,1.9063180828,-2.47573777
39,59,2008,519,435,-266,507,3,84,-263,-198,40177,12.886086007,10.800476711,-6.604429437,-19,0.0744860463,2.0856092959,-6.529943391
39,61,2001,12062,8414,-9011,18977,1577,3648,-7434,5007,849297,14.244322848,9.9363067855,-10.64131928,8793,1.8623194439,4.3080160629,-8.778999839
39,61,2002,11479,8460,-12737,19199,1477,3019,-11260,-1177,848120,13.525256316,9.9680868048,-15.00750847,7064,1.7402912779,3.5571695111,-13.26721719
39,61,2003,11722,8169,-12992,19653,1293,3553,-11699,-959,847161,13.828975845,9.6373403583,-15.32725253,7187,1.5254108316,4.191635487,-13.8018417
39,61,2004,11736,8133,-12336,19661,1176,3603,-11160,-907,846254,13.860748842,9.6054422572,-14.56937608,6650,1.3889093931,4.2553065846,-13.18046669
39,61,2005,11499,8060,-11889,20173,1238,3439,-10651,471,846725,13.584338613,9.5216774691,-14.04506494,7683,1.4625107577,4.0626611435,-12.58255418
39,61,2006,11472,7910,-10169,20687,1252,3562,-8917,459,847184,13.545001532,9.3393446755,-12.00654817,5814,1.4782376149,4.2056568564,-10.52831055
39,61,2007,11989,8176,-9032,21067,1111,3813,-7921,6744,853928,14.095485776,9.6125358001,-10.61893632,10852,1.3062044122,4.4829499763,-9.312731907
39,61,2008,11909,8083,-7372,21067,1113,3826,-6259,-2434,851494,13.966044768,9.4791787604,-8.64536754,-1,1.3052487889,4.4868660074,-7.340118751
39,63,2001,952,599,235,1785,82,353,317,602,71929,13.29089183,8.3626514771,3.280839895,-68,1.144803708,4.9282403529,4.4256436031
39,63,2002,929,608,254,1791,76,321,330,582,72511,12.863472722,8.418720576,3.5170312933,-69,1.052340072,4.4447521462,4.5693713653
39,63,2003,921,616,133,2018,67,305,200,403,72914,12.666322847,8.4717208183,1.8291215403,-102,0.9214371669,4.1946020285,2.7505587072
39,63,2004,953,665,55,2000,69,288,124,364,73278,13.037649119,9.097625041,0.7524351538,-48,0.943964102,3.9400240779,1.6963992558
39,63,2005,906,636,-291,2052,70,270,-221,-18,73260,12.365393277,8.6803423003,-3.971666052,-67,0.9553835865,3.6850509765,-3.016282466
39,63,2006,952,643,112,2143,72,309,184,457,73717,12.954407833,8.7496683155,1.5240479803,-36,0.9797451302,4.2047395171,2.5037931105
39,63,2007,983,637,130,2217,65,346,195,548,74265,13.285399576,8.6091551675,1.7569704424,7,0.8784852212,4.6762444081,2.6354556635
39,63,2008,978,626,-455,2217,65,352,-390,8,74273,13.168347494,8.4288195613,-6.126378435,46,0.8751969193,4.7395279322,-5.251181516
39,65,2001,381,284,-322,1939,9,97,-313,-239,31693,11.976424361,8.9273084479,-10.12180747,-23,0.2829076621,3.0491159136,-9.838899804
39,65,2002,386,330,-31,1987,9,56,-22,4,31697,12.178577063,10.411736867,-0.978072251,-30,0.28395646,1.7668401956,-0.694115791
39,65,2003,407,313,-218,1929,7,94,-211,-149,31548,12.870582655,9.8980156534,-6.893825599,-32,0.2213613724,2.9725670013,-6.672464226
39,65,2004,385,329,324,2249,5,56,329,353,31901,12.13573106,10.370533815,10.212926918,-32,0.1576068969,1.765197245,10.370533815
39,65,2005,378,308,-240,2213,7,70,-233,-191,31710,11.884736917,9.6838597098,-7.545864709,-28,0.2200877207,2.2008772068,-7.325776988
39,65,2006,358,323,-53,2263,6,35,-47,-27,31683,11.294622435,10.190399571,-1.672108908,-15,0.1892953481,1.1042228637,-1.48281356
39,65,2007,411,325,81,2494,6,86,87,181,31864,12.935307725,10.228649661,2.5492942232,8,0.1888366091,2.7066580641,2.7381308323
39,65,2008,406,314,-24,2494,5,92,-19,84,31948,12.724879333,9.8414091393,-0.752209616,11,0.1567103366,2.8834701937,-0.595499279
39,67,2001,174,216,-68,271,3,-42,-65,-120,15733,11.017539416,13.676945482,-4.305705059,-13,0.1899575761,-2.659406066,-4.115747483
39,67,2002,181,206,80,271,3,-25,83,44,15777,11.488416376,13.075214218,5.0777530943,-14,0.190415741,-1.586797842,5.2681688353
39,67,2003,184,224,85,271,3,-40,88,28,15805,11.652206953,14.185295421,5.3828129947,-20,0.1899816351,-2.533088468,5.5727946299
39,67,2004,154,223,-122,271,2,-69,-120,-203,15602,9.8067309835,14.200655905,-7.768968701,-14,0.1273601426,-4.393924921,-7.641608559
39,67,2005,178,216,37,271,3,-38,40,-13,15589,11.41354878,13.850149081,2.3724792408,-15,0.1923631817,-2.436600301,2.5648424225
39,67,2006,163,189,-79,271,2,-26,-77,-108,15481,10.492436434,12.166076601,-5.085291278,-5,0.1287415513,-1.673640167,-4.956549726
39,67,2007,191,192,-2,271,3,-1,1,1,15482,12.337305817,12.401899041,-0.129186448,1,0.1937796725,-0.064593224,0.0645932242
39,67,2008,180,205,-84,271,2,-25,-82,-95,15387,11.662185364,13.281933331,-5.44235317,12,0.1295798374,-1.619747967,-5.312773332
39,69,2001,399,272,-193,579,17,127,-176,-74,29135,13.677498972,9.324009324,-6.615933087,-25,0.5827505828,4.3534896476,-6.033182504
39,69,2002,386,264,-10,579,17,122,7,101,29236,13.225745661,9.0455877062,-0.342635898,-28,0.5824810265,4.1801579551,0.2398451286
39,69,2003,357,292,-134,579,10,65,-124,-93,29143,12.230425324,10.003597184,-4.590691858,-34,0.3425889447,2.2268281403,-4.248102914
39,69,2004,360,255,-78,579,10,105,-68,17,29160,12.349278768,8.7474057939,-2.675677066,-20,0.3430355213,3.6018729739,-2.332641545
39,69,2005,378,240,-96,579,11,138,-85,25,29185,12.957408518,8.2269260434,-3.290770417,-28,0.3770674437,4.7304824749,-2.913702974
39,69,2006,379,245,-106,579,11,134,-95,25,29210,12.980563404,8.3911293775,-3.630447812,-14,0.3767445843,4.5894340269,-3.253703228
39,69,2007,392,264,-463,579,10,128,-453,-308,28902,13.491189427,9.0859030837,-15.9347467,17,0.3441629956,4.4052863436,-15.5905837
39,69,2008,386,270,-205,579,9,116,-196,-61,28841,13.369585924,9.3517829001,-7.100427757,19,0.3117260967,4.0178030237,-6.788701661
39,71,2001,577,447,25,426,10,130,35,124,41143,14.045422458,10.880942528,0.6085538327,-41,0.2434215331,3.1644799299,0.8519753657
39,71,2002,616,467,273,426,9,149,282,397,41540,14.900281799,11.296155195,6.6035339792,-34,0.2176989224,3.604126604,6.8212329016
39,71,2003,610,409,72,426,8,201,80,225,41765,14.644979293,9.8193385751,1.7285877198,-56,0.1920653022,4.8256407178,1.920653022
39,71,2004,613,433,353,426,7,180,360,501,42266,14.589853744,10.305720508,8.4016612917,-39,0.1666051814,4.2841332365,8.5682664731
39,71,2005,574,451,-243,426,8,123,-235,-142,42124,13.603507525,10.688470198,-5.758976182,-30,0.1895959237,2.9150373267,-5.569380258
39,71,2006,591,421,226,426,8,170,234,382,42506,13.966678483,9.9491905944,5.3408956635,-22,0.1890582536,4.0174878885,5.5299539171
39,71,2007,616,459,-60,426,7,157,-53,80,42586,14.478446858,10.788323227,-1.41023833,-24,0.1645278052,3.6901236309,-1.245710525
39,71,2008,607,425,-385,426,6,182,-379,-237,42349,14.293283099,10.007652911,-9.065756166,-40,0.1412845117,4.2856301878,-8.924471655
39,73,2001,363,306,84,716,15,57,99,129,28370,12.824362756,10.810619844,2.9676211337,-27,0.5299323453,2.0137429122,3.497553479
39,73,2002,381,305,87,731,13,76,100,148,28518,13.394740543,10.722823794,3.0586415413,-28,0.4570383912,2.6719167487,3.5156799325
39,73,2003,356,285,53,755,10,71,63,99,28617,12.461713486,9.9763717511,1.8552550976,-35,0.3500481316,2.4853417345,2.2053032292
39,73,2004,372,277,-6,768,11,95,5,81,28698,12.980895054,9.6658815319,-0.209369275,-19,0.3838436709,3.3150135218,0.1744743959
39,73,2005,339,255,-37,772,11,84,-26,35,28733,11.805470913,8.8802214832,-1.288502725,-23,0.3830683777,2.9252494298,-0.905434347
39,73,2006,334,275,-134,776,12,59,-122,-76,28657,11.639658477,9.5835511413,-4.669803102,-13,0.4181913225,2.0561073358,-4.251611779
39,73,2007,371,283,169,783,10,88,179,263,28920,12.887090331,9.830314188,5.8703996387,-4,0.3473609254,3.0567761433,6.2177605641
39,73,2008,379,286,-36,783,9,93,-27,55,28975,13.092667761,9.8799550911,-1.243630711,-11,0.3109076777,3.2127126695,-0.932723033
39,75,2001,890,250,81,911,2,640,83,687,39736,22.593133211,6.3463857333,2.0562289776,-36,0.0507710859,16.246747477,2.1070000635
39,75,2002,852,269,49,911,2,583,51,592,40328,21.282973621,6.7196243006,1.2240207834,-42,0.049960032,14.563349321,1.2739808153
39,75,2003,887,290,-281,911,1,597,-280,274,40602,21.920177932,7.1666872606,-6.944272828,-43,0.0247127147,14.753490671,-6.919560114
39,75,2004,852,279,-89,911,1,573,-88,458,41060,20.866498494,6.8330435209,-2.179716392,-27,0.0244911954,14.033454973,-2.155225197
39,75,2005,760,276,-272,911,1,484,-271,177,41237,18.469689053,6.707413393,-6.610204503,-36,0.0243022224,11.76227566,-6.585902281
39,75,2006,758,261,-374,911,1,497,-373,104,41341,18.358400543,6.321296229,-9.058102642,-20,0.0242195258,12.037104313,-9.033883117
39,75,2007,787,276,-589,911,0,511,-589,-73,41268,19.053614013,6.682080645,-14.25994746,5,0,12.371533368,-14.25994746
39,75,2008,814,283,-345,911,-1,531,-346,177,41445,19.682516654,6.8429388367,-8.342098582,-8,-0.024179996,12.839577817,-8.366278578
39,77,2001,892,522,-392,579,57,370,-335,-15,59562,14.974105876,8.7628736182,-6.580548771,-50,0.95686551,6.2112322581,-5.623683261
39,77,2002,877,529,-79,579,52,348,-27,263,59825,14.691716854,8.8619363917,-1.323427174,-58,0.8711166207,5.8297804619,-0.452310553
39,77,2003,843,501,-359,579,47,342,-312,-33,59792,14.094986499,8.3767357483,-6.002491285,-63,0.7858414774,5.7182507503,-5.216649807
39,77,2004,842,575,-228,579,47,267,-181,42,59834,14.077207296,9.6132947687,-3.81188036,-44,0.785782355,4.4639125274,-3.026098005
39,77,2005,856,532,-254,579,46,324,-208,63,59897,14.29871963,8.8865874335,-4.242844376,-53,0.768389139,5.4121321963,-3.474455237
39,77,2006,834,591,-375,579,48,243,-327,-110,59787,13.936699977,9.876006818,-6.266501788,-26,0.8021122289,4.0606931587,-5.464389559
39,77,2007,864,530,-443,579,43,334,-400,-72,59715,14.460009038,8.8701444327,-7.414101856,-6,0.7196532276,5.5898646048,-6.694448628
39,77,2008,876,534,-429,579,43,342,-386,-56,59659,14.676562736,8.9466718046,-7.187494764,-12,0.7204248831,5.729890931,-6.467069881
39,79,2001,438,363,-8,438,24,75,16,59,32695,13.408642145,11.112641778,-0.244906706,-32,0.7347201176,2.2960003674,0.4898134117
39,79,2002,393,347,148,438,21,46,169,188,32883,11.985726921,10.582817408,4.5137088658,-27,0.6404586904,1.4029095123,5.1541675562
39,79,2003,436,361,-16,438,19,75,3,29,32912,13.253286724,10.973478228,-0.486359146,-49,0.5775514857,2.2798084961,0.0911923398
39,79,2004,445,364,81,438,19,81,100,157,33069,13.488731605,11.033479335,2.4552522696,-24,0.5759233719,2.4552522696,3.0311756415
39,79,2005,468,381,141,438,19,87,160,215,33284,14.106370473,11.484032372,4.2499962323,-32,0.5726945278,2.6223381008,4.82269076
39,79,2006,488,410,-196,438,19,78,-177,-114,33170,14.686851055,12.339362567,-5.898817227,-15,0.5718241189,2.3474884883,-5.326993108
39,79,2007,418,359,-29,438,18,59,-11,41,33211,12.593965141,10.816348051,-0.873743993,-7,0.5423238577,1.7776170892,-0.331420135
39,79,2008,451,371,-33,438,17,80,-16,59,33270,13.567786285,11.161083618,-0.99276485,-5,0.5114243167,2.4067026669,-0.481340533
39,81,2001,793,1030,-564,2131,19,-237,-545,-839,72798,10.830744016,14.067675078,-7.70307645,-57,0.2595008024,-3.236931062,-7.443575648
39,81,2002,661,1024,-443,2134,17,-363,-426,-841,71957,9.1326724465,14.148043245,-6.120686677,-52,0.2348796242,-5.015370799,-5.885807053
39,81,2003,724,986,-219,2133,12,-262,-207,-561,71396,10.100939639,13.756252049,-3.055394725,-92,0.167418889,-3.655312411,-2.887975836
39,81,2004,695,1013,-202,2163,16,-318,-186,-552,70844,9.772215973,14.243532058,-2.840269966,-48,0.2249718785,-4.471316085,-2.615298088
39,81,2005,729,958,-473,2179,14,-229,-459,-753,70091,10.345194593,13.594919644,-6.712314187,-65,0.1986731472,-3.249725051,-6.51364104
39,81,2006,741,978,-496,2166,18,-237,-478,-743,69348,10.628303416,14.027639326,-7.11422199,-28,0.2581774109,-3.39933591,-6.856044579
39,81,2007,733,968,-402,2238,16,-235,-386,-592,68756,10.615188554,14.0184209,-5.821699589,29,0.2317094364,-3.403232347,-5.589990152
39,81,2008,726,962,-46,2238,16,-236,-30,-230,68526,10.576768986,14.014947335,-0.670153407,36,0.2330968372,-3.438178348,-0.43705657
39,83,2001,708,526,580,3474,11,182,591,727,55370,12.87120613,9.5625062493,10.544208412,-46,0.1999763664,3.3086998809,10.744184778
39,83,2002,735,514,570,3441,11,221,581,763,56133,13.183501789,9.2194828839,10.223940163,-39,0.1973041084,3.9640189053,10.421244271
39,83,2003,721,556,574,3549,8,165,582,702,56835,12.764676723,9.8434955032,10.162169818,-45,0.1416330288,2.9211812195,10.303802847
39,83,2004,692,592,596,3587,8,100,604,652,57487,12.106156295,10.356711744,10.426689526,-52,0.1399555641,1.7494445514,10.56664509
39,83,2005,733,594,426,3621,9,139,435,522,58009,12.69308028,10.286070513,7.3768788529,-52,0.1558495532,2.4070097666,7.5327284062
39,83,2006,728,549,197,3607,11,179,208,359,58368,12.511063183,9.434853966,3.3855486909,-28,0.1890407898,3.0762092166,3.5745894807
39,83,2007,772,575,313,3612,6,197,319,522,58890,13.167545072,9.8074331815,5.3386549319,6,0.1023384332,3.36011189,5.4409933651
39,83,2008,782,589,205,3612,5,193,210,434,59324,13.230243457,9.9649787673,3.4682863282,31,0.0845923495,3.2652646895,3.5528786777
39,85,2001,2722,2009,-675,2900,441,713,-234,1600,229256,11.914766957,8.793815877,-2.954617082,1121,1.9303498267,3.1209510803,-1.024267255
39,85,2002,2606,2108,-504,2900,413,498,-91,1285,230541,11.33543716,9.1692638273,-2.192271807,878,1.7964449529,2.166173333,-0.395826854
39,85,2003,2596,2161,-1089,2900,362,435,-727,553,231094,11.24698084,9.3623750366,-4.718013149,845,1.5683386225,1.8846058033,-3.149674526
39,85,2004,2576,2181,99,2900,347,395,446,910,232004,11.125075038,9.4191726157,0.4275552907,69,1.4986028875,1.7059024224,1.9261581782
39,85,2005,2513,2235,-598,2900,356,278,-242,4,232008,10.831616424,9.6333715507,-2.577519547,-32,1.5344430747,1.198244873,-1.043076472
39,85,2006,2548,2119,-483,2900,365,429,-118,310,232318,10.975047704,9.1272080392,-2.080434867,-1,1.5721712762,1.8478396644,-0.508263591
39,85,2007,2564,2226,-9,2900,335,338,326,695,233013,11.020112565,9.5673832175,-0.038682142,31,1.4398353,1.4527293475,1.4011531576
39,85,2008,2630,2182,152,2900,335,448,487,1017,234030,11.262346294,9.3438933888,0.6509036641,82,1.4345574176,1.9184529048,2.0854610817
39,87,2001,780,732,-269,618,13,48,-256,-264,61988,12.556342563,11.783644559,-4.330328397,-56,0.209272376,0.7726980039,-4.121056021
39,87,2002,711,770,-16,618,12,-59,-4,-122,61866,11.481260193,12.433994865,-0.258368724,-59,0.1937765433,-0.952734671,-0.064592181
39,87,2003,749,723,338,618,10,26,348,311,62177,12.076457358,11.65724789,5.4497230799,-63,0.1612344106,0.4192094677,5.6109574905
39,87,2004,735,741,11,618,11,-6,22,-24,62153,11.823373281,11.919890614,0.1769484437,-40,0.1769484437,-0.096517333,0.3538968873
39,87,2005,763,734,308,618,10,29,318,290,62443,12.247584192,11.782079682,4.9439789399,-57,0.1605187968,0.4655045106,5.1044977367
39,87,2006,801,712,132,618,11,89,143,202,62645,12.806983883,11.383985674,2.110514198,-30,0.1758761832,1.4229982093,2.2863903812
39,87,2007,799,739,-110,618,9,60,-101,-47,62598,12.759196123,11.801058742,-1.756585198,-6,0.1437206071,0.9581373809,-1.612864591
39,87,2008,806,735,-96,618,8,71,-88,-25,62573,12.878382373,11.743934298,-1.533901623,-8,0.1278251352,1.134448075,-1.406076487
39,89,2001,2043,1319,611,3235,58,724,669,1255,147326,13.926522766,8.9912303125,4.1650050955,-138,0.3953687325,4.9352924536,4.560373828
39,89,2002,1953,1289,531,3216,48,664,579,1113,148439,13.206430781,8.7163795581,3.5906885534,-130,0.3245820161,4.4900512231,3.9152705695
39,89,2003,2075,1298,1084,3314,29,777,1113,1755,150194,13.896655761,8.6929441823,7.2597469134,-135,0.1942183215,5.2037115791,7.4539652349
39,89,2004,2057,1321,1277,3307,52,736,1329,1931,152125,13.608142393,8.7391133207,8.448030061,-134,0.3440074888,4.8690290719,8.7920375497
39,89,2005,2010,1386,1321,3394,43,624,1364,1849,153974,13.133005988,9.0558936815,8.6311944828,-139,0.2809548545,4.0771123068,8.9121493373
39,89,2006,2105,1308,568,3427,52,797,620,1341,155315,13.611864631,8.4581087591,3.6729401951,-76,0.3362550883,5.1537558723,4.0091952834
39,89,2007,2116,1366,596,3404,40,750,636,1419,156734,13.561972639,8.7550352669,3.8199128983,33,0.2563699932,4.806937372,4.0762828915
39,89,2008,2171,1339,50,3404,41,832,91,987,157721,13.808017045,8.5163218903,0.3180105261,64,0.2607686314,5.2916951551,0.5787791576
39,91,2001,590,442,-199,585,24,148,-175,-69,45947,12.831247349,9.6125615737,-4.327827496,-42,0.5219490447,3.2186857758,-3.805878451
39,91,2002,656,439,69,585,23,217,92,267,46214,14.235956641,9.5268063498,1.4973795857,-42,0.4991265286,4.7091502913,1.9965061143
39,91,2003,609,455,76,585,20,154,96,186,46400,13.151359406,9.8257282916,1.6412205498,-64,0.4319001447,3.3256311141,2.0731206945
39,91,2004,624,471,-106,585,21,153,-85,35,46435,13.443205688,10.147035062,-2.283621479,-33,0.452415576,3.2961706253,-1.831205903
39,91,2005,607,485,-252,585,20,122,-232,-149,46286,13.093042569,10.461492003,-5.435661824,-39,0.4314017321,2.6315505657,-5.004260092
39,91,2006,613,456,-375,585,21,157,-354,-217,46069,13.274863299,9.8749390937,-8.12083807,-20,0.4547669319,3.3999242055,-7.666071139
39,91,2007,650,438,-5,585,20,212,15,213,46282,14.076729001,9.4855496963,-0.108282531,-14,0.4331301231,4.591179305,0.3248475923
39,91,2008,637,451,-257,585,19,186,-238,-62,46220,13.772675185,9.7511405159,-5.556636613,-10,0.4108019286,4.0215346695,-5.145834685
39,93,2001,3773,2400,-720,8164,211,1373,-509,1671,286803,13.193806989,8.3925620918,-2.517768628,807,0.7378460839,4.8012448967,-1.779922544
39,93,2002,3633,2558,507,8479,201,1075,708,2395,289198,12.614561433,8.8819290244,1.7604136104,612,0.697915455,3.7326324086,2.4583290654
39,93,2003,3639,2576,1932,8860,175,1063,2107,3793,292991,12.501095005,8.8493599158,6.6370199368,623,0.6011793421,3.6517350895,7.2381992789
39,93,2004,3685,2645,311,8322,190,1040,501,2336,295327,12.52723867,8.991735762,1.0572513505,795,0.6459091852,3.5355029083,1.7031605356
39,93,2005,3603,2629,1691,8690,184,974,1875,3562,298889,12.126903348,8.8486341667,5.6915330452,713,0.6193034183,3.2782691816,6.3108364635
39,93,2006,3669,2566,979,9290,244,1103,1223,2326,301215,12.227880501,8.5518510125,3.2627677869,0,0.81319238,3.6760294882,4.0759601669
39,93,2007,3672,2694,302,9395,208,978,510,1472,302687,12.160913526,8.9219774069,1.000162278,-16,0.6888534895,3.2389361188,1.6890157675
39,93,2008,3802,2709,266,9395,209,1093,475,1686,304373,12.525944717,8.9249827035,0.8763548908,118,0.688564557,3.6009620136,1.5649194478
39,95,2001,6585,4836,-2371,9637,533,1749,-1838,-480,454392,14.4842422,10.637174682,-5.215207025,-391,1.1723767795,3.8470675183,-4.042830245
39,95,2002,6300,4393,-3197,10287,495,1907,-2702,-1148,453244,13.8822171,9.6800920193,-7.044674297,-353,1.0907456293,4.202125081,-5.953928667
39,95,2003,6243,4398,-3024,10388,431,1845,-2593,-1229,452015,13.792737769,9.7165562563,-6.680960918,-481,0.9522136759,4.0761815127,-5.728747243
39,95,2004,6484,4511,-4924,10328,402,1973,-4522,-2971,449044,14.391954356,10.012662878,-10.92936201,-422,0.8922834132,4.3792914781,-10.03707859
39,95,2005,6274,4302,-4598,10510,418,1972,-4180,-2586,446458,14.012252346,9.6080187426,-10.26910046,-378,0.9335545873,4.4042336031,-9.335545873
39,95,2006,6376,4254,-4921,10608,436,2122,-4485,-2550,443908,14.322200084,9.5556209469,-11.05388121,-187,0.9793725277,4.7665791371,-10.07450869
39,95,2007,6483,4262,-4184,11286,394,2221,-3790,-1500,442408,14.629093912,9.6173373831,-9.441327924,69,0.889073423,5.0117565293,-8.552254501
39,95,2008,6444,4215,-4653,11286,395,2229,-4258,-1952,440456,14.59794487,9.5484695265,-10.54069483,77,0.8948150565,5.0494753439,-9.645879773
39,97,2001,501,366,-162,4496,30,135,-132,-34,40178,12.464236845,9.1056101505,-4.030352034,-37,0.7463614877,3.3586266949,-3.283990546
39,97,2002,507,346,36,4490,29,161,65,183,40361,12.590173705,8.5921106545,0.8939768311,-43,0.7201480028,3.9980630502,1.6141248339
39,97,2003,516,352,102,4555,24,164,126,231,40592,12.748137808,8.6964040863,2.5199807296,-59,0.5929366422,4.051733722,3.1129173718
39,97,2004,449,362,56,4528,28,87,84,144,40736,11.041707653,8.9022230966,1.3771394846,-27,0.6885697423,2.1394845564,2.0657092268
39,97,2005,443,350,-7,4422,26,93,19,73,40809,10.865166472,8.5842173033,-0.171684346,-39,0.637684714,2.2809491692,0.4660003679
39,97,2006,495,336,282,4663,28,159,310,450,41259,12.06316713,8.1883316274,6.8723497587,-19,0.682360969,3.8748355023,7.5547107277
39,97,2007,509,343,226,4638,18,166,244,414,41673,12.275116963,8.2718371678,5.4502483963,4,0.4340905802,4.0032797955,5.8843389765
39,97,2008,509,345,-1,4638,18,164,17,188,41861,12.186654536,8.2601096559,-0.023942347,7,0.4309622429,3.9265448799,0.4070198961
39,99,2001,2968,3177,-1880,7235,112,-209,-1768,-2192,254850,11.596196073,12.41277457,-7.345299399,-215,0.4375923046,-0.816578497,-6.907707094
39,99,2002,2799,3068,-2289,7211,106,-269,-2183,-2646,252204,11.040244234,12.101275209,-9.02862417,-194,0.4181014251,-1.061030975,-8.610522745
39,99,2003,2558,2977,-1172,7326,93,-419,-1079,-1805,250399,10.179008084,11.846328016,-4.66372067,-307,0.3700733979,-1.667319932,-4.293647272
39,99,2004,2785,3091,-1813,7244,103,-306,-1710,-2223,248176,11.171839743,12.399338114,-7.272727273,-207,0.413177556,-1.22749837,-6.859549717
39,99,2005,2623,3103,-1927,7363,98,-480,-1829,-2507,245669,10.622766253,12.566696028,-7.804068078,-198,0.3968856625,-1.943929776,-7.407182416
39,99,2006,2733,2892,-2054,7430,140,-159,-1914,-2182,243487,11.174349287,11.824448642,-8.398138835,-109,0.5724145262,-0.650099355,-7.825724309
39,99,2007,2714,2998,-3114,7414,119,-284,-2995,-3290,240197,11.222202926,12.39652335,-12.87617535,-11,0.4920567974,-1.174320424,-12.38411856
39,99,2008,2662,2890,-2031,7414,119,-228,-1912,-2219,237978,11.133999059,12.087624824,-8.49479793,-79,0.497725728,-0.953625765,-7.997072202
39,101,2001,844,632,-316,4789,18,212,-298,-145,66005,12.77288033,9.564526503,-4.782263251,-59,0.2724074004,3.2083538269,-4.509855851
39,101,2002,774,623,-235,4788,17,151,-218,-125,65880,11.737498578,9.4476248247,-3.563710809,-58,0.2578003564,2.2898737536,-3.305910452
39,101,2003,784,696,19,4924,10,88,29,23,65903,11.898348042,10.56281918,0.2883528224,-94,0.1517646434,1.3355288618,0.4401174658
39,101,2004,812,668,-275,4906,16,144,-259,-163,65740,12.336394643,10.148659632,-4.177966166,-48,0.2430816678,2.1877350106,-3.934884498
39,101,2005,732,638,-68,5088,13,94,-55,-24,65716,11.136806232,9.7066699124,-1.034566699,-63,0.1977848101,1.4301363194,-0.836781889
39,101,2006,780,678,-285,5194,15,102,-270,-196,65520,11.88698223,10.332530708,-4.34332043,-28,0.2285958121,1.5544515224,-4.114724618
39,101,2007,805,640,-169,5422,10,165,-159,16,65536,12.284824808,9.7668172384,-2.579050177,10,0.1526065194,2.5180075693,-2.426443658
39,101,2008,818,631,22,5422,10,187,32,232,65768,12.459635655,9.6112837385,0.3351002254,13,0.1523182843,2.8483519162,0.4874185097
39,103,2001,2038,1045,1803,1519,108,993,1911,2779,154615,13.30065818,6.82001364,11.766970902,-125,0.704843515,6.4806445402,12.471814417
39,103,2002,2055,1072,2287,1519,102,983,2389,3274,157889,13.151831657,6.8607121829,14.636612651,-98,0.6527916443,6.2911194737,15.289404296
39,103,2003,2067,1118,1943,1519,86,949,2029,2865,160754,12.97376688,7.0172575578,12.1954664,-113,0.5397890429,5.9565093223,12.735255443
39,103,2004,2058,1166,2074,1519,86,892,2160,2888,163642,12.688195909,7.1887446208,12.786840775,-164,0.5302161556,5.4994512879,13.31705693
39,103,2005,2004,1157,1226,1519,89,847,1315,2018,165660,12.171198474,7.0269843487,7.4460525597,-144,0.5405372576,5.1442141256,7.9865898172
39,103,2006,2119,1099,1116,1519,92,1020,1208,2144,167804,12.709018065,6.5914161649,6.6933761965,-84,0.5517837008,6.1176019001,7.2451598973
39,103,2007,1960,1159,611,1519,82,801,693,1498,169302,11.628389883,6.8761754463,3.6249725606,4,0.4864938625,4.752214437,4.111466423
39,103,2008,2119,1168,807,1519,82,951,889,1908,171210,12.445963725,6.8602574946,4.7399210601,68,0.4816276666,5.5857062306,5.2215487266
39,105,2001,326,264,-52,232,5,62,-47,-5,23021,14.159445784,11.466545052,-2.258561904,-20,0.2171694139,2.6929007319,-2.04139249
39,105,2002,282,270,92,232,4,12,96,87,23108,12.226581977,11.706301893,3.9888139782,-21,0.1734266947,0.5202800841,4.1622406729
39,105,2003,264,236,25,232,2,28,27,23,23131,11.41893207,10.207833214,1.0813382642,-32,0.0865070611,1.2110988559,1.1678453254
39,105,2004,290,268,-45,232,5,22,-40,-35,23096,12.54678002,11.594955329,-1.946914141,-17,0.2163237935,0.9518246912,-1.730590348
39,105,2005,296,284,-20,232,3,12,-17,-24,23072,12.822734361,12.302893779,-0.86640097,-19,0.1299601456,0.5198405822,-0.736440825
39,105,2006,272,267,-175,232,4,5,-171,-177,22895,11.834576979,11.617029608,-7.614157983,-11,0.1740378968,0.2175473709,-7.440120086
39,105,2007,273,270,-62,232,3,3,-59,-65,22830,11.94095134,11.809732094,-2.711864407,-9,0.1312192455,0.1312192455,-2.580645161
39,105,2008,276,242,-125,232,3,34,-122,-108,22722,12.118018967,10.625219529,-5.488233228,-20,0.1317175975,1.492799438,-5.35651563
39,107,2001,558,342,-316,519,10,216,-306,-122,40787,13.66039953,8.3725029377,-7.735996866,-32,0.2448100274,5.2878965922,-7.491186839
39,107,2002,545,340,-194,519,10,205,-184,-12,40775,13.3640666,8.3372158603,-4.757117285,-33,0.2452122312,5.0268507393,-4.511905054
39,107,2003,533,381,-174,519,9,152,-165,-60,40715,13.081359676,9.3508405939,-4.270462633,-47,0.2208859983,3.7305190821,-4.049576635
39,107,2004,566,382,-145,519,8,184,-137,17,40732,13.898608911,9.3803332228,-3.560597689,-30,0.1964467691,4.5182756885,-3.36415092
39,107,2005,592,405,-128,519,9,187,-119,29,40761,14.528855239,9.9395040065,-3.141374106,-39,0.2208778668,4.5893512326,-2.920496239
39,107,2006,536,387,-139,519,10,149,-129,3,40764,13.149340693,9.4940202392,-3.409996933,-17,0.2453235204,3.6553204538,-3.164673413
39,107,2007,576,394,-166,519,9,182,-157,35,40799,14.124051347,9.661243456,-4.070473131,10,0.2206883023,4.4628078908,-3.849784829
39,107,2008,584,380,-220,519,8,204,-212,19,40818,14.310744085,9.3117855349,-5.391033731,27,0.1960375902,4.9989585503,-5.194996141
39,109,2001,1264,959,-146,1399,59,305,-87,124,99096,12.763293414,9.6835430256,-1.47424117,-94,0.5957549932,3.0797503888,-0.878486176
39,109,2002,1256,911,-202,1399,54,345,-148,106,99202,12.667803004,9.1881915097,-2.037337744,-91,0.5446348425,3.4796114938,-1.492702902
39,109,2003,1220,902,103,1399,45,318,148,317,99519,12.278521143,9.0780541563,1.036629244,-149,0.4528962717,3.2004669864,1.4895255157
39,109,2004,1222,951,241,1399,47,271,288,491,100010,12.248846032,9.5324489172,2.4156889475,-68,0.4711094628,2.7163971152,2.8867984103
39,109,2005,1242,912,298,1399,47,330,345,585,100595,12.382542808,9.092495202,2.9710126866,-90,0.4685825378,3.290047606,3.4395952244
39,109,2006,1212,935,-14,1399,49,277,35,263,100858,12.032583282,9.2825621857,-0.138990236,-49,0.4864658258,2.7500210967,0.3474755898
39,109,2007,1225,948,-346,1399,43,277,-303,-12,100846,12.14651172,9.3999127434,-3.430769841,14,0.4263673502,2.7465989767,-3.004402491
39,109,2008,1283,927,-218,1399,43,356,-175,239,101085,12.707310913,9.1813540269,-2.159153374,58,0.4258880509,3.5259568863,-1.733265323
39,111,2001,182,183,-130,144,3,-1,-127,-140,15027,12.05537524,12.121613566,-8.610982314,-12,0.1987149765,-0.066238325,-8.412267338
39,111,2002,154,184,-140,144,3,-30,-137,-178,14849,10.309278351,12.317579328,-9.372071228,-11,0.2008300977,-2.008300977,-9.17124113
39,111,2003,142,152,-14,144,2,-10,-12,-43,14806,9.5767998651,10.251222391,-0.944191536,-21,0.1348845051,-0.674422526,-0.809307031
39,111,2004,149,179,30,144,1,-30,31,-12,14794,10.067567568,12.094594595,2.027027027,-13,0.0675675676,-2.027027027,2.0945945946
39,111,2005,159,188,-206,144,2,-29,-204,-243,14551,10.83659908,12.813085705,-14.03987051,-10,0.1363094224,-1.976486625,-13.90356108
39,111,2006,151,197,-141,144,1,-46,-140,-192,14359,10.446212383,13.628502248,-9.754410239,-6,0.0691802145,-3.182289865,-9.685230024
39,111,2007,148,174,-77,144,2,-26,-75,-109,14250,10.346394491,12.164004334,-5.382921458,-8,0.1398161418,-1.817609843,-5.243105317
39,111,2008,146,177,12,144,1,-31,13,-29,14221,10.256050016,12.433704471,0.842963015,-11,0.0702469179,-2.177654455,0.9132099329
39,113,2001,7731,5598,-5552,15435,414,2133,-5138,-3419,555097,13.88453619,10.053761944,-9.971147966,-414,0.7435258029,3.8307742456,-9.227622163
39,113,2002,7485,5648,-4441,15382,242,1837,-4199,-2787,552310,13.518065174,10.20040509,-8.020538068,-425,0.437057017,3.3176600834,-7.583481051
39,113,2003,7272,5490,-3056,15542,-11,1782,-3067,-1899,550411,13.189192915,9.9571877202,-5.542653128,-614,-0.019950649,3.2320051944,-5.562603777
39,113,2004,7356,5578,-4390,15578,437,1778,-3953,-2651,547760,13.396820714,10.158709345,-7.995111872,-476,0.7958687673,3.2381113688,-7.199243105
39,113,2005,7115,5458,-4740,15537,258,1657,-4482,-3285,544475,13.028331815,9.9941862328,-8.679450851,-460,0.4724258058,3.0341455822,-8.207025045
39,113,2006,7069,5224,-5748,15578,377,1845,-5371,-3757,540718,13.028097306,9.6277804962,-10.59350733,-231,0.6948072831,3.40031681,-9.898700047
39,113,2007,7435,5454,-5257,15571,249,1981,-5008,-2962,537756,13.788000452,10.114291119,-9.748960105,65,0.4617635659,3.6737093337,-9.287196539
39,113,2008,7258,5435,-5274,15571,271,1823,-5003,-3130,534626,13.536221235,10.136313366,-9.836047229,50,0.505416913,3.3999078687,-9.330630316
39,115,2001,192,171,-90,185,0,21,-90,-84,14792,12.943238506,11.527571795,-6.06714305,-15,0,1.4156667116,-6.06714305
39,115,2002,162,164,-94,185,-1,-2,-95,-111,14681,10.99311234,11.128829776,-6.378719506,-14,-0.067858718,-0.135717436,-6.446578224
39,115,2003,183,173,4,185,-3,10,1,-8,14673,12.468488111,11.787149963,0.2725352592,-19,-0.204401444,0.6813381481,0.0681338148
39,115,2004,170,151,38,185,1,19,39,47,14720,11.567379988,10.274555166,2.5856496445,-11,0.0680434117,1.2928248222,2.6536930562
39,115,2005,169,128,-28,185,-1,41,-29,-2,14718,11.481758272,8.6962429513,-1.902303146,-14,-0.067939398,2.7855153203,-1.970242544
39,115,2006,183,156,-102,185,1,27,-101,-81,14637,12.468063362,10.62851303,-6.949412366,-7,0.0681314938,1.8395503321,-6.881280872
39,115,2007,172,167,-44,185,-1,5,-45,-35,14602,11.765108246,11.423099285,-3.009678854,5,-0.068401792,0.3420089606,-3.078080646
39,115,2008,167,167,-100,185,-1,0,-101,-92,14510,11.472932124,11.472932124,-6.870019236,9,-0.068700192,0,-6.938719428
39,117,2001,437,266,441,371,4,171,445,596,32390,13.617100835,8.2886700735,13.74174249,-20,0.1246416552,5.3284307616,13.866384146
39,117,2002,440,270,325,371,3,170,328,477,32867,13.485143356,8.2749743323,9.9606172518,-21,0.0919441592,5.210169024,10.052561411
39,117,2003,414,258,369,371,2,156,371,506,33373,12.5,7.7898550725,11.141304348,-21,0.0603864734,4.7101449275,11.201690821
39,117,2004,421,263,332,371,3,158,335,459,33832,12.5288297,7.8267986013,9.8802172457,-34,0.0892790715,4.7020310989,9.9694963172
39,117,2005,411,304,115,371,3,107,118,195,34027,12.113352687,8.9597547857,3.3893809222,-30,0.0884186328,3.1535979015,3.477799555
39,117,2006,439,275,11,371,3,164,14,162,34189,12.870880732,8.0626246042,0.3225049842,-16,0.0879559048,4.8082561276,0.4104608889
39,117,2007,429,273,148,371,3,156,151,288,34477,12.495266944,7.95153351,4.3107214633,-19,0.0873794891,4.5437334343,4.3981009524
39,117,2008,458,272,-181,371,2,186,-179,-22,34455,13.288458191,7.891835432,-5.251552254,-29,0.0580282017,5.3966227587,-5.193524053
39,119,2001,1031,842,-135,2442,14,189,-121,-13,84695,12.172157518,9.9407920757,-1.593832459,-81,0.165286329,2.2313654422,-1.42854613
39,119,2002,1075,846,223,2555,11,229,234,379,85074,12.664267328,9.9664838693,2.6270991759,-84,0.1295878517,2.6977834587,2.7566870277
39,119,2003,1081,856,-92,2486,2,225,-90,18,85092,12.705240765,10.060764195,-1.081297086,-117,0.0235064584,2.6444765699,-1.057790628
39,119,2004,1089,911,-71,2469,14,178,-57,63,85155,12.793176972,10.702097541,-0.834082245,-58,0.1644669216,2.0910794316,-0.669615324
39,119,2005,1064,861,-155,2458,8,203,-147,-17,85138,12.496109646,10.111983464,-1.820391913,-73,0.0939557116,2.3841261825,-1.726436201
39,119,2006,1062,875,83,2407,12,187,95,240,85378,12.456309085,10.262966525,0.9735156818,-42,0.1407492552,2.1933425602,1.114264937
39,119,2007,1138,885,-420,2407,8,253,-412,-148,85230,13.340523305,10.374660039,-4.923567476,11,0.0937822376,2.9658632655,-4.829785239
39,119,2008,1122,867,-446,2407,8,255,-438,-143,85087,13.175431695,10.181015401,-5.237292813,40,0.093942472,2.9944162943,-5.143350341
39,121,2001,125,117,-164,2179,1,8,-163,-166,13935,8.9171065773,8.3464117563,-11.69924383,-11,0.0713368526,0.5706948209,-11.62790698
39,121,2002,135,117,18,2179,0,18,18,23,13958,9.6798479905,8.3892015918,1.2906463987,-13,0,1.2906463987,1.2906463987
39,121,2003,157,140,123,2179,0,17,123,130,14088,11.195892462,9.9835983741,8.7713042858,-10,0,1.2122940883,8.7713042858
39,121,2004,129,102,66,2349,1,27,67,82,14170,9.1301578314,7.2191945644,4.6712435417,-12,0.0707764173,1.910963267,4.7420199589
39,121,2005,117,133,-154,2303,1,-16,-153,-180,13990,8.3096590909,9.4460227273,-10.9375,-11,0.0710227273,-1.136363636,-10.86647727
39,121,2006,167,125,355,2546,1,42,356,390,14380,11.772999648,8.8121254847,25.026436376,-8,0.0704970039,2.9608741628,25.09693338
39,121,2007,160,125,-51,2564,1,35,-50,-24,14356,11.135857461,8.6998886414,-3.549554566,-9,0.0695991091,2.4359688196,-3.479955457
39,121,2008,171,123,-63,2564,0,48,-63,-23,14333,11.92094531,8.5747150476,-4.391927219,-8,0,3.3462302625,-4.391927219
39,123,2001,428,412,-35,637,4,16,-31,-32,40972,10.442080609,10.051722455,-0.853908461,-17,0.0975895384,0.3903581536,-0.756318923
39,123,2002,428,453,-22,637,3,-25,-19,-57,40915,10.453429726,11.064027257,-0.537325827,-13,0.0732717037,-0.610597531,-0.464054123
39,123,2003,407,430,246,637,-1,-23,245,212,41127,9.9217473977,10.482435826,5.9969284025,-10,-0.024377758,-0.560688428,5.9725506448
39,123,2004,431,441,170,637,6,-10,176,175,41302,10.457484623,10.700117677,4.1247619163,9,0.1455798323,-0.242633054,4.2703417487
39,123,2005,407,467,51,637,3,-60,54,-8,41294,9.855198799,11.308053659,1.2349266308,-2,0.072642743,-1.45285486,1.3075693738
39,123,2006,416,476,-39,637,5,-60,-34,-94,41200,10.085581982,11.540233229,-0.945523311,0,0.1212209373,-1.454651247,-0.824302374
39,123,2007,419,460,-81,637,1,-41,-80,-131,41069,10.186096829,11.182827067,-1.969149984,-10,0.0243104936,-0.996730239,-1.94483949
39,123,2008,445,430,-240,637,1,15,-239,-246,40823,10.867972452,10.501636301,-5.861378401,-22,0.02442241,0.3663361501,-5.836955991
39,125,2001,239,165,-202,125,1,74,-201,-143,20091,11.853688779,8.1835089895,-10.01859888,-16,0.0495970242,3.6701797892,-9.96900186
39,125,2002,202,161,-313,125,0,41,-313,-283,19808,10.125567057,8.0703777037,-15.68961628,-11,0,2.0551893531,-15.68961628
39,125,2003,209,178,-184,125,-2,31,-186,-171,19637,10.597033845,9.0252249968,-9.329446064,-16,-0.101407022,1.5718088478,-9.430853087
39,125,2004,262,192,-210,125,1,70,-209,-157,19480,13.395710305,9.8167037349,-10.73701971,-18,0.0511286653,3.57900657,-10.68589104
39,125,2005,253,165,-141,125,-1,88,-142,-71,19409,13.011391396,8.4856900409,-7.251407853,-17,-0.051428424,4.5257013551,-7.302836278
39,125,2006,258,171,-230,125,0,87,-230,-149,19260,13.344022343,8.8442938788,-11.89583387,-6,0,4.4997284647,-11.89583387
39,125,2007,258,159,-187,125,0,99,-187,-88,19172,13.426311407,8.2743547044,-9.731473772,0,0,5.1519567027,-9.731473772
39,125,2008,257,167,-166,125,-1,90,-167,-76,19096,13.43158775,8.7279188878,-8.6756559,1,-0.052262987,4.7036688617,-8.727918888
39,127,2001,475,316,52,293,9,159,61,183,34296,13.887061644,9.2385504831,1.520267801,-37,0.2631232733,4.6485111608,1.7833910743
39,127,2002,479,302,13,293,8,177,21,163,34459,13.933532107,8.7848156498,0.378154316,-35,0.2327103483,5.148716457,0.6108646644
39,127,2003,440,330,132,293,4,110,136,207,34666,12.730560579,9.547920434,3.8191681736,-39,0.1157323689,3.1826401447,3.9349005425
39,127,2004,447,327,-19,293,7,120,-12,86,34752,12.878504134,9.4211875882,-0.547408453,-22,0.2016767985,3.4573165461,-0.345731655
39,127,2005,463,366,-31,293,5,97,-26,39,34791,13.315502639,10.525861697,-0.891534734,-32,0.1437959248,2.7896409416,-0.747738809
39,127,2006,459,321,-109,293,6,138,-103,18,34809,13.189655172,9.224137931,-3.132183908,-17,0.1724137931,3.9655172414,-2.959770115
39,127,2007,479,321,-131,293,4,158,-127,24,34833,13.756066741,9.2185749978,-3.762097585,-7,0.1148732087,4.5374917435,-3.647224376
39,127,2008,468,341,283,293,4,127,287,408,35241,13.357307989,9.7325684277,8.0771755573,-6,0.1141650255,3.624739561,8.1913405828
39,129,2001,638,458,-700,6057,2,180,-698,-552,52264,12.143129045,8.7171678721,-13.32318234,-34,0.0380662352,3.4259611724,-13.2851161
39,129,2002,600,454,-832,4856,1,146,-831,-707,51557,11.558355246,8.7458221362,-16.02758594,-22,0.0192639254,2.8125331099,-16.00832202
39,129,2003,539,458,81,5108,-3,81,78,87,51644,10.445635217,8.8758829856,1.5697522311,-72,-0.058138972,1.5697522311,1.5116132596
39,129,2004,646,419,-65,4695,4,227,-61,130,51774,12.492989615,8.1030381558,-1.257034559,-36,0.0773559728,4.3899514591,-1.179678586
39,129,2005,593,454,519,4652,1,139,520,610,52384,11.386547361,8.7175252981,9.9656291403,-49,0.0192015976,2.6690220626,9.9848307379
39,129,2006,632,477,793,4844,3,155,796,924,53308,11.959277902,9.0262271506,15.005866102,-27,0.0567687242,2.9330507512,15.062634826
39,129,2007,625,480,689,5167,1,145,690,855,54163,11.631044654,8.9326422942,12.822063626,20,0.0186096714,2.6984023597,12.840673298
39,129,2008,660,474,186,5167,1,186,187,381,54544,12.142732299,8.72068956,3.4220427387,8,0.0183980792,3.4220427387,3.440440818
39,131,2001,395,282,-82,484,10,113,-72,13,27752,14.236542863,10.163810348,-2.955434215,-28,0.3604188067,4.0727325152,-2.595015408
39,131,2002,378,333,122,484,10,45,132,151,27903,13.583685203,11.966579822,4.3841523673,-26,0.3593567514,1.6171053814,4.7435091187
39,131,2003,371,321,42,484,7,50,49,60,27963,13.281781406,11.491783912,1.503597895,-39,0.2505996492,1.789997494,1.7541975441
39,131,2004,377,283,-20,484,7,94,-13,62,28025,13.467171537,10.109309138,-0.714438808,-19,0.2500535829,3.3578623991,-0.464385225
39,131,2005,404,335,-294,484,8,69,-286,-243,27782,14.478470443,12.005662372,-10.53631265,-26,0.286702385,2.4728080707,-10.24961026
39,131,2006,386,312,87,484,8,74,95,156,27938,13.854989232,11.1988514,3.1227566403,-13,0.2871500359,2.656137832,3.4099066762
39,131,2007,389,297,-147,484,6,92,-141,-43,27895,13.934411549,10.638869486,-5.265703079,6,0.2149266563,3.2955420629,-5.050776423
39,131,2008,386,318,-9,484,5,68,-4,72,27967,13.819770148,11.385199241,-0.32222262,8,0.1790125667,2.4345709069,-0.143210053
39,133,2001,1732,1073,19,7829,119,659,138,643,153026,11.342167389,7.0266429608,0.1244233143,-154,0.7792828633,4.3155244279,0.9037061776
39,133,2002,1603,1130,227,7877,110,473,337,666,153692,10.452598152,7.3683318227,1.4801870122,-144,0.7172712394,3.0842663293,2.1974582516
39,133,2003,1609,1152,435,8189,89,457,524,781,154473,10.442457774,7.4765142051,2.823162916,-200,0.5776126426,2.9659435692,3.4007755585
39,133,2004,1651,1172,-111,8129,93,479,-18,364,154837,10.67537422,7.5781578352,-0.717726553,-97,0.601338463,3.0972163849,-0.11638809
39,133,2005,1659,1316,-76,8344,94,343,18,219,155056,10.706921421,8.4932541232,-0.490491879,-142,0.6066610088,2.2136672981,0.1161691293
39,133,2006,1602,1225,-880,8093,97,377,-783,-475,154581,10.347600577,7.9124910783,-5.684075224,-69,0.6265401099,2.4351094992,-5.057535114
39,133,2007,1683,1168,214,8094,85,515,299,767,155348,10.860551933,7.5372101352,1.380961446,-47,0.5485127239,3.3233417976,1.9294741699
39,133,2008,1734,1177,51,8094,85,557,136,643,155991,11.138983552,7.5608902193,0.3276171633,-50,0.5460286055,3.5780933323,0.8736457688
39,135,2001,516,364,-201,489,14,152,-187,-78,42283,12.192240442,8.6007277539,-4.749302963,-43,0.3307972213,3.5915126884,-4.418505742
39,135,2002,463,400,-4,489,12,63,8,28,42311,10.946402818,9.4569354801,-0.094569355,-43,0.2837080644,1.4894673381,0.1891387096
39,135,2003,503,373,-189,489,7,130,-182,-103,42208,11.902649108,8.8264177286,-4.47236716,-51,0.1656432281,3.0762313799,-4.306723932
39,135,2004,492,425,-203,489,10,67,-193,-156,42052,11.678139093,10.087823404,-4.818419179,-30,0.2373605507,1.5903156895,-4.581058628
39,135,2005,506,403,-248,489,8,103,-240,-172,41880,12.057379784,9.6030119621,-5.909545823,-35,0.1906305104,2.4543678216,-5.718915312
39,135,2006,534,406,-154,489,10,128,-144,-35,41845,12.756046581,9.698417438,-3.678710063,-19,0.2388772768,3.057629143,-3.439832786
39,135,2007,506,416,-305,489,9,90,-296,-213,41632,12.123099776,9.9668172071,-7.307402039,-7,0.2156282569,2.1562825689,-7.091773782
39,135,2008,521,410,-88,489,8,111,-80,11,41643,12.512758931,9.846892825,-2.113479436,-20,0.1921344941,2.6658661063,-1.921344941
39,137,2001,496,275,-219,460,6,221,-213,-22,34741,14.272559853,7.913213628,-6.30179558,-30,0.1726519337,6.3593462247,-6.129143646
39,137,2002,436,305,-236,460,5,131,-231,-126,34615,12.572812734,8.7952015687,-6.805467443,-26,0.1441836323,3.7776111656,-6.661283811
39,137,2003,467,312,-43,460,1,155,-42,66,34681,13.478411452,9.0048487647,-1.241052875,-47,0.0288616948,4.4735626876,-1.21219118
39,137,2004,493,305,-265,460,4,188,-261,-104,34577,14.236622484,8.80764677,-7.652545554,-31,0.1155101216,5.428975714,-7.537035433
39,137,2005,477,294,-80,460,2,183,-78,71,34648,13.781148429,8.4940411701,-2.31130372,-34,0.057782593,5.2871072589,-2.253521127
39,137,2006,517,272,-250,460,3,245,-247,-16,34632,14.924942263,7.8521939954,-7.217090069,-14,0.0866050808,7.0727482679,-7.130484988
39,137,2007,503,294,-243,460,3,209,-240,-18,34614,14.52791497,8.491465211,-7.01845594,13,0.0866476042,6.0364497588,-6.931808335
39,137,2008,518,307,-309,460,2,211,-307,-71,34543,14.9804069,8.8783492633,-8.936188672,25,0.0578394089,6.102057637,-8.878349263
39,139,2001,1673,1193,-1229,6110,51,480,-1178,-793,128006,13.029341329,9.2910963572,-9.57146473,-95,0.3971885283,3.7382449719,-9.174276202
39,139,2002,1546,1229,-186,6505,41,317,-145,53,128059,12.075059067,9.5991252221,-1.452756136,-119,0.3202311913,2.4759338449,-1.132524945
39,139,2003,1562,1193,-470,6569,21,369,-449,-242,127817,12.209038753,9.3248292142,-3.673654426,-162,0.1641420063,2.884209539,-3.50951242
39,139,2004,1594,1257,-657,6584,53,337,-604,-366,127451,12.488835263,9.8484729774,-5.147531222,-99,0.4152498551,2.6403622859,-4.732281367
39,139,2005,1529,1302,-671,6627,41,227,-630,-516,126935,12.02110179,10.236412381,-5.275447548,-113,0.3223447831,1.784689409,-4.953102765
39,139,2006,1660,1187,-1102,6629,49,473,-1053,-637,126298,13.110455588,9.3747655321,-8.703447023,-57,0.3869953758,3.7356900562,-8.316451647
39,139,2007,1636,1263,-847,6889,38,373,-809,-430,125868,12.975579579,10.017210885,-6.717797007,6,0.3013887677,2.9583686936,-6.416408239
39,139,2008,1623,1227,-1301,6889,39,396,-1262,-869,124999,12.939127107,9.7820757613,-10.3720298,-3,0.3109217235,3.1570513459,-10.06110808
39,141,2001,880,720,32,5345,22,160,54,142,73592,11.969369296,9.793120333,0.4352497926,-72,0.2992342324,2.1762489629,0.734484025
39,141,2002,932,724,145,5254,21,208,166,303,73895,12.638402029,9.8178144514,1.9662749937,-71,0.2847708612,2.8205875772,2.2510458549
39,141,2003,877,761,358,5791,20,116,378,410,74305,11.835357625,10.269905533,4.8313090418,-84,0.2699055331,1.5654520918,5.1012145749
39,141,2004,861,750,-57,5762,19,111,-38,23,74328,11.585583282,10.0919715,-0.766989834,-50,0.255663278,1.493611782,-0.511326556
39,141,2005,929,714,312,5897,20,215,332,480,74808,12.458427207,9.5751528806,4.1841004184,-67,0.2682115653,2.8832743268,4.4523119837
39,141,2006,935,735,247,6032,21,200,268,432,75240,12.46267861,9.7968650032,3.2922798038,-36,0.2799104287,2.6658136063,3.5721902325
39,141,2007,929,730,332,6349,18,199,350,559,75799,12.301458564,9.6663775581,4.396215547,10,0.2383490357,2.6350810056,4.6345645827
39,141,2008,952,755,25,6349,17,197,42,274,76073,12.536873156,9.942583228,0.3292246102,35,0.2238727349,2.5942899284,0.5530973451
39,143,2001,868,566,-390,1017,12,302,-378,-133,61675,14.058615356,9.167253792,-6.316658973,-57,0.1943587376,4.8913615639,-6.122300236
39,143,2002,842,615,-176,1017,11,227,-165,9,61684,13.651213126,9.9708979483,-2.853460226,-53,0.1783412641,3.6803151777,-2.675118962
39,143,2003,835,635,-437,1017,9,200,-428,-286,61398,13.568190312,10.318324369,-7.100957086,-58,0.1462439674,3.249865943,-6.954713118
39,143,2004,794,656,-81,1017,14,138,-67,33,61431,12.928542934,10.68151658,-1.318906773,-38,0.2279591953,2.2470263537,-1.090947578
39,143,2005,802,622,-334,1017,12,180,-322,-198,61233,13.076371225,10.141524816,-5.44577056,-56,0.1956564273,2.9348464097,-5.250114133
39,143,2006,785,641,-254,1017,16,144,-238,-123,61110,12.832773432,10.478736013,-4.152260448,-29,0.2615597133,2.3540374194,-3.890700735
39,143,2007,813,619,-400,1017,10,194,-390,-183,60927,13.323828019,10.144464384,-6.555388939,13,0.1638847235,3.1793636356,-6.391504216
39,143,2008,822,613,-544,1017,10,209,-534,-290,60637,13.523740581,10.085222599,-8.950018097,35,0.1645223915,3.4385179823,-8.785495706
39,145,2001,1080,977,-762,3471,16,103,-746,-707,78391,13.715243604,12.407215742,-9.676866321,-64,0.2031887941,1.3080278623,-9.473677527
39,145,2002,942,992,-375,3457,15,-50,-360,-472,77919,12.052971659,12.692725993,-4.798157508,-62,0.1919263003,-0.639754334,-4.606231207
39,145,2003,965,918,-745,3343,9,47,-736,-749,77170,12.44446737,11.838363778,-9.607386726,-60,0.11606239,0.6061035921,-9.491324336
39,145,2004,1018,1035,-720,3132,15,-17,-705,-792,76378,13.259697293,13.481126423,-9.378174903,-70,0.1953786438,-0.22142913,-9.182796259
39,145,2005,998,887,-239,3262,12,111,-227,-184,76194,13.082348006,11.627297276,-3.132947068,-68,0.1573027816,1.4550507301,-2.975644286
39,145,2006,983,865,-113,3461,14,118,-99,-17,76177,12.902717709,11.353866549,-1.483221873,-36,0.183762002,1.5488511593,-1.299459871
39,145,2007,1024,913,148,3833,12,111,160,272,76449,13.418421501,11.963885577,1.9393812326,1,0.157247127,1.4545359244,2.0966283595
39,145,2008,1026,900,-13,3833,12,126,-1,138,76587,13.408609739,11.761938367,-0.169894665,13,0.1568258449,1.6466713714,-0.01306882
39,147,2001,704,584,-387,1639,21,120,-366,-293,58314,12.042319173,9.989651132,-6.619854432,-47,0.3592169071,2.0526680408,-6.260637524
39,147,2002,745,558,-535,1622,20,187,-515,-371,57943,12.816432559,9.5994219703,-9.203746871,-43,0.3440653036,3.2170105886,-8.859681568
39,147,2003,710,517,-338,1692,17,193,-321,-188,57755,12.273332296,8.9370602776,-5.842797628,-60,0.2938685198,3.3362720185,-5.548929109
39,147,2004,757,584,-365,1728,18,173,-347,-223,57532,13.13244338,10.131237694,-6.332023559,-49,0.3122641755,3.0012056867,-6.019759383
39,147,2005,757,556,-454,1826,17,201,-437,-286,57246,13.190681141,9.6882677865,-7.910923696,-50,0.2962240151,3.5024133545,-7.614699681
39,147,2006,675,567,-487,1886,17,108,-470,-386,56860,11.831104412,9.9381277058,-8.535922739,-24,0.2979685556,1.8929767059,-8.237954183
39,147,2007,737,585,-351,1916,15,152,-336,-172,56688,12.981294254,10.3040124,-6.18240744,12,0.2642054462,2.6772818544,-5.918201994
39,147,2008,751,531,-467,1916,14,220,-453,-227,56461,13.274531812,9.3858540509,-8.254602339,6,0.2474613121,3.8886777612,-8.007141026
39,149,2001,785,444,-71,665,49,341,-22,273,48263,16.311179911,9.2256864721,-1.475278693,-46,1.0181500836,7.0854934392,-0.457128609
39,149,2002,683,408,-315,665,48,275,-267,-28,48235,14.155733798,8.4561338059,-6.528632718,-36,0.9948392713,5.6995999917,-5.533793446
39,149,2003,737,406,-289,665,41,331,-248,30,48265,15.274611399,8.414507772,-5.989637306,-53,0.8497409326,6.8601036269,-5.139896373
39,149,2004,747,398,-355,665,43,349,-312,-3,48262,15.477534783,8.246397381,-7.35545495,-40,0.8909424306,7.231137402,-6.46451252
39,149,2005,708,371,-133,665,42,337,-91,200,48462,14.639593069,7.6713121873,-2.750093048,-46,0.8684504363,6.9682808817,-1.881642612
39,149,2006,720,397,-258,665,45,323,-213,89,48551,14.843371507,8.1844701226,-5.31887479,-21,0.9277107192,6.6589013844,-4.391164071
39,149,2007,704,418,-142,665,41,286,-101,197,48748,14.470857871,8.592071861,-2.918837809,12,0.8427630294,5.8787860101,-2.07607478
39,149,2008,745,402,-235,665,41,343,-194,171,48919,15.255920628,8.2320538155,-4.812270265,22,0.8395875782,7.0238668127,-3.972682687
39,151,2001,4810,3950,-1576,8796,108,860,-1468,275,378375,12.716877623,10.443173932,-4.166694207,883,0.2855348822,2.2737036915,-3.881159324
39,151,2002,4411,3798,-1035,8883,103,613,-932,334,378709,11.652603938,10.033232772,-2.734174808,653,0.2720966234,1.6193711662,-2.462078184
39,151,2003,4492,3924,-746,8904,69,568,-677,423,379132,11.854729422,10.35573425,-1.968750701,532,0.1820962445,1.4989951718,-1.786654457
39,151,2004,4471,3909,-583,8948,68,562,-515,133,379265,11.790658455,10.308585081,-1.537453339,86,0.1793256039,1.4820733732,-1.358127735
39,151,2005,4406,3896,-1126,8936,70,510,-1056,-593,378672,11.626296117,10.280537828,-2.971223202,-47,0.184711922,1.3457582886,-2.78651128
39,151,2006,4501,3799,-888,9065,74,702,-814,-109,378563,11.887987217,10.033873236,-2.34537495,3,0.1954479125,1.8541139805,-2.149927037
39,151,2007,4622,3826,-454,9452,62,796,-392,486,379049,12.20149628,10.100156808,-1.198502664,82,0.1636721699,2.1013394719,-1.034830494
39,151,2008,4667,3879,-913,9452,62,788,-851,165,379214,12.309713121,10.231278593,-2.408135436,228,0.1635316506,2.0784345273,-2.244603785
39,153,2001,7094,5467,-1131,9331,590,1627,-541,1601,545179,13.03137431,10.042644961,-2.077598583,515,1.0838047425,2.9887293492,-0.99379384
39,153,2002,6924,5327,-1923,9174,543,1597,-1380,592,545771,12.693523993,9.7658004491,-3.525367799,375,0.9954626701,2.9277235437,-2.529905129
39,153,2003,6743,5428,-1634,9376,450,1315,-1184,-134,545637,12.35651562,9.9467843373,-2.994297275,-265,0.8246228725,2.4097312829,-2.169674402
39,153,2004,6669,5497,-1809,9647,428,1172,-1381,-92,545545,12.223442102,10.075312826,-3.31567053,117,0.7844704183,2.1481292763,-2.531200111
39,153,2005,6613,5505,-1686,9782,439,1108,-1247,-198,545347,12.124023276,10.092658118,-3.091048426,-59,0.8048459426,2.0313651581,-2.286202484
39,153,2006,6522,5222,-2420,9885,451,1300,-1969,-673,544674,11.966741925,9.5814667791,-4.440281426,-4,0.827506993,2.3852751461,-3.612774433
39,153,2007,6835,5248,-2915,10427,398,1587,-2517,-940,543734,12.559628375,9.6434425326,-5.356447215,-10,0.7313433933,2.9161858421,-4.625103821
39,153,2008,6814,5350,-3130,10427,400,1464,-2730,-1172,542562,12.545383579,9.8499856393,-5.762701879,94,0.7364475244,2.6953979394,-5.026254354
39,155,2001,2769,2395,-1293,4072,53,374,-1240,-1053,223893,12.338499997,10.671978148,-5.761531418,-187,0.2361648609,1.6665218486,-5.525366557
39,155,2002,2431,2473,-1479,4106,48,-42,-1431,-1651,222242,10.898046555,11.086330371,-6.630280072,-178,0.2151815034,-0.188283815,-6.415098569
39,155,2003,2415,2406,-1684,4073,33,9,-1651,-1857,220385,10.912122397,10.871456102,-7.609115576,-215,0.149109747,0.0406662946,-7.460005829
39,155,2004,2426,2465,-1316,4042,49,-39,-1267,-1482,218903,11.045145781,11.222705833,-5.99151354,-176,0.2230882701,-0.177560052,-5.76842527
39,155,2005,2448,2461,-1628,3934,41,-13,-1587,-1792,217111,11.228997234,11.288628347,-7.467650121,-192,0.1880673556,-0.059631113,-7.279582766
39,155,2006,2377,2490,-1684,3991,49,-113,-1635,-1838,215273,10.994856424,11.517539964,-7.78937241,-90,0.2266503848,-0.522683541,-7.562722025
39,155,2007,2464,2420,-2019,4021,42,44,-1977,-1888,213385,11.496344405,11.291052541,-9.42009714,45,0.195960416,0.2052918644,-9.224136724
39,155,2008,2452,2392,-2207,4021,43,60,-2164,-2068,211317,11.546919958,11.264368899,-10.3931698,36,0.2024949259,0.2825510593,-10.19067487
39,157,2001,1204,891,-150,1163,32,313,-118,109,91138,13.218640039,9.7822327864,-1.646840536,-86,0.3513259811,3.4364072527,-1.295514555
39,157,2002,1159,964,105,1163,31,195,136,236,91374,12.700534759,10.563688963,1.150609275,-95,0.3397036907,2.1368457964,1.4903129657
39,157,2003,1234,919,-175,1163,25,315,-150,45,91419,13.501611112,10.055089637,-1.914734153,-120,0.2735334504,3.4465214751,-1.641200702
39,157,2004,1162,909,-60,1163,23,253,-37,157,91576,12.699800541,9.9346976693,-0.655755622,-59,0.2513729883,2.7651028717,-0.404382633
39,157,2005,1199,933,-474,1163,24,266,-450,-267,91309,13.112064959,10.203133116,-5.183585313,-83,0.2624600159,2.9089318424,-4.921125297
39,157,2006,1155,902,-461,1163,25,253,-436,-224,91085,12.664890292,9.8906762284,-5.054990844,-41,0.2741318245,2.7742140641,-4.780859019
39,157,2007,1202,942,-125,1163,20,260,-105,178,91263,13.183583039,10.331892864,-1.371004892,23,0.2193607827,2.8516901748,-1.151644109
39,157,2008,1205,942,-264,1163,20,263,-244,85,91348,13.197452508,10.317012666,-2.891392085,66,0.2190448549,2.8804398421,-2.67234723
39,159,2001,637,254,905,2100,15,383,920,1284,42479,15.225757105,6.071181012,21.631570141,-19,0.3585343117,9.1545760929,21.990104453
39,159,2002,594,294,145,2139,14,300,159,422,42901,13.914265636,6.8868587491,3.3965799953,-37,0.3279456547,7.0274068869,3.72452565
39,159,2003,614,285,504,2201,8,329,512,818,43719,14.176864465,6.580466405,11.637035327,-23,0.1847148465,7.5963980605,11.821750173
39,159,2004,659,320,622,2343,12,339,634,925,44644,14.915745278,7.2428505144,14.078290687,-48,0.2716068943,7.6728947636,14.349897582
39,159,2005,747,309,340,2231,10,438,350,747,45391,16.593546954,6.8639973344,7.5526184262,-41,0.2221358361,9.7295496196,7.7747542622
39,159,2006,691,343,888,2397,12,348,900,1224,46615,15.020759516,7.4560354759,19.303088929,-24,0.2608525531,7.5647240397,19.563941482
39,159,2007,693,289,584,2743,10,404,594,996,47611,14.7093159,6.134188016,12.395729417,-2,0.2122556407,8.575127884,12.607985057
39,159,2008,738,300,173,2743,10,438,183,612,48223,15.401631989,6.2608260116,3.6104096667,-9,0.2086942004,9.140805977,3.8191038671
39,161,2001,343,333,-231,464,6,10,-225,-238,29393,11.622390892,11.283545676,-7.827324478,-23,0.2033071293,0.3388452155,-7.624017349
39,161,2002,338,301,-162,464,5,37,-157,-144,29249,11.527574094,10.265679888,-5.525050305,-24,0.170526244,1.2618942055,-5.354524061
39,161,2003,366,324,-107,464,5,42,-102,-97,29152,12.534031952,11.095700416,-3.664320816,-37,0.1712299447,1.4383315354,-3.493090872
39,161,2004,387,329,-52,464,5,58,-47,-9,29143,13.277296509,11.287417446,-1.784029505,-20,0.1715412986,1.9898790634,-1.612488207
39,161,2005,383,281,-193,464,5,102,-188,-112,29031,13.167394369,9.660673153,-6.635266614,-26,0.1718980988,3.5067212157,-6.463368515
39,161,2006,385,304,-44,464,5,81,-39,30,29061,13.254837155,10.46615713,-1.514838532,-12,0.1721407423,2.7886800248,-1.34269779
39,161,2007,403,327,-284,464,5,76,-279,-189,28872,13.912623203,11.288902698,-9.804429254,14,0.1726131911,2.6237205047,-9.631816063
39,161,2008,401,317,-234,464,4,84,-230,-124,28748,13.918778202,11.003123915,-8.122179799,22,0.1388406803,2.9156542867,-7.983339118
39,163,2001,187,112,51,140,0,75,51,114,12935,14.520888337,8.6970026402,3.9602422736,-12,0,5.8238856965,3.9602422736
39,163,2002,149,122,70,140,-1,27,69,84,13019,11.481852508,9.4012483625,5.3941588965,-12,-0.077059413,2.0806041458,5.3170994837
39,163,2003,184,124,105,140,-1,60,104,152,13171,14.051164567,9.4692630775,8.018327606,-12,-0.076365025,4.5819014891,7.9419625811
39,163,2004,185,125,-26,140,0,60,-26,25,13196,14.032692381,9.4815489058,-1.972162172,-9,0,4.5511434748,-1.972162172
39,163,2005,155,119,9,140,0,36,9,32,13228,11.731759007,9.0069633666,0.6811989101,-13,0,2.7247956403,0.6811989101
39,163,2006,180,135,101,140,0,45,101,140,13368,13.535870056,10.151902542,7.5951270868,-6,0,3.3839675139,7.5951270868
39,163,2007,173,127,-36,140,0,46,-36,11,13379,12.936030209,9.4963921187,-2.691890679,1,0,3.4396380903,-2.691890679
39,163,2008,174,140,-136,140,-1,34,-137,-98,13281,13.053263316,10.502625656,-10.20255064,5,-0.075018755,2.5506376594,-10.27756939
39,165,2001,2484,1046,4604,6093,168,1438,4772,6124,166811,15.169558287,6.3878252692,28.116202236,-86,1.0259604639,8.7817330182,29.1421627
39,165,2002,2571,1159,5373,5964,156,1412,5529,6922,173733,15.099370419,6.8067562488,31.555393723,-19,0.916181169,8.2926141703,32.471574892
39,165,2003,2626,1127,5234,6003,122,1499,5356,6976,180709,14.81765705,6.3592915061,29.533746001,121,0.6884060015,8.4583655436,30.222152002
39,165,2004,2664,1246,5627,6219,129,1418,5756,6884,187593,14.466388996,6.7661864448,30.556445526,-290,0.7005120798,7.7002025512,31.256957605
39,165,2005,2842,1251,4917,6229,126,1591,5043,6483,194076,14.892485373,6.5554184385,25.765781345,-151,0.6602579722,8.337066935,26.426039317
39,165,2006,2713,1219,3226,6469,131,1494,3357,4741,198817,13.810375853,6.2052518116,16.421773867,-110,0.6668482259,7.6051240414,17.088622093
39,165,2007,2768,1303,3231,6825,116,1465,3347,4789,203606,13.756668978,6.475773005,16.057730299,-23,0.576507804,7.2808959726,16.634238103
39,165,2008,2948,1326,2020,6825,117,1622,2137,3747,207353,14.346929986,6.4531984943,9.8306643728,-12,0.5693998671,7.8937314915,10.40006424
39,167,2001,706,683,-410,1770,4,23,-406,-434,62755,11.211332021,10.846090326,-6.51083021,-51,0.0635202947,0.3652416947,-6.447309916
39,167,2002,702,680,-306,1693,3,22,-303,-331,62424,11.215938776,10.864442119,-4.888998953,-50,0.0479313623,0.3514966568,-4.841067591
39,167,2003,687,693,79,1774,1,-6,80,-13,62411,11.006528618,11.102655505,1.2656706853,-87,0.0160211479,-0.096126887,1.2816918332
39,167,2004,716,692,70,1852,3,24,73,56,62467,11.467191979,11.082816829,1.1210941879,-41,0.0480468938,0.3843751501,1.1691410817
39,167,2005,678,711,-413,1879,2,-33,-411,-496,61971,10.89699288,11.427377489,-6.637843745,-52,0.0321445218,-0.530384609,-6.605699224
39,167,2006,701,622,-271,1912,3,79,-268,-215,61756,11.331398967,10.054393948,-4.380612154,-26,0.0484938615,1.2770050191,-4.332118293
39,167,2007,664,695,-48,2034,2,-31,-46,-74,61682,10.758437434,11.260713881,-0.777718369,3,0.032404932,-0.502276446,-0.745313437
39,167,2008,699,703,-145,2034,1,-4,-144,-115,61567,11.34289122,11.407800469,-2.352960267,33,0.0162273122,-0.064909249,-2.336732955
39,169,2001,1602,1007,-144,3427,89,595,-55,429,112090,14.319489075,9.0010770902,-1.287145085,-111,0.7955271708,5.3184119848,-0.491617915
39,169,2002,1614,908,-236,3364,86,706,-150,452,112542,14.370169878,8.0843334877,-2.101214431,-104,0.7656967841,6.2858363902,-1.335517647
39,169,2003,1621,949,-365,3476,76,672,-289,242,112784,14.388042214,8.4233510558,-3.239750406,-141,0.6745781667,5.9646911586,-2.565172239
39,169,2004,1580,954,-489,3370,74,626,-415,125,112909,14.001320378,8.4539617977,-4.333320041,-86,0.655758043,5.54735858,-3.677561998
39,169,2005,1636,1030,-326,3468,75,606,-251,246,113155,14.473777337,9.1124637271,-2.884139005,-109,0.6635289122,5.3613136103,-2.220610093
39,169,2006,1613,964,-288,3514,77,649,-211,385,113540,14.230574119,8.5048192505,-2.540858863,-53,0.6793268488,5.7257548689,-1.861532014
39,169,2007,1615,978,-854,3514,70,637,-784,-129,113411,14.232147027,8.6186004909,-7.525853598,18,0.6168732458,5.6135465365,-6.908980353
39,169,2008,1653,969,-367,3514,70,684,-297,401,113812,14.549583449,8.5290661597,-3.230306791,14,0.6161348103,6.0205172892,-2.614171981
39,171,2001,458,395,-181,1083,14,63,-167,-138,39067,11.702780049,10.093008994,-4.624897792,-34,0.3577269011,1.6097710548,-4.267170891
39,171,2002,444,351,-230,1083,13,93,-217,-153,38914,11.387389236,9.0021928418,-5.898872802,-29,0.3334145497,2.385196394,-5.565458253
39,171,2003,447,337,-351,1083,13,110,-338,-260,38654,11.525371287,8.689150165,-9.050123762,-32,0.335189769,2.8362211221,-8.714933993
39,171,2004,470,392,-122,1083,14,78,-108,-58,38596,12.16828479,10.148867314,-3.158576052,-28,0.3624595469,2.0194174757,-2.796116505
39,171,2005,438,371,-253,1083,13,67,-240,-209,38387,11.379135653,9.638491615,-6.572879727,-36,0.337736903,1.7406440383,-6.235142824
39,171,2006,475,369,-184,1083,14,106,-170,-81,38306,12.387049666,9.6227817402,-4.79835187,-17,0.3650919901,2.7642679254,-4.43325988
39,171,2007,466,385,-106,1083,14,81,-92,-3,38303,12.165672441,10.05103839,-2.767298881,8,0.3654923051,2.1146340508,-2.401806576
39,171,2008,487,344,-325,1083,13,143,-312,-145,38158,12.738520291,8.9980512941,-8.501065903,24,0.3400426361,3.7404689973,-8.161023267
39,173,2001,1410,928,217,7868,125,482,342,699,121891,11.600975798,7.6352521567,1.785398403,-125,1.0284553013,3.9657236417,2.8138537043
39,173,2002,1317,959,-301,7871,114,358,-187,60,121951,10.802076755,7.8657491326,-2.468811772,-111,0.9350317009,2.936327622,-1.533780071
39,173,2003,1368,930,66,7731,90,438,156,407,122358,11.198932499,7.6133093746,0.540299375,-187,0.736771875,3.5856231248,1.2770712499
39,173,2004,1409,920,714,8027,105,489,819,1211,123569,11.458684894,7.4818950339,5.8066011459,-97,0.8539119332,3.9767898604,6.6605130791
39,173,2005,1365,886,-58,8041,100,479,42,406,123975,11.028342436,7.1583233688,-0.468603561,-115,0.8079371748,3.8700190673,0.3393336134
39,173,2006,1363,986,-273,7753,107,377,-166,152,124127,10.987416466,7.9483438263,-2.200707773,-59,0.862548468,3.0390726395,-1.338159305
39,173,2007,1391,977,189,7753,93,414,282,684,124811,11.175473411,7.8493440134,1.5184503772,-12,0.7471739951,3.3261293977,2.2656243723
39,173,2008,1440,937,-116,7753,94,503,-22,529,125340,11.51304612,7.491475149,-0.927439826,48,0.7515460662,4.0215709711,-0.17589376
39,175,2001,280,248,-154,445,6,32,-148,-133,22777,12.257316086,10.856479961,-6.741523847,-17,0.2626567733,1.4008361241,-6.478867074
39,175,2002,277,221,-47,445,6,56,-41,-5,22772,12.162725856,9.70383543,-2.063711607,-20,0.2634525456,2.4588904257,-1.800259062
39,175,2003,273,251,-39,445,6,22,-33,-42,22730,11.999472551,11.032482089,-1.714210364,-31,0.2637246714,0.966990462,-1.450485693
39,175,2004,312,239,8,445,5,73,13,70,22800,13.705249286,10.49857237,0.3514166484,-16,0.2196354052,3.2066769163,0.5710520536
39,175,2005,292,236,-175,445,6,56,-169,-132,22668,12.844198117,10.380927246,-7.697721474,-19,0.2639218791,2.4632708718,-7.433799595
39,175,2006,298,253,-184,445,5,45,-179,-143,22525,13.187883079,11.196424225,-8.142853982,-9,0.221273206,1.9914588542,-7.921580776
39,175,2007,280,215,-168,445,6,65,-162,-106,22419,12.45995016,9.5674617302,-7.475970096,-9,0.266998932,2.89248843,-7.208971164
39,175,2008,297,229,-131,445,5,68,-126,-65,22354,13.266924262,10.229379313,-5.851741005,-7,0.2233488933,3.037544949,-5.628392111
40,0,2001,49572,35007,-10013,113267,6615,14565,-3398,9526,3463387,14.332867638,10.121655317,-2.895081975,-1641,1.9126103329,4.2112123203,-0.982471642
40,0,2002,50370,35080,1072,112708,5127,15290,6199,19559,3482946,14.502615985,10.100293205,0.3086520615,-1930,1.4761745514,4.4023227795,1.7848266128
40,0,2003,50632,35020,-1758,110741,1807,15612,49,13211,3496157,14.509601019,10.035673639,-0.50378967,-2450,0.5178315895,4.4739273801,0.0140419191
40,0,2004,50922,35737,-3966,112679,6684,15185,2718,15803,3511960,14.532291627,10.198745255,-1.131830419,-2100,1.9075024004,4.333546372,0.7756719815
40,0,2005,51860,35856,-531,110542,5115,16004,4584,18127,3530087,14.728671933,10.183402638,-0.150808423,-2461,1.452702602,4.5452692946,1.3018941793
40,0,2006,52485,36031,15688,114257,6081,16454,21769,38045,3568132,14.788216593,10.152124075,4.4202637309,-178,1.7133875413,4.6360925184,6.1336512722
40,0,2007,55442,34658,14736,115225,4492,20784,19228,39991,3608123,15.451513359,9.6590770534,4.106877473,-21,1.251906461,5.7924363056,5.358783934
40,0,2008,55858,34748,7954,115267,4992,21110,12946,34238,3642361,15.408074826,9.58501529,2.1940604241,182,1.3770115209,5.8230595364,3.571071945
40,1,2001,373,215,-127,384,8,158,-119,21,21073,17.709198813,10.207715134,-6.029673591,-18,0.3798219585,7.5014836795,-5.649851632
40,1,2002,371,226,-12,384,7,145,-5,119,21192,17.555897315,10.694428014,-0.567845735,-21,0.3312433456,6.8614693008,-0.23660239
40,1,2003,368,251,20,384,4,117,24,111,21303,17.319684669,11.813154489,0.9412872103,-30,0.1882574421,5.50653018,1.1295446523
40,1,2004,385,224,-58,384,7,161,-51,94,21397,18.032786885,10.491803279,-2.716627635,-16,0.3278688525,7.5409836066,-2.388758782
40,1,2005,399,247,95,384,6,152,101,234,21631,18.546063029,11.480896161,4.4157292926,-19,0.2788881658,7.0651668681,4.6946174584
40,1,2006,374,214,41,384,6,160,47,197,21828,17.21162475,9.8483628247,1.8868358683,-10,0.2761223222,7.363261925,2.1629581905
40,1,2007,378,224,-123,384,3,154,-120,24,21852,17.307692308,10.256410256,-5.631868132,-10,0.1373626374,7.0512820513,-5.494505495
40,1,2008,400,251,-192,384,5,149,-187,-41,21811,18.322149188,11.497148616,-8.79463161,-3,0.2290268649,6.8250005726,-8.565604745
40,3,2001,41,67,-123,1054,1,-26,-122,-153,5927,6.8293495461,11.160156575,-20.48804864,-5,0.1665695011,-4.330807029,-20.32147914
40,3,2002,41,55,-20,1060,1,-14,-19,-39,5888,6.9403300889,9.3101988997,-3.385526873,-6,0.1692763436,-2.369868811,-3.216250529
40,3,2003,43,80,-37,1056,-1,-37,-38,-84,5804,7.3554567225,13.684570647,-6.329113924,-9,-0.171057133,-6.329113924,-6.500171057
40,3,2004,43,75,-17,1056,0,-32,-17,-52,5752,7.4420214607,12.98026999,-2.942194531,-3,0,-5.538248529,-2.942194531
40,3,2005,49,79,-56,1050,0,-30,-56,-92,5660,8.5874518051,13.845075359,-9.814230634,-6,0,-5.257623554,-9.814230634
40,3,2006,45,69,-10,1050,0,-24,-10,-35,5625,7.9751883031,12.228622065,-1.772264067,-1,0,-4.253433762,-1.772264067
40,3,2007,56,64,4,1102,0,-8,4,-2,5623,9.9573257468,11.379800853,0.7112375533,2,0,-1.422475107,0.7112375533
40,3,2008,53,63,22,1102,0,-10,22,14,5637,9.4138543517,11.190053286,3.9076376554,2,0,-1.776198934,3.9076376554
40,5,2001,157,172,84,1537,1,-15,85,58,13898,11.320210541,12.401759319,6.056673156,-12,0.0721032519,-1.081548778,6.1287764078
40,5,2002,172,178,108,1559,1,-6,109,92,13990,12.335054504,12.765347103,7.7452667814,-11,0.0717154332,-0.430292599,7.8169822146
40,5,2003,154,141,162,1558,1,13,163,170,14160,10.941385435,10.017761989,11.509769094,-6,0.0710479574,0.9236234458,11.580817052
40,5,2004,165,124,110,1640,0,41,110,137,14297,11.596443757,8.7149031873,7.7309625048,-14,0,2.88154057,7.7309625048
40,5,2005,159,162,14,1561,1,-3,15,0,14297,11.121214241,11.331048472,0.9792264111,-12,0.0699447437,-0.209834231,1.0491711548
40,5,2006,173,129,-13,1568,0,44,-13,23,14320,12.090715309,9.015620086,-0.908550861,-8,0,3.0750952231,-0.908550861
40,5,2007,172,145,130,1567,1,27,131,159,14479,11.944859196,10.06979409,9.0280912532,1,0.0694468558,1.8750651064,9.097538109
40,5,2008,168,130,146,1567,0,38,146,176,14655,11.532916867,8.9242809089,10.022653944,-8,0,2.608635958,10.022653944
40,7,2001,50,53,-153,96,13,-3,-140,-148,5644,8.7443161945,9.2689751661,-26.75760756,-5,2.2735222106,-0.524658972,-24.48408534
40,7,2002,65,53,-96,96,13,12,-83,-75,5569,11.5936859,9.4533131187,-17.12298225,-4,2.3187371801,2.1403727816,-14.80424507
40,7,2003,75,56,-62,96,3,19,-59,-47,5522,13.524479308,10.098277883,-11.18023623,-7,0.5409791723,3.4262014246,-10.63925706
40,7,2004,77,60,-84,96,4,17,-80,-67,5455,14.029334062,10.93194862,-15.30472807,-4,0.7287965747,3.0973854423,-14.57593149
40,7,2005,74,62,-66,96,4,12,-62,-53,5402,13.631758313,11.421202911,-12.15805471,-3,0.7368518007,2.210555402,-11.42120291
40,7,2006,71,55,-116,96,4,16,-112,-98,5304,13.26359051,10.274612367,-21.67009154,-2,0.7472445358,2.9889781431,-20.922847
40,7,2007,66,32,7,96,1,34,8,29,5333,12.409513961,6.0167340416,1.3161605716,-13,0.1880229388,6.3927799192,1.5041835104
40,7,2008,76,50,-101,96,1,26,-100,-85,5248,14.365371893,9.4509025612,-19.09082317,-11,0.1890180512,4.9144693318,-18.90180512
40,9,2001,266,254,30,1869,10,12,40,31,19776,13.461197844,12.853925761,1.518180208,-21,0.5060600693,0.6072720832,2.0242402773
40,9,2002,293,268,56,1879,10,25,66,70,19846,14.789763263,13.52783807,2.8267124325,-21,0.5047700772,1.2619251931,3.3314825097
40,9,2003,268,248,-693,1419,9,20,-684,-644,19202,13.726695349,12.702315099,-35.49477566,20,0.4609711125,1.0243802499,-35.03380455
40,9,2004,280,229,-1058,439,7,51,-1051,-1043,18159,14.98889216,12.258772517,-56.63659966,-43,0.374722304,2.7301196435,-56.26187736
40,9,2005,328,252,397,439,8,76,405,466,18625,17.8338408,13.701609395,21.585471944,-15,0.4349717268,4.132231405,22.020443671
40,9,2006,300,265,656,759,7,35,663,686,19311,15.816111345,13.970898355,34.584563475,-12,0.3690425981,1.8452129903,34.953606073
40,9,2007,373,258,1337,1874,7,115,1344,1482,20793,18.601635747,12.866546978,66.676640734,23,0.3490923599,5.7350887692,67.025733094
40,9,2008,350,227,224,1874,6,123,230,343,21136,16.694888979,10.827827995,10.684728947,-10,0.2861980968,5.867060984,10.970927043
40,11,2001,122,160,80,1770,31,-38,111,65,12022,10.175570291,13.345010217,6.6725051086,-8,2.5855957296,-3.169439927,9.2581008382
40,11,2002,125,161,-393,1432,31,-36,-362,-397,11625,10.572165602,13.616949296,-33.23888865,1,2.6218970694,-3.044783693,-30.61699158
40,11,2003,130,138,-482,1026,23,-8,-459,-446,11179,11.401508507,12.1031398,-42.27328539,21,2.0171899667,-0.701631293,-40.25609542
40,11,2004,144,148,1555,2579,21,-4,1576,1511,12690,12.065859483,12.401022246,130.29452428,-61,1.7596045079,-0.335162763,132.05412879
40,11,2005,164,137,7,2667,23,27,30,46,12736,12.900180917,10.776370644,0.5506174782,-11,1.809171714,2.1238102729,2.3597891922
40,11,2006,159,168,-280,2610,22,-9,-258,-271,12465,12.618546883,13.332804254,-22.22134042,-4,1.7459624618,-0.714257371,-20.47537796
40,11,2007,157,145,97,2750,21,12,118,131,12596,12.529428195,11.571764894,7.7411116875,1,1.6759107777,0.9576633015,9.4170224652
40,11,2008,159,139,25,2792,20,20,45,63,12659,12.591566027,11.007721243,1.979805979,-2,1.5838447832,1.5838447832,3.5636507622
40,13,2001,489,390,-258,1033,48,99,-210,-139,36459,13.386807561,10.676594987,-7.062978222,-28,1.31404246,2.7102125737,-5.748935762
40,13,2002,508,372,155,975,45,136,200,305,36764,13.875421657,10.160741843,4.2336424348,-31,1.2291219972,3.7146798137,5.4627644319
40,13,2003,493,449,67,929,37,44,104,101,36865,13.391462603,12.196281357,1.8199350799,-47,1.0050387755,1.1951812465,2.8249738554
40,13,2004,482,496,512,879,38,-14,550,494,37359,12.987712869,13.364949343,13.796076741,-42,1.0239275706,-0.377236473,14.820004311
40,13,2005,522,463,225,795,38,59,263,288,37647,13.918886489,12.345679012,5.9995200384,-34,1.0132522732,1.5732074767,7.0127723115
40,13,2006,556,454,1013,1121,38,102,1051,1133,38780,14.549831866,11.880618106,26.508956259,-20,0.9944129692,2.6692137595,27.503369228
40,13,2007,568,448,348,956,37,120,385,518,39298,14.549553011,11.475703783,8.9141627603,13,0.9477701785,3.0738492277,9.8619329389
40,13,2008,598,427,579,956,38,171,617,811,40109,15.061644439,10.754719357,14.583097208,23,0.9570944627,4.3069250822,15.540191671
40,15,2001,387,388,-226,1514,28,-1,-198,-226,29872,12.906453227,12.939803235,-7.537101884,-27,0.9338002335,-0.033350008,-6.603301651
40,15,2002,434,364,-115,1530,25,70,-90,-49,29823,14.540581288,12.195326242,-3.852919005,-29,0.837591088,2.3452550465,-3.015327917
40,15,2003,461,364,23,1535,12,97,35,93,29916,15.433803713,12.186343929,0.7700162373,-39,0.4017476021,3.2474597834,1.1717638394
40,15,2004,421,374,-74,1542,21,47,-53,-27,29889,14.079090377,12.507315442,-2.474709472,-21,0.7022824179,1.5717749352,-1.772427055
40,15,2005,435,357,-294,1542,18,78,-276,-221,29668,14.60785466,11.988515204,-9.872894874,-23,0.6044629515,2.6193394563,-9.268431922
40,15,2006,416,361,-150,1542,20,55,-130,-89,29579,14.042905126,12.186271035,-5.063547521,-14,0.6751396695,1.8566340912,-4.388407852
40,15,2007,422,333,-568,1421,17,89,-551,-467,29112,14.380399039,11.347566066,-19.35560819,-5,0.5793051746,3.0328329727,-18.77630301
40,15,2008,444,331,-199,1421,19,113,-180,-88,29024,15.274528691,11.387092335,-6.846016238,-21,0.6536397413,3.8874363561,-6.192376496
40,17,2001,1112,656,901,2565,88,456,989,1358,89502,12.519279916,7.385474483,10.143769069,-87,0.9907343819,5.1338054333,11.134503451
40,17,2002,1121,651,681,2257,77,470,758,1161,90663,12.44414842,7.2267088502,7.5597369078,-67,0.8547720145,5.2174395693,8.4145089224
40,17,2003,1197,647,983,2111,47,550,1030,1510,92173,13.093701459,7.0773808222,10.752805793,-70,0.5141219453,6.0163206371,11.266927739
40,17,2004,1222,705,1778,2173,79,517,1857,2260,94433,13.097113705,7.5560271374,19.056193263,-114,0.8467037501,5.5410865674,19.902897013
40,17,2005,1354,719,2023,2103,70,635,2093,2636,97069,14.140844482,7.5090599576,21.127716682,-92,0.731062861,6.6317845244,21.858779543
40,17,2006,1392,710,2180,2259,76,682,2256,2887,99956,14.130186525,7.2072072072,22.129171425,-51,0.7714757011,6.9229793173,22.900647126
40,17,2007,1519,685,2446,2211,65,834,2511,3375,103331,14.944388967,6.7392405811,24.064499943,30,0.6394899821,8.2051483863,24.703989926
40,17,2008,1619,710,1781,2211,69,909,1850,2748,106079,15.462489852,6.7809560193,17.009693902,-11,0.6589943174,8.6815338332,17.668688219
40,19,2001,631,587,-27,1097,25,44,-2,-2,45593,13.83954029,12.874501031,-0.592183182,-44,0.5483177611,0.9650392596,-0.043865421
40,19,2002,646,592,257,1097,24,54,281,290,45883,14.123923215,12.943285671,5.6189601644,-45,0.5247277975,1.1806375443,6.1436879619
40,19,2003,677,576,209,1097,18,101,227,265,46148,14.712433854,12.51752127,4.5419478219,-63,0.3911725397,2.1949125838,4.9331203616
40,19,2004,659,622,445,1097,22,37,467,460,46608,14.209323386,13.41153133,9.5950666264,-44,0.4743628445,0.7977920566,10.069429471
40,19,2005,651,626,27,1097,23,25,50,34,46642,13.962466488,13.426273458,0.5790884718,-41,0.4932975871,0.5361930295,1.072386059
40,19,2006,644,613,371,1097,25,31,396,404,47046,13.747758518,13.085987533,7.9199043634,-23,0.5336862779,0.6617709845,8.4535906413
40,19,2007,749,574,242,1097,20,175,262,438,47484,15.846821115,12.144292817,5.1200677034,1,0.4231460912,3.7025282979,5.5432137946
40,19,2008,703,552,303,1097,22,151,325,495,47979,14.72821931,11.564689985,6.3480091763,19,0.4609115574,3.1635293255,6.8089207337
40,21,2001,623,376,59,1847,90,247,149,354,43026,14.539429158,8.7750005834,1.376928283,-42,2.1003990758,5.7644285748,3.4773273589
40,21,2002,612,393,212,1992,89,219,301,484,43510,14.14440233,9.0829250254,4.8996949247,-36,2.0569473976,5.0614773042,6.9566423223
40,21,2003,614,414,120,1939,77,200,197,340,43850,14.056776557,9.478021978,2.7472527473,-57,1.7628205128,4.5787545788,4.5100732601
40,21,2004,600,402,40,2009,72,198,112,282,44132,13.639153463,9.1382328203,0.9092768975,-28,1.6366984156,4.5009206429,2.5459753131
40,21,2005,606,465,110,1956,74,141,184,283,44415,13.687646109,10.502896767,2.4845562244,-42,1.6714287328,3.1847493422,4.1559849571
40,21,2006,660,451,303,1879,77,209,380,567,44982,14.765596161,10.089824043,6.7787509648,-22,1.7226528854,4.6757721176,8.5014038502
40,21,2007,662,425,-194,1699,70,237,-124,106,45088,14.699678028,9.4371044743,-4.307760631,-7,1.5543466193,5.2625735539,-2.753414011
40,21,2008,682,412,310,1699,72,270,382,645,45733,15.018552978,9.072791535,6.8266149899,-7,1.5855363848,5.9457614428,8.4121513747
40,23,2001,230,178,-225,230,1,52,-224,-185,15143,15.096321092,11.683239802,-14.7681402,-13,0.0656361787,3.4130812904,-14.70250402
40,23,2002,238,216,94,230,0,22,94,104,15247,15.663047055,14.215202369,6.1862454755,-12,0,1.4478446858,6.1862454755
40,23,2003,213,228,-73,230,0,-15,-73,-109,15138,14.020075695,15.00740497,-4.805002468,-21,0,-0.987329274,-4.805002468
40,23,2004,214,245,73,230,1,-31,74,30,15168,14.122615984,16.168415495,4.8175278823,-13,0.0659935326,-2.045799512,4.8835214149
40,23,2005,235,229,-72,230,1,6,-71,-79,15089,15.533595532,15.136993093,-4.759229269,-14,0.0661004065,0.3966024391,-4.693128863
40,23,2006,226,240,21,230,1,-14,22,0,15089,14.977798396,15.905626615,1.3917423288,-8,0.0662734442,-0.927828219,1.4580157731
40,23,2007,230,192,-137,230,1,38,-136,-98,14991,15.292553191,12.765957447,-9.109042553,0,0.0664893617,2.5265957447,-9.042553191
40,23,2008,233,196,-137,230,2,37,-135,-101,14890,15.595194271,13.118704193,-9.169706502,-3,0.1338643285,2.4764900773,-9.035842174
40,25,2001,28,40,-110,41,28,-12,-82,-95,3056,9.0220718544,12.888674078,-35.44385371,-1,9.0220718544,-3.866602223,-26.42178186
40,25,2002,38,43,-100,41,28,-5,-72,-76,2980,12.591119947,14.247846256,-33.13452618,1,9.2776673294,-1.656726309,-23.85685885
40,25,2003,35,50,-85,41,12,-15,-73,-88,2892,11.920980926,17.029972752,-28.95095368,0,4.0871934605,-5.108991826,-24.86376022
40,25,2004,34,39,-112,41,13,-5,-99,-110,2782,11.984490659,13.746915756,-39.47832217,-6,4.582305252,-1.762425097,-34.89601692
40,25,2005,28,37,-96,41,13,-9,-83,-93,2689,10.235788704,13.525863645,-35.0941327,-1,4.7523304697,-3.290074941,-30.34180223
40,25,2006,23,36,-27,41,13,-13,-14,-29,2660,8.5997382688,13.460459899,-10.09534492,-2,4.8607216302,-4.86072163,-5.234623294
40,25,2007,31,28,-40,41,10,3,-30,-30,2630,11.720226843,10.586011342,-15.12287335,-3,3.7807183365,1.1342155009,-11.34215501
40,25,2008,32,37,-78,41,10,-5,-68,-74,2556,12.340917856,14.269186271,-30.08098727,-1,3.8565368299,-1.928268415,-26.22445044
40,27,2001,2417,1277,2651,9917,447,1140,3098,4084,212460,11.486659887,6.0688724349,12.598732048,-154,2.1243429745,5.4177874516,14.723075022
40,27,2002,2548,1300,1693,10016,343,1248,2036,3126,215586,11.905262519,6.0741135299,7.9103647739,-158,1.6026314929,5.8311489887,9.5129962668
40,27,2003,2592,1325,2452,9846,131,1267,2583,3720,219306,11.920200877,6.0934668837,11.276362867,-130,0.602448424,5.8267339937,11.878811291
40,27,2004,2680,1440,1317,9301,463,1240,1780,2838,222144,12.141805414,6.5239551478,5.9667006456,-182,2.097632801,5.6178502662,8.0643334466
40,27,2005,2662,1367,1953,8927,358,1295,2311,3408,225552,11.891998142,6.1068224867,8.724670312,-198,1.5992995247,5.7851756549,10.323969837
40,27,2006,2784,1545,4754,10483,426,1239,5180,6296,231848,12.173152602,6.7555749891,20.78705728,-123,1.86270223,5.4175776126,22.64975951
40,27,2007,2966,1407,1549,9779,323,1559,1872,3393,235241,12.69993513,6.0245477843,6.6325689537,-38,1.3830340685,6.6753873459,8.0156030221
40,27,2008,3083,1396,2577,9779,356,1687,2933,4519,239760,12.981025303,5.8778823624,10.850503473,-101,1.4989442127,7.1031429408,12.349447685
40,29,2001,86,78,-11,76,3,8,-8,-7,5997,14.332138988,12.998916757,-1.833180568,-7,0.4999583368,1.3332222315,-1.333222231
40,29,2002,73,71,-68,76,3,2,-65,-68,5929,12.242159987,11.906758343,-11.40365588,-5,0.5031024652,0.3354016435,-10.90055341
40,29,2003,76,94,-20,76,3,-18,-17,-43,5886,12.865002116,15.911976301,-3.385526873,-8,0.5078290309,-3.046974185,-2.877697842
40,29,2004,76,103,-25,76,2,-27,-23,-55,5831,12.972603909,17.58129214,-4.267303917,-5,0.3413843134,-4.608688231,-3.925919604
40,29,2005,52,72,-124,76,3,-20,-121,-145,5686,9.030129374,12.503256056,-21.53338543,-4,0.5209690023,-3.473126682,-21.01241643
40,29,2006,74,90,-63,76,2,-16,-61,-80,5606,13.106624159,15.940488842,-11.15834219,-3,0.3542330854,-2.833864683,-10.8041091
40,29,2007,82,76,81,76,3,6,84,92,5698,14.508138712,13.446567587,14.331210191,2,0.5307855626,1.0615711253,14.861995754
40,29,2008,69,77,27,76,2,-8,29,23,5721,12.085121289,13.486294772,4.7289605044,2,0.3502933707,-1.401173483,5.0792538751
40,31,2001,1886,824,-3427,9364,-56,1062,-3483,-2451,112224,16.62413673,7.2631435132,-30.20727284,-30,-0.493611695,9.3609932172,-30.70088453
40,31,2002,1877,863,-466,8694,-676,1014,-1142,-231,111993,16.742709072,7.6978998024,-4.156687495,-103,-6.029872846,9.0448092696,-10.18656034
40,31,2003,1870,870,-418,6908,-1965,1000,-2383,-1526,110467,16.812011148,7.821630855,-3.757978963,-143,-17.66609728,8.9903802931,-21.42407624
40,31,2004,1841,882,1424,9542,895,959,2319,3156,113623,16.4308983,7.8718372083,12.709179348,-122,7.9878620197,8.5590610915,20.697041367
40,31,2005,2051,940,-2714,8210,-74,1111,-2788,-1763,111860,18.192058825,8.3376573844,-24.07276824,-86,-0.656368773,9.8544014405,-24.72913701
40,31,2006,1886,917,-963,10298,442,969,-521,396,112256,16.830569883,8.1832622392,-8.593763944,-52,3.944385943,8.6473076443,-4.649378001
40,31,2007,2025,895,685,10353,-136,1130,549,1675,113931,17.905538338,7.9138058332,6.0569351908,-4,-1.202544797,9.9917325045,4.8543903938
40,31,2008,2081,905,-3477,10353,109,1176,-3368,-2159,111772,18.440162514,8.0193883112,-30.81040128,33,0.9658710784,10.420774203,-29.8445302
40,33,2001,85,88,-194,175,1,-3,-193,-199,6430,13.017842101,13.477295352,-29.71131021,-3,0.1531510835,-0.459453251,-29.55815912
40,33,2002,74,69,-54,175,-1,5,-55,-58,6372,11.560693642,10.779565693,-8.436181847,-8,-0.15622559,0.7811279488,-8.592407436
40,33,2003,72,79,69,175,-6,-7,63,53,6425,11.252637337,12.346643745,10.783777448,-3,-0.937719778,-1.094006408,9.8460576698
40,33,2004,76,83,-33,175,2,-7,-31,-43,6382,11.868509409,12.961661591,-5.153431717,-5,0.312329195,-1.093152182,-4.841102522
40,33,2005,85,100,70,175,-1,-15,69,49,6431,13.267774916,15.60914696,10.926402872,-5,-0.15609147,-2.341372044,10.770311402
40,33,2006,63,73,-76,175,1,-10,-75,-88,6343,9.8637858149,11.429466103,-11.89917019,-3,0.1565680288,-1.565680288,-11.74260216
40,33,2007,81,69,-71,175,-1,12,-72,-66,6277,12.836767036,10.935023772,-11.25198098,-6,-0.158478605,1.9017432647,-11.41045959
40,33,2008,86,58,-103,175,1,28,-102,-86,6191,13.795316009,9.3038177735,-16.52229708,-12,0.1604106513,4.4914982355,-16.36188643
40,35,2001,200,164,-189,1113,2,36,-187,-161,14768,13.469374011,11.044886689,-12.72855844,-10,0.1346937401,2.424487322,-12.5938647
40,35,2002,209,175,-44,1123,1,34,-43,-25,14743,14.164209956,11.859984413,-2.981938938,-16,0.0677713395,2.304225543,-2.914167599
40,35,2003,181,173,49,1122,0,8,49,41,14784,12.259965455,11.718088529,3.318996173,-16,0,0.5418769262,3.318996173
40,35,2004,184,208,70,1147,1,-24,71,35,14819,12.431172516,14.052629801,4.7292504138,-12,0.0675607202,-1.621457285,4.796811134
40,35,2005,177,180,196,1146,1,-3,197,182,15001,11.871227364,12.072434608,13.145539906,-12,0.0670690812,-0.201207243,13.212608987
40,35,2006,193,202,26,1150,1,-9,27,11,15012,12.861093526,13.460833639,1.7325825476,-7,0.0666377903,-0.599740113,1.7992203379
40,35,2007,193,177,122,1157,1,16,123,137,15149,12.797984152,11.737011372,8.0899174431,-2,0.0663107987,1.0609727794,8.1562282418
40,35,2008,197,152,-73,1157,1,45,-72,-17,15132,13.011459331,10.03929857,-4.821505234,10,0.0660480169,2.9721607609,-4.755457217
40,37,2001,850,697,250,675,10,153,260,340,67910,12.547977561,10.2893416,3.6905816357,-73,0.1476232654,2.258635961,3.8382049011
40,37,2002,908,697,288,675,8,211,296,447,68357,13.326777576,10.229916267,4.2269955308,-60,0.1174165425,3.096861309,4.3444120734
40,37,2003,896,772,-51,675,0,124,-51,-21,68336,13.109669113,11.295384548,-0.746197684,-94,0,1.8142845647,-0.746197684
40,37,2004,869,719,-280,675,8,150,-272,-173,68163,12.732694012,10.534875713,-4.102594158,-51,0.1172169759,2.197818299,-3.985377182
40,37,2005,898,710,-204,675,5,188,-199,-71,68092,13.181167664,10.421635903,-2.994385527,-60,0.0733918021,2.7595317603,-2.920993725
40,37,2006,876,806,69,675,8,70,77,114,68206,12.854187149,11.827026075,1.0124873439,-33,0.117389837,1.0271610735,1.1298771809
40,37,2007,878,737,572,675,5,141,577,734,68940,12.803873245,10.747670366,8.3414755079,16,0.0729149957,2.0562028787,8.4143905036
40,37,2008,930,739,636,675,7,191,643,882,69822,13.404246119,10.651331056,9.1667747654,48,0.1008921751,2.7529150632,9.2676669405
40,39,2001,343,297,-421,1363,32,46,-389,-357,25694,13.257319548,11.479369987,-16.27210358,-14,1.2368344768,1.7779495603,-15.03526911
40,39,2002,351,297,-580,1221,29,54,-551,-502,25192,13.795542978,11.673151751,-22.79605392,-5,1.1398026962,2.1223912274,-21.65625123
40,39,2003,401,264,3,1469,24,137,27,127,25319,15.877729603,10.453168617,0.118786007,-37,0.9502880561,5.4245609867,1.0690740631
40,39,2004,359,283,-59,1376,29,76,-30,28,25347,14.171239095,11.171199621,-2.328978013,-18,1.1447519046,3.0000394742,-1.184226108
40,39,2005,358,255,61,1425,27,103,88,170,25517,14.076753696,10.026737968,2.3985530041,-21,1.0616546084,4.0500157282,3.4602076125
40,39,2006,395,298,175,1329,29,97,204,288,25805,15.393008846,11.612953509,6.8196874635,-13,1.1301196368,3.7800553369,7.9498071003
40,39,2007,431,277,44,1264,26,154,70,215,26020,16.63289918,10.689821515,1.6980221901,-9,1.0033767487,5.9430776652,2.7013989387
40,39,2008,435,266,197,1264,28,169,225,392,26412,16.592920354,10.146475435,7.5144949649,-2,1.0680500458,6.4464449191,8.5825450107
40,41,2001,454,420,421,531,19,34,440,446,37641,12.133197926,11.224544337,11.251269443,-28,0.5077770057,0.9086535892,11.759046448
40,41,2002,432,457,325,531,18,-25,343,291,37932,11.432654519,12.094266471,8.6009553677,-27,0.476360605,-0.661611951,9.0773159726
40,41,2003,433,467,589,531,14,-34,603,565,38497,11.330777584,12.220492222,15.412997684,-4,0.3663530859,-0.889714637,15.77935077
40,41,2004,424,488,379,531,14,-64,393,292,38789,10.972233005,12.628419119,9.8077271433,-37,0.3622907124,-1.656186114,10.170017856
40,41,2005,476,469,194,531,15,7,209,179,38968,12.243270702,12.063222604,4.9899044459,-37,0.3858173541,0.1800480986,5.3757218
40,41,2006,485,473,718,531,14,12,732,724,39692,12.331553521,12.026442919,18.255784389,-20,0.3559623697,0.3051106026,18.611746758
40,41,2007,484,454,573,531,11,30,584,637,40329,12.096824584,11.347021407,14.321240674,23,0.2749278314,0.7498031767,14.596168506
40,41,2008,498,525,78,531,11,-27,89,96,40425,12.333754365,13.002451891,1.9317928524,34,0.2724323253,-0.668697526,2.2042251777
40,43,2001,55,109,-56,134,6,-54,-50,-107,4601,11.816521646,23.418197443,-12.03136749,-3,1.2890750886,-11.6016758,-10.74229241
40,43,2002,50,59,-76,134,6,-9,-70,-81,4520,10.96371012,12.937177941,-16.66483938,-2,1.3156452143,-1.973467822,-15.34919417
40,43,2003,60,71,-28,134,2,-11,-26,-43,4477,13.33777926,15.783038791,-6.224296988,-6,0.444592642,-2.445259531,-5.779704346
40,43,2004,44,90,90,134,1,-46,91,41,4518,9.7832128961,20.011117287,20.011117287,-4,0.2223457476,-10.22790439,20.233463035
40,43,2005,64,87,-91,134,2,-23,-89,-116,4402,14.349775785,19.506726457,-20.40358744,-4,0.4484304933,-5.156950673,-19.95515695
40,43,2006,52,63,-32,134,1,-11,-31,-45,4357,11.873501541,14.38520379,-7.306770179,-3,0.2283365681,-2.511702249,-7.078433611
40,43,2007,65,67,-23,134,2,-2,-21,-27,4330,14.964890066,15.425348221,-5.295268792,-4,0.4604581559,-0.460458156,-4.834810637
40,43,2008,62,59,63,134,1,3,64,59,4389,14.221814428,13.533662117,14.451198532,-8,0.2293841037,0.688152311,14.680582636
40,45,2001,41,59,-130,63,1,-18,-129,-147,3896,10.32875677,14.863332913,-32.74971659,0,0.2519208968,-4.534576143,-32.49779569
40,45,2002,38,63,85,63,1,-25,86,58,3954,9.6815286624,16.050955414,21.656050955,-3,0.2547770701,-6.369426752,21.910828025
40,45,2003,49,68,-23,63,1,-19,-22,-45,3909,12.463436347,17.29619738,-5.850184408,-4,0.2543558438,-4.832761033,-5.595828564
40,45,2004,54,60,11,63,0,-6,11,2,3911,13.810741688,15.345268542,2.8132992327,-3,0,-1.534526854,2.8132992327
40,45,2005,56,49,-44,63,1,7,-43,-39,3872,14.390337916,12.591545676,-11.30669408,-3,0.2569703199,1.7987922395,-11.04972376
40,45,2006,41,66,-43,63,0,-25,-43,-69,3803,10.684039088,17.198697068,-11.20521173,-1,0,-6.51465798,-11.20521173
40,45,2007,54,46,80,63,1,8,81,90,3893,14.033264033,11.954261954,20.79002079,1,0.2598752599,2.079002079,21.04989605
40,45,2008,57,57,75,63,0,0,75,78,3971,14.496439471,14.496439471,19.074262462,3,0,0,19.074262462
40,47,2001,822,668,-669,1751,44,154,-625,-509,57181,14.311706175,11.630437621,-11.64784846,-38,0.7660767295,2.6812685534,-10.88177173
40,47,2002,809,741,-61,1764,-14,68,-75,-62,57119,14.155730534,12.965879265,-1.067366579,-55,-0.244969379,1.1898512686,-1.312335958
40,47,2003,915,679,31,1779,-145,236,-114,37,57156,16.014001313,11.883614089,0.5425508641,-85,-2.537737913,4.1303872238,-1.995187049
40,47,2004,879,730,-197,1779,119,149,-78,26,57182,15.375465724,12.76915811,-3.44592349,-45,2.0815476919,2.6063076143,-1.364375798
40,47,2005,911,670,-445,1778,30,241,-415,-221,56961,15.962433088,11.7396599,-7.797236799,-47,0.5256564134,4.222773188,-7.271580386
40,47,2006,935,701,-46,1784,78,234,32,238,57199,16.38051857,12.28100911,-0.805886475,-28,1.3665031535,4.0995094604,0.5606166783
40,47,2007,1002,663,-45,1714,19,339,-26,305,57504,17.471208251,11.560290489,-0.784635101,-8,0.331290376,5.9109177615,-0.453344725
40,47,2008,951,669,339,1714,42,282,381,663,58167,16.443188007,11.567289986,5.8614518764,0,0.7261975776,4.8758980211,6.5876494541
40,49,2001,366,370,-222,580,10,-4,-212,-237,27021,13.485878517,13.633265167,-8.1799591,-21,0.3684666261,-0.14738665,-7.811492474
40,49,2002,378,387,42,580,9,-9,51,19,27040,13.98420303,14.317160245,1.5538003367,-23,0.332957215,-0.332957215,1.8867575517
40,49,2003,348,348,-42,580,7,0,-35,-74,26966,12.887456949,12.887456949,-1.555382735,-39,0.2592304559,0,-1.296152279
40,49,2004,336,379,-121,580,10,-43,-111,-174,26792,12.500465047,14.100226943,-4.501655568,-20,0.3720376502,-1.599761896,-4.129617917
40,49,2005,353,388,134,580,9,-35,143,82,26874,13.155442925,14.459806954,4.9938508553,-26,0.3354078933,-1.304364029,5.3292587486
40,49,2006,365,371,96,580,9,-6,105,86,26960,13.560203589,13.783111045,3.5665193001,-13,0.3343611844,-0.222907456,3.9008804845
40,49,2007,415,356,71,580,9,59,80,142,27102,15.352743147,13.170064001,2.6266138878,3,0.3329510562,2.1826791462,2.959564944
40,49,2008,389,344,81,580,10,45,91,145,27247,14.314890798,12.658926567,2.9807356161,9,0.3679920514,1.6559642312,3.3487276675
40,51,2001,561,477,227,860,9,84,236,279,45849,12.273159846,10.435467463,4.9661448933,-41,0.1968956125,1.8376923834,5.1630405058
40,51,2002,603,443,639,887,6,160,645,782,46631,13.040657439,9.580449827,13.819204152,-23,0.1297577855,3.4602076125,13.948961938
40,51,2003,590,471,385,786,-5,119,380,462,47093,12.590158337,10.050787418,8.2156117963,-37,-0.106696257,2.5393709189,8.1089155392
40,51,2004,658,517,761,896,9,141,770,857,47950,13.846364277,10.879286218,16.013804278,-54,0.1893879612,2.9670780594,16.203192239
40,51,2005,649,498,905,932,4,151,909,1017,48967,13.392903206,10.276834817,18.675774116,-43,0.082544858,3.1160683884,18.758318974
40,51,2006,672,545,963,900,7,127,970,1070,50037,13.575209082,11.009656176,19.453759444,-27,0.1414084279,2.565552907,19.595167872
40,51,2007,672,462,189,834,1,210,190,409,50446,13.375396833,9.1955853229,3.7618303594,9,0.0199038643,4.1798115104,3.7817342237
40,51,2008,712,471,353,834,3,241,356,620,51066,14.02789818,9.279691071,6.9548427772,23,0.0591063126,4.7482071085,7.0139490898
40,53,2001,49,85,-66,99,5,-36,-61,-101,5023,9.6580270031,16.753720311,-13.00877107,-4,0.9855129595,-7.095693308,-12.02325811
40,53,2002,47,75,-60,99,5,-28,-55,-86,4937,9.437751004,15.060240964,-12.04819277,-3,1.0040160643,-5.62248996,-11.04417671
40,53,2003,41,69,-31,99,1,-28,-30,-65,4872,8.3596696911,14.068712407,-6.320725864,-7,0.2038943827,-5.709042716,-6.116831481
40,53,2004,43,62,-143,99,0,-19,-143,-169,4703,8.9817232376,12.950391645,-29.8694517,-7,0,-3.968668407,-29.8694517
40,53,2005,40,61,-16,99,1,-21,-15,-40,4663,8.5415332052,13.025838138,-3.416613282,-4,0.2135383301,-4.484304933,-3.203074952
40,53,2006,35,70,-107,99,0,-35,-107,-143,4520,7.6227812262,15.245562452,-23.30393118,-1,0,-7.622781226,-23.30393118
40,53,2007,44,65,-14,99,1,-21,-13,-35,4485,9.7723486952,14.436424209,-3.109383676,-1,0.222098834,-4.664075514,-2.887284842
40,53,2008,49,63,-22,99,0,-14,-22,-35,4450,10.968102966,14.10184667,-4.924454393,1,0,-3.133743705,-4.924454393
40,55,2001,74,90,-181,982,1,-16,-180,-199,5836,12.467357426,15.163002274,-30.49448235,-3,0.168477803,-2.695644849,-30.32600455
40,55,2002,51,80,57,1087,1,-29,58,26,5862,8.7194392204,13.677551718,9.7452555992,-3,0.1709693965,-4.958112498,9.9162249957
40,55,2003,66,88,-50,1080,0,-22,-50,-80,5782,11.336310546,15.115080728,-8.58811405,-8,0,-3.778770182,-8.58811405
40,55,2004,58,78,51,1106,1,-20,52,27,5809,10.007764645,13.458717971,8.7999309809,-5,0.1725476663,-3.450953326,8.9724786472
40,55,2005,61,71,6,1105,1,-10,7,-7,5802,10.507277582,12.229782103,1.0335027129,-4,0.1722504522,-1.722504522,1.2057531651
40,55,2006,54,99,-5,1077,1,-45,-4,-52,5750,9.3490304709,17.139889197,-0.86565097,-3,0.1731301939,-7.790858726,-0.692520776
40,55,2007,74,67,-58,982,0,7,-58,-56,5694,12.93254107,11.70919259,-10.13631597,-5,0,1.2233484796,-10.13631597
40,55,2008,65,72,27,982,0,-7,27,19,5713,11.396510914,12.623827474,4.7339353029,-1,0,-1.22731656,4.7339353029
40,57,2001,40,58,-105,154,3,-18,-102,-120,3153,12.449424214,18.05166511,-32.67973856,0,0.9337068161,-5.602240896,-31.74603175
40,57,2002,44,54,-99,154,3,-10,-96,-107,3046,14.195838038,17.422164865,-31.94063559,-1,0.9678980481,-3.226326827,-30.97273754
40,57,2003,36,63,-42,154,2,-27,-40,-69,2977,11.95417566,20.919807405,-13.94653827,-2,0.66412087,-8.965631745,-13.2824174
40,57,2004,34,51,-34,154,3,-17,-31,-51,2926,11.519566322,17.279349483,-11.51956632,-3,1.0164323225,-5.759783161,-10.503134
40,57,2005,46,56,20,154,3,-10,23,11,2937,15.691625448,19.102848371,6.8224458468,-2,1.023366877,-3.411222923,7.8458127239
40,57,2006,37,45,-31,154,4,-8,-27,-36,2901,12.675573827,15.416238438,-10.62007537,-1,1.3703323056,-2.740664611,-9.249743063
40,57,2007,53,33,-94,154,3,20,-91,-70,2831,18.492672715,11.514305652,-32.79832519,1,1.0467550593,6.9783670621,-31.75157013
40,57,2008,42,34,0,154,3,8,3,12,2843,14.804370814,11.984490659,0,1,1.0574550582,2.8198801551,1.0574550582
40,59,2001,38,46,-123,45,2,-8,-121,-130,3417,10.913268237,13.210798392,-35.32452613,-1,0.5743825388,-2.297530155,-34.7501436
40,59,2002,39,53,3,45,1,-14,4,-14,3403,11.436950147,15.542521994,0.8797653959,-4,0.293255132,-4.105571848,1.1730205279
40,59,2003,40,64,-77,45,-1,-24,-78,-101,3302,11.931394482,19.090231171,-22.96793438,1,-0.298284862,-7.158836689,-23.26621924
40,59,2004,37,66,42,45,0,-29,42,10,3312,11.188388267,19.957665558,12.700332628,-3,0,-8.769277291,12.700332628
40,59,2005,49,56,-39,45,0,-7,-39,-49,3263,14.904942966,17.034220532,-11.86311787,-3,0,-2.129277567,-11.86311787
40,59,2006,52,48,21,45,0,4,21,23,3286,15.880287067,14.658726523,6.4131928539,-2,0,1.2215605436,6.4131928539
40,59,2007,51,46,-54,45,0,5,-54,-46,3240,15.629788538,14.097456329,-16.54918786,3,0,1.5323322096,-16.54918786
40,59,2008,48,62,67,45,0,-14,67,50,3290,14.701378254,18.989280245,20.520673813,-3,0,-4.287901991,20.520673813
40,61,2001,166,159,-74,139,6,7,-68,-70,11757,14.07734057,13.483717775,-6.275440977,-9,0.5088195387,0.5936227951,-5.766621438
40,61,2002,190,184,-28,139,6,6,-22,-27,11730,16.179162941,15.668242006,-2.384297697,-11,0.510920935,0.510920935,-1.873376762
40,61,2003,162,168,150,139,5,-6,155,143,11873,13.727068593,14.235478541,12.710248697,-6,0.4236749566,-0.508409948,13.133923654
40,61,2004,154,154,92,139,4,0,96,86,11959,12.923799933,12.923799933,7.7207116482,-10,0.3356831151,0,8.0563947633
40,61,2005,159,176,22,139,5,-17,27,-1,11958,13.295981938,14.717564912,1.839695614,-11,0.4181126395,-1.421582974,2.2578082535
40,61,2006,162,156,65,139,4,6,69,69,12027,13.508442777,13.008130081,5.4200542005,-6,0.333541797,0.5003126954,5.7535959975
40,61,2007,180,135,-25,139,3,45,-22,14,12041,14.957620076,11.218215057,-2.077447233,-9,0.2492936679,3.7394050191,-1.828153565
40,61,2008,180,153,88,139,2,27,90,111,12152,14.880337288,12.648286694,7.2748315628,-6,0.165337081,2.2320505931,7.4401686438
40,63,2001,165,205,-206,1335,10,-40,-196,-246,13879,11.784030853,14.640765605,-14.71218397,-10,0.714183688,-2.856734752,-13.99800029
40,63,2002,171,204,93,1346,10,-33,103,60,13939,12.294198001,14.666762528,6.6863182112,-10,0.7189589474,-2.372564527,7.4052771587
40,63,2003,174,206,-58,1354,7,-32,-51,-100,13839,12.527899777,14.831881345,-4.175966592,-17,0.503995968,-2.303981568,-3.671970624
40,63,2004,162,233,3,1342,4,-71,7,-73,13766,11.737004166,16.880999819,0.217351929,-9,0.289802572,-5.143995653,0.507154501
40,63,2005,187,187,-37,1369,6,0,-31,-44,13722,13.605937136,13.605937136,-2.692083818,-13,0.4365541327,0,-2.255529686
40,63,2006,176,177,-85,1367,5,-1,-80,-87,13635,12.866907921,12.940015353,-6.214131666,-6,0.3655371569,-0.073107431,-5.84859451
40,63,2007,190,179,-81,1305,5,11,-76,-59,13576,13.964940649,13.156444085,-5.953474698,6,0.3674984381,0.8084965639,-5.58597626
40,63,2008,172,175,42,1305,4,-3,46,49,13625,12.646593875,12.867174001,3.0881217602,6,0.2941068343,-0.220580126,3.3822285945
40,65,2001,447,261,-569,748,32,186,-537,-366,27885,15.925609235,9.2988456605,-20.2721961,-15,1.1400883568,6.6267635742,-19.13210774
40,65,2002,447,258,-675,765,-51,189,-726,-543,27342,16.18773426,9.3432560161,-24.44456516,-6,-1.846922701,6.8444782443,-26.29148786
40,65,2003,456,265,-78,690,-228,191,-306,-153,27189,16.724431974,9.7192422659,-2.860758101,-38,-8.362215987,7.0051897086,-11.22297409
40,65,2004,453,279,-321,718,147,174,-174,-25,27164,16.668813129,10.266222656,-11.81167553,-25,5.4090850551,6.4025904734,-6.402590473
40,65,2005,448,313,-860,658,19,135,-841,-721,26443,16.714235081,11.677579421,-32.08536199,-15,0.7088626485,5.0366556606,-31.37649934
40,65,2006,445,294,-473,654,84,151,-389,-249,26194,16.908258449,11.170849403,-17.97214887,-11,3.1916712579,5.7374090469,-14.78047761
40,65,2007,473,260,-718,593,7,213,-711,-508,25686,18.234387047,10.023130301,-27.67925983,-10,0.2698535081,8.2112567463,-27.40940632
40,65,2008,446,225,-675,593,40,221,-635,-450,25236,17.516986764,8.8370448922,-26.51113468,-36,1.5710302031,8.6799418719,-24.94010447
40,67,2001,83,116,-86,342,6,-33,-80,-121,6648,12.37236342,17.291495863,-12.81955728,-8,0.8943877171,-4.919132444,-11.92516956
40,67,2002,63,113,-89,342,6,-50,-83,-136,6512,9.5744680851,17.17325228,-13.52583587,-3,0.9118541033,-7.598784195,-12.61398176
40,67,2003,74,118,8,342,1,-44,9,-43,6469,11.401278792,18.180417533,1.2325706802,-8,0.154071335,-6.779138741,1.3866420153
40,67,2004,85,99,-35,342,2,-14,-33,-51,6418,13.191588422,15.364320633,-5.431830527,-4,0.3103903158,-2.172732211,-5.121440211
40,67,2005,91,101,-28,342,2,-10,-26,-42,6376,14.225418165,15.78865093,-4.377051743,-6,0.3126465531,-1.563232765,-4.06440519
40,67,2006,87,102,-43,342,2,-15,-41,-58,6318,13.707263274,16.070584528,-6.774854262,-2,0.3151095006,-2.363321254,-6.459744761
40,67,2007,87,109,-51,342,2,-22,-49,-72,6246,13.849092646,17.35116205,-8.11843362,-1,0.3183699459,-3.502069405,-7.800063674
40,67,2008,89,95,-20,342,2,-6,-18,-27,6219,14.279983955,15.242679503,-3.208985158,-3,0.3208985158,-0.962695548,-2.888086643
40,69,2001,119,138,-50,234,3,-19,-47,-76,10440,11.357129223,13.170452376,-4.771903035,-10,0.2863141821,-1.813323153,-4.485588853
40,69,2002,132,142,-31,265,3,-10,-28,-47,10393,12.672202755,13.632218115,-2.976047617,-9,0.2880046081,-0.96001536,-2.688043009
40,69,2003,108,139,14,221,-2,-31,12,-34,10359,10.408635312,13.396299152,1.3492675405,-15,-0.192752506,-2.98766384,1.1565150347
40,69,2004,144,150,-93,225,2,-6,-91,-105,10254,13.971765391,14.553922282,-9.023431815,-8,0.1940522971,-0.582156891,-8.829379518
40,69,2005,134,132,-36,259,0,2,-36,-39,10215,13.092969857,12.897552396,-3.51751429,-5,0,0.1954174606,-3.51751429
40,69,2006,163,131,124,247,1,32,125,152,10367,15.839082694,12.729569527,12.049363522,-5,0.0971722865,3.1095131668,12.146535808
40,69,2007,165,126,11,254,-1,39,10,35,10402,15.889065434,12.13346815,1.0592710289,-14,-0.096297366,3.7555972844,0.9629736627
40,69,2008,172,121,-145,254,1,51,-144,-116,10286,16.627996906,11.697602475,-14.01778809,-23,0.0966744006,4.9303944316,-13.92111369
40,71,2001,658,587,-603,1119,53,71,-550,-513,47427,13.799322617,12.310337958,-12.6458838,-34,1.1114955907,1.4889846593,-11.53438821
40,71,2002,687,613,7,1113,52,74,59,88,47515,14.471993428,12.913146974,0.1474584483,-45,1.0954056161,1.5588464536,1.2428640644
40,71,2003,700,613,-529,1121,39,87,-490,-432,47083,14.799467219,12.960104865,-11.1841688,-29,0.8245417451,1.8393623544,-10.35962705
40,71,2004,677,642,-549,1118,40,35,-509,-522,46561,14.459014993,13.71150314,-11.72525736,-48,0.854299261,0.7475118534,-10.8709581
40,71,2005,683,635,-570,1117,41,48,-529,-519,46042,14.751141972,13.714458495,-12.31061629,-38,0.8855004697,1.0366834768,-11.42511582
40,71,2006,705,527,-626,1060,42,178,-584,-426,45616,15.3832726,11.499269022,-13.65947326,-20,0.9164502826,3.8840035785,-12.74302298
40,71,2007,712,592,-57,1166,38,120,-19,95,45711,15.592322095,12.964402641,-1.248261741,-6,0.8321744939,2.6279194543,-0.416087247
40,71,2008,714,551,-268,1166,40,163,-228,-79,45632,15.633381868,12.06441654,-5.867992074,-14,0.8758197125,3.5689653285,-4.992172361
40,73,2001,194,158,-90,275,23,36,-67,-43,13842,13.993580265,11.396833411,-6.491867133,-12,1.6590327118,2.5967468532,-4.832834421
40,73,2002,194,151,-81,275,22,43,-59,-27,13815,14.028998084,10.91947789,-5.857468272,-11,1.5909173085,3.1095201938,-4.266550964
40,73,2003,193,141,89,275,17,52,106,142,13957,13.898890969,10.154112055,6.4093331413,-16,1.224254645,3.744778914,7.6335877863
40,73,2004,165,155,-5,275,17,10,12,12,13969,11.816944783,11.100766311,-0.358089236,-10,1.2175034018,0.7161784717,0.859414166
40,73,2005,198,163,55,275,18,35,73,98,14067,14.124696818,11.627906977,3.923526894,-10,1.2840633471,2.4967898416,5.2075902411
40,73,2006,193,171,-6,275,18,22,12,26,14093,13.707386364,12.144886364,-0.426136364,-8,1.2784090909,1.5625,0.8522727273
40,73,2007,223,136,112,275,14,87,126,211,14304,15.705884424,9.5784765996,7.8881571997,-2,0.98601965,6.1274078248,8.8741768497
40,73,2008,218,153,-78,275,14,65,-64,-4,14300,15.242623409,10.697804503,-5.453782688,-5,0.9788840722,4.5448189064,-4.474898616
40,75,2001,124,154,-141,336,3,-30,-138,-175,10023,12.264477523,15.231689827,-13.94589783,-7,0.2967212304,-2.967212304,-13.6491766
40,75,2002,132,176,-21,336,3,-44,-18,-72,9951,13.217182337,17.622909783,-2.102733554,-10,0.3003905077,-4.405727446,-1.802343046
40,75,2003,113,162,-24,336,-1,-49,-25,-88,9863,11.406076512,16.352074291,-2.422529525,-14,-0.10093873,-4.945997779,-2.523468255
40,75,2004,128,163,-75,336,3,-35,-72,-117,9746,13.055229741,16.625019124,-7.649548677,-10,0.3059819471,-3.569789382,-7.34356673
40,75,2005,133,149,55,336,1,-16,56,31,9777,13.624955181,15.264047534,5.6343799621,-9,0.102443272,-1.639092353,5.7368232341
40,75,2006,95,165,-115,336,2,-70,-113,-187,9590,9.810502401,17.039293644,-11.87587133,-4,0.2065368927,-7.228791243,-11.66933443
40,75,2007,109,167,-108,336,1,-58,-107,-162,9428,11.462824692,17.562309391,-11.35766116,3,0.1051635293,-6.099484699,-11.25249763
40,75,2008,113,136,-15,336,3,-23,-12,-29,9399,12.004036756,14.447336272,-1.593456207,6,0.3186912413,-2.443299517,-1.274764965
40,77,2001,115,117,-74,665,6,-2,-68,-81,10572,10.836277974,11.024734982,-6.972909305,-11,0.5653710247,-0.188457008,-6.40753828
40,77,2002,127,137,14,659,6,-10,20,0,10572,12.01286417,12.958758986,1.3242527431,-10,0.5675368899,-0.945894816,1.891789633
40,77,2003,121,105,-93,659,5,16,-88,-84,10488,11.490978158,9.9715099715,-8.831908832,-12,0.4748338082,1.5194681861,-8.357075024
40,77,2004,108,138,52,672,4,-30,56,17,10505,10.289144,13.147239556,4.9540322965,-9,0.3810794074,-2.858095556,5.3351117039
40,77,2005,99,143,15,670,5,-44,20,-33,10472,9.4389092816,13.633980073,1.4301377699,-9,0.47671259,-4.195070792,1.9068503599
40,77,2006,121,124,-3,706,4,-3,1,-6,10466,11.557932945,11.844493266,-0.286560321,-4,0.3820804279,-0.286560321,0.095520107
40,77,2007,122,120,-44,659,5,2,-39,-39,10427,11.678552625,11.487100943,-4.211937012,-2,0.478629206,0.1914516824,-3.733307806
40,77,2008,125,111,122,659,4,14,126,134,10561,11.911568515,10.577472842,11.625690871,-6,0.3811701925,1.3340956737,12.006861063
40,79,2001,783,552,-400,1504,106,231,-294,-100,48028,16.286035193,11.481342818,-8.319813636,-37,2.2047506136,4.8046923749,-6.115063023
40,79,2002,733,549,60,1513,100,184,160,296,48324,15.215044836,11.395715709,1.2454334108,-48,2.0757223514,3.8193291265,3.3211557622
40,79,2003,727,574,-84,1515,74,153,-10,78,48402,15.032152679,11.868577218,-1.736864959,-65,1.5300953208,3.1635754606,-0.206769638
40,79,2004,747,526,-84,1517,74,221,-10,177,48579,15.405079345,10.84748559,-1.732298079,-34,1.5260721172,4.5575937555,-0.206225962
40,79,2005,716,557,38,1517,77,159,115,227,48806,14.704523284,11.439133337,0.7804076603,-47,1.5813523643,3.2653899471,2.3617600246
40,79,2006,738,567,88,1519,78,171,166,314,49120,15.072605845,11.580172784,1.7972754937,-23,1.5930396422,3.4924330617,3.3903151359
40,79,2007,760,546,100,1523,67,214,167,390,49510,15.411132515,11.071682044,2.0277805941,9,1.3586129981,4.3394504715,3.3863935922
40,79,2008,762,552,-12,1523,69,210,57,292,49802,15.345577574,11.116481392,-0.241662639,25,1.389560174,4.2290961817,1.147897535
40,81,2001,390,338,-67,480,7,52,-60,-39,32088,12.146694698,10.527135405,-2.086739858,-31,0.2180175971,1.619559293,-1.868722261
40,81,2002,415,330,-46,480,4,85,-42,7,32095,12.931773211,10.28309677,-1.433401368,-36,0.1246435972,2.6486764408,-1.308757771
40,81,2003,374,351,4,480,-4,23,0,-22,32073,11.656900636,10.940032415,0.1246727341,-45,-0.124672734,0.7168682209,0
40,81,2004,401,381,-6,480,11,20,5,3,32076,12.502143447,11.878595146,-0.18706449,-22,0.3429515659,0.6235483016,0.1558870754
40,81,2005,420,353,-116,480,6,67,-110,-70,32006,13.108205112,11.017134297,-3.620361412,-27,0.187260073,2.0910708155,-3.433101339
40,81,2006,414,362,187,480,9,52,196,234,32240,12.887961896,11.269184074,5.8213740933,-14,0.2801730847,1.6187778227,6.101547178
40,81,2007,418,344,-97,480,3,74,-94,-29,32211,12.97109432,10.674776187,-3.010038634,-9,0.0930939784,2.2963181332,-2.916944656
40,81,2008,421,321,-147,480,6,100,-141,-58,32153,13.081846995,9.974519918,-4.567770804,-17,0.1864396246,3.1073270772,-4.381331179
40,83,2001,404,316,501,2437,11,88,512,577,34519,11.802340018,9.2315332817,14.636070171,-23,0.3213508421,2.5708067367,14.957421013
40,83,2002,410,310,107,2420,10,100,117,185,34704,11.845773804,8.9565606807,3.0914580414,-32,0.2889213123,2.8892131228,3.3803793537
40,83,2003,408,324,608,2560,5,84,613,691,35395,11.64067961,9.2440691023,17.346895105,-6,0.1426553874,2.396610508,17.489550493
40,83,2004,445,304,-538,1455,12,141,-526,-423,34972,12.647974192,8.6404138303,-15.29125869,-38,0.341068967,4.0075603621,-14.95018972
40,83,2005,485,319,294,1453,9,166,303,434,35406,13.78271619,9.0653329165,8.3548836284,-35,0.2557617437,4.7173832732,8.6106453721
40,83,2006,445,320,237,1320,11,125,248,357,35763,12.505444786,8.9926793969,6.6602031784,-16,0.3091233543,3.5127653894,6.9693265326
40,83,2007,457,296,1194,2077,7,161,1201,1360,37123,12.540131164,8.1222731389,32.763493675,-2,0.1920807837,4.4178580249,32.955574459
40,83,2008,485,312,794,2077,9,173,803,979,38102,12.894649385,8.295114656,21.110003323,3,0.2392821535,4.5995347291,21.349285477
40,85,2001,95,108,-89,98,11,-13,-78,-99,8728,10.823127314,12.304186841,-10.13956138,-8,1.2532042153,-1.481059527,-8.886357163
40,85,2002,113,115,63,98,10,-2,73,65,8793,12.898807146,13.127104617,7.1913703556,-6,1.141487358,-0.228297472,8.3328577136
40,85,2003,108,96,40,98,8,12,48,51,8844,12.246980779,10.886205137,4.5359188071,-9,0.9071837614,1.3607756421,5.4431025685
40,85,2004,108,96,91,98,9,12,100,102,8946,12.141652614,10.792580101,10.230466554,-10,1.0118043845,1.3490725126,11.242270939
40,85,2005,125,92,55,98,9,33,64,88,9034,13.904338154,10.233592881,6.1179087875,-9,1.0011123471,3.6707452725,7.1190211346
40,85,2006,119,119,30,98,9,0,39,34,9068,13.147718484,13.147718484,3.3145508784,-5,0.9943652635,0,4.3089161419
40,85,2007,129,91,-15,98,5,38,-10,28,9096,14.203919841,10.019819423,-1.651618586,0,0.5505395287,4.1841004184,-1.101079057
40,85,2008,123,98,26,98,6,25,32,59,9155,13.478713495,10.739137582,2.8491589502,2,0.6574982193,2.7395759136,3.5066571695
40,87,2001,381,279,-173,222,27,102,-146,-68,27778,13.699122681,10.031641018,-6.220336545,-24,0.9708039695,3.6674816626,-5.249532576
40,87,2002,371,249,103,222,25,122,128,224,28002,13.302258874,8.9279311581,3.693079957,-26,0.8963786303,4.374327716,4.5894585873
40,87,2003,377,258,427,222,18,119,445,554,28556,13.331447364,9.1233777715,15.099543831,-10,0.6365147282,4.2080695923,15.736058559
40,87,2004,396,281,344,222,27,115,371,458,29014,13.75716519,9.7620288345,11.950668751,-28,0.9379885357,3.9951363557,12.888657287
40,87,2005,409,279,752,222,23,130,775,878,29892,13.886531083,9.4727192476,25.53220385,-27,0.780905171,4.4138118358,26.313109021
40,87,2006,436,294,729,222,25,142,754,879,30771,14.374495162,9.6928935265,24.034419663,-17,0.82422564,4.6816016353,24.858645303
40,87,2007,426,278,818,222,22,148,840,1008,31779,13.621103118,8.8888888889,26.155075939,20,0.7034372502,4.7322142286,26.858513189
40,87,2008,486,279,349,222,24,207,373,586,32365,15.153404839,8.6991768521,10.881766026,6,0.7483162884,6.454227987,11.630082315
40,89,2001,517,441,-436,510,31,76,-405,-358,34034,15.111215035,12.889837196,-12.74369392,-29,0.906088329,2.2213778388,-11.83760559
40,89,2002,492,424,-186,510,30,68,-156,-115,33919,14.480596883,12.479213574,-5.474371992,-27,0.8829632246,2.0013833091,-4.591408768
40,89,2003,484,364,-253,510,25,120,-228,-140,33779,14.298797601,10.753641171,-7.474371473,-32,0.7385742563,3.54515643,-6.735797217
40,89,2004,481,450,-321,510,19,31,-302,-302,33477,14.30355656,13.381705721,-9.545616748,-31,0.5650053527,0.9218508386,-8.980611395
40,89,2005,458,427,-42,510,23,31,-19,-17,33460,13.684509315,12.758265234,-1.254911335,-29,0.6872133499,0.9262440803,-0.567697985
40,89,2006,486,417,-90,510,22,69,-68,-14,33446,14.527845036,12.465249753,-2.690341673,-15,0.6576390757,2.0625952829,-2.032702598
40,89,2007,522,380,-209,510,19,142,-190,-37,33409,15.615885125,11.367885723,-6.252337148,11,0.5683942861,4.2479994017,-5.683942861
40,89,2008,495,363,-44,510,18,132,-26,123,33532,14.789142678,10.845371297,-1.31459046,17,0.5377870065,3.9437713808,-0.776803454
40,91,2001,221,251,12,324,9,-30,21,-27,19451,11.354003442,12.895270878,0.6165069742,-18,0.4623802307,-1.541267436,1.0788872049
40,91,2002,235,285,110,324,8,-50,118,50,19501,12.066132676,14.633394948,5.6479769973,-18,0.4107619634,-2.567262272,6.0587389608
40,91,2003,241,277,29,324,6,-36,35,-27,19474,12.36690186,14.214239897,1.4881334189,-26,0.3078896729,-1.847338037,1.7960230917
40,91,2004,206,285,56,324,9,-79,65,-30,19444,10.586361067,14.646179146,2.8778457269,-16,0.4625109204,-4.059818079,3.3403566473
40,91,2005,216,280,23,324,8,-64,31,-48,19396,11.122554068,14.418125644,1.184346035,-15,0.411946447,-3.295571576,1.596292482
40,91,2006,215,270,111,324,8,-55,119,54,19450,11.06935077,13.901045153,5.7148741183,-10,0.4118828193,-2.831694383,6.1267569377
40,91,2007,226,265,238,324,7,-39,245,200,19650,11.560102302,13.554987212,12.173913043,-6,0.358056266,-1.99488491,12.531969309
40,91,2008,231,244,70,324,8,-13,78,48,19698,11.741384568,12.402155129,3.5579953238,-17,0.406628037,-0.66077056,3.9646233608
40,93,2001,73,100,33,120,4,-27,37,1,7530,9.6951988844,13.281094362,4.3827611395,-9,0.5312437745,-3.585895478,4.914004914
40,93,2002,84,111,-24,120,4,-27,-20,-53,7477,11.194775771,14.793096555,-3.198507363,-6,0.5330845605,-3.598320784,-2.665422803
40,93,2003,61,93,-140,120,1,-32,-139,-173,7304,8.2538393884,12.583722346,-18.94323794,-2,0.1353088424,-4.329882958,-18.8079291
40,93,2004,87,104,-23,120,2,-17,-21,-44,7260,11.947267234,14.281790717,-3.158472947,-6,0.2746498215,-2.334523483,-2.883823126
40,93,2005,82,99,-65,120,2,-17,-63,-83,7177,11.359700769,13.714760684,-9.004640853,-3,0.2770658724,-2.355059915,-8.727574981
40,93,2006,81,102,19,120,2,-21,21,-4,7173,11.289198606,14.216027875,2.6480836237,-4,0.2787456446,-2.926829268,2.9268292683
40,93,2007,96,96,-3,120,1,0,-2,-6,7167,13.389121339,13.389121339,-0.418410042,-4,0.1394700139,0,-0.278940028
40,93,2008,86,91,-47,120,1,-5,-46,-55,7112,12.045661461,12.745990616,-6.583094054,-4,0.1400658309,-0.700329155,-6.443028223
40,95,2001,165,186,144,275,48,-21,192,161,13311,12.471184007,14.058425607,10.883942406,-10,3.6279808019,-1.587241601,14.511923208
40,95,2002,166,188,200,275,47,-22,247,219,13530,12.369136768,14.008419955,14.90257442,-6,3.5021049886,-1.639283186,18.404679408
40,95,2003,175,177,71,275,35,-2,106,89,13619,12.89181922,13.039154297,5.2303952263,-15,2.578363844,-0.147335077,7.8087590703
40,95,2004,186,163,223,275,34,23,257,266,13885,13.52530541,11.852821408,16.215823153,-14,2.4723676556,1.6724840023,18.688190809
40,95,2005,196,199,433,275,35,-3,468,451,14336,13.890365331,14.102972963,30.686368307,-14,2.4804223805,-0.212607633,33.166790688
40,95,2006,222,165,109,275,35,57,144,192,14528,15.38248337,11.432926829,7.5526607539,-9,2.4251662971,3.949556541,9.977827051
40,95,2007,220,171,162,275,25,49,187,238,14766,15.020140643,11.674745682,11.060285383,2,1.706834164,3.3453949614,12.767119547
40,95,2008,223,164,74,275,25,59,99,153,14919,15.024423109,11.049351524,4.9856830049,-5,1.6843523665,3.975071585,6.6700353714
40,97,2001,560,439,-75,535,10,121,-65,19,38451,14.567589714,11.419949794,-1.95101648,-37,0.2601355306,3.1476399204,-1.690880949
40,97,2002,510,410,-51,535,10,100,-41,22,38473,13.259840882,10.659872082,-1.325984088,-37,0.25999688,2.5999688004,-1.065987208
40,97,2003,506,423,137,535,6,83,143,178,38651,13.121726052,10.969348063,3.5527202946,-48,0.1555935895,2.1523779887,3.7083138841
40,97,2004,494,454,158,535,8,40,166,177,38828,12.751842435,11.719304586,4.0785245034,-29,0.2065075698,1.032537849,4.2850320732
40,97,2005,546,413,92,535,6,133,98,196,39024,14.026614602,10.609875148,2.3634588707,-35,0.154138622,3.4167394543,2.5175974927
40,97,2006,524,417,150,535,7,107,157,245,39269,13.385615572,10.652293308,3.8317601829,-19,0.1788154752,2.7333222638,4.0105756581
40,97,2007,625,412,111,535,4,213,115,319,39588,15.851477992,10.449294292,2.8152224913,-9,0.1014494591,5.4021836996,2.9166719505
40,97,2008,598,419,143,535,6,179,149,324,39912,15.044025157,10.540880503,3.5974842767,-4,0.1509433962,4.5031446541,3.748427673
40,99,2001,146,152,61,356,23,-6,84,67,12659,11.563898459,12.039127163,4.8314918221,-11,1.8217100313,-0.475228704,6.6532018534
40,99,2002,176,189,-67,356,20,-13,-47,-74,12585,13.943907463,14.973855174,-5.308192046,-14,1.584534939,-1.02994771,-3.723657107
40,99,2003,144,201,39,356,16,-57,55,-15,12570,11.4490161,15.980918306,3.1007751938,-13,1.2721129,-4.531902206,4.3728880938
40,99,2004,159,191,-38,356,18,-32,-20,-61,12509,12.679931417,15.231867299,-3.030423861,-9,1.435463934,-2.551935883,-1.594959927
40,99,2005,170,185,79,356,18,-15,97,71,12580,13.55175575,14.747498904,6.297580613,-11,1.4348917852,-1.195743154,7.7324723983
40,99,2006,168,166,126,356,18,2,144,140,12720,13.280632411,13.122529644,9.9604743083,-6,1.4229249012,0.1581027668,11.383399209
40,99,2007,170,203,-43,356,13,-33,-30,-59,12661,13.395847287,15.996217643,-3.388361373,4,1.024388322,-2.600370356,-2.363973051
40,99,2008,162,179,125,356,15,-17,140,123,12784,12.733346433,14.0695618,9.8251129888,0,1.1790135587,-1.336215366,11.004126547
40,101,2001,952,776,-99,3193,72,176,-27,83,69494,13.707209964,11.17310392,-1.42543465,-66,1.0366797451,2.5341060437,-0.388754904
40,101,2002,1024,850,-185,3236,70,174,-115,-2,69492,14.73529708,12.231447772,-2.662138633,-61,1.0072956988,2.5038493086,-1.654842934
40,101,2003,976,780,276,3327,60,196,336,446,69938,13.999856559,11.188409955,3.9589758302,-86,0.8606469196,2.811446604,4.8196227498
40,101,2004,998,865,-184,3295,62,133,-122,-41,69897,14.273965745,12.371723817,-2.631673043,-52,0.886759395,1.902241928,-1.744913648
40,101,2005,1020,862,151,3385,61,158,212,314,70211,14.56019642,12.304793445,2.1554800582,-56,0.8707568447,2.2554029748,3.026236903
40,101,2006,991,816,199,3423,63,175,262,400,70611,14.074505404,11.589098294,2.8262629419,-37,0.8947465595,2.4854071097,3.7210095014
40,101,2007,1085,824,108,3427,53,261,161,401,71012,15.322369954,11.636527965,1.5251759954,-21,0.7484659978,3.6858419889,2.2736419932
40,101,2008,1081,828,-38,3427,55,253,17,266,71278,15.194321456,11.638203669,-0.534120458,-4,0.7730690843,3.5561177876,0.238948626
40,103,2001,166,129,12,274,0,37,12,36,11414,14.566514567,11.31976132,1.053001053,-13,0,3.2467532468,1.053001053
40,103,2002,137,130,-146,274,0,7,-146,-145,11269,12.079530926,11.462328616,-12.87307675,-6,0,0.6172023101,-12.87307675
40,103,2003,160,139,-33,274,-2,21,-35,-28,11241,14.215904043,12.350066637,-2.932030209,-14,-0.177698801,1.8658374056,-3.109729009
40,103,2004,157,124,-80,274,1,33,-79,-56,11185,14.00160528,11.058592705,-7.134575939,-10,0.0891821992,2.9430125747,-7.045393739
40,103,2005,126,106,-76,274,-1,20,-77,-66,11119,11.298421808,9.5050215208,-6.81492109,-9,-0.089670014,1.7934002869,-6.904591105
40,103,2006,139,123,-55,274,0,16,-55,-45,11074,12.526472311,11.084576218,-4.956517821,-6,0,1.4418960934,-4.956517821
40,103,2007,139,122,14,274,-1,17,13,26,11100,12.537205736,11.003878416,1.2627401461,-4,-0.090195725,1.5333273203,1.1725444214
40,103,2008,146,121,46,274,1,25,47,69,11169,13.112398401,10.867124703,4.1313036059,-3,0.089810948,2.2452736989,4.2211145539
40,105,2001,126,121,5,203,2,5,7,1,10595,11.89296333,11.421020341,0.4719429893,-11,0.1887771957,0.4719429893,0.660720185
40,105,2002,117,153,2,203,2,-36,4,-42,10553,11.064876111,14.469453376,0.1891431814,-10,0.1891431814,-3.404577265,0.3782863628
40,105,2003,139,113,197,203,2,26,199,226,10779,13.032064504,10.594412151,18.469904369,1,0.1875117195,2.4376523533,18.657416089
40,105,2004,118,128,-158,203,1,-10,-157,-179,10600,11.038869919,11.97436737,-14.78085972,-12,0.0935497451,-0.935497451,-14.68730998
40,105,2005,127,138,47,203,2,-11,49,27,10627,11.965892495,13.002308381,4.4283224196,-11,0.1884392519,-1.036415885,4.6167616715
40,105,2006,130,111,-19,203,1,19,-18,-4,10623,12.235294118,10.447058824,-1.788235294,-5,0.0941176471,1.7882352941,-1.694117647
40,105,2007,130,114,51,203,2,16,53,65,10688,12.20027216,10.698700202,4.7862606166,-4,0.1876964948,1.5015719581,4.9739571114
40,105,2008,129,105,24,203,1,24,25,41,10729,12.046505113,9.8052948592,2.2412102535,-8,0.0933837606,2.2412102535,2.3345940141
40,107,2001,137,158,-71,1058,3,-21,-68,-101,11723,11.636301864,13.419968573,-6.030492207,-12,0.2548095299,-1.783666709,-5.775682677
40,107,2002,141,150,-131,1061,2,-9,-129,-146,11577,12.103004292,12.875536481,-11.24463519,-8,0.1716738197,-0.772532189,-11.07296137
40,107,2003,127,157,16,1058,-2,-30,14,-31,11546,10.984733815,13.579552826,1.3839034727,-15,-0.172987934,-2.594819011,1.2109155386
40,107,2004,134,159,-69,1065,1,-25,-68,-100,11446,11.656228253,13.830897704,-6.002087683,-7,0.086986778,-2.17466945,-5.915100905
40,107,2005,159,166,-155,1058,0,-7,-155,-172,11274,13.996478873,14.612676056,-13.6443662,-10,0,-0.616197183,-13.6443662
40,107,2006,145,165,-36,1063,0,-20,-36,-62,11212,12.896913635,14.675798274,-3.201992351,-6,0,-1.778884639,-3.201992351
40,107,2007,156,130,-33,1062,-1,26,-34,-15,11197,13.922977375,11.602481146,-2.945245214,-7,-0.089249855,2.3204962292,-3.034495069
40,107,2008,141,114,-41,1062,1,27,-40,-25,11172,12.606732532,10.192677366,-3.665787474,-12,0.0894094506,2.4140551656,-3.576378023
40,109,2001,10956,6550,-2820,17163,2498,4406,-322,3498,665327,16.510493115,9.8707310972,-4.249688808,-586,3.7644406535,6.6397620174,-0.485248155
40,109,2002,11325,6441,498,17200,2113,4884,2611,6833,672160,16.934744039,9.6314954837,0.7446801352,-662,3.1596568789,7.3032485549,3.9043370141
40,109,2003,11623,6370,-1375,17447,1322,5253,-53,4288,676448,17.237032555,9.4467777145,-2.039139617,-912,1.9605400532,7.7902548405,-0.078599563
40,109,2004,11600,6354,-3679,17547,2247,5246,-1432,3252,679700,17.107277377,9.3706586597,-5.425661506,-562,3.3137976091,7.7366187171,-2.111863897
40,109,2005,11765,6378,-859,17797,1970,5387,1111,5895,685595,17.234370594,9.3430357542,-1.258336111,-603,2.8858232104,7.8913348397,1.6274870999
40,109,2006,11993,6312,-406,17671,2160,5681,1754,7082,692677,17.402950941,9.1592951174,-0.589143507,-353,3.1343595459,8.2436558241,2.5452160386
40,109,2007,12558,6454,-1435,16933,1739,6104,304,6350,699027,18.046941016,9.2749607675,-2.062220127,-58,2.4990946351,8.7719802487,0.4368745078
40,109,2008,12484,6583,-226,16933,1838,5901,1612,7590,706617,17.762676752,9.3665252368,-0.321560793,77,2.615171409,8.3961515149,2.2936106155
40,111,2001,539,459,-111,982,12,80,-99,-57,39580,13.608190161,11.588421677,-2.802428772,-38,0.3029652726,2.019768484,-2.499463499
40,111,2002,540,488,-89,918,11,52,-78,-66,39514,13.654638784,12.339747642,-2.250486763,-40,0.2781500493,1.3148911422,-1.972336713
40,111,2003,530,471,55,962,4,59,59,65,39579,13.401944546,11.910029965,1.3907678303,-53,0.1011467513,1.4919145816,1.4919145816
40,111,2004,545,481,-77,904,11,64,-66,-30,39549,13.775149125,12.157516935,-1.94621373,-28,0.2780305328,1.6176321909,-1.668183197
40,111,2005,590,505,-274,965,8,85,-266,-217,39332,14.959242403,12.804097311,-6.947173591,-36,0.2028371851,2.155145092,-6.744336405
40,111,2006,524,470,-261,923,11,54,-250,-213,39119,13.358656996,11.982001504,-6.653834878,-17,0.2804298224,1.376655492,-6.373405055
40,111,2007,553,457,113,1035,9,96,122,225,39344,14.095815862,11.64880262,2.8803385035,7,0.2294074914,2.4470132419,3.1097459949
40,111,2008,563,450,-263,1035,11,113,-252,-125,39219,14.332446572,11.455774347,-6.695263674,14,0.2800300396,2.8766722248,-6.415233634
40,113,2001,492,367,285,1526,22,125,307,384,44936,10.995887717,8.202217057,6.3695691042,-48,0.4916860361,2.7936706598,6.8612551404
40,113,2002,479,367,-148,1549,20,112,-128,-63,44873,10.667082364,8.1729002661,-3.295883486,-47,0.4453896603,2.4941820976,-2.850493826
40,113,2003,449,392,-47,1542,12,57,-35,-39,44834,10.010367084,8.7395632448,-1.047855797,-61,0.2675376504,1.2708038392,-0.780318147
40,113,2004,444,405,-91,1551,13,39,-78,-71,44763,9.9110461288,9.0404812661,-2.031318013,-32,0.2901882876,0.8705648627,-1.741129725
40,113,2005,416,383,160,1547,13,33,173,177,44940,9.2750521164,8.5392907707,3.5673277371,-29,0.2898453786,0.7357613458,3.8571731157
40,113,2006,493,440,64,1533,13,53,77,107,45047,10.957138253,9.7791903275,1.422427684,-23,0.2889306233,1.1779479258,1.7113583073
40,113,2007,481,356,284,1527,12,125,296,386,45433,10.632183908,7.8691423519,6.2776304156,-35,0.2652519894,2.7630415561,6.542882405
40,113,2008,478,366,-6,1527,12,112,6,56,45489,10.51450694,8.0508567783,-0.131981259,-62,0.2639625173,2.4636501617,0.1319812587
40,115,2001,431,432,-193,1046,21,-1,-172,-200,33037,13.006608927,13.036786674,-5.824305157,-27,0.6337326855,-0.030177747,-5.190572472
40,115,2002,434,439,-413,1071,20,-5,-393,-415,32622,13.219817542,13.372119588,-12.58014895,-17,0.6092081817,-0.152302045,-11.97094077
40,115,2003,397,414,-169,1081,14,-17,-155,-212,32410,12.209373847,12.732193382,-5.19744126,-40,0.4305572641,-0.522819535,-4.766883996
40,115,2004,404,435,12,1171,22,-31,34,-18,32392,12.468750964,13.425511558,0.3703589395,-21,0.6789913892,-0.956760594,1.0493503287
40,115,2005,417,441,125,1170,19,-24,144,88,32480,12.856085831,13.59600444,3.853742755,-32,0.5857688988,-0.739918609,4.4395116537
40,115,2006,489,457,280,1130,21,32,301,317,32797,14.982306172,14.001868958,8.57882562,-16,0.6434119215,0.9804372137,9.2222375416
40,115,2007,494,416,-594,1012,19,78,-575,-472,32325,15.171524216,12.776020392,-18.24268296,25,0.5835201622,2.3955038236,-17.6591628
40,115,2008,468,406,-573,1012,21,62,-552,-476,31849,14.58534609,12.653099386,-17.85769938,14,0.6544706579,1.9322467043,-17.20322872
40,117,2001,209,185,70,164,1,24,71,80,16767,12.494768936,11.059962934,4.18485084,-15,0.0597835834,1.4348060023,4.2446344234
40,117,2002,202,201,-17,164,1,1,-16,-33,16734,12.059341512,11.999641802,-1.014895078,-18,0.0596997105,0.0596997105,-0.955195367
40,117,2003,217,182,-135,164,-1,35,-136,-115,16619,13.01232273,10.913560999,-8.095223818,-14,-0.059964621,2.0987617306,-8.155188439
40,117,2004,189,198,-119,164,0,-9,-119,-143,16476,11.421664904,11.965553709,-7.191418643,-15,0,-0.543888805,-7.191418643
40,117,2005,213,194,-6,164,0,19,-6,-3,16473,12.929072202,11.775774682,-0.364199217,-16,0,1.1532975204,-0.364199217
40,117,2006,221,183,-78,164,0,38,-78,-46,16427,13.434650456,11.124620061,-4.741641337,-6,0,2.3100303951,-4.741641337
40,117,2007,202,174,-38,164,0,28,-38,-6,16421,12.299074525,10.594252314,-2.313687287,4,0,1.7048222114,-2.313687287
40,117,2008,208,185,-148,164,0,23,-148,-114,16307,12.710828648,11.305304327,-9.044243461,11,0,1.4055243217,-9.044243461
40,119,2001,782,524,478,7539,283,258,761,2208,70465,11.274347256,7.5546777007,6.8914808033,1189,4.0801026513,3.7196695549,10.971583455
40,119,2002,880,553,-193,7850,266,327,73,1368,71833,12.368409957,7.7724212568,-2.712617184,968,3.7386330096,4.5959886998,1.0260158259
40,119,2003,811,530,72,8030,226,281,298,1549,73382,11.169645009,7.2995213993,0.9916330958,970,3.1126261061,3.8701236098,4.1042592019
40,119,2004,872,552,-197,8035,226,320,29,1398,74780,11.770899421,7.4513033031,-2.65925136,1049,3.0507147582,4.3195961178,0.3914633982
40,119,2005,897,535,-871,7590,225,362,-646,262,75042,11.974209395,7.1418082792,-11.62713086,546,3.0035642296,4.832401116,-8.623566632
40,119,2006,902,510,53,7593,230,392,283,2239,77281,11.843254138,6.6962966853,0.6958896555,1564,3.0198985052,5.1469574523,3.7157881607
40,119,2007,908,519,-154,7485,212,389,58,443,77724,11.715751105,6.6965581755,-1.987032676,-4,2.7353956324,5.0191929293,0.748362956
40,119,2008,973,553,-87,7485,215,420,128,556,78280,12.474039127,7.0895618061,-1.115356017,8,2.756339581,5.3844773211,1.6409835645
40,121,2001,491,586,-486,2753,19,-95,-467,-595,43356,11.247666281,13.423894991,-11.13312793,-33,0.435245742,-2.17622871,-10.69788219
40,121,2002,508,520,446,2868,17,-12,463,424,43780,11.659933896,11.935365406,10.236871098,-27,0.3901946383,-0.275431509,10.627065736
40,121,2003,505,562,35,2843,6,-57,41,-77,43703,11.545100191,12.848210509,0.8001554588,-61,0.1371695072,-1.303110319,0.937324966
40,121,2004,519,509,-41,2933,18,10,-23,-42,43661,11.881324115,11.652396868,-0.938601712,-29,0.4120690445,0.2289272469,-0.526532668
40,121,2005,551,570,323,2962,14,-19,337,279,43940,12.579765071,13.013550074,7.3743450417,-39,0.3196310544,-0.433785002,7.6939760962
40,121,2006,566,617,446,2952,16,-51,462,388,44328,12.824579689,13.980151357,10.105587529,-23,0.362532288,-1.155571668,10.468119817
40,121,2007,567,532,250,2952,13,35,263,308,44636,12.746729014,11.95989389,5.620250888,10,0.2922530462,0.7868351243,5.9125039342
40,121,2008,592,515,353,2952,15,77,368,479,45115,13.19205357,11.476195251,7.8662076189,34,0.3342581141,1.7158583191,8.200465733
40,123,2001,494,442,-285,1145,26,52,-259,-236,34928,14.095759858,12.611995663,-8.132169149,-29,0.7418820978,1.4837641956,-7.390287051
40,123,2002,493,419,35,1227,26,74,61,101,35029,14.094372257,11.978786969,1.0006146633,-34,0.7433137499,2.1155852881,1.7439284132
40,123,2003,500,424,95,1062,12,76,107,135,35164,14.24643483,12.080976736,2.7068226176,-48,0.3419144359,2.1654580941,3.0487370536
40,123,2004,491,421,27,1087,15,70,42,90,35254,13.945298077,11.957170042,0.7668493851,-22,0.4260274362,1.9881280354,1.1928768213
40,123,2005,485,401,141,993,13,84,154,207,35461,13.717033161,11.341299583,3.9878385067,-31,0.3676730538,2.3757335784,4.3555115605
40,123,2006,523,426,207,1048,14,97,221,301,35762,14.686267077,11.962427867,5.8127290342,-17,0.3931314323,2.7238392092,6.2058604664
40,123,2007,559,370,531,1097,12,189,543,750,36512,15.468909981,10.238813405,14.694080859,18,0.3320696239,5.2300965769,15.026150483
40,123,2008,562,390,286,1097,14,172,300,487,36999,15.290228673,10.610656908,7.7811483996,15,0.3808953762,4.6795717648,8.1620437758
40,125,2001,933,727,417,2946,21,206,438,591,66264,14.143113759,11.020411257,6.321198754,-53,0.3183337502,3.122702502,6.6395325041
40,125,2002,919,712,177,2962,17,207,194,341,66605,13.833174029,10.717323078,2.6642783494,-60,0.2558911409,3.1158509509,2.9201694902
40,125,2003,885,737,824,3418,5,148,829,939,67544,13.194283968,10.987782242,12.284847446,-38,0.0745439772,2.2065017257,12.359391423
40,125,2004,890,756,-241,3195,27,134,-214,-131,67413,13.189386249,11.203568544,-3.571507962,-51,0.400127448,1.9858177049,-3.171380514
40,125,2005,911,729,172,3130,19,182,191,310,67723,13.482713711,10.78913095,2.5455837083,-63,0.2811982003,2.6935827611,2.8267819086
40,125,2006,941,752,261,3100,24,189,285,440,68163,13.849844723,11.068101202,3.8414553376,-34,0.3532372724,2.7817435203,4.19469261
40,125,2007,968,655,704,3360,17,313,721,1063,69226,14.091375583,9.5349700485,10.248273151,29,0.2474725051,4.5564055346,10.495745656
40,125,2008,987,698,46,3360,20,289,66,390,69616,14.217599862,10.054594431,0.6626237018,35,0.2880972616,4.1630054306,0.9507209634
40,127,2001,139,152,22,184,2,-13,24,0,11654,11.927235284,13.042732109,1.8877638579,-11,0.1716148962,-1.115496825,2.0593787541
40,127,2002,124,141,-16,184,2,-17,-14,-44,11610,10.660247593,12.12173315,-1.375515818,-13,0.1719394773,-1.461485557,-1.203576341
40,127,2003,121,182,5,184,0,-61,5,-72,11538,10.454466909,15.724900639,0.4320027648,-16,0,-5.270433731,0.4320027648
40,127,2004,154,171,51,184,1,-17,52,27,11565,13.331601956,14.803272302,4.4150110375,-8,0.0865688439,-1.471670346,4.5015798814
40,127,2005,133,172,-42,184,1,-39,-41,-91,11474,11.545640002,14.931203611,-3.645991579,-11,0.0868093233,-3.38556361,-3.559182256
40,127,2006,149,153,29,184,1,-4,30,21,11495,12.974008446,13.322303975,2.5251425835,-5,0.0870738822,-0.348295529,2.6122164657
40,127,2007,148,160,154,184,0,-12,154,145,11640,12.794467257,13.831856494,13.313161876,3,0,-1.037389237,13.313161876
40,127,2008,153,143,51,184,0,10,51,70,11710,13.104925054,12.248394004,4.3683083512,9,0,0.8565310493,4.3683083512
40,129,2001,43,45,-113,38,2,-2,-111,-115,3310,12.769116555,13.363028953,-33.55605048,-2,0.5939123979,-0.593912398,-32.96213808
40,129,2002,41,35,-123,38,2,6,-121,-115,3195,12.605687932,10.760953113,-37.8170638,0,0.6149116065,1.8447348194,-37.20215219
40,129,2003,41,44,-36,38,1,-3,-35,-41,3154,12.915419751,13.860450465,-11.34036856,-3,0.3150102378,-0.945030713,-11.02535832
40,129,2004,47,49,63,38,0,-2,63,57,3211,14.768263943,15.396700707,19.795758052,-4,0,-0.628436764,19.795758052
40,129,2005,41,32,41,38,1,9,42,49,3260,12.671920878,9.8902797095,12.671920878,-2,0.3090712409,2.7816411683,12.980992119
40,129,2006,44,32,-14,38,0,12,-14,-5,3255,13.507290867,9.8234842671,-4.297774367,-3,0,3.6838066002,-4.297774367
40,129,2007,64,34,14,38,1,30,15,41,3296,19.539001679,10.380094642,4.2741566173,-4,0.3052969012,9.1589070371,4.5794535185
40,129,2008,55,29,87,38,0,26,87,108,3404,16.417910448,8.6567164179,25.970149254,-5,0,7.7611940299,25.970149254
40,131,2001,932,549,1225,853,35,383,1260,1595,72965,12.914400527,7.6073024561,16.974399834,-48,0.4849828524,5.3070980705,17.459382686
40,131,2002,902,606,1681,853,32,296,1713,1976,74941,12.196935892,8.1943937366,22.730653253,-33,0.43270726,4.0025421552,23.163360513
40,131,2003,966,611,1540,853,28,355,1568,1918,76859,12.727272727,8.0500658762,20.289855072,-5,0.3689064559,4.6772068511,20.658761528
40,131,2004,989,621,1361,853,27,368,1388,1665,78524,12.72983531,7.9931524041,17.5180039,-91,0.3475283654,4.7366829061,17.865532265
40,131,2005,897,647,883,853,29,250,912,1090,79614,11.344521873,8.1827264794,11.167461331,-72,0.3667682657,3.1617953939,11.534229597
40,131,2006,969,693,1335,853,29,276,1364,1598,81212,12.050290376,8.6180095258,16.601793242,-42,0.3606382053,3.4322808501,16.962431448
40,131,2007,1051,700,1308,853,27,351,1335,1719,82931,12.805907044,8.5291483645,15.937322944,33,0.3289814369,4.2767586799,16.266304381
40,131,2008,1075,668,904,853,27,407,931,1369,84300,12.856467999,7.9889494173,10.811392625,31,0.3229066381,4.8675185821,11.134299263
40,133,2001,365,360,-372,547,14,5,-358,-372,24499,14.786307474,14.583755317,-15.06988049,-19,0.5671460401,0.2025521572,-14.50273445
40,133,2002,350,346,-298,547,13,4,-285,-302,24197,14.374897322,14.210612781,-12.23919829,-21,0.5339247577,0.1642845408,-11.70527353
40,133,2003,394,311,-164,547,9,83,-155,-99,24098,16.31638886,12.879180039,-6.791593333,-27,0.3727093902,3.4372088208,-6.418883942
40,133,2004,393,327,29,547,12,66,41,89,24187,16.278347313,13.544579062,1.2012012012,-18,0.4970487729,2.733768251,1.6982499741
40,133,2005,339,333,-55,547,11,6,-44,-60,24127,14.033199487,13.784824275,-2.276772778,-22,0.4553545556,0.2483752122,-1.821418222
40,133,2006,342,339,5,547,11,3,16,8,24135,14.172641001,14.048319589,0.2072023538,-11,0.4558451784,0.1243214123,0.6630475322
40,133,2007,346,294,-84,547,7,52,-77,-32,24103,14.345536714,12.189560098,-3.482731457,-7,0.2902276214,2.1559766159,-3.192503835
40,133,2008,382,278,-5,547,9,104,4,97,24200,15.816822972,11.510672215,-0.207026479,-11,0.3726476616,4.3061507567,0.1656211829
40,135,2001,530,405,84,490,17,125,101,187,39235,13.540615459,10.347074077,2.1460598086,-39,0.4343216279,3.1935413819,2.5803814366
40,135,2002,557,404,51,490,15,153,66,182,39417,14.163657631,10.273101765,1.2968519554,-37,0.3814270457,3.8905558663,1.6782790012
40,135,2003,551,419,149,490,4,132,153,238,39655,13.936665318,10.597936058,3.7687171186,-47,0.1011736139,3.3387292594,3.8698907325
40,135,2004,525,387,322,490,13,138,335,437,40092,13.166639497,9.7056942581,8.0755388917,-36,0.3260310733,3.4609452393,8.401569965
40,135,2005,564,466,81,490,10,98,91,150,40242,14.04137725,11.601563473,2.0165807753,-39,0.2489605895,2.4398137775,2.2655413648
40,135,2006,560,439,331,490,12,121,343,444,40686,13.839462238,10.849149862,8.1801107157,-20,0.2965599051,2.9903123764,8.4766706208
40,135,2007,585,405,65,490,7,180,72,240,40926,14.33612704,9.9250110278,1.5929030045,-12,0.1715434005,4.4111160124,1.7644464049
40,135,2008,583,439,-37,490,9,144,-28,108,41034,14.226451928,10.712542704,-0.902879453,-8,0.2196193265,3.513909224,-0.683260127
40,137,2001,504,630,-277,614,1,-126,-276,-448,42624,11.762509335,14.703136669,-6.464712472,-46,0.0233383122,-2.940627334,-6.44137416
40,137,2002,519,559,-77,614,0,-40,-77,-162,42462,12.199421762,13.139646945,-1.809933479,-45,0,-0.940225184,-1.809933479
40,137,2003,537,565,-108,614,-4,-28,-112,-200,42262,12.676455314,13.337425051,-2.5494547,-60,-0.094424248,-0.660969737,-2.643878948
40,137,2004,550,590,269,614,4,-40,273,194,42456,12.984253641,13.928562997,6.3504804174,-39,0.0944309356,-0.944309356,6.444911353
40,137,2005,577,589,156,614,1,-12,157,104,42560,13.573915498,13.856215301,3.6698974311,-41,0.0235249835,-0.282299802,3.6934224146
40,137,2006,541,545,225,614,3,-4,228,204,42764,12.681074493,12.774834748,5.2740143453,-20,0.0703201913,-0.093760255,5.3443345366
40,137,2007,581,534,429,614,1,47,430,491,43255,13.508643439,12.415861612,9.9745405085,14,0.0232506772,1.0927818273,9.9977911857
40,137,2008,606,534,151,614,3,72,154,243,43498,13.97069842,12.310813459,3.481147626,17,0.0691618734,1.6598849608,3.5503094994
40,139,2001,404,133,-620,460,244,271,-376,-113,20069,20.074035428,6.6085314651,-30.80668803,-8,12.123922387,13.465503963,-18.68276565
40,139,2002,366,155,-561,437,231,211,-330,-125,19944,18.294054432,7.7474820683,-28.04088671,-6,11.54624747,10.546572364,-16.49463924
40,139,2003,394,159,-655,404,206,235,-449,-199,19745,19.854367709,8.0122955983,-33.00662652,15,10.38071002,11.842072111,-22.6259165
40,139,2004,399,129,-126,385,184,270,58,312,20057,20.049243757,6.4820863273,-6.331340134,-16,9.2457665444,13.567157429,2.9144264107
40,139,2005,386,142,-655,386,194,244,-461,-228,19829,19.355162212,7.1202928346,-32.84360427,-11,9.7277240134,12.234869378,-23.11588026
40,139,2006,344,130,-378,404,194,214,-184,21,19850,17.339146652,6.5525844905,-19.05289952,-9,9.7784722397,10.786562161,-9.274427279
40,139,2007,410,125,-410,433,174,285,-236,40,19890,20.634121792,6.2908907901,-20.63412179,-9,8.7569199799,14.343231002,-11.87720181
40,139,2008,406,117,-42,433,173,289,131,393,20283,20.212580589,5.8248077067,-2.090956613,-27,8.6127498569,14.387772882,6.5217932442
40,141,2001,112,118,-59,399,15,-6,-44,-57,9185,12.156075324,12.807293645,-6.403646823,-7,1.6280458024,-0.651218321,-4.77560102
40,141,2002,108,139,-362,403,13,-31,-349,-384,8801,12.009340598,15.45646614,-40.25353052,-4,1.4455687757,-3.447125542,-38.80796175
40,141,2003,110,120,-51,398,8,-10,-43,-64,8737,12.544189759,13.684570647,-5.815942525,-11,0.9123047098,-1.140380887,-4.903637815
40,141,2004,107,130,-144,403,14,-23,-130,-162,8575,12.361367837,15.018484288,-16.63585952,-9,1.6173752311,-2.657116451,-15.01848429
40,141,2005,114,124,-229,398,12,-10,-217,-228,8347,13.473584683,14.655478076,-27.0653587,-1,1.4182720719,-1.181893393,-25.64708663
40,141,2006,126,137,-95,402,13,-11,-82,-98,8249,15.184381779,16.51000241,-11.44854182,-5,1.5666425645,-1.325620631,-9.881899253
40,141,2007,125,120,-132,403,11,5,-121,-132,8117,15.275571306,14.664548454,-16.1310033,-16,1.344250275,0.6110228523,-14.78675302
40,141,2008,109,104,-206,403,13,5,-193,-218,7899,13.611388611,12.987012987,-25.72427572,-30,1.6233766234,0.6243756244,-24.1008991
40,143,2001,9338,5327,-2487,11825,1822,4011,-665,2838,566657,16.520474561,9.4243486814,-4.399916495,-508,3.2234209307,7.0961258797,-1.176495565
40,143,2002,9370,5298,-1991,11677,1698,4072,-293,3286,569943,16.487770544,9.3225409115,-3.503431286,-493,2.9878585254,7.1652296322,-0.515572761
40,143,2003,9253,5247,-5778,11737,1455,4006,-4323,-745,569198,16.245574516,9.2122046349,-10.14448606,-428,2.5545564596,7.0333698813,-7.589929605
40,143,2004,9338,5267,-6856,11628,1386,4071,-5470,-1991,567207,16.434281792,9.2695825872,-12.06612079,-592,2.4392712105,7.1646992049,-9.626849583
40,143,2005,9299,5377,-2639,11551,1425,3922,-1214,2200,569407,16.362634984,9.4614354565,-4.643616918,-508,2.5074475592,6.9011995277,-2.136169359
40,143,2006,9391,5401,1605,11422,1456,3990,3061,6759,576166,16.395288646,9.4293423466,2.8020911806,-292,2.5419593513,6.9659462994,5.3440505319
40,143,2007,9944,5436,2119,12015,1311,4508,3430,7975,584141,17.140291319,9.3699339916,3.6524816277,37,2.2597467739,7.7703573278,5.9122284016
40,143,2008,9887,5510,1914,12015,1319,4377,3233,7841,591982,16.812867362,9.369768298,3.2547616193,231,2.2429626833,7.4430990636,5.4977243026
40,145,2001,753,377,680,214,46,376,726,1057,58755,12.932255932,6.4747151211,11.678531253,-45,0.7900182906,6.4575408105,12.468549544
40,145,2002,751,365,1020,214,43,386,1063,1425,60180,12.628746794,6.1378063648,17.152226006,-24,0.7230840375,6.4909404296,17.875310043
40,145,2003,766,412,567,214,28,354,595,910,61090,12.632967758,6.7947555042,9.3510348808,-39,0.4617795003,5.8382122536,9.8128143811
40,145,2004,738,439,637,214,36,299,673,904,61994,11.991810471,7.133339833,10.350654837,-68,0.5849663644,4.8584706379,10.935621202
40,145,2005,805,487,841,214,34,318,875,1147,63141,12.866104607,7.7835937188,13.441483198,-46,0.5434131138,5.0825108882,13.984896312
40,145,2006,779,474,1563,214,36,305,1599,1867,65008,12.157722651,7.3976386862,24.393479465,-37,0.5618459762,4.7600839648,24.955325441
40,145,2007,909,388,1618,214,27,521,1645,2127,67135,13.757822965,5.8724260839,24.488622174,-39,0.4086482069,7.8853968807,24.897270381
40,145,2008,970,403,1329,214,29,567,1358,1825,68960,14.254748521,5.922333664,19.530475036,-100,0.4261728939,8.3324148573,19.95664793
40,147,2001,601,575,-176,660,76,26,-100,-118,48860,12.285614996,11.754124164,-3.597784092,-44,1.5535885852,0.5314908318,-2.044195507
40,147,2002,577,560,47,660,74,17,121,93,48953,11.798022758,11.450420701,0.9610174517,-45,1.5130913069,0.347602057,2.4741087585
40,147,2003,585,604,-85,660,61,-19,-24,-108,48845,11.963434835,12.351990838,-1.738276856,-65,1.2474692734,-0.388556003,-0.490807583
40,147,2004,626,560,-148,660,62,66,-86,-57,48788,12.823533027,11.471531142,-3.031761802,-37,1.2700623765,1.3520018846,-1.761699425
40,147,2005,576,586,-196,660,62,-10,-134,-190,48598,11.829215698,12.034584026,-4.025219231,-46,1.2732836342,-0.205368328,-2.751935596
40,147,2006,613,606,255,660,62,7,317,301,48899,12.57474589,12.431151728,5.2309301825,-23,1.2718340051,0.1435941619,6.5027641876
40,147,2007,619,563,737,660,58,56,795,871,49770,12.547000578,11.411892286,14.938835906,20,1.1756478732,1.1351082914,16.114483779
40,147,2008,671,556,485,660,59,115,544,682,50452,13.390273593,11.095368282,9.6785136996,23,1.1773862026,2.2949053102,10.855899902
40,149,2001,131,148,-101,231,5,-17,-96,-120,11380,11.451048951,12.937062937,-8.828671329,-7,0.4370629371,-1.486013986,-8.391608392
40,149,2002,109,150,-64,231,4,-41,-60,-113,11267,9.6259990286,13.246787654,-5.651962732,-12,0.3532476708,-3.620788625,-5.298715062
40,149,2003,148,131,-46,231,2,17,-44,-39,11228,13.158479662,11.647032674,-4.089797733,-12,0.1778172927,1.5114469882,-3.91198044
40,149,2004,146,147,10,231,3,-1,13,4,11232,13.000890472,13.089937667,0.8904719501,-8,0.267141585,-0.089047195,1.1576135352
40,149,2005,166,140,8,231,3,26,11,25,11257,14.762772911,12.450531371,0.7114589355,-12,0.2667971008,2.3122415403,0.9782560363
40,149,2006,170,135,161,231,3,35,164,193,11450,14.973356234,11.890606421,14.180649139,-6,0.2642356982,3.0827498128,14.444884837
40,149,2007,183,144,155,231,2,39,157,201,11651,15.84346998,12.466992771,13.419332496,5,0.1731526774,3.3764772088,13.592485174
40,149,2008,172,136,12,231,2,36,14,58,11709,14.726027397,11.643835616,1.0273972603,8,0.1712328767,3.0821917808,1.198630137
40,151,2001,90,139,-145,974,4,-49,-141,-196,8847,10.061486864,15.53940749,-16.21017328,-6,0.447177194,-5.477920626,-15.76299609
40,151,2002,88,143,50,976,4,-55,54,-8,8839,9.9513739681,16.170982698,5.6541897546,-7,0.4523351804,-6.21960873,6.106524935
40,151,2003,85,103,-180,928,4,-18,-176,-195,8644,9.723731625,11.782874793,-20.59143168,-1,0.4575873706,-2.059143168,-20.13384431
40,151,2004,88,115,-41,913,2,-27,-39,-73,8571,10.223642173,13.360441475,-4.76328783,-7,0.2323555039,-3.136799303,-4.530932326
40,151,2005,79,120,16,893,3,-41,19,-28,8543,9.2322075494,14.023606404,1.8698141872,-6,0.3505901601,-4.791398855,2.2204043473
40,151,2006,76,121,-114,863,2,-45,-112,-160,8383,8.9802670448,14.297530427,-13.47040057,-3,0.236322817,-5.317263382,-13.23407775
40,151,2007,117,89,43,995,3,28,46,65,8448,13.902917236,10.575723368,5.1096191551,-9,0.3564850573,3.3271938685,5.4661042125
40,151,2008,100,108,-12,995,2,-8,-10,-26,8422,11.855364552,12.803793717,-1.422643746,-8,0.237107291,-0.948429164,-1.185536455
40,153,2001,240,193,-154,813,12,47,-142,-110,18319,13.061935343,10.503973005,-8.381408512,-15,0.6530967672,2.5579623381,-7.728311745
40,153,2002,266,162,-30,852,12,104,-18,69,18388,14.493148446,8.8266543166,-1.634565614,-17,0.6538262457,5.6664941292,-0.980739369
40,153,2003,262,179,-32,957,9,83,-23,36,18424,14.234488754,9.7250896447,-1.738563512,-24,0.4889709877,4.509399109,-1.249592524
40,153,2004,297,188,210,1192,8,109,218,307,18731,15.987081147,10.119768537,11.30399677,-20,0.4306284484,5.8673126093,11.734625219
40,153,2005,260,167,46,1174,9,93,55,133,18864,13.831626546,8.8841601277,2.4471339274,-15,0.4787870727,4.9474664184,2.9259210001
40,153,2006,291,221,146,1184,8,70,154,215,19079,15.33879767,11.649052526,7.6957541576,-9,0.4216851593,3.689745144,8.1174393169
40,153,2007,297,187,468,1385,9,110,477,595,19674,15.327845586,9.6508657394,24.152968802,8,0.4644801693,5.6769798467,24.617448972
40,153,2008,305,193,40,1385,8,112,48,164,19838,15.438347844,9.7691840454,2.0247013565,4,0.4049402713,5.6691637983,2.4296416279
41,0,2001,45666,30033,13654,77968,13664,15633,27318,39888,3470716,13.23356049,8.703269877,3.9567957547,-3063,3.959693657,4.5302906132,7.9164894116
41,0,2002,45101,30944,23342,81610,12762,14157,36104,47266,3517982,12.906839014,8.8554405985,6.6799280782,-2995,3.6521824237,4.051398415,10.332110502
41,0,2003,45771,30684,11582,81999,10963,15087,22545,33895,3551877,12.948207312,8.6802296906,3.27644441,-3737,3.1013348357,4.2679776216,6.3777792457
41,0,2004,45672,30829,2444,82127,10367,14843,12811,24385,3576262,12.814564924,8.6499435547,0.6857329802,-3269,2.9087536031,4.1646213689,3.5944865834
41,0,2005,45971,30868,22821,82015,10766,15103,33587,45677,3621939,12.772913677,8.5765874001,6.3407509738,-3013,2.9913029658,4.1963262765,9.3320539396
41,0,2006,47002,30564,33735,81622,10814,16438,44549,59029,3680968,12.872134343,8.3703653901,9.2387866914,-1958,2.9615603759,4.5017689531,12.200347067
41,0,2007,49665,29620,25297,81620,9749,20045,35046,54581,3735549,13.393079258,7.9875769178,6.8218005838,-510,2.6289968728,5.4055023402,9.4507974565
41,0,2008,50114,30120,24756,81620,9766,19994,34522,54511,3790060,13.318257698,8.004667795,6.5791353231,-5,2.5954045712,5.3135899035,9.1745398944
41,1,2001,163,202,-63,423,12,-39,-51,-108,16609,9.7821520735,12.122666987,-3.780831783,-18,0.7201584349,-2.340514913,-3.060673348
41,1,2002,175,209,-225,423,10,-34,-215,-258,16351,10.618932039,12.682038835,-13.65291262,-9,0.6067961165,-2.063106796,-13.0461165
41,1,2003,155,191,-33,428,8,-36,-25,-81,16270,9.5030808375,11.710248,-2.023236565,-20,0.4904815916,-2.207167162,-1.532754974
41,1,2004,128,207,15,505,10,-79,25,-65,16205,7.882986913,12.748267898,0.9237875289,-11,0.6158583526,-4.865280985,1.5396458814
41,1,2005,175,242,-123,513,9,-67,-114,-197,16008,10.865178655,15.024989911,-7.636668426,-16,0.5587806165,-4.159811256,-7.077887809
41,1,2006,160,196,-59,520,10,-36,-49,-92,15916,10.023806541,12.279163012,-3.696278662,-7,0.6264879088,-2.255356472,-3.069790753
41,1,2007,174,191,11,520,8,-17,19,-1,15915,10.932738525,12.000879646,0.6911501367,-3,0.5026546448,-1.06814112,1.1938047815
41,1,2008,173,186,77,520,8,-13,85,68,15983,10.847075052,11.662173177,4.8278888959,-4,0.5015988463,-0.815098125,5.3294877422
41,3,2001,779,463,-664,4681,372,316,-292,-38,78149,9.9657148705,5.9231399038,-8.494524614,-62,4.758980657,4.0425749667,-3.735543957
41,3,2002,796,434,787,5534,344,362,1131,1436,79585,10.092941281,5.5029353215,9.9788251106,-57,4.3617736189,4.5900059594,14.34059873
41,3,2003,771,519,-669,5366,294,252,-375,-187,79398,9.6991502236,6.528999956,-8.415994163,-64,3.6985086456,3.1701502676,-4.717485517
41,3,2004,752,496,-908,4565,284,256,-624,-449,78949,9.49812753,6.2647224134,-11.46848377,-81,3.5870588012,3.2334051166,-7.881424972
41,3,2005,804,485,-43,4423,292,319,249,503,79452,10.151451064,6.123698714,-0.542925865,-65,3.6868454113,4.02775235,3.143919546
41,3,2006,791,488,99,4280,297,303,396,658,80110,9.9146413306,6.1167445883,1.2408969554,-41,3.7226908662,3.7978967423,4.9635878217
41,3,2007,804,525,525,4280,269,279,794,1041,81151,9.9714128028,6.5111837332,6.5111837332,-32,3.3362065223,3.4602290696,9.8473902555
41,3,2008,863,510,97,4280,270,353,367,708,81859,10.588307466,6.2572848292,1.1901110361,-12,3.3126802037,4.3310226366,4.5027912398
41,5,2001,4203,2676,3119,2894,995,1527,4114,5325,344837,12.283206376,7.8205710829,9.1152321403,-316,2.9078730297,4.4626352928,12.02310517
41,5,2002,4025,2641,4804,3696,923,1384,5727,6824,351661,11.557822133,7.5836542244,13.794727336,-287,2.6504024419,3.9741679086,16.445129778
41,5,2003,4072,2685,2369,3896,801,1387,3170,4130,355791,11.511735072,7.5906209891,6.6972741614,-427,2.2644645856,3.9211140827,8.9617387469
41,5,2004,4103,2766,3258,4073,750,1337,4008,5040,360831,11.450946245,7.7195508929,9.0926597286,-305,2.0931537128,3.7313953521,11.185813441
41,5,2005,3960,2772,3097,4210,784,1188,3881,4781,365612,10.902438319,7.6317068235,8.5264776452,-288,2.1584625359,3.2707314958,10.684940181
41,5,2006,3779,2816,3428,4347,786,963,4214,4979,370591,10.266190168,7.650063909,9.312648821,-198,2.1352806223,2.6161262587,11.447929443
41,5,2007,4106,2737,2518,4347,713,1369,3231,4516,375107,11.012501039,7.3407733426,6.7534041931,-84,1.9123022993,3.6717276967,8.6657064924
41,5,2008,4235,2751,3263,4347,715,1484,3978,5469,380576,11.208403524,7.2808307187,8.6358962687,7,1.8923278676,3.927572805,10.528224136
41,7,2001,374,413,-32,1121,75,-39,43,-30,35538,10.51950609,11.616459933,-0.900064692,-34,2.1095266222,-1.096953844,1.2094619301
41,7,2002,416,410,56,1121,41,6,97,69,35607,11.694426875,11.525757256,1.5742497716,-34,1.1525757256,0.1686696184,2.7268254972
41,7,2003,408,390,217,1121,-19,18,198,181,35788,11.429371805,10.925134813,6.0788570628,-35,-0.532250158,0.5042369914,5.5466069052
41,7,2004,382,362,207,1121,95,20,302,294,36082,10.630304717,10.07374426,5.7604007235,-28,2.6436621678,0.5565604564,8.4040628913
41,7,2005,382,375,376,1121,54,7,430,407,36489,10.527621226,10.334706701,10.362265919,-30,1.4881977649,0.1929145251,11.850463684
41,7,2006,420,361,318,1121,83,59,401,441,36930,11.441180076,9.8339666844,8.6626077718,-19,2.2609951103,1.6072133916,10.923602882
41,7,2007,460,354,221,1121,47,106,268,375,37305,12.393076042,9.5372802586,5.9540647942,1,1.2662490739,2.8557957837,7.2203138681
41,7,2008,427,363,-40,1121,55,64,15,99,37404,11.43101902,9.7177046942,-1.070821454,20,1.4723794991,1.7133143263,0.4015580452
41,9,2001,549,389,437,248,14,160,451,576,44233,12.492888838,8.8519740585,9.9442484924,-35,0.3185800432,3.6409147798,10.262828536
41,9,2002,494,381,820,248,12,113,832,922,45155,11.052937755,8.5246341791,18.346981698,-23,0.2684924151,2.5283035754,18.615474113
41,9,2003,526,401,430,248,3,125,433,520,45675,11.582076406,8.8296818232,9.4682373665,-38,0.06605747,2.7523945833,9.5342948365
41,9,2004,514,405,484,248,14,109,498,566,46241,11.184124636,8.8123939249,10.531354715,-41,0.3046259628,2.3717307106,10.835980678
41,9,2005,506,396,683,248,10,110,693,767,47008,10.852663299,8.493388669,14.648950659,-36,0.2144795118,2.3592746303,14.863430171
41,9,2006,531,352,1039,248,12,179,1051,1204,48212,11.153119093,7.3934047469,21.823146398,-26,0.2520478891,3.7597143457,22.075194287
41,9,2007,482,317,521,248,10,165,531,702,48914,9.9252517349,6.5276033194,10.728332269,6,0.2059180858,3.3976484155,10.934250355
41,9,2008,553,356,285,248,10,197,295,494,49408,11.248754094,7.2415125811,5.7972783304,2,0.2034132748,4.0072415126,6.0006916051
41,11,2001,624,816,-307,1415,48,-192,-259,-502,62169,9.9967958988,13.072733098,-4.918295418,-51,0.7689842999,-3.0759372,-4.149311118
41,11,2002,587,887,394,1420,36,-300,430,81,62250,9.4358578674,14.25827245,6.333437819,-49,0.57868975,-4.822414583,6.9121275689
41,11,2003,653,883,573,1380,5,-230,578,293,62543,10.465330587,14.151434776,9.1832073914,-55,0.0801326998,-3.686104189,9.2633400912
41,11,2004,612,856,801,1400,48,-244,849,544,63087,9.7428958051,13.627318316,12.751731274,-61,0.7641486906,-3.884422511,13.515879965
41,11,2005,629,893,886,1400,32,-264,918,598,63685,9.9233269176,14.088284479,13.977849998,-56,0.5048433408,-4.164957562,14.482693339
41,11,2006,652,866,191,1400,43,-214,234,-10,63675,10.238693467,13.599246231,2.9993718593,-30,0.6752512563,-3.360552764,3.6746231156
41,11,2007,662,787,-159,1400,30,-125,-129,-228,63447,10.415191706,12.381806454,-2.50153396,26,0.4719875395,-1.966614748,-2.02954642
41,11,2008,671,811,62,1400,33,-140,95,6,63453,10.575256107,12.781717888,0.9771473601,51,0.5200945626,-2.206461781,1.4972419228
41,13,2001,233,206,510,273,30,27,540,555,19876,11.888664949,10.511008496,26.022399673,-12,1.5307293926,1.3776564533,27.553129066
41,13,2002,232,196,142,273,30,36,172,189,20065,11.617135275,9.8144763526,7.1104879698,-19,1.5022157683,1.8026589219,8.612703738
41,13,2003,215,190,299,273,26,25,325,336,20401,10.626204715,9.3905995156,14.777838185,-14,1.2850294074,1.2356051994,16.062867593
41,13,2004,244,186,725,273,22,58,747,770,21171,11.738670259,8.9483306071,34.879245646,-35,1.0584046955,2.7903396517,35.937650342
41,13,2005,237,197,467,273,26,40,493,514,21685,11.060294941,9.1935784954,21.793914504,-19,1.2133656898,1.8667164458,23.007280194
41,13,2006,241,208,770,273,24,33,794,814,22499,10.908926308,9.4151729133,34.854245881,-13,1.0863661054,1.4937533949,35.940611986
41,13,2007,268,197,259,273,19,71,278,358,22857,11.817620601,8.6868330541,11.420760208,9,0.8378163859,3.1307875474,12.258576594
41,13,2008,282,213,64,273,18,69,82,166,23023,12.292938099,9.2850915432,2.7898866609,15,0.7846556234,3.0078465562,3.5745422842
41,15,2001,175,327,149,277,14,-152,163,-5,21100,8.2928562966,15.495794337,7.0607747897,-16,0.6634285037,-7.202938041,7.7242032934
41,15,2002,142,328,464,277,9,-186,473,281,21381,6.6853416822,15.442197688,21.845060145,-6,0.423718839,-8.756856006,22.268778984
41,15,2003,155,352,317,277,-2,-197,315,119,21500,7.229309018,16.417527576,14.785102959,1,-0.093281407,-9.188218558,14.691821553
41,15,2004,158,309,609,277,16,-151,625,438,21938,7.2747364059,14.227174363,28.039965008,-36,0.7366821677,-6.952437958,28.776647175
41,15,2005,163,291,281,277,9,-128,290,144,22082,7.4057246706,13.221263062,12.766924125,-18,0.4089050432,-5.815538392,13.175829169
41,15,2006,123,294,31,277,13,-171,44,-136,21946,5.5873535023,13.35513764,1.4081947851,-9,0.590533297,-7.767784137,1.9987280821
41,15,2007,133,311,-21,277,8,-178,-13,-195,21751,6.0873744193,14.2343868,-0.961164382,-4,0.3661578598,-8.147012381,-0.595006522
41,15,2008,157,332,-65,277,9,-175,-56,-228,21523,7.2560891066,15.344086518,-3.004113324,3,0.4159541526,-8.087997412,-2.588159172
41,17,2001,1460,951,3481,1221,92,509,3573,4032,120645,12.30727731,8.0165895354,29.343583778,-50,0.7755270634,4.2906877745,30.119110841
41,17,2002,1444,966,4251,1221,88,478,4339,4795,125440,11.735782352,7.8509458114,34.549037934,-22,0.7152000325,3.8848365402,35.264237967
41,17,2003,1564,998,3178,1221,68,566,3246,3852,129292,12.279572256,7.8356861329,24.951713958,40,0.5338944459,4.4438861235,25.485608404
41,17,2004,1589,939,4255,1221,76,650,4331,4764,134056,12.067682306,7.1312483862,32.314655893,-217,0.577183043,4.9364339201,32.891838936
41,17,2005,1721,1052,6227,1216,71,669,6298,6886,140942,12.516454665,7.6509647343,45.287602092,-81,0.5163673918,4.8654899308,45.803969483
41,17,2006,1876,1063,7098,1211,75,813,7173,7885,148827,12.948244981,7.3368786861,48.990747803,-101,0.5176537173,5.6113662952,49.50840152
41,17,2007,2121,1060,3918,1211,66,1061,3984,4972,153799,14.017301884,7.0053465333,25.893346903,-73,0.436181954,7.0119553508,26.329528857
41,17,2008,2137,1107,3682,1211,66,1030,3748,4657,158456,13.687531024,7.0903588413,23.583289299,-121,0.4227314214,6.597172183,24.00602072
41,19,2001,1049,1150,-198,1524,43,-101,-155,-349,100077,10.463683835,11.471150058,-1.975032793,-93,0.428921263,-1.007466222,-1.54611153
41,19,2002,1080,1179,679,1524,36,-99,715,518,100595,10.763833519,11.750518259,6.7672619997,-98,0.3587944506,-0.986684739,7.1260564503
41,19,2003,1078,1257,987,1524,23,-179,1010,738,101333,10.677073016,12.449982172,9.7757616576,-93,0.2278039697,-1.772909156,10.003565627
41,19,2004,1114,1234,893,1524,36,-120,929,719,102052,10.954593505,12.134621531,8.7813752243,-90,0.3540084077,-1.180028026,9.135383632
41,19,2005,1075,1192,995,1524,33,-117,1028,826,102878,10.491387303,11.633240619,9.710632899,-85,0.3220611916,-1.141853316,10.032694091
41,19,2006,1145,1219,990,1524,37,-74,1027,899,103777,11.081270717,11.797440178,9.5811860347,-54,0.3580847306,-0.716169461,9.9392707653
41,19,2007,1191,1170,179,1524,25,21,204,223,104000,11.464214037,11.262074243,1.7230011021,-2,0.240642612,0.2021397941,1.9636437142
41,19,2008,1162,1217,54,1524,26,-55,80,59,104059,11.169908536,11.698604723,0.5190835292,34,0.2499291066,-0.528696187,0.7690126358
41,21,2001,16,15,-35,26,2,1,-33,-32,1876,8.4566596195,7.9281183932,-18.49894292,0,1.0570824524,0.5285412262,-17.44186047
41,21,2002,14,24,-37,26,2,-10,-35,-47,1829,7.5573549258,12.955465587,-19.97300945,-2,1.0796221323,-5.398110661,-18.89338731
41,21,2003,20,26,-77,26,1,-6,-76,-79,1750,11.176306231,14.5291981,-43.02877899,3,0.5588153115,-3.352891869,-42.46996368
41,21,2004,18,25,22,26,0,-7,22,13,1763,10.24765158,14.232849416,12.524907486,-2,0,-3.985197837,12.524907486
41,21,2005,16,23,-15,26,1,-7,-14,-22,1741,9.1324200913,13.127853881,-8.561643836,-1,0.5707762557,-3.99543379,-7.99086758
41,21,2006,17,23,-27,26,0,-6,-27,-34,1707,9.8607888631,13.341067285,-15.6612529,-1,0,-3.480278422,-15.6612529
41,21,2007,15,12,-25,26,1,3,-24,-21,1686,8.8417329797,7.0733863837,-14.73622163,0,0.5894488653,1.7683465959,-14.14677277
41,21,2008,14,15,63,26,0,-1,63,61,1747,8.1561316633,8.7387124964,36.702592485,-1,0,-0.582580833,36.702592485
41,23,2001,64,102,-422,172,4,-38,-418,-455,7448,8.3382190085,13.289036545,-54.98013159,1,0.521138688,-4.950817536,-54.4589929
41,23,2002,72,102,-84,172,4,-30,-80,-115,7333,9.7422366552,13.801501928,-11.36594276,-5,0.5412353697,-4.059265273,-10.82470739
41,23,2003,78,95,-5,172,1,-17,-4,-31,7302,10.659378203,12.982576016,-0.683293475,-10,0.1366586949,-2.323197813,-0.54663478
41,23,2004,66,85,-85,172,0,-19,-85,-110,7192,9.1072167794,11.728991307,-11.72899131,-6,0,-2.621774527,-11.72899131
41,23,2005,60,76,-68,172,1,-16,-67,-91,7101,8.3957181837,10.634576366,-9.515147275,-8,0.1399286364,-2.238858182,-9.375218638
41,23,2006,52,90,-35,172,0,-38,-35,-76,7025,7.3623106329,12.742460711,-4.955401388,-3,0,-5.380150078,-4.955401388
41,23,2007,62,88,-109,172,1,-26,-108,-129,6896,8.9074060771,12.642769916,-15.65979455,5,0.14366784,-3.735363839,-15.51612672
41,23,2008,66,94,43,172,0,-28,43,20,6916,9.5569070374,13.611352447,6.2264697365,5,0,-4.05444541,6.2264697365
41,25,2001,90,71,-266,169,4,19,-262,-245,7384,11.989609006,9.4584693266,-35.43595551,-2,0.5328715114,2.5311396789,-34.90308399
41,25,2002,75,76,-148,169,4,-1,-144,-150,7234,10.261321658,10.39813928,-20.24900807,-5,0.5472704884,-0.136817622,-19.70173758
41,25,2003,76,70,-147,169,3,6,-144,-138,7096,10.607117934,9.769713887,-20.51639916,0,0.4187020237,0.8374040475,-20.09769714
41,25,2004,71,64,-121,169,2,7,-119,-119,6977,10.090243729,9.0954309671,-17.19604917,-7,0.2842322177,0.994812762,-16.91181695
41,25,2005,74,71,-173,169,3,3,-170,-172,6805,10.738644609,10.303294152,-25.10520969,-5,0.4353504571,0.4353504571,-24.66985924
41,25,2006,78,74,-15,169,2,4,-13,-12,6793,11.472275335,10.883953523,-2.206206795,-3,0.294160906,0.588321812,-1.912045889
41,25,2007,82,75,-32,169,3,7,-29,-25,6768,12.093503429,11.061131185,-4.719415972,-3,0.4424452474,1.0323722439,-4.276970725
41,25,2008,74,81,-12,169,2,-7,-10,-21,6747,10.950795413,11.986681465,-1.775804661,-4,0.2959674436,-1.035886053,-1.479837218
41,27,2001,325,177,-326,870,116,148,-210,-73,20394,15.907589144,8.6635177798,-15.95653557,-11,5.6777856636,7.2440713639,-10.27874991
41,27,2002,326,181,-20,870,111,145,91,215,20609,15.901275516,8.8286222959,-0.975538375,-21,5.4142379826,7.0726532205,4.4386996073
41,27,2003,294,188,-193,870,98,106,-95,-5,20604,14.267342829,9.1233348701,-9.365976755,-16,4.7557809429,5.1440079587,-4.610195812
41,27,2004,299,192,28,870,86,107,114,208,20812,14.438864207,9.2717790226,1.3521344408,-13,4.1529843539,5.1670851845,5.5051187947
41,27,2005,311,174,-38,870,93,137,55,172,20984,14.881806871,8.326155613,-1.818355824,-20,4.4501866207,6.5556512585,2.6318307972
41,27,2006,299,154,-91,870,92,145,1,136,21120,14.202926088,7.3152194566,-4.322629679,-10,4.3701311039,6.8877066312,0.047501425
41,27,2007,305,166,-145,870,83,139,-62,80,21200,14.413988658,7.8449905482,-6.852551985,3,3.9224952741,6.5689981096,-2.930056711
41,27,2008,316,146,73,870,82,170,155,336,21536,14.788468738,6.8326469487,3.4163234744,11,3.8375140397,7.9558217896,7.253837514
41,29,2001,2067,1891,1730,3751,272,176,2002,2009,183797,11.307903771,10.345063392,9.464283272,-169,1.4880260405,0.9628403791,10.952309312
41,29,2002,2106,1887,2457,3912,254,219,2711,2795,186592,11.371827997,10.189287479,13.267132663,-135,1.371531012,1.1825405182,14.638663675
41,29,2003,2104,2017,2736,3868,218,87,2954,2941,189533,11.187770023,10.72515786,14.548354935,-100,1.1591890994,0.4626121635,15.707544035
41,29,2004,2140,1941,2042,3857,218,199,2260,2283,191816,11.223315126,10.17965171,10.709350228,-176,1.1433096717,1.0436634159,11.852659899
41,29,2005,2174,1841,2054,4044,221,333,2275,2452,194268,11.261797951,9.5367847411,10.640171569,-156,1.1448285865,1.7250132096,11.785000155
41,29,2006,2228,2044,1935,4227,224,184,2159,2234,196502,11.403127159,10.46139673,9.903523812,-109,1.1464544361,0.9417304297,11.049978248
41,29,2007,2394,1916,1880,4225,204,478,2084,2501,199003,12.106041643,9.6888787752,9.5068330362,-61,1.031592521,2.4171628677,10.538425557
41,29,2008,2436,1924,1469,4225,205,512,1674,2135,201138,12.175708063,9.6166101449,7.3424117998,-51,1.0246388148,2.559097918,8.3670506147
41,31,2001,310,170,194,150,42,140,236,362,19465,16.075503008,8.8155984236,10.060153495,-14,2.1779713752,7.2599045841,12.23812487
41,31,2002,316,189,-37,150,40,127,3,109,19574,16.188939266,9.6826250672,-1.895540357,-21,2.0492328185,6.5063141986,0.1536924614
41,31,2003,303,172,-59,150,32,131,-27,77,19651,15.449330784,8.7699171447,-3.008285532,-27,1.631612492,6.6794136393,-1.37667304
41,31,2004,320,169,-211,150,30,151,-181,-49,19602,16.304486281,8.6108068173,-10.75077064,-19,1.5285455889,7.693679464,-9.222225053
41,31,2005,301,173,-46,150,32,128,-14,103,19705,15.315338235,8.8025033709,-2.340550029,-11,1.628208716,6.512834864,-0.712341313
41,31,2006,357,180,173,150,32,177,205,371,20076,17.948266761,9.0495462658,8.6976194666,-11,1.608808225,8.8987204947,10.306427692
41,31,2007,333,160,371,150,30,173,401,552,20628,16.362028302,7.8616352201,18.229166667,-22,1.4740566038,8.5003930818,19.70322327
41,31,2008,355,165,-288,150,29,190,-259,-116,20512,17.258142927,8.0213903743,-14.00097229,-47,1.4098201264,9.2367525523,-12.59115216
41,33,2001,777,961,690,1010,22,-184,712,465,76307,10.213672124,12.632353811,9.0700563264,-63,0.2891902017,-2.418681687,9.3592465281
41,33,2002,733,1031,1439,1010,20,-298,1459,1114,77421,9.5363238968,13.413301415,18.721378018,-47,0.2601998335,-3.876977519,18.981577852
41,33,2003,750,1056,1202,1010,14,-306,1216,880,78301,9.632550314,13.562630842,15.437767303,-30,0.1798076059,-3.930080528,15.617574909
41,33,2004,822,1076,1126,1010,21,-254,1147,807,79108,10.444129624,13.671391089,14.306678779,-86,0.2668208298,-3.227261465,14.573499609
41,33,2005,812,1014,1022,1010,18,-202,1040,769,79877,10.214800138,12.75592037,12.856558795,-69,0.2264364563,-2.541120231,13.082995251
41,33,2006,795,1049,1113,1010,20,-254,1133,836,80713,9.900990099,13.0643253,13.861386139,-43,0.2490815119,-3.163335201,14.110467651
41,33,2007,900,1054,360,1010,17,-154,377,215,80928,11.135788568,13.041245724,4.4543154274,-8,0.210342673,-1.905457155,4.6646581004
41,33,2008,869,1022,796,1010,17,-153,813,690,81618,10.692357856,12.574901874,9.7941505789,30,0.2091715576,-1.882544018,10.003322137
41,35,2001,828,657,42,1001,71,171,113,217,64102,12.938814098,10.266667708,0.6563166572,-67,1.1094876823,2.6721463899,1.7658043395
41,35,2002,803,701,-110,1060,54,102,-56,-15,64087,12.52837607,10.936975872,-1.7162159,-61,0.8425059873,1.5914001981,-0.873709913
41,35,2003,786,694,407,1404,16,92,423,445,64532,12.222144473,10.791562677,6.3287694664,-70,0.2487968341,1.4305817958,6.5775663005
41,35,2004,787,690,72,1385,68,97,140,193,64725,12.177290205,10.676404373,1.1140595867,-44,1.0521673875,1.5008858321,2.1662269742
41,35,2005,811,736,577,1367,48,75,625,640,65365,12.468291183,11.315243293,8.8707817665,-60,0.7379506496,1.1530478899,9.608732416
41,35,2006,785,706,419,1348,64,79,483,531,65896,11.960902324,10.757193683,6.3842268458,-31,0.9751563678,1.2037086416,7.3593832136
41,35,2007,873,676,253,1348,42,197,295,512,66408,13.196879913,10.218889829,3.8245253356,20,0.6349014391,2.9779900834,4.4594267747
41,35,2008,863,664,-268,1348,45,199,-223,17,66425,12.993759081,9.9975156776,-4.03514187,41,0.6775424781,2.9962434034,-3.357599392
41,37,2001,80,93,28,55,10,-13,38,18,7428,10.78312441,12.535382127,3.7740935436,-7,1.3478905513,-1.752257717,5.1219840949
41,37,2002,68,76,-99,55,9,-8,-90,-102,7326,9.21783923,10.302290904,-13.42008947,-4,1.2200081334,-1.084451674,-12.20008133
41,37,2003,77,87,-25,55,5,-10,-20,-41,7285,10.540004106,11.908835809,-3.422079255,-11,0.6844158511,-1.368831702,-2.737663404
41,37,2004,64,83,-71,55,6,-19,-65,-90,7195,8.8397790055,11.464088398,-9.806629834,-6,0.8287292818,-2.624309392,-8.977900552
41,37,2005,56,79,-86,55,6,-23,-80,-109,7086,7.8425880541,11.063651005,-12.04397451,-6,0.8402772915,-3.221062951,-11.20369722
41,37,2006,81,105,196,55,6,-24,202,174,7260,11.292346299,14.638226683,27.324689809,-4,0.8364700962,-3.345880385,28.161159905
41,37,2007,72,98,10,55,4,-26,14,-13,7247,9.9262425036,13.510718963,1.3786447922,-1,0.5514579169,-3.58447646,1.930102709
41,37,2008,77,94,10,55,3,-17,13,-8,7239,10.630954025,12.97804777,1.3806433798,-4,0.4141930139,-2.347093746,1.7948363938
41,39,2001,3653,2828,92,7418,751,825,843,1337,324822,11.269352328,8.7242618081,0.283816155,-331,2.3168036131,2.5450905204,2.6006197681
41,39,2002,3590,3011,1615,7418,699,579,2314,2580,327402,11.008487881,9.2330242371,4.9522863311,-313,2.1434353842,1.7754636444,7.0957217152
41,39,2003,3576,2815,2102,7418,610,761,2712,3102,330504,10.870853891,8.5574534964,6.3899706037,-371,1.8543682532,2.3134003946,8.2443388569
41,39,2004,3644,3001,497,7418,562,643,1059,1486,331990,11.000854347,9.0597046917,1.5003909469,-216,1.6966191392,1.9411496557,3.1970100861
41,39,2005,3509,3026,2637,7493,591,483,3228,3432,335422,10.515243957,9.0678621301,7.9021653791,-279,1.7710199996,1.4473818271,9.6731853787
41,39,2006,3588,2999,3002,7567,586,589,3588,4000,339422,10.633568647,8.8879800369,8.8968709806,-177,1.7366976664,1.7455886101,10.633568647
41,39,2007,3801,2904,1945,7567,540,897,2485,3359,342781,11.143310715,8.513594927,5.7021150596,-23,1.5831064947,2.6297157884,7.2852215543
41,39,2008,3938,2921,2158,7567,541,1017,2699,3779,346560,11.425404843,8.4747606772,6.2610522223,63,1.5696150381,2.9506441659,7.8306672605
41,41,2001,444,586,-370,642,95,-142,-275,-459,43886,10.064489805,13.283313121,-8.387074838,-42,2.153438134,-3.218823316,-6.233636704
41,41,2002,420,579,516,642,89,-159,605,421,44307,9.5245654417,13.130293787,11.701608971,-25,2.0183007722,-3.605728346,13.719909743
41,41,2003,431,541,222,642,75,-110,297,141,44448,9.7121288941,12.190862487,5.0025350684,-46,1.6900456312,-2.478733592,6.6925806997
41,41,2004,455,523,504,642,85,-68,589,475,44923,10.182273892,11.70402032,11.278826465,-46,1.9021830348,-1.521746428,13.1810095
41,41,2005,434,543,545,642,80,-109,625,473,45396,9.610380983,12.024048096,12.068335566,-43,1.7714987987,-2.413667113,13.839834365
41,41,2006,462,541,166,642,84,-79,250,149,45545,10.160433688,11.897823864,3.6507185978,-22,1.8473515796,-1.737390176,5.4980701774
41,41,2007,487,498,177,642,77,-11,254,236,45781,10.665089898,10.905985152,3.8762236384,-7,1.6862667805,-0.240895254,5.5624904189
41,41,2008,481,516,126,642,77,-35,203,165,45946,10.487642679,11.250776761,2.7472826976,-3,1.6788949818,-0.763134083,4.4261776794
41,43,2001,1320,975,241,994,106,345,347,584,103597,12.77769711,9.4380717293,2.33289773,-108,1.0260877983,3.3396253812,3.3589855283
41,43,2002,1414,1046,692,994,100,368,792,1061,104658,13.579505894,10.045377062,6.6456987827,-99,0.9603610958,3.5341288324,7.6060598785
41,43,2003,1351,963,1088,994,86,388,1174,1474,106132,12.818444898,9.1370558376,10.323070354,-88,0.8159779876,3.6813890602,11.139048342
41,43,2004,1412,1073,472,994,86,339,558,823,106955,13.252802846,10.071003862,4.4301153989,-74,0.807182043,3.1817989835,5.2372974419
41,43,2005,1367,1094,1101,994,85,273,1186,1381,108336,12.699090998,10.162988699,10.228016963,-78,0.7896289209,2.5361022987,11.017645884
41,43,2006,1477,1090,2097,994,88,387,2185,2508,110844,13.477507072,9.9461629711,19.134957569,-64,0.8029929738,3.5313441007,19.937950543
41,43,2007,1550,1095,1723,994,77,455,1800,2209,113053,13.845652242,9.781283358,15.391005686,-46,0.6878162727,4.0643688839,16.078821958
41,43,2008,1583,1064,1757,994,77,519,1834,2295,115348,13.861585545,9.3169469486,15.385221606,-58,0.6742527397,4.5446385962,16.059474346
41,45,2001,517,266,-390,3424,114,251,-276,-46,31474,16.414261676,8.4452487538,-12.38213163,-21,3.6193923231,7.9690129219,-8.762739309
41,45,2002,481,259,-471,3464,112,222,-359,-152,31322,15.319447099,8.2489330531,-15.00095547,-15,3.5671061851,7.0705140455,-11.43384929
41,45,2003,448,263,-455,3463,95,185,-360,-189,31133,14.346329357,8.422063886,-14.57049075,-14,3.0421903771,5.9242654711,-11.52830038
41,45,2004,454,297,-349,3460,84,157,-265,-139,30994,14.615223655,9.5610604085,-11.23505078,-31,2.7041382974,5.0541632463,-8.530912486
41,45,2005,485,300,-273,3486,91,185,-182,-26,30968,15.654756141,9.6833543139,-8.811852426,-29,2.9372841419,5.9714018269,-5.874568284
41,45,2006,445,255,-356,3512,90,190,-266,-90,30878,14.390583061,8.2462891699,-11.51246645,-14,2.9104550011,6.1442938913,-8.602011448
41,45,2007,457,235,-156,3512,78,222,-78,135,31013,14.767898402,7.593995896,-5.04112068,-9,2.52056034,7.173902506,-2.52056034
41,45,2008,459,237,-407,3512,77,222,-330,-106,30907,14.825581395,7.6550387597,-13.14599483,2,2.4870801034,7.1705426357,-10.65891473
41,47,2001,4466,2415,-334,11224,1771,2051,1437,3210,288772,15.551926231,8.4097406735,-1.163086288,-278,6.1671431606,7.1421855575,5.0040568728
41,47,2002,4547,2528,1373,12042,1659,2019,3032,4806,293578,15.616038465,8.6820640508,4.7153773504,-245,5.6976045334,6.933974414,10.412981884
41,47,2003,4508,2485,-3,12113,1457,2023,1454,3037,296615,15.27635875,8.4209741559,-0.010166166,-440,4.9373679457,6.8553845945,4.9272017798
41,47,2004,4641,2572,-869,12281,1329,2069,460,2308,298923,15.585907197,8.6375680477,-2.918369609,-221,4.4631912657,6.9483391488,1.5448216571
41,47,2005,4709,2416,-656,11618,1412,2293,756,2776,301699,15.680411307,8.0449933569,-2.18440217,-273,4.7017924751,7.6354179501,2.5173903054
41,47,2006,4817,2402,598,10952,1408,2415,2006,4263,305962,15.854234516,7.9057237506,1.9682026656,-158,4.634162798,7.948510765,6.6023654636
41,47,2007,5108,2382,149,10952,1267,2726,1416,4138,310100,16.582746542,7.7329879136,0.4837175479,-4,4.1132223705,8.8497586282,4.5969399184
41,47,2008,5128,2453,468,10952,1269,2675,1737,4506,314606,16.417322709,7.8532941896,1.4983048026,94,4.0627110993,8.564028519,5.5610159019
41,49,2001,154,89,-52,40,69,65,17,71,11090,13.930978335,8.0510199466,-4.70396671,-11,6.2418019811,5.879958388,1.5378352707
41,49,2002,176,77,141,40,67,99,208,300,11390,15.658362989,6.8505338078,12.544483986,-7,5.9608540925,8.8078291815,18.505338078
41,49,2003,170,83,-108,40,44,87,-64,14,11404,14.916206019,7.2826182329,-9.476177942,-9,3.8606650873,7.6335877863,-5.615512854
41,49,2004,190,89,-154,40,43,101,-111,-22,11382,16.676906873,7.8118142719,-13.51707189,-12,3.7742473449,8.8650926007,-9.742824541
41,49,2005,162,71,-222,40,43,91,-179,-94,11288,14.29201588,6.2637847375,-19.58535509,-6,3.7935597706,8.0282311425,-15.79179532
41,49,2006,151,61,-104,40,44,90,-60,23,11311,13.36342316,5.3984689588,-9.203947077,-7,3.8939776096,7.9649542015,-5.309969468
41,49,2007,154,53,-326,40,34,101,-292,-191,11120,13.730997281,4.7256029602,-29.06691632,0,3.0315188801,9.0053943204,-26.03539744
41,49,2008,159,55,-110,40,34,104,-76,20,11140,14.285714286,4.9415992812,-9.883198562,-8,3.0548068284,9.3441150045,-6.828391734
41,51,2001,9423,5805,698,16493,4327,3618,5025,8000,669766,14.153621543,8.7192797469,1.0484164106,-643,6.499280528,5.4343417958,7.5476969386
41,51,2002,9165,5893,329,16719,4069,3272,4398,7009,676775,13.612656429,8.7527969813,0.4886594615,-661,6.0436332796,4.8598594473,6.5322927412
41,51,2003,9517,5804,-4149,16714,3578,3713,-571,2412,679187,14.037266531,8.5607118784,-6.119640521,-730,5.2774340284,5.4765546527,-0.842206493
41,51,2004,9191,5582,-12564,16760,3247,3609,-9317,-6527,672660,13.597692638,8.2583310094,-18.58790233,-819,4.8037980629,5.3393616289,-13.78410427
41,51,2005,9465,5609,-4137,16760,3420,3856,-717,2515,675175,14.044745833,8.322977219,-6.138733599,-624,5.0748051505,5.7217686141,-1.063928448
41,51,2006,9927,5446,1973,16755,3406,4481,5379,9518,684693,14.599946465,8.0096009319,2.9017522289,-342,5.0093097271,6.5903455335,7.911061956
41,51,2007,10373,5331,6248,16755,3100,5042,9348,14493,699186,14.991195039,7.7044308065,9.0296911796,103,4.4801604765,7.286764233,13.509851656
41,51,2008,10164,5402,7355,16755,3104,4762,10459,15381,714567,14.378749329,7.6420704324,10.404929291,160,4.3911489489,6.7366788965,14.79607824
41,53,2001,756,511,767,2147,195,245,962,1142,63796,11.957295374,8.082245947,12.131277185,-65,3.084223013,3.8750494267,15.215500198
41,53,2002,737,561,670,2126,185,176,855,975,64771,11.464839344,8.7269672622,10.422581222,-56,2.8778769046,2.7378720823,13.300458127
41,53,2003,774,557,846,2148,161,217,1007,1179,65950,11.842014672,8.5219666312,12.943597433,-45,2.46326145,3.3200480412,15.406858883
41,53,2004,839,577,1479,2422,151,262,1630,1807,67757,12.549829104,8.630812149,22.123000292,-85,2.2586700771,3.919016955,24.381670369
41,53,2005,776,550,1975,2452,159,226,2134,2323,70080,11.259676284,7.9804406654,28.657036935,-37,2.3070728469,3.2792356189,30.964109782
41,53,2006,871,517,2094,2309,157,354,2251,2557,72637,12.205974061,7.2451074504,29.344787236,-48,2.2001583553,4.9608666101,31.544945592
41,53,2007,825,535,2011,2309,138,290,2149,2371,75008,11.175454638,7.2471130076,27.241017305,-68,1.8693487758,3.9283416303,29.110366081
41,53,2008,974,578,1655,2309,137,396,1792,2066,77074,12.80887942,7.6011625307,21.764574374,-122,1.801659631,5.2077168896,23.566234005
41,55,2001,13,16,-77,0,4,-3,-73,-76,1845,6.9038767924,8.497079129,-40.89219331,0,2.1242697823,-1.593202337,-38.76792353
41,55,2002,12,20,-84,0,4,-8,-80,-88,1757,6.6629650194,11.104941699,-46.64075514,0,2.2209883398,-4.44197668,-44.4197668
41,55,2003,19,14,-17,0,3,5,-14,-10,1747,10.844748858,7.9908675799,-9.703196347,-1,1.7123287671,2.8538812785,-7.99086758
41,55,2004,15,17,-75,0,2,-2,-73,-79,1668,8.78477306,9.9560761347,-43.9238653,-4,1.1713030747,-1.171303075,-42.75256223
41,55,2005,13,19,-5,0,3,-6,-2,-9,1659,7.8148482116,11.421701232,-3.005710851,-1,1.8034265104,-3.606853021,-1.20228434
41,55,2006,13,18,-14,0,2,-5,-12,-18,1641,7.8787878788,10.909090909,-8.484848485,-1,1.2121212121,-3.03030303,-7.272727273
41,55,2007,20,10,15,0,2,10,17,23,1664,12.102874433,6.0514372163,9.0771558245,-4,1.2102874433,6.0514372163,10.287443268
41,55,2008,21,7,-33,0,1,14,-32,-26,1638,12.719563901,4.2398546336,-19.98788613,-8,0.6056935191,8.4797092671,-19.38219261
41,57,2001,232,262,79,469,55,-30,134,79,24332,9.5502727179,10.785221776,3.2520325203,-25,2.2640732736,-1.234949058,5.516105794
41,57,2002,234,296,53,475,51,-62,104,18,24350,9.6134094737,12.160552155,2.1773961629,-24,2.0952302699,-2.547142681,4.2726264328
41,57,2003,249,285,151,500,43,-36,194,136,24486,10.197395364,11.671717585,6.1839626505,-22,1.7609959866,-1.474322221,7.9449586371
41,57,2004,260,284,177,509,48,-24,225,180,24666,10.579427083,11.555989583,7.2021484375,-21,1.953125,-0.9765625,9.1552734375
41,57,2005,277,296,158,509,47,-19,205,166,24832,11.192371409,11.960079195,6.3840963271,-20,1.899066629,-0.767707786,8.2831629561
41,57,2006,283,312,123,517,49,-29,172,130,24962,11.366831345,12.531630317,4.9403542595,-13,1.9681086075,-1.164798972,6.908462867
41,57,2007,275,261,-39,517,44,14,5,-4,24958,11.017628205,10.456730769,-1.5625,-23,1.7628205128,0.5608974359,0.2003205128
41,57,2008,285,271,-63,517,44,14,-19,-31,24927,11.426280445,10.864989476,-2.525809362,-26,1.7640573319,0.5612909692,-0.76175203
41,59,2001,1082,568,-878,3277,215,514,-663,-197,70501,15.325887577,8.0453827577,-12.4363487,-48,3.0453473467,7.2805048194,-9.391001353
41,59,2002,1048,637,751,3962,206,411,957,1319,71820,14.72727145,8.9515953373,10.55360769,-49,2.8948644262,5.7756761125,13.448472116
41,59,2003,1052,589,-49,4019,171,463,122,475,72295,14.599451827,8.1740276862,-0.68001249,-110,2.3731048121,6.4254241404,1.6930923221
41,59,2004,1124,650,-102,4197,155,474,53,477,72772,15.496287922,8.9613764674,-1.406246769,-50,2.1369436192,6.5349114547,0.7306968504
41,59,2005,1061,602,-408,4293,164,459,-244,146,72918,14.565172627,8.2641224518,-5.600933489,-69,2.2513556181,6.301050175,-3.349577871
41,59,2006,1098,514,-635,4347,160,584,-475,76,72994,15.050167224,7.0453423982,-8.703876309,-33,2.193102692,8.0048248259,-6.510773617
41,59,2007,1095,447,-535,4347,144,648,-391,243,73237,14.976304614,6.1136147602,-7.317189926,-14,1.9694866342,8.8626898537,-5.347703291
41,59,2008,1065,515,-408,4347,144,550,-264,289,73526,14.513194743,7.0181176455,-5.559984465,3,1.9623474581,7.4950770971,-3.597637007
41,61,2001,283,251,-245,689,32,32,-213,-199,24347,11.576299266,10.26731843,-10.02188452,-18,1.3089808357,1.3089808357,-8.712903688
41,61,2002,319,261,60,735,30,58,90,120,24467,13.070020896,10.69365346,2.4583111402,-28,1.2291555701,2.3763674356,3.6874667104
41,61,2003,300,230,-53,659,21,70,-32,6,24473,12.259910094,9.3992644054,-2.16591745,-32,0.8581937066,2.8606456886,-1.307723743
41,61,2004,285,235,-192,654,28,50,-164,-136,24337,11.677934849,9.6291743495,-7.86724032,-22,1.1473058799,2.0487604999,-6.71993444
41,61,2005,320,254,42,654,26,66,68,112,24449,13.118517608,10.412823351,1.721805436,-22,1.0658795556,2.7056942565,2.7876849916
41,61,2006,324,235,-119,654,28,89,-91,-13,24436,13.255599877,9.6144011455,-4.868569091,-11,1.1455456684,3.6411987317,-3.723023422
41,61,2007,325,215,159,654,23,110,182,301,24737,13.218636243,8.7446362841,6.4669635776,9,0.9354727188,4.4739999593,7.4024362963
41,61,2008,342,226,69,654,23,116,92,224,24961,13.763129301,9.0949333977,2.7767717011,16,0.925590567,4.6681959033,3.7023622681
41,63,2001,55,70,-99,109,1,-15,-98,-117,7098,7.6853210368,9.7813176832,-13.83357787,-4,0.1397331098,-2.095996646,-13.69384476
41,63,2002,70,80,-66,109,1,-10,-65,-79,7019,9.9171212014,11.333852802,-9.350428561,-4,0.14167316,-1.4167316,-9.208755401
41,63,2003,52,68,-24,109,1,-16,-23,-47,6972,7.4333500107,9.7205346294,-3.430776928,-8,0.1429490387,-2.287184619,-3.287827889
41,63,2004,61,75,-94,109,0,-14,-94,-116,6856,8.8226786231,10.847555684,-13.59560312,-8,0,-2.024877061,-13.59560312
41,63,2005,69,74,-26,109,1,-5,-25,-36,6820,10.090669786,10.821877742,-3.802281369,-6,0.1462415911,-0.731207956,-3.656039778
41,63,2006,70,88,-59,109,0,-18,-59,-78,6742,10.322961215,12.977436956,-8.700781596,-1,0,-2.654475741,-8.700781596
41,63,2007,50,48,9,109,1,2,10,4,6746,7.4139976275,7.1174377224,1.334519573,-8,0.1482799526,0.2965599051,1.4827995255
41,63,2008,60,64,24,109,0,-4,24,14,6760,8.8849400267,9.4772693618,3.5539760107,-6,0,-0.592329335,3.5539760107
41,65,2001,308,304,-145,527,40,4,-105,-121,23699,12.963235758,12.794882047,-6.102822029,-20,1.6835371115,0.1683537111,-4.419284918
41,65,2002,287,315,-202,527,38,-28,-164,-208,23491,12.163593982,13.350286078,-8.561135834,-16,1.6105107014,-1.186692096,-6.950625132
41,65,2003,278,272,72,527,27,6,99,69,23560,11.81696457,11.56192217,3.0605088096,-36,1.1476908036,0.2550424008,4.2081996132
41,65,2004,259,265,-167,527,27,-6,-140,-167,23393,11.032308905,11.287883628,-7.113496475,-21,1.1500862565,-0.255574724,-5.963410219
41,65,2005,282,281,-2,527,28,1,26,8,23401,12.052827286,12.010086763,-0.085481045,-19,1.1967346241,0.0427405223,1.1112535795
41,65,2006,294,254,94,527,28,40,122,151,23552,12.523161459,10.819329968,4.004004004,-11,1.1926820437,1.7038314911,5.1966860477
41,65,2007,293,288,123,527,25,5,148,153,23705,12.400279324,12.188670462,5.2055780096,0,1.0580443109,0.2116088622,6.2636223205
41,65,2008,303,262,-5,527,24,41,19,70,23775,12.763268745,11.036225779,-0.210614996,10,1.0109519798,1.7270429655,0.800336984
41,67,2001,7609,2668,6061,4130,3315,4941,9376,13972,462481,16.704903457,5.8573639667,13.306402924,-345,7.2777966827,10.84753949,20.584199607
41,67,2002,7491,2754,1864,4161,3108,4737,4972,9243,471724,16.03716529,5.8959222012,3.9905588174,-466,6.6537858393,10.141243089,10.644344657
41,67,2003,7772,2773,-105,4197,2717,4999,2612,6906,478630,16.356010497,5.8357201632,-0.220970291,-705,5.7178693413,10.520290334,5.4968990502
41,67,2004,7532,2748,455,4197,2482,4784,2937,7406,486036,15.61576753,5.6973087058,0.9433316816,-315,5.1458224919,9.9184588241,6.0891541736
41,67,2005,7615,2840,5145,4268,2604,4775,7749,12115,498151,15.474701454,5.7712609494,10.455330135,-409,5.291677293,9.7034405047,15.747007428
41,67,2006,7561,2735,5643,4338,2595,4826,8238,12776,510927,14.985957478,5.4207900678,11.184467405,-288,5.1433090405,9.5651674102,16.327776445
41,67,2007,8027,2650,1283,4338,2374,5377,3657,8867,519794,15.575504914,5.1420316458,2.4895194723,-167,4.6064841989,10.433473268,7.0960036712
41,67,2008,8010,2746,1832,4338,2377,5264,4209,9422,529216,15.271541739,5.2354124365,3.492817037,-51,4.5318919743,10.036129303,8.0247090114
41,69,2001,9,14,-43,31,1,-5,-42,-47,1496,5.9230009872,9.2135570911,-28.29878249,0,0.6581112208,-3.290556104,-27.64067127
41,69,2002,12,17,31,31,1,-5,32,27,1523,7.9496522027,11.262007287,20.536601524,0,0.6624710169,-3.312355084,21.199072541
41,69,2003,5,17,-7,31,1,-12,-6,-20,1503,3.3046926636,11.235955056,-4.626569729,-2,0.6609385327,-7.931262393,-3.965631196
41,69,2004,8,17,-35,31,0,-9,-35,-46,1457,5.4054054054,11.486486486,-23.64864865,-2,0,-6.081081081,-23.64864865
41,69,2005,6,26,-42,31,1,-20,-41,-61,1396,4.2060988433,18.226428321,-29.4426919,0,0.7010164739,-14.02032948,-28.74167543
41,69,2006,8,17,-14,31,0,-9,-14,-23,1373,5.7782592994,12.278801011,-10.11195377,0,0,-6.500541712,-10.11195377
41,69,2007,6,20,4,31,1,-14,5,-16,1357,4.3956043956,14.652014652,2.9304029304,-7,0.7326007326,-10.25641026,3.663003663
41,69,2008,6,8,-21,31,0,-2,-21,-38,1319,4.4843049327,5.9790732436,-15.69506726,-15,0,-1.494768311,-15.69506726
41,71,2001,1176,675,282,5073,335,501,617,1033,86280,13.712126954,7.8704810321,3.2881120756,-85,3.9060905863,5.8416459216,7.194202662
41,71,2002,1194,712,537,5004,316,482,853,1253,87533,13.738903304,8.1927128581,6.1790545011,-82,3.6360916617,5.5461904461,9.8151461628
41,71,2003,1184,654,564,4967,278,530,842,1260,88793,13.429670043,7.4180778785,6.3972414732,-112,3.1532502297,6.0115921645,9.5504917029
41,71,2004,1119,739,320,4985,256,380,576,898,89691,12.538939065,8.2808543063,3.5857555859,-58,2.8686044687,4.2580847583,6.4543600547
41,71,2005,1154,785,916,5071,268,369,1184,1485,91176,12.760757905,8.6804115731,10.12898981,-68,2.9635035689,4.0803463318,13.092493379
41,71,2006,1203,792,1673,5100,269,411,1942,2298,93474,13.030056864,8.5783915516,18.120769022,-55,2.9136203628,4.4516653128,21.034389385
41,71,2007,1382,754,1972,5100,244,628,2216,2825,96299,14.564769488,7.9463358855,20.782724624,-19,2.5714933104,6.6184336023,23.354217934
41,71,2008,1406,744,994,5100,244,662,1238,1869,98168,14.460036921,7.6516838332,10.222814154,-31,2.5094231926,6.8083530882,12.732237346
42,0,2001,145534,131207,-24247,437926,19109,14327,-5138,-519,12284522,11.846690151,10.680450442,-1.973742879,-9708,1.5555018215,1.1662397089,-0.418241057
42,0,2002,141883,129467,-6556,443914,17651,12416,11095,14253,12298775,11.543040789,10.532924042,-0.53337028,-9258,1.4360156817,1.0101167472,0.9026454019
42,0,2003,143959,128895,1211,448833,14745,15064,15956,18872,12317647,11.696175829,10.472277409,0.0983896035,-12148,1.1979807626,1.2238984203,1.2963703661
42,0,2004,145837,130135,-3061,450467,14952,15702,11891,18005,12335652,11.831033242,10.55720778,-0.248323764,-9588,1.2129816784,1.2738254625,0.9646579145
42,0,2005,144482,129360,-3334,455819,15049,15122,11715,16229,12351881,11.70485524,10.47978346,-0.270095841,-10608,1.219157864,1.2250717802,0.9490620225
42,0,2006,146959,125731,3312,466234,17177,21228,20489,36174,12388055,11.880305592,10.164213844,0.2677452359,-5543,1.3886050473,1.7160917474,1.6563502832
42,0,2007,148212,126740,-5056,469969,14951,21472,9895,31875,12419930,11.948733442,10.217677897,-0.407610695,508,1.2053377169,1.7310555452,0.7977270222
42,0,2008,148925,126816,-11462,469969,15016,22109,3554,28349,12448279,11.977139166,10.199045697,-0.921819501,2686,1.2076462764,1.7780934687,0.2858267759
42,1,2001,1080,789,835,3713,143,291,978,1183,92768,11.716652292,8.5596654245,9.0587080221,-86,1.5513715535,3.1569868676,10.610079576
42,1,2002,1071,916,1150,3824,131,155,1281,1369,94137,11.460367566,9.8017709532,12.305716808,-67,1.4017816538,1.6585966133,13.707498462
42,1,2003,1021,901,1361,3804,107,120,1468,1544,95681,10.75767314,9.4933041124,14.34005205,-44,1.1273957159,1.2643690272,15.467447766
42,1,2004,1055,874,1630,3899,111,181,1741,1810,97491,10.922908082,9.0489304868,16.876151823,-112,1.1492348788,1.8739775951,18.025386702
42,1,2005,1109,928,1078,3955,114,181,1192,1287,98778,11.300816736,9.4564093158,10.984923753,-86,1.161670972,1.8444074204,12.146594725
42,1,2006,1083,869,796,3977,118,214,914,1080,99858,10.904367788,8.7496727683,8.0146599811,-48,1.1881028615,2.15469502,9.2027628426
42,1,2007,1133,937,373,3958,101,196,474,661,100519,11.308683132,9.3523707811,3.7229821786,-9,1.008099732,1.9563123512,4.7310819106
42,1,2008,1133,941,280,3958,101,192,381,600,101119,11.237961099,9.3335581587,2.7772542874,27,1.0017952965,1.9044029399,3.7790495839
42,3,2001,14157,15287,-7195,40800,2158,-1130,-5037,-7338,1272576,11.092697719,11.978107652,-5.637632273,-1171,1.6908979075,-0.885409933,-3.946734365
42,3,2002,13532,15380,-6115,40935,1982,-1848,-4133,-7107,1265469,10.663325512,12.119564468,-4.818669488,-1126,1.56183204,-1.456238956,-3.256837448
42,3,2003,13663,15063,-7034,41389,1684,-1400,-5350,-8170,1257299,10.831753059,11.94164505,-5.576414478,-1420,1.33504151,-1.109891992,-4.241372968
42,3,2004,13515,15070,-10297,40292,1632,-1555,-8665,-11295,1246004,10.797734034,12.04009263,-8.226730843,-1075,1.3038773173,-1.242358596,-6.922853526
42,3,2005,12998,14914,-12153,40688,1683,-1916,-10470,-13417,1232587,10.488216894,12.034256559,-9.806377898,-1031,1.3580296225,-1.546039665,-8.448348275
42,3,2006,13105,14312,-9194,41348,1733,-1207,-7461,-9208,1223379,10.671971843,11.654884473,-7.487074332,-540,1.411257322,-0.98291263,-6.07581701
42,3,2007,12867,14180,-4975,42190,1528,-1313,-3447,-4950,1218429,10.53891215,11.614344781,-4.074849456,-190,1.251531652,-1.07543263,-2.823317804
42,3,2008,12942,14206,-3601,42190,1537,-1264,-2064,-3326,1215103,10.636391878,11.675211175,-2.959484404,2,1.26318454,-1.038819296,-1.696299864
42,5,2001,722,869,-307,1085,5,-147,-302,-512,71803,10.019567299,12.059562303,-4.26039773,-63,0.0693875852,-2.039995004,-4.191010144
42,5,2002,677,865,-86,1085,3,-188,-83,-336,71467,9.4506875131,12.075102952,-1.200530467,-65,0.0418789698,-2.624415439,-1.158651497
42,5,2003,699,875,2,1085,-6,-176,-4,-279,71188,9.7998668115,12.267358312,0.0280396761,-99,-0.084119028,-2.4674915,-0.056079352
42,5,2004,738,859,-220,1085,2,-121,-218,-387,70801,10.395171457,12.099528837,-3.0988316,-48,0.0281711964,-1.70435738,-3.070660403
42,5,2005,680,866,-711,1085,-1,-186,-712,-962,69839,9.6700796359,12.31513083,-10.1109215,-64,-0.014220705,-2.645051195,-10.12514221
42,5,2006,723,823,-444,1085,1,-100,-443,-571,69268,10.394875887,11.832618057,-6.383575233,-28,0.0143774217,-1.43774217,-6.369197812
42,5,2007,694,856,-125,1085,-1,-162,-126,-264,69004,10.038185605,12.381393196,-1.808030548,24,-0.014464244,-2.343207591,-1.822494793
42,5,2008,700,859,-111,1085,-1,-159,-112,-214,68790,10.160094053,12.467886846,-1.611100628,57,-0.01451442,-2.307792792,-1.625615049
42,7,2001,1805,2131,-1086,4364,44,-326,-1042,-1522,179593,10.008095191,11.815651441,-6.021491068,-154,0.2439646473,-1.80755625,-5.77752642
42,7,2002,1819,2209,-491,4363,37,-390,-454,-994,178599,10.156564077,12.334167151,-2.741546433,-150,0.2065931121,-2.177603073,-2.534953321
42,7,2003,1801,2111,-195,4328,20,-310,-175,-728,177871,10.104637136,11.843913934,-1.094061211,-243,0.1122114063,-1.739276797,-0.981849805
42,7,2004,1797,2158,-562,4291,45,-361,-517,-1008,176863,10.131535178,12.166863058,-3.16857138,-130,0.2537112315,-2.035327879,-2.914860149
42,7,2005,1743,2069,-1068,4272,35,-326,-1033,-1508,175355,9.8972795257,11.748405817,-6.064426009,-149,0.1987405527,-1.851126291,-5.865685456
42,7,2006,1789,2058,-1105,4292,46,-269,-1059,-1405,173950,10.243197206,11.783398463,-6.326849029,-77,0.2633801406,-1.540201257,-6.063468888
42,7,2007,1779,2168,-585,4335,36,-389,-549,-927,173023,10.254400198,12.496649595,-3.372020301,11,0.2075089416,-2.242249397,-3.16451136
42,7,2008,1772,2091,-288,4335,37,-319,-251,-547,172476,10.257627374,12.10423185,-1.667153885,23,0.2141829644,-1.846604476,-1.45297092
42,9,2001,552,498,-190,468,6,54,-184,-179,49844,11.054702755,9.9732644417,-3.805060731,-49,0.1201598126,1.081438313,-3.684900918
42,9,2002,553,473,-111,468,5,80,-106,-74,49770,11.102857028,9.4966570964,-2.228602405,-48,0.1003874957,1.6061999317,-2.12821491
42,9,2003,535,498,32,468,1,37,33,0,49770,10.749447458,10.006027728,0.642957605,-70,0.0200924252,0.7434197308,0.6630500301
42,9,2004,536,501,-25,468,2,35,-23,-23,49747,10.7720289,10.06863149,-0.502426721,-35,0.0401941377,0.7033974095,-0.462232583
42,9,2005,496,494,-157,468,2,2,-155,-195,49552,9.9900301111,9.9497477316,-3.162166789,-42,0.0402823795,0.0402823795,-3.12188441
42,9,2006,523,492,70,468,2,31,72,79,49631,10.546162145,9.9210550195,1.4115322182,-24,0.0403294919,0.6251071252,1.4518617102
42,9,2007,500,503,-60,468,2,-3,-58,-71,49560,10.081559819,10.142049178,-1.209787178,-10,0.0403262393,-0.060489359,-1.169460939
42,9,2008,528,501,157,468,1,27,158,167,49727,10.635833493,10.091955644,3.1625489742,-18,0.020143624,0.5438778491,3.1826925982
42,11,2001,4704,3712,1280,12515,633,992,1913,2571,377068,12.517879358,9.8780544597,3.4062256758,-334,1.6844850412,2.6398248987,5.090710717
42,11,2002,4668,3571,1989,12586,599,1097,2588,3379,380447,12.324508426,9.4281961413,5.2513811608,-306,1.5814868352,2.8963122842,6.832867996
42,11,2003,4738,3655,2579,13184,531,1083,3110,3838,384285,12.391269098,9.5589042959,6.7448465606,-355,1.3887218006,2.8323648023,8.1335683612
42,11,2004,5018,3575,2929,13397,525,1443,3454,4550,388835,12.981167219,9.248240894,7.5770902318,-347,1.3581332781,3.7329263245,8.9352235099
42,11,2005,4999,3606,2931,13882,531,1393,3462,4470,393305,12.782877746,9.2208556013,7.4948218989,-385,1.3578131792,3.5620221444,8.8526350781
42,11,2006,5060,3468,2890,14156,761,1592,3651,5048,398353,12.783297838,8.7613590717,7.3011325598,-195,1.9225473626,4.0219387665,9.2236799224
42,11,2007,5244,3640,767,14186,656,1604,1423,3126,401479,13.112753678,9.1019114014,1.9179027596,99,1.6403444723,4.0108422769,3.5582472319
42,11,2008,5322,3612,-462,14186,657,1710,195,2116,403595,13.221144889,8.9730881882,-1.147720582,211,1.6321481007,4.2480567004,0.4844275185
42,13,2001,1485,1660,-437,4090,28,-175,-409,-697,128335,11.539941018,12.899866727,-3.395928771,-113,0.2175881135,-1.359925709,-3.178340658
42,13,2002,1413,1683,-646,4073,24,-270,-622,-994,127341,11.053051518,13.165099579,-5.053270546,-102,0.1877376054,-2.112048061,-4.86553294
42,13,2003,1483,1603,-236,4073,13,-120,-223,-504,126837,11.668987875,12.613208067,-1.856966378,-161,0.1022905208,-0.944220192,-1.754675857
42,13,2004,1441,1591,-100,4078,28,-150,-72,-308,126529,11.374849033,12.558906878,-0.789371897,-86,0.2210241311,-1.184057845,-0.568347766
42,13,2005,1449,1656,-341,4073,22,-207,-319,-647,125882,11.481274588,13.121456672,-2.701942467,-121,0.1743188688,-1.640182084,-2.527623598
42,13,2006,1426,1578,-172,4071,27,-152,-145,-353,125529,11.343974607,12.553150021,-1.368277442,-56,0.214787738,-1.209175414,-1.153489704
42,13,2007,1448,1587,-101,4064,19,-139,-82,-187,125342,11.543781465,12.651920708,-0.805194702,34,0.1514722706,-1.108139243,-0.653722431
42,13,2008,1488,1553,-201,4064,19,-65,-182,-168,125174,11.879480752,12.398409682,-1.604687924,79,0.1516869182,-0.518928931,-1.453001006
42,15,2001,691,644,-255,1040,7,47,-248,-260,62501,11.032875094,10.282447989,-4.071466207,-59,0.111765739,0.7504271048,-3.959700468
42,15,2002,744,645,-220,1040,6,99,-214,-166,62335,11.919638566,10.333557628,-3.524624307,-51,0.0961261175,1.5860809382,-3.42849819
42,15,2003,716,660,-363,1040,1,56,-362,-370,61965,11.520514883,10.619469027,-5.840707965,-64,0.0160901046,0.9010458568,-5.82461786
42,15,2004,729,716,-118,1040,7,13,-111,-144,61821,11.778391741,11.568351833,-1.906516084,-46,0.1130984118,0.2100399076,-1.793417672
42,15,2005,778,652,-125,1040,4,126,-121,-54,61767,12.590219115,10.551186199,-2.022850115,-59,0.0647312037,2.0390329158,-1.958118911
42,15,2006,690,671,-254,1040,6,19,-248,-254,61513,11.194029851,10.885788449,-4.120700844,-25,0.09733939,0.3082414017,-4.023361454
42,15,2007,778,665,-240,1040,4,113,-236,-99,61414,12.657918927,10.819429417,-3.904756481,24,0.0650792747,1.83848951,-3.839677207
42,15,2008,752,677,-303,1040,4,75,-299,-181,61233,12.262835618,11.039813448,-4.941009564,43,0.065227849,1.2230221693,-4.875781715
42,17,2001,7255,5013,1172,9091,1019,2242,2191,3791,603199,12.065454467,8.3368881106,1.9490989159,-642,1.6946517025,3.7285663563,3.6437506184
42,17,2002,6966,5002,1897,9040,905,1964,2802,4176,607375,11.50859014,8.2638483893,3.1340504587,-590,1.4951584951,3.2447417506,4.6292089538
42,17,2003,7016,5038,862,9072,727,1978,1589,2651,610026,11.526193916,8.2766483681,1.4161315787,-916,1.1943476307,3.2495455483,2.6104792094
42,17,2004,6974,5148,1323,9132,794,1826,2117,3540,613566,11.399224578,8.4145695624,2.1624855344,-403,1.297818227,2.9846550157,3.4603037614
42,17,2005,6839,5201,445,9239,773,1638,1218,2287,615853,11.125580457,8.4609071439,0.7239191846,-569,1.2575045611,2.6646733132,1.9814237457
42,17,2006,6893,5021,199,9323,834,1872,1033,2613,618466,11.168911764,8.1356602305,0.3224450081,-292,1.3513524462,3.0332515338,1.6737974543
42,17,2007,6896,5146,-1004,9352,727,1750,-277,1597,620063,11.135790926,8.309857904,-1.621278145,124,1.1739733183,2.8259330222,-0.447304827
42,17,2008,6879,5339,-1061,9352,736,1540,-325,1580,621643,11.079917468,8.5994591312,-1.708939153,365,1.1854658027,2.4804583372,-0.52347335
42,19,2001,2106,1763,1068,6372,76,343,1144,1312,175831,12.022263451,10.064221493,6.0967603825,-175,0.4338518624,1.958041958,6.5306122449
42,19,2002,2078,1681,1342,6377,72,397,1414,1641,177472,11.763274017,9.5159112716,7.5968786,-170,0.4075821604,2.2473627453,8.0044607603
42,19,2003,2041,1751,1022,6483,57,290,1079,1145,178617,11.463426278,9.8346199967,5.7401379992,-224,0.3201446829,1.6288062816,6.0602826821
42,19,2004,2114,1886,549,6526,66,228,615,726,179343,11.811375573,10.537490222,3.0673818304,-117,0.3687562856,1.2738853503,3.436138116
42,19,2005,1993,1845,592,6506,62,148,654,647,179990,11.092774669,10.269026224,3.2949937801,-155,0.3450838081,0.823748445,3.6400775882
42,19,2006,2087,1670,686,6506,66,417,752,1080,181070,11.560405473,9.2505400764,3.7999224506,-89,0.3655902066,2.3098653963,4.1655126572
42,19,2007,1995,1809,433,6586,60,186,493,664,181734,10.997673675,9.9723266557,2.38696376,-15,0.330757103,1.0253470193,2.7177208631
42,19,2008,2082,1766,749,6586,60,316,809,1168,182902,11.419607499,9.6863721629,4.1082065402,43,0.329095317,1.7332353361,4.4373018572
42,21,2001,1524,2030,-642,8732,46,-506,-596,-1241,150968,10.053533085,13.391517167,-4.235149764,-139,0.3034530984,-3.337984082,-3.931696666
42,21,2002,1509,1915,-639,8781,41,-406,-598,-1135,149833,10.033211326,12.732670437,-4.248656088,-131,0.2726054767,-2.699459111,-3.976050612
42,21,2003,1439,1910,-481,8844,25,-471,-456,-1123,148710,9.6401523399,12.795476698,-3.222316383,-196,0.1674800615,-3.155324359,-3.054836322
42,21,2004,1529,1869,-579,9110,45,-340,-534,-982,147728,10.315816461,12.609719402,-3.906381773,-108,0.303604801,-2.293902941,-3.602776972
42,21,2005,1518,1915,-474,9230,37,-397,-437,-964,146764,10.309278351,13.005446667,-3.219102726,-130,0.2512801706,-2.696168317,-2.967822555
42,21,2006,1454,1887,-387,9493,46,-433,-341,-842,145922,9.9355623433,12.894364609,-2.644472233,-68,0.3143300329,-2.958802266,-2.3301422
42,21,2007,1498,1852,-590,9686,33,-354,-557,-926,144996,10.29843461,12.732110079,-4.056125781,-15,0.2268680522,-2.433675469,-3.829257729
42,21,2008,1514,1787,-426,9686,34,-273,-392,-677,144319,10.466100963,12.353317318,-2.944887061,-12,0.2350379344,-1.887216356,-2.709849126
42,23,2001,63,68,-37,81,2,-5,-35,-46,5897,10.641891892,11.486486486,-6.25,-6,0.3378378378,-0.844594595,-5.912162162
42,23,2002,44,77,-58,81,2,-33,-56,-92,5805,7.5200820373,13.160143565,-9.912835413,-3,0.3418219108,-5.640061528,-9.571013502
42,23,2003,67,78,-54,81,2,-11,-52,-69,5736,11.610778962,13.517026254,-9.357941253,-6,0.3465904168,-1.906247292,-9.011350836
42,23,2004,50,73,-120,81,1,-23,-119,-150,5586,8.8323617735,12.895248189,-21.19766826,-8,0.1766472355,-4.062886416,-21.02102102
42,23,2005,52,83,-64,81,2,-31,-62,-98,5488,9.3913671663,14.990066823,-11.55860574,-5,0.3612064295,-5.598699657,-11.19739931
42,23,2006,48,61,-89,81,1,-13,-88,-103,5385,8.8292099696,11.220454336,-16.37082682,-2,0.1839418744,-2.391244367,-16.18688494
42,23,2007,52,73,-35,81,2,-21,-33,-51,5334,9.7023976117,13.62067357,-6.530459931,3,0.3731691389,-3.918275959,-6.157290792
42,23,2008,52,72,-53,81,1,-20,-52,-68,5266,9.8113207547,13.58490566,-10,4,0.1886792453,-3.773584906,-9.811320755
42,25,2001,594,772,578,918,16,-178,594,375,59207,10.064470217,13.080422572,9.7933733766,-41,0.2710968409,-3.015952355,10.064470217
42,25,2002,597,790,565,918,14,-193,579,349,59556,10.053636234,13.303806741,9.5147478592,-37,0.2357636638,-3.250170508,9.7505115229
42,25,2003,583,717,604,918,8,-134,612,442,59998,9.7529150008,11.994579855,10.104220687,-36,0.1338307376,-2.241664854,10.238051424
42,25,2004,648,748,810,918,14,-100,824,655,60653,10.741726136,12.399399922,13.42715767,-69,0.2320743301,-1.657673786,13.659232
42,25,2005,616,766,1086,918,12,-150,1098,888,61541,10.082328101,12.537440464,17.775013503,-60,0.196408989,-2.455112362,17.971422492
42,25,2006,623,852,802,918,16,-229,818,559,62100,10.077563268,13.781836122,12.973042923,-30,0.2588138239,-3.704272854,13.231856747
42,25,2007,655,763,1111,918,12,-108,1123,1054,63154,10.458747824,12.183243649,17.739952417,39,0.1916106472,-1.724495824,17.931563064
42,25,2008,680,758,431,918,12,-78,443,404,63558,10.733000821,11.96413915,6.8028284614,39,0.1894058968,-1.231138329,6.9922343582
42,27,2001,1272,860,-23,14685,671,412,648,925,136836,9.3273253235,6.3062105174,-0.168654467,-135,4.9203107642,3.021114806,4.7516562969
42,27,2002,1225,892,1562,16397,626,333,2188,2430,139266,8.8735322453,6.4613802146,11.314659075,-91,4.5345560699,2.4121520308,15.849215145
42,27,2003,1307,919,491,16716,542,388,1033,1237,140503,9.3434226094,6.5697057215,3.510038639,-184,3.8746251372,2.7737168879,7.3846637762
42,27,2004,1347,878,-391,16298,523,469,132,500,141003,9.5699558802,6.2378777007,-2.777915924,-101,3.715728972,3.3320781795,0.9378130484
42,27,2005,1218,868,-315,16149,530,350,215,436,141439,8.6247796008,6.146394658,-2.230546448,-129,3.7529829133,2.4783849427,1.5224364648
42,27,2006,1313,880,1426,17508,543,433,1969,2330,143769,9.2073153628,6.1709348966,9.999719503,-72,3.8077473283,3.0363804662,13.807466831
42,27,2007,1385,907,-1009,17089,497,478,-512,-1,143768,9.6335428136,6.3087533083,-7.018227219,33,3.4569464104,3.3247895054,-3.561280809
42,27,2008,1381,936,6,17089,498,445,504,1011,144779,9.5720974399,6.4876779173,0.041587679,62,3.4517773534,3.0844195226,3.4933650324
42,29,2001,5853,3377,2726,15056,1002,2476,3728,5789,441568,13.342497324,7.6982083486,6.2141889127,-415,2.2841589474,5.6442889757,8.4983478601
42,29,2002,5787,3238,3685,15274,934,2549,4619,6790,448358,13.005575745,7.2770095491,8.2815874578,-378,2.0990509323,5.7285661954,10.38063839
42,29,2003,5925,3336,3936,15376,806,2589,4742,6932,455290,13.113513226,7.383405928,8.7113566344,-399,1.783880449,5.7301072984,10.495237083
42,29,2004,6117,3290,4663,15947,751,2827,5414,7807,463097,13.321181593,7.1647355635,10.154760466,-434,1.6354761119,6.1564460298,11.790236578
42,29,2005,6109,3437,4332,16450,787,2672,5119,7376,470473,13.087395696,7.3631329199,9.2805038722,-415,1.6860010497,5.7242627762,10.966504922
42,29,2006,6241,3357,4228,16297,822,2884,5050,7688,478161,13.157866996,7.077545186,8.9138698381,-246,1.7330182136,6.0803218101,10.646888052
42,29,2007,6307,3479,3862,16649,732,2828,4594,7437,485598,13.088334324,7.2196472355,8.0144517457,15,1.5190519622,5.8686870888,9.5335037079
42,29,2008,6433,3539,2128,16649,734,2894,2862,5891,491489,13.16771178,7.2439813445,4.3558045496,135,1.5024250655,5.9237304355,5.8582296152
42,31,2001,423,409,-253,2291,7,14,-246,-266,41487,10.163382989,9.827006247,-6.078808265,-34,0.168188371,0.336376742,-5.910619894
42,31,2002,368,468,-288,2236,6,-100,-282,-415,41072,8.9148366623,11.337346625,-6.976828692,-33,0.1453505978,-2.422509963,-6.831478094
42,31,2003,404,437,57,2383,2,-33,59,-30,41042,9.8399785664,10.643739192,1.3883138076,-56,0.0487127652,-0.803760625,1.4370265728
42,31,2004,416,438,-789,1821,6,-22,-783,-853,40189,10.242395145,10.784060273,-19.42608118,-48,0.147726853,-0.541665128,-19.27835432
42,31,2005,376,444,-32,1585,4,-68,-28,-132,40057,9.3711836104,11.065972136,-0.797547541,-36,0.0996934427,-1.694788525,-0.697854099
42,31,2006,414,418,118,1681,5,-4,123,101,40158,10.322258929,10.421990899,2.9420931247,-18,0.1246649629,-0.09973197,3.0667580876
42,31,2007,419,443,-166,1674,4,-24,-162,-171,39987,10.456048412,11.05496288,-4.142491734,15,0.0998190779,-0.598914468,-4.042672656
42,31,2008,408,452,11,1674,4,-44,15,2,39989,10.203060918,11.303391017,0.2750825248,31,0.100030009,-1.100330099,0.3751125338
42,33,2001,820,922,-223,3459,14,-102,-209,-388,82981,9.85873159,11.085061617,-2.681094079,-77,0.1683198076,-1.226330027,-2.512774271
42,33,2002,799,900,162,3653,13,-101,175,-2,82979,9.6288262232,10.845986985,1.9522776573,-76,0.1566642564,-1.217160762,2.1089419137
42,33,2003,794,934,-237,3817,7,-140,-230,-481,82498,9.5964998157,11.288577869,-2.864446419,-111,0.0846039027,-1.692078053,-2.779842516
42,33,2004,827,914,-180,3782,14,-87,-166,-311,82187,10.043416219,11.099978747,-2.185991438,-58,0.1700215563,-1.056562528,-2.015969882
42,33,2005,820,927,-5,3747,11,-107,6,-183,82004,9.9883672065,11.291727318,-0.060904678,-82,0.1339902918,-1.303360111,0.0730856137
42,33,2006,790,911,879,4753,13,-121,892,732,82736,9.5908704625,11.059851888,10.671360932,-39,0.1578244506,-1.468981425,10.829185383
42,33,2007,790,959,399,5492,7,-169,406,269,83005,9.532945982,11.572272401,4.8147410719,32,0.0844691416,-2.039326419,4.8992102135
42,33,2008,797,924,-33,5492,7,-127,-26,-109,82896,9.6081397942,11.139173362,-0.39782762,44,0.084387677,-1.531033568,-0.313439943
42,35,2001,440,437,-188,2259,14,3,-174,-205,37712,11.635748192,11.556413545,-4.971637864,-34,0.3702283516,0.0793346468,-4.601409512
42,35,2002,409,392,-178,2246,12,17,-166,-182,37530,10.871587677,10.419712395,-4.731400016,-33,0.3189707876,0.4518752824,-4.412429228
42,35,2003,417,396,-109,2307,8,21,-101,-134,37396,11.130982569,10.57042949,-2.90953741,-54,0.2135440301,0.560553079,-2.69599338
42,35,2004,418,422,-132,2125,12,-4,-120,-154,37242,11.200728851,11.307912859,-3.537072269,-30,0.3215520244,-0.107184008,-3.215520244
42,35,2005,433,440,-23,2039,10,-7,-13,-56,37186,11.63540603,11.823507282,-0.618046972,-36,0.2687160746,-0.188101252,-0.349330897
42,35,2006,453,401,28,2072,13,52,41,75,37261,12.169731487,10.772764517,0.7522129837,-18,0.3492417424,1.3969669698,1.1014547262
42,35,2007,421,380,-200,2008,8,41,-192,-151,37110,11.321617297,10.21903699,-5.378440521,0,0.2151376208,1.1025803068,-5.1633029
42,35,2008,446,403,-134,2008,8,43,-126,-72,37038,12.029994066,10.870151589,-3.614392836,11,0.2157846469,1.1598424772,-3.398608189
42,37,2001,582,632,243,3939,19,-50,262,149,64256,9.0680336234,9.8470743127,3.78613775,-63,0.2960354619,-0.779040689,4.0821732119
42,37,2002,601,626,147,4126,18,-25,165,83,64339,9.3471752401,9.7359928458,2.2862475213,-57,0.2799486761,-0.388817606,2.5661961974
42,37,2003,639,693,248,4240,14,-54,262,138,64477,9.9211278102,10.759532977,3.8504533598,-70,0.2173643026,-0.838405167,4.0678176624
42,37,2004,617,742,261,4240,19,-125,280,105,64582,9.5615183753,11.498616912,4.0446617439,-50,0.2944389775,-1.937098536,4.3391007214
42,37,2005,632,655,21,4240,17,-23,38,-46,64536,9.7894948807,10.145758144,0.3252838489,-61,0.2633250205,-0.356263263,0.5886088694
42,37,2006,654,662,89,4041,22,-8,111,73,64609,10.128150528,10.252042278,1.3782957141,-30,0.3407023114,-0.12389175,1.7189980255
42,37,2007,656,670,194,4181,20,-14,214,209,64818,10.136988418,10.353326586,2.997828892,9,0.3090545249,-0.216338167,3.3068834169
42,37,2008,653,697,188,4181,20,-44,208,186,65004,10.059928209,10.737779421,2.8962733589,22,0.3081141871,-0.677851212,3.204387546
42,39,2001,1092,943,-311,3746,11,149,-300,-233,90106,12.103411012,10.451938264,-3.447033722,-82,0.1219208069,1.6514727479,-3.325112915
42,39,2002,1066,975,-179,3909,10,91,-169,-165,89941,11.841352536,10.830505368,-1.988369703,-87,0.1110821063,1.0108471677,-1.877287597
42,39,2003,1018,929,-316,3862,1,89,-315,-333,89608,11.339522916,10.348150087,-3.519930493,-107,0.0111390205,0.9913728286,-3.508791472
42,39,2004,1009,919,-266,3997,8,90,-258,-233,89375,11.274813809,10.269131705,-2.972349329,-65,0.0893939648,1.0056821039,-2.882955364
42,39,2005,1046,950,-356,4138,5,96,-351,-340,89035,11.725800123,10.649627263,-3.99080769,-85,0.0560506698,1.0761728603,-3.93475702
42,39,2006,1033,904,-297,4204,8,129,-289,-199,88836,11.615159301,10.164669901,-3.33949885,-39,0.089952831,1.4504893996,-3.249546019
42,39,2007,1023,965,-179,4367,3,58,-176,-101,88735,11.522151703,10.86889188,-2.01609497,17,0.0337893012,0.6532598228,-1.982305669
42,39,2008,1055,929,-482,4367,3,126,-479,-324,88411,11.911078997,10.488523591,-5.441838935,29,0.0338703668,1.4225554063,-5.407968568
42,41,2001,2228,2029,758,13985,318,199,1076,1068,215055,10.385929583,9.4582814736,3.5334536013,-207,1.4823723552,0.927648109,5.0158259564
42,41,2002,2221,1974,1812,14328,246,247,2058,2126,217181,10.276793233,9.1338990737,8.3843085722,-179,1.1382670578,1.1428941597,9.52257563
42,41,2003,2201,2050,1796,14488,122,151,1918,1869,219050,10.090983905,9.3986901435,8.2341695111,-200,0.5593366817,0.6922937618,8.7935061928
42,41,2004,2304,2078,1254,14338,303,226,1557,1611,220661,10.479610471,9.4516625693,5.7037463243,-172,1.3781779396,1.0279479021,7.0819242639
42,41,2005,2359,2147,1616,14681,237,212,1853,1877,222538,10.645330878,9.6886500195,7.2924352266,-188,1.069496998,0.9566808589,8.3619322246
42,41,2006,2384,2036,2427,14739,290,348,2717,2950,225488,10.642239513,9.0887582417,10.834192658,-115,1.294567726,1.5534812712,12.128760384
42,41,2007,2434,2158,1231,14328,224,276,1455,1715,227203,10.753472015,9.5340972098,5.4385883528,-16,0.9896375232,1.2193748053,6.4282258759
42,41,2008,2472,2091,1489,14328,236,381,1725,2158,229361,10.828711856,9.1597234999,6.5226342857,52,1.0338090607,1.6689883565,7.5564433464
42,43,2001,3184,2465,-1235,6721,470,719,-765,-263,251534,12.651714279,9.7947473929,-4.907307517,-217,1.8675583264,2.8569668866,-3.039749191
42,43,2002,3178,2454,-28,6636,434,724,406,884,252418,12.612312284,9.7390227641,-0.111121694,-246,1.722386259,2.8732895196,1.6112645649
42,43,2003,3079,2390,-445,6635,354,689,-91,236,252654,12.192321095,9.4639972123,-1.762125004,-362,1.4017803402,2.7283238825,-0.360344664
42,43,2004,3240,2519,-1243,6616,387,721,-856,-325,252329,12.832115141,9.9765734688,-4.922938,-190,1.532724864,2.8555416717,-3.390213136
42,43,2005,3365,2491,-643,6562,382,874,-261,392,252721,13.325413325,9.8643698644,-2.546282546,-221,1.5127215127,3.461043461,-1.033561034
42,43,2006,3325,2352,-222,6401,468,973,246,1090,253811,13.128489414,9.2866788278,-0.876548767,-129,1.8478595627,3.8418105865,0.9713107958
42,43,2007,3465,2370,364,6401,399,1095,763,1781,255592,13.604160164,9.3050099823,1.429123896,-77,1.5665396552,4.2991501817,2.9956635513
42,43,2008,3383,2379,-360,6401,403,1004,43,970,256562,13.210870168,9.2901744397,-1.405827154,-77,1.5737453969,3.9206957282,0.1679182433
42,45,2001,6914,5902,-1235,23337,1265,1012,30,513,552554,12.51861542,10.686269628,-2.236113689,-529,2.2904322399,1.8323457919,0.0543185511
42,45,2002,6560,5648,-1761,23576,1189,912,-572,-189,552365,11.874173582,10.22337384,-3.187563975,-529,2.1521939617,1.6507997419,-1.035370014
42,45,2003,6792,5759,-1664,23849,1040,1033,-624,-328,552037,12.299869069,10.429173435,-3.013395485,-737,1.8833721779,1.8706956344,-1.130023307
42,45,2004,6806,5701,-2463,24039,963,1105,-1500,-800,551237,12.337823605,10.334694736,-4.464892674,-405,1.7457132136,2.0031288692,-2.71917946
42,45,2005,6806,5499,-1573,24105,1003,1307,-570,242,551479,12.344066831,9.9735562012,-2.852955793,-495,1.8191447299,2.3705106301,-1.033811063
42,45,2006,7012,5549,-788,24751,1033,1463,245,1443,552922,12.69828622,10.048886229,-1.427017904,-265,1.8706973282,2.6493999915,0.4436794244
42,45,2007,6802,5616,-1861,24440,922,1186,-939,240,553162,12.299246712,10.154744124,-3.365024718,-7,1.667142821,2.1445025875,-1.697881897
42,45,2008,6762,5460,-1828,24440,924,1302,-904,457,553619,12.21921952,9.8664505444,-3.303273186,59,1.6697070152,2.352768976,-1.633566171
42,47,2001,389,385,-258,466,8,4,-250,-276,34760,11.146770589,11.03215084,-7.392973809,-30,0.229239498,0.114619749,-7.163734311
42,47,2002,348,356,-372,466,8,-8,-364,-393,34367,10.068424783,10.299882824,-10.76279891,-21,0.231458041,-0.231458041,-10.53134087
42,47,2003,308,384,-206,466,5,-76,-201,-315,34052,9.0033470235,11.224952133,-6.021719113,-38,0.1461582309,-2.22160511,-5.875560882
42,47,2004,316,396,-231,466,4,-80,-227,-333,33719,9.3255227162,11.686414543,-6.81707515,-26,0.1180445913,-2.360891827,-6.699030559
42,47,2005,325,351,-438,466,5,-26,-433,-482,33237,9.7078678535,10.484497282,-13.08321883,-23,0.1493518131,-0.776629428,-12.93386702
42,47,2006,300,370,-322,466,4,-70,-318,-403,32834,9.0811399858,11.200072649,-9.747090251,-15,0.1210818665,-2.118932663,-9.626008385
42,47,2007,318,348,-206,466,5,-30,-201,-250,32584,9.7220948363,10.639273594,-6.297960806,-19,0.1528631264,-0.917178758,-6.14509768
42,47,2008,304,369,-242,466,4,-65,-238,-316,32268,9.3751927466,11.379756985,-7.463146857,-13,0.1233577993,-2.004564239,-7.339789058
42,49,2001,3476,2682,-1442,14418,426,794,-1016,766,281481,12.365794136,9.541156465,-5.129883528,988,1.5154857025,2.8246376708,-3.614397826
42,49,2002,3307,2705,-1407,14869,397,602,-1010,366,281847,11.740939559,9.6036412179,-4.995313565,774,1.4094807998,2.1372983413,-3.585832765
42,49,2003,3359,2694,-1449,14955,330,665,-1119,251,282098,11.912509199,9.5541231858,-5.138798996,705,1.1703268936,2.3583860128,-3.968472103
42,49,2004,3310,2669,-3384,13784,338,641,-3046,-2430,279668,11.784266047,9.502177063,-12.04772094,-25,1.2033480132,2.2820889837,-10.84437292
42,49,2005,3290,2781,-1702,13636,339,509,-1363,-887,278781,11.782633687,9.959727746,-6.095453658,-33,1.214076845,1.8229059413,-4.881376813
42,49,2006,3328,2693,-144,14970,368,635,224,860,279641,11.919301174,9.645035475,-0.515738993,1,1.317999649,2.2742656987,0.8022606559
42,49,2007,3369,2654,-1420,15170,330,715,-1090,-348,279293,12.055090583,9.4966489782,-5.08110081,27,1.1808192023,2.5584416049,-3.900281607
42,49,2008,3379,2649,-1251,15170,331,730,-920,-118,279175,12.100961917,9.4866670964,-4.480113453,72,1.1853857338,2.6142948208,-3.294727719
42,51,2001,1497,1851,-985,3011,21,-354,-964,-1438,147076,10.128894753,12.524104334,-6.664636828,-120,0.1420887039,-2.395209581,-6.522548124
42,51,2002,1501,1830,-432,3011,15,-329,-417,-878,146198,10.236161405,12.47979705,-2.946050451,-132,0.1022934184,-2.243635644,-2.843757033
42,51,2003,1510,1799,-304,3073,8,-289,-296,-786,145412,10.356297795,12.338397174,-2.08497651,-201,0.0548678029,-1.982099379,-2.030108707
42,51,2004,1457,1907,1025,4481,16,-450,1041,458,145870,10.004051057,13.093840333,7.0378533517,-133,0.1098591743,-3.089789276,7.147712526
42,51,2005,1445,1704,-189,4901,13,-259,-176,-565,145305,9.925302653,11.704301537,-1.298188375,-130,0.0892933803,-1.778998884,-1.208894994
42,51,2006,1391,1788,-90,5041,16,-397,-74,-535,144770,9.5906231147,12.327846247,-0.620529173,-64,0.1103162975,-2.737223132,-0.510212876
42,51,2007,1481,1728,-159,5045,13,-247,-146,-394,144376,10.243959799,11.952439252,-1.099790417,-1,0.0899199712,-1.708479453,-1.009870446
42,51,2008,1496,1729,-276,5045,13,-233,-263,-451,143925,10.378042393,11.994408622,-1.914665575,45,0.0901835235,-1.616366228,-1.824482052
42,53,2001,45,65,124,464,0,-20,124,101,5044,9.0117152298,13.016921999,24.832281967,-3,0,-4.005206769,24.832281967
42,53,2002,33,71,-6,464,-1,-38,-7,-49,4995,6.574359996,14.144835143,-1.195338181,-4,-0.19922303,-7.570475147,-1.394561211
42,53,2003,29,75,11,464,-1,-46,10,-42,4953,5.8303176518,15.07840772,2.211499799,-6,-0.201045436,-9.248090068,2.0104543627
42,53,2004,39,83,912,1262,0,-44,912,834,5787,7.2625698324,15.456238361,169.83240223,-34,0,-8.193668529,169.83240223
42,53,2005,39,68,783,2030,-1,-29,782,749,6536,6.3296275258,11.036273635,127.07944494,-4,-0.162298142,-4.706646109,126.9171468
42,53,2006,30,76,526,2543,0,-46,526,475,7011,4.4290248764,11.220196353,77.655569499,-5,0,-6.791171477,77.655569499
42,53,2007,39,91,-31,2538,0,-52,-31,-83,6928,5.5958103164,13.056890738,-4.44795179,0,0,-7.461080422,-4.44795179
42,53,2008,43,77,-62,2538,-1,-34,-63,-103,6825,6.2531811241,11.197556897,-9.016214644,-6,-0.145422817,-4.944375773,-9.161637461
42,55,2001,1658,1337,284,3054,136,321,420,608,130149,12.769070815,10.296892449,2.1872232277,-133,1.0474026724,2.4721783665,3.2346259001
42,55,2002,1533,1209,756,2985,122,324,878,1076,131225,11.730317476,9.2511114342,5.7848140978,-126,0.933528201,2.4792060419,6.7183422988
42,55,2003,1618,1290,866,3039,90,328,956,1155,132380,12.275943173,9.7873712562,6.5704368278,-129,0.6828398551,2.4885719163,7.2532766829
42,55,2004,1662,1391,1556,3000,112,271,1668,1805,134185,12.469754094,10.436478908,11.674450884,-134,0.8403203721,2.0332751862,12.514771257
42,55,2005,1789,1297,2224,2965,107,492,2331,2702,136887,13.199445166,9.5694132924,16.408924566,-121,0.7894581513,3.6300318735,17.198382718
42,55,2006,1913,1297,2134,3000,122,616,2256,2796,139683,13.833749141,9.3791806776,15.431897892,-76,0.882235962,4.4545684637,16.314133854
42,55,2007,1888,1359,1326,3013,102,529,1428,1960,141643,13.422150814,9.6613892779,9.4267860063,3,0.7251373851,3.7607615364,10.151923391
42,55,2008,1872,1378,1233,3013,103,494,1336,1852,143495,13.130484187,9.665495304,8.6484439114,22,0.7224571962,3.4649888826,9.3709011075
42,57,2001,148,141,-58,102,1,7,-57,-62,14196,10.402755324,9.9107331131,-4.076755465,-12,0.0702888873,0.4920222113,-4.006466578
42,57,2002,170,134,65,102,0,36,65,85,14281,11.939459915,9.4111036977,4.5650876146,-16,0,2.5283562173,4.5650876146
42,57,2003,148,125,150,102,-1,23,149,159,14440,10.30604784,8.7044322969,10.445318756,-13,-0.069635458,1.6016155426,10.375683298
42,57,2004,160,127,50,102,0,33,50,73,14513,11.052395261,8.7728387386,3.4538735192,-10,0,2.2795565226,3.4538735192
42,57,2005,173,159,64,102,0,14,64,66,14579,11.893304001,10.930840093,4.3998350062,-12,0,0.9624639076,4.3998350062
42,57,2006,179,117,114,102,0,62,114,169,14748,12.207181096,7.9789954649,7.7744058376,-7,0,4.228185631,7.7744058376
42,57,2007,174,133,161,102,0,41,161,204,14952,11.717171717,8.9562289562,10.841750842,2,0,2.7609427609,10.841750842
42,57,2008,170,142,-51,102,-1,28,-52,-17,14935,11.376183625,9.5024592632,-3.412855087,7,-0.066918727,1.8737243618,-3.479773815
42,59,2001,382,463,-202,3242,5,-81,-197,-313,40355,9.4294212754,11.428853535,-4.986238475,-35,0.1234217444,-1.99943226,-4.862816731
42,59,2002,407,454,-22,3296,3,-47,-19,-105,40250,10.098629117,11.264809875,-0.545871844,-39,0.0744370697,-1.166180758,-0.471434775
42,59,2003,398,483,-169,3237,-2,-85,-171,-308,39942,9.9261771748,12.046089385,-4.214884278,-52,-0.049880287,-2.119912211,-4.264764565
42,59,2004,402,440,-261,3154,8,-38,-253,-321,39621,10.105199653,11.060417531,-6.560838581,-30,0.2010985006,-0.955217878,-6.35974008
42,59,2005,437,422,407,3672,4,15,411,388,40009,10.975762903,10.59902047,10.222278036,-38,0.100464649,0.3767424338,10.322742685
42,59,2006,427,395,-449,3297,6,32,-443,-427,39582,10.729856391,9.9257453732,-11.28268272,-16,0.1507708158,0.8041110176,-11.1319119
42,59,2007,412,445,-181,3230,4,-33,-177,-195,39387,10.434474287,11.270245286,-4.584077296,15,0.1013055756,-0.835770999,-4.482771721
42,59,2008,428,436,-60,3230,4,-8,-56,-43,39344,10.872464468,11.075688103,-1.524177262,21,0.1016118175,-0.203223635,-1.422565444
42,61,2001,519,424,-101,4676,5,95,-96,-47,45562,11.385199241,9.3012032335,-2.215616808,-46,0.1096840004,2.0839960075,-2.105932808
42,61,2002,482,403,40,4799,4,79,44,80,45642,10.569711855,8.837331696,0.8771545108,-43,0.0877154511,1.7323801588,0.9648699618
42,61,2003,453,432,80,4892,-1,21,79,35,45677,9.921265016,9.4613388232,1.7520997821,-65,-0.021901247,0.4599261928,1.7301985348
42,61,2004,383,443,34,4963,2,-60,36,-54,45623,8.3899233297,9.704271632,0.7447973713,-30,0.0438116101,-1.314348302,0.7886089814
42,61,2005,452,443,-35,4952,0,9,-35,-68,45555,9.914672399,9.7172563557,-0.767729057,-42,0,0.1974160433,-0.767729057
42,61,2006,456,447,-106,4994,1,9,-105,-115,45440,10.02252871,9.8247156437,-2.329798341,-19,0.0219792296,0.1978130667,-2.307819111
42,61,2007,453,432,63,4997,0,21,63,87,45527,9.9596556993,9.497949806,1.38511768,3,0,0.4617058933,1.38511768
42,61,2008,438,429,-1,4997,-1,9,-2,16,45543,9.6189744153,9.4213242561,-0.021961129,9,-0.021961129,0.1976501592,-0.043922258
42,63,2001,876,892,-323,5381,54,-16,-269,-365,89170,9.8038667077,9.9829327663,-3.614896058,-80,0.6043479477,-0.179066059,-3.01054811
42,63,2002,878,946,-190,5433,50,-68,-140,-288,88882,9.8622874217,10.626109227,-2.134207984,-80,0.56163368,-0.763821805,-1.572574304
42,63,2003,856,881,127,5574,36,-25,163,10,88892,9.6302046418,9.9114606185,1.4287803616,-128,0.4050086064,-0.281255977,1.833788968
42,63,2004,911,886,-459,5447,43,25,-416,-461,88431,10.275034823,9.9930635056,-5.176993396,-70,0.4849906667,0.2819713179,-4.692002729
42,63,2005,829,870,-387,5307,40,-41,-347,-465,87966,9.3992528218,9.8641133353,-4.387829725,-77,0.4535224522,-0.464860514,-3.934307273
42,63,2006,864,898,-141,5451,41,-34,-100,-174,87792,9.8317004062,10.218596024,-1.604478886,-40,0.466550598,-0.386895618,-1.137928288
42,63,2007,901,886,-288,5446,38,15,-250,-222,87570,10.275886452,10.104811761,-3.284634071,13,0.4333892177,0.1710746912,-2.851244854
42,63,2008,892,902,-159,5446,38,-10,-121,-91,87479,10.191432113,10.305685837,-1.8166342,40,0.4341641483,-0.114253723,-1.382470051
42,65,2001,484,529,-171,929,6,-45,-165,-250,45651,10.573226145,11.55627403,-3.735581964,-40,0.1310730514,-0.983047885,-3.604508913
42,65,2002,532,577,-89,929,4,-45,-85,-171,45480,11.675500104,12.663089399,-1.95323216,-41,0.0877857151,-0.987589295,-1.865446445
42,65,2003,494,563,105,927,1,-69,106,-30,45450,10.865500935,12.383151875,2.3094688222,-67,0.0219949412,-1.51765094,2.3314637633
42,65,2004,507,558,-88,927,9,-51,-79,-162,45288,11.175031409,12.299146995,-1.939650422,-32,0.1983733386,-1.124115586,-1.741277083
42,65,2005,469,524,-39,991,6,-55,-33,-133,45155,10.371173004,11.587408644,-0.862421636,-45,0.1326802517,-1.21623564,-0.729741384
42,65,2006,493,532,-5,959,8,-39,3,-56,45099,10.924723558,11.788951182,-0.110798413,-20,0.1772774614,-0.864227624,0.066479048
42,65,2007,516,566,31,959,6,-50,37,-8,45091,11.442510256,12.55128063,0.6874376317,5,0.1330524448,-1.108770374,0.8204900765
42,65,2008,504,543,21,959,6,-39,27,14,45105,11.175661892,12.040445253,0.4656525788,26,0.133043594,-0.864783361,0.5986961728
42,67,2001,301,249,-150,487,7,52,-143,-110,22730,13.210445469,10.928242265,-6.583278473,-19,0.3072196621,2.2822032039,-6.276058811
42,67,2002,291,212,23,487,6,79,29,87,22817,12.778009529,9.3090653611,1.0099457703,-21,0.263464114,3.4689441676,1.2734098843
42,67,2003,309,208,42,487,4,101,46,115,22932,13.508491989,9.093094931,1.8361057072,-32,0.1748672102,4.4153970579,2.0109729174
42,67,2004,305,195,73,487,7,110,80,173,23105,13.250211786,8.4714468797,3.1713621652,-17,0.3041032213,4.7787649065,3.4754653865
42,67,2005,299,226,-14,487,5,73,-9,43,23148,12.928891099,9.7723390915,-0.605366138,-21,0.2162021923,3.1565520074,-0.389163946
42,67,2006,269,225,-79,487,6,44,-73,-40,23108,11.630923556,9.7284676582,-3.415773089,-11,0.2594258042,1.9024558976,-3.156347285
42,67,2007,274,228,-66,487,5,46,-61,-15,23093,11.861215125,9.8699162356,-2.857081016,0,0.2164455315,1.9912988896,-2.640635484
42,67,2008,293,220,-22,487,5,73,-17,53,23146,12.673284457,9.5157767253,-0.951577673,-3,0.2162676528,3.1575077316,-0.73531002
42,69,2001,2240,2874,-186,8155,125,-634,-61,-891,212022,10.542788897,13.526774683,-0.875428007,-196,0.5883252733,-2.983985786,-0.287102733
42,69,2002,2100,2966,-358,8162,118,-866,-240,-1304,210718,9.9351847471,14.032265695,-1.693712447,-198,0.558262762,-4.097080948,-1.135449685
42,69,2003,2109,2765,-79,8176,88,-656,9,-943,209775,10.031082563,13.151229628,-0.375749418,-296,0.4185563137,-3.120147065,0.0428068957
42,69,2004,2184,3008,352,8324,108,-824,460,-514,209261,10.423925391,14.35676171,1.6800465831,-150,0.515468838,-3.93283632,2.1955154211
42,69,2005,2271,2769,360,8387,101,-498,461,-246,209015,10.858858744,13.240061586,1.7213514522,-209,0.482934713,-2.381202842,2.2042861651
42,69,2006,2237,2787,431,8402,110,-550,541,-104,208911,10.705244469,13.337289377,2.0625661002,-95,0.5264089815,-2.632044907,2.5889750817
42,69,2007,2342,2681,532,8539,92,-339,624,351,209262,11.201105762,12.822444299,2.5444014798,66,0.4400092785,-1.621338537,2.9844107582
42,69,2008,2335,2675,247,8539,93,-340,340,146,209408,11.15436979,12.77856068,1.1799269114,146,0.4442639788,-1.62419089,1.6241908902
42,71,2001,6802,4283,8,14200,526,2519,534,2561,474337,14.378832127,9.0538867979,0.0169112992,-492,1.111917921,5.3249453289,1.1288292202
42,71,2002,6634,4229,1182,14250,490,2405,1672,3590,477927,13.933110986,8.8819907085,2.4825048516,-487,1.0291263767,5.0511202776,3.5116312283
42,71,2003,6635,4242,1513,14228,419,2393,1932,3668,481595,13.829802756,8.8419025306,3.15365359,-657,0.8733515229,4.9879002253,4.027005113
42,71,2004,6840,4588,1467,14407,424,2252,1891,3806,485401,14.146904434,9.4891809273,3.0341387141,-337,0.876942614,4.6577235066,3.9110813282
42,71,2005,6724,4508,1259,14221,430,2216,1689,3483,488884,13.802942671,9.2539657287,2.5844593728,-422,0.8826985944,4.5489769421,3.4671579671
42,71,2006,7037,4437,1482,14170,608,2600,2090,4437,493321,14.328984275,9.0347737998,3.017699971,-253,1.2380307573,5.2942104754,4.2557307283
42,71,2007,7090,4337,1422,14200,505,2753,1927,4634,497955,14.304795032,8.7503379483,2.8690294126,-46,1.0188887858,5.5544570836,3.8879181984
42,71,2008,7203,4466,1118,14200,507,2737,1625,4415,502370,14.401319571,8.9290980431,2.2352735361,53,1.0136705571,5.472221528,3.2489440932
42,73,2001,1026,1237,-323,2975,20,-211,-303,-598,94024,10.877516618,13.114510777,-3.42440338,-84,0.212037361,-2.236994158,-3.212366019
42,73,2002,994,1189,-36,3085,16,-195,-20,-302,93722,10.588774195,12.666048811,-0.383496852,-87,0.1704430454,-2.077274616,-0.213053807
42,73,2003,1030,1205,-162,3053,2,-175,-160,-454,93268,11.016631905,12.888389753,-1.732712979,-119,0.0213915183,-1.871757848,-1.711321461
42,73,2004,943,1220,-289,3067,19,-277,-270,-614,92654,10.144038898,13.123783092,-3.108830585,-67,0.2043867859,-2.979744194,-2.904443799
42,73,2005,931,1188,-375,3005,12,-257,-363,-706,91948,10.086564609,12.870933143,-4.062794553,-86,0.1300094257,-2.784368533,-3.932785127
42,73,2006,925,1079,-523,3015,16,-154,-507,-702,91246,10.098584015,11.779861786,-5.709793989,-41,0.17467821,-1.681277771,-5.535115779
42,73,2007,971,1102,-415,2879,12,-131,-403,-530,90716,10.672558007,12.112419077,-4.561391939,4,0.1318956705,-1.43986107,-4.429496268
42,73,2008,1010,1130,-377,2879,12,-120,-365,-444,90272,11.160960948,12.487015714,-4.166022057,41,0.1326054766,-1.326054766,-4.03341658
42,75,2001,1434,1252,225,4431,124,182,349,402,120819,11.88877282,10.379876967,1.8653932249,-129,1.0280389328,1.508895853,2.8934321577
42,75,2002,1399,1254,351,4481,111,145,462,490,121309,11.555871275,10.358157669,2.899292936,-117,0.9168704156,1.197713606,3.8161633516
42,75,2003,1493,1276,946,4505,77,217,1023,1128,122437,12.250457443,10.469915404,7.7621786614,-112,0.6318052399,1.7805420397,8.3939839013
42,75,2004,1480,1331,1024,4507,121,149,1145,1187,123624,12.029537391,10.818455586,8.3231393841,-107,0.9834959624,1.2110818049,9.3066353465
42,75,2005,1585,1366,1021,4521,106,219,1127,1236,124860,12.757360635,10.994671689,8.2178329389,-110,0.853173645,1.7626889458,9.0710065839
42,75,2006,1585,1384,1257,4551,157,201,1414,1550,126410,12.615911171,11.016038524,10.005173718,-65,1.249651769,1.599872647,11.254825487
42,75,2007,1596,1338,1069,4572,120,258,1189,1451,127861,12.553535401,10.52420449,8.4083517192,4,0.9438748422,2.0293309107,9.3522265614
42,75,2008,1637,1332,606,4572,122,305,728,1073,128934,12.749469421,10.374033762,4.719718063,40,0.9501742635,2.3754356588,5.6698923266
42,77,2001,3779,3246,978,10466,846,533,1824,2069,314723,12.046982915,10.347845076,3.1177426013,-288,2.6969429864,1.699137839,5.8146855878
42,77,2002,3819,3177,676,10366,805,642,1481,1826,316549,12.099380299,10.06539178,2.1417075365,-297,2.5504061641,2.0339885184,4.6921137006
42,77,2003,3871,3078,2395,10517,698,793,3093,3593,320142,12.15974468,9.6687404094,7.5232726707,-293,2.1925863566,2.4910042705,9.7158590274
42,77,2004,4017,3181,2761,10440,653,836,3414,3961,324103,12.470411101,9.8751251465,8.571273351,-289,2.0271791011,2.5952859549,10.598452452
42,77,2005,4197,3172,3046,10536,684,1025,3730,4460,328563,12.861095874,9.7201325027,9.3340238345,-295,2.0960184842,3.1409633718,11.430042319
42,77,2006,4225,3168,3096,10615,886,1057,3982,4865,333428,12.764523989,9.5711270999,9.353601484,-174,2.6767735513,3.1933968891,12.030375035
42,77,2007,4268,3125,1436,10552,772,1143,2208,3369,336797,12.736021485,9.325226603,4.2851281286,18,2.30370398,3.4107948823,6.5888321086
42,77,2008,4329,3181,1191,10552,773,1148,1964,3192,339989,12.792817818,9.4003126542,3.5195763506,80,2.2843262124,3.3925051641,5.803902563
42,79,2001,2989,4459,-1464,12749,166,-1470,-1298,-3068,315487,9.4283974879,14.065314285,-4.617990606,-300,0.5236246179,-4.636916797,-4.094365988
42,79,2002,2977,4386,-227,13111,157,-1409,-70,-1788,313699,9.4630204741,13.941823245,-0.721567231,-309,0.4990575124,-4.478802771,-0.222509719
42,79,2003,3042,4483,625,13381,120,-1441,745,-1083,312616,9.7139618243,14.31548023,1.995800835,-387,0.3831937603,-4.601518405,2.3789945954
42,79,2004,3089,4428,361,13544,137,-1339,498,-1063,311553,9.8979603281,14.188464983,1.1567379988,-222,0.4389836727,-4.290504655,1.5957216715
42,79,2005,3128,4248,1079,13551,132,-1120,1211,-222,311331,10.043603624,13.639778835,3.4645295111,-313,0.4238349356,-3.596175211,3.8883644467
42,79,2006,3164,4120,903,13685,152,-956,1055,-40,311291,10.163469971,13.23435407,2.9006363412,-139,0.488257723,-3.0708841,3.3888940641
42,79,2007,3236,4099,1325,13815,123,-863,1448,691,311982,10.383892773,13.15314477,4.2517484313,106,0.3946906091,-2.769251997,4.6464390404
42,79,2008,3309,4074,445,13815,124,-765,569,1,311983,10.606364139,13.058424751,1.4263620556,197,0.3974581908,-2.452060612,1.8238202463
42,81,2001,1294,1218,-834,5616,19,76,-815,-843,119115,10.825145458,10.189356389,-6.976948463,-104,0.1589472672,0.6357890686,-6.818001196
42,81,2002,1284,1196,-601,5482,13,88,-588,-596,118519,10.806534418,10.065899661,-5.058198743,-96,0.1094119528,0.7406347577,-4.94878679
42,81,2003,1297,1241,-173,5590,-2,56,-175,-281,118238,10.956381438,10.483322563,-1.461414024,-162,-0.01689496,0.4730588747,-1.478308983
42,81,2004,1351,1243,-213,5660,18,108,-195,-166,118072,11.43413313,10.520079557,-1.80271677,-79,0.1523422623,0.9140535737,-1.650374508
42,81,2005,1334,1293,-327,5584,11,41,-316,-389,117683,11.316833153,10.969014443,-2.774066298,-114,0.0933172149,0.3478187101,-2.680749083
42,81,2006,1397,1265,-541,5610,17,132,-524,-441,117242,11.893157391,10.769394488,-4.605725231,-49,0.1447270405,1.1237629031,-4.460998191
42,81,2007,1359,1207,-581,5785,9,152,-572,-407,116835,11.611563716,10.312845773,-4.964178454,13,0.076897773,1.2987179432,-4.887280681
42,81,2008,1396,1237,-377,5785,10,159,-367,-165,116670,11.956917411,10.595062204,-3.229052911,43,0.0856512709,1.3618552065,-3.14340164
42,83,2001,473,582,-420,2486,4,-109,-416,-561,45219,10.395718634,12.791349355,-9.230870669,-36,0.087913054,-2.395630721,-9.142957615
42,83,2002,508,491,149,2903,4,17,153,132,45351,11.217842553,10.84244231,3.2902727172,-38,0.0883294689,0.3754002429,3.3786021862
42,83,2003,479,538,-442,2765,0,-59,-442,-537,44814,10.624965341,11.933677147,-9.804247768,-36,0,-1.308711806,-9.804247768
42,83,2004,470,537,-360,2830,4,-67,-356,-458,44356,10.541661994,12.044409555,-8.074464506,-35,0.0897162723,-1.502747561,-7.984748234
42,83,2005,442,512,-352,2809,2,-70,-350,-458,43898,10.01654316,11.602873524,-7.976975548,-38,0.0453237247,-1.586330365,-7.931651823
42,83,2006,538,522,107,3073,7,16,114,110,44008,12.240347644,11.876322435,2.4344185835,-20,0.1592610288,0.3640252087,2.5936796123
42,83,2007,471,521,-233,3180,4,-50,-229,-270,43738,10.735532104,11.875185194,-5.310783398,9,0.0911722472,-1.13965309,-5.21961115
42,83,2008,477,505,-181,3180,4,-28,-177,-201,43537,10.930965339,11.572615296,-4.147808651,4,0.0916642796,-0.641649957,-4.056144371
42,85,2001,1321,1456,-211,6520,33,-135,-178,-422,119747,11.012187599,12.137581487,-1.758948965,-109,0.2750962837,-1.125393888,-1.483852682
42,85,2002,1302,1424,-247,6619,30,-122,-217,-444,119303,10.893118594,11.91382556,-2.066513282,-105,0.250993516,-1.020706965,-1.815519766
42,85,2003,1238,1332,62,6580,17,-94,79,-189,119114,10.385165487,11.173699862,0.5200971407,-174,0.1426072805,-0.788534375,0.6627044212
42,85,2004,1261,1380,-226,6617,29,-119,-197,-401,118713,10.604346857,11.605074277,-1.90054115,-85,0.2438747493,-1.00072742,-1.6566664
42,85,2005,1173,1429,-275,6617,23,-256,-252,-619,118094,9.9068017415,12.06889999,-2.322566478,-111,0.1942510145,-2.162098249,-2.128315464
42,85,2006,1222,1383,-451,6800,32,-161,-419,-633,117461,10.375496169,11.742480525,-3.829254314,-53,0.271698754,-1.366984356,-3.55755556
42,85,2007,1196,1374,-378,7114,27,-178,-351,-526,116935,10.204952303,11.723749552,-3.225311012,3,0.230379358,-1.518797249,-2.994931654
42,85,2008,1261,1389,-218,7114,27,-128,-191,-283,116652,10.796833728,11.892785129,-1.866542231,36,0.2311772487,-1.095951401,-1.635364982
42,87,2001,599,564,-8,690,5,35,-3,-15,46476,12.886292986,12.133337636,-0.17210408,-47,0.10756505,0.7529553497,-0.06453903
42,87,2002,548,487,-79,690,5,61,-74,-56,46420,11.798139855,10.484843266,-1.700826731,-43,0.1076472615,1.3132965897,-1.59317947
42,87,2003,616,517,-293,690,2,99,-291,-240,46180,13.304535637,11.166306695,-6.328293737,-48,0.0431965443,2.1382289417,-6.285097192
42,87,2004,571,541,-178,690,3,30,-175,-182,45998,12.389073315,11.73815878,-3.862092907,-37,0.0650914535,0.6509145349,-3.797001454
42,87,2005,573,569,9,690,3,4,12,-28,45970,12.46085595,12.373869172,0.1957202505,-44,0.0652400835,0.086986778,0.260960334
42,87,2006,596,505,-69,690,3,91,-66,4,45974,12.964413121,10.984947359,-1.5009136,-21,0.065257113,1.9794657618,-1.435656487
42,87,2007,638,566,-9,690,2,72,-7,80,46054,13.86534533,12.300604164,-0.195592646,15,0.0434650324,1.5647411657,-0.152127613
42,87,2008,631,539,-107,690,1,92,-106,8,46062,13.700117243,11.702635807,-2.323157758,22,0.0217117547,1.9974814364,-2.301446003
42,89,2001,1520,1206,3369,3855,149,314,3518,3778,143543,10.730371186,8.5137024016,23.783302978,-54,1.0518587544,2.2166687845,24.835161732
42,89,2002,1517,1152,4189,3978,143,365,4332,4698,148241,10.398102706,7.896252022,28.713020591,1,0.9801771173,2.5018506841,29.693197708
42,89,2003,1551,1186,4102,3945,100,365,4202,4684,152925,10.29996746,7.876055066,27.240790793,117,0.6640855874,2.4239123938,27.90487638
42,89,2004,1533,1175,3480,4059,113,358,3593,3734,156659,9.9036125898,7.5908315675,22.481782004,-217,0.7300118869,2.3127810223,23.211793891
42,89,2005,1663,1229,2968,3880,109,434,3077,3373,160032,10.502350872,7.7615088525,18.743822843,-138,0.688368157,2.7408420195,19.432191
42,89,2006,1618,1179,2204,3930,124,439,2328,2684,162716,10.026398305,7.3060096422,13.657714378,-83,0.7684013534,2.7203886624,14.426115731
42,89,2007,1639,1206,1238,4010,106,433,1344,1751,164467,10.018857948,7.3720211625,7.5676303475,-26,0.6479554256,2.6468367855,8.2155857731
42,89,2008,1712,1251,71,4010,106,461,177,591,165058,10.390713906,7.592747136,0.4309232987,-47,0.6433502769,2.7979667704,1.0742735756
42,91,2001,9470,7117,3684,22239,1631,2353,5315,6952,757890,12.552789317,9.4338122039,4.8832603849,-716,2.161942912,3.1189771134,7.0452032969
42,91,2002,9407,6986,2136,21945,1471,2421,3607,5315,763205,12.368721217,9.1854880859,2.8085030849,-713,1.9341329766,3.1832331314,4.7426360615
42,91,2003,9688,7050,2179,22877,1198,2638,3377,5021,768226,12.652218742,9.2070749515,2.8457044424,-994,1.5645497577,3.4451437904,4.4102542002
42,91,2004,9689,7152,-844,22816,1272,2537,428,2444,770670,12.592143979,9.294975099,-1.096890238,-521,1.6531331552,3.2971688795,0.556242917
42,91,2005,9497,7227,-1405,23277,1255,2270,-150,1368,772038,12.312116097,9.3692390264,-1.821472372,-752,1.6270091294,2.9428770707,-0.194463243
42,91,2006,9522,7155,-2648,23150,1343,2367,-1305,715,772753,12.327881247,9.263389028,-3.428295478,-347,1.7387465359,3.0644922193,-1.689548942
42,91,2007,9341,6962,-1268,23276,1176,2379,-92,2357,775110,12.069543622,8.9956281661,-1.638387894,70,1.5195143239,3.0739154563,-0.11887357
42,91,2008,9220,7026,-715,23276,1187,2194,472,2938,778048,11.87258476,9.0473731584,-0.920704783,272,1.5284987104,2.8252116011,0.607793927
42,93,2001,197,245,34,1004,8,-48,42,-27,18251,10.785950888,13.413999836,1.8615346711,-21,0.4380081579,-2.628048947,2.299542829
42,93,2002,235,241,-120,947,8,-6,-112,-135,18116,12.923804548,13.253774026,-6.599389556,-17,0.4399593038,-0.329969478,-6.159430253
42,93,2003,211,206,-46,944,6,5,-40,-56,18060,11.665192393,11.388766033,-2.543122512,-21,0.331711632,0.27642636,-2.21141088
42,93,2004,217,201,-114,937,4,16,-110,-109,17951,12.051873039,11.163255672,-6.331398739,-15,0.2221543417,0.8886173669,-6.109244398
42,93,2005,192,243,20,954,5,-51,25,-44,17907,10.708907357,13.553460873,1.115511183,-18,0.2788777957,-2.844553517,1.3943889787
42,93,2006,214,259,-32,983,4,-45,-28,-80,17827,11.977388482,14.495998209,-1.791011362,-7,0.2238764202,-2.518609727,-1.567134942
42,93,2007,209,235,-24,969,5,-26,-19,-46,17781,11.738935071,13.19928106,-1.348011683,-1,0.2808357672,-1.46034599,-1.067175916
42,93,2008,209,234,-57,969,4,-25,-53,-76,17705,11.779293242,13.188299611,-3.212534521,2,0.225441019,-1.409006369,-2.987093502
42,95,2001,2989,2557,956,10539,494,432,1450,1883,269323,11.137131285,9.5274823339,3.5620935124,1,1.840663384,1.6096489512,5.4027568964
42,95,2002,2775,2533,2846,10812,470,242,3316,3607,272930,10.235074771,9.342502485,10.496945153,49,1.7335081595,0.8925722864,12.230453312
42,95,2003,2991,2610,3091,10581,413,381,3504,3975,276905,10.879627525,9.4937572181,11.243373012,90,1.5022688625,1.3858703065,12.745641874
42,95,2004,3197,2653,3958,10889,408,544,4366,4875,281780,11.444731826,9.4973016995,14.168986101,-35,1.4605725946,1.9474301261,15.629558696
42,95,2005,3010,2679,3219,10885,410,331,3629,3930,285710,10.608116443,9.441576063,11.344693299,-30,1.4449593825,1.1665403796,12.789652681
42,95,2006,3064,2565,2916,11111,509,499,3425,3929,289639,10.650926655,8.9163273074,10.136456307,5,1.7693608575,1.7345993475,11.905817165
42,95,2007,3359,2612,2136,10970,450,747,2586,3414,293053,11.529247012,8.9652852622,7.3314890199,81,1.5445552711,2.5639617499,8.876044291
42,95,2008,3447,2655,344,10970,451,792,795,1734,294787,11.727681002,9.0330702232,1.1703864997,147,1.5344311377,2.6946107784,2.7048176375
42,97,2001,978,1219,-627,3730,19,-241,-608,-942,93531,10.404033957,12.967809196,-6.67007085,-93,0.2021233591,-2.563775239,-6.46794749
42,97,2002,986,1218,-180,3872,16,-232,-164,-476,93055,10.568852969,13.055641902,-1.929405207,-80,0.1715026851,-2.486788934,-1.757902522
42,97,2003,975,1170,-170,3932,9,-195,-161,-485,92570,10.505050505,12.606060606,-1.831649832,-129,0.096969697,-2.101010101,-1.734680135
42,97,2004,927,1179,-233,3884,21,-252,-212,-531,92039,10.042847315,12.772941731,-2.524253964,-67,0.227507868,-2.730094416,-2.296746096
42,97,2005,968,1247,-154,3892,17,-279,-137,-505,91534,10.546213223,13.585875919,-1.677806649,-89,0.1852124223,-3.039662695,-1.492594227
42,97,2006,1036,1131,-398,3954,25,-95,-373,-508,91026,11.349693252,12.390446976,-4.360210342,-40,0.2738825592,-1.040753725,-4.086327783
42,97,2007,992,1169,83,3912,17,-177,100,-47,90979,10.900799429,12.84580094,0.9120628554,30,0.1868080547,-1.945001511,1.0988709101
42,97,2008,980,1149,213,3912,17,-169,230,112,91091,10.76509035,12.621519196,2.3397594332,51,0.1867413632,-1.856428846,2.5265007964
42,99,2001,560,355,-25,502,4,205,-21,137,43749,12.820366067,8.1271963462,-0.572337771,-47,0.0915740433,4.693169721,-0.480763728
42,99,2002,496,375,-26,502,3,121,-23,54,43803,11.330409357,8.5663377193,-0.593932749,-44,0.0685307018,2.7640716374,-0.525402047
42,99,2003,524,399,183,502,-2,125,181,252,44055,11.928338911,9.0828382162,4.1658130165,-54,-0.045528011,2.8455006943,4.1202850053
42,99,2004,547,404,94,502,3,143,97,209,44264,12.386915613,9.1486543099,2.1286472899,-31,0.0679355518,3.2382613028,2.1965828417
42,99,2005,562,399,102,502,1,163,103,224,44488,12.664503335,8.9913466739,2.2985397512,-42,0.0225347034,3.6731566613,2.3210744547
42,99,2006,539,394,186,502,3,145,189,313,44801,12.073155708,8.8252752299,4.1662466821,-21,0.0671975271,3.247880478,4.2334442093
42,99,2007,561,385,104,502,1,176,105,284,45085,12.482477805,8.5664063369,2.3140422313,3,0.0222504061,3.9160714683,2.3362926373
42,99,2008,567,388,-86,502,1,179,-85,100,45185,12.562313061,8.5964329235,-1.905394926,6,0.022155755,3.9658801374,-1.883239171
42,101,2001,21695,17625,-23819,55564,5749,4070,-18070,-15205,1498607,14.403706788,11.701559444,-15.81386919,-1205,3.8168661132,2.702147344,-11.99700307
42,101,2002,21190,16930,-21985,55838,5412,4260,-16573,-13337,1485270,14.202998314,11.347652735,-14.7358621,-1024,3.6274953693,2.8553455789,-11.10836673
42,101,2003,21657,16660,-20626,56279,4786,4997,-15840,-11911,1473359,14.639888949,11.261973029,-13.94294452,-1068,3.2352822878,3.3779159198,-10.70766223
42,101,2004,22031,16233,-16139,56925,4371,5798,-11768,-7268,1466091,14.989879059,11.04492337,-10.98096583,-1298,2.9740257531,3.944955689,-8.006940074
42,101,2005,21791,15791,-18405,57161,4583,6000,-13822,-8941,1457150,14.908794725,10.803761989,-12.59218792,-1119,3.1355608381,4.1050327359,-9.456627079
42,101,2006,22378,15277,-18074,57845,5188,7101,-12886,-6442,1450708,15.391398067,10.507390664,-12.43114347,-657,3.5682622742,4.8840074034,-8.8628812
42,101,2007,22636,15341,-13592,58951,4615,7295,-8977,-2077,1448631,15.614593533,10.58241206,-9.375930169,-395,3.1834842355,5.0321814731,-6.192445933
42,101,2008,22199,15343,-12209,58951,4620,6856,-7589,-1236,1447395,15.330663468,10.595899346,-8.431554137,-503,3.1905790901,4.7347641216,-5.240975046
42,103,2001,391,346,1369,392,24,45,1393,1423,48033,8.2626290375,7.3116870767,28.929767653,-15,0.5071690458,0.9509419608,29.436936699
42,103,2002,393,366,1637,392,22,27,1659,1693,49726,8.0401804437,7.4878016346,33.490522612,7,0.4500864371,0.5523788091,33.940609049
42,103,2003,389,352,1855,392,5,37,1860,1976,51702,7.6704657491,6.940884174,36.57767086,79,0.0985921047,0.7295815751,36.676262965
42,103,2004,414,352,1725,392,11,62,1736,1704,53406,7.8776115995,6.6978726643,32.823381665,-94,0.2093085208,1.1797389352,33.032690185
42,103,2005,386,363,1967,392,8,23,1975,1947,55353,7.0982631322,6.6753096295,36.171719122,-51,0.1471142618,0.4229535027,36.318833384
42,103,2006,442,384,1794,392,10,58,1804,1831,57184,7.8551942917,6.82442219,31.882847419,-31,0.1777193279,1.0307721016,32.060566747
42,103,2007,475,417,1287,392,5,58,1292,1374,58558,8.2079106979,7.2056816022,22.239118038,24,0.08639906,1.0022290957,22.325517098
42,103,2008,450,450,1076,392,5,0,1081,1106,59664,7.6127962647,7.6127962647,18.203041735,25,0.0845866252,0,18.28762836
42,105,2001,220,201,-52,299,3,19,-49,-49,18071,12.15771877,11.107733967,-2.873642618,-19,0.1657870741,1.0499848029,-2.707855544
42,105,2002,215,207,55,299,2,8,57,50,18121,11.881078691,11.438992042,3.0393457118,-15,0.1105216622,0.442086649,3.149867374
42,105,2003,230,236,-172,299,0,-6,-172,-190,17931,12.759347609,13.092200155,-9.541772995,-12,0,-0.332852546,-9.541772995
42,105,2004,210,196,-172,299,1,14,-171,-174,17757,11.768661735,10.984084286,-9.639094373,-17,0.0560412464,0.784577449,-9.583053127
42,105,2005,181,207,-195,299,1,-26,-194,-235,17522,10.261061821,11.735026503,-11.05473511,-15,0.0566909493,-1.473964682,-10.99804416
42,105,2006,218,195,-175,299,1,23,-174,-158,17364,12.49785014,11.179269621,-10.03267787,-7,0.0573295878,1.3185805194,-9.975348277
42,105,2007,198,227,-368,299,1,-29,-367,-386,16978,11.531069827,13.219963893,-21.43148331,10,0.0582377264,-1.688894066,-21.37324559
42,105,2008,194,208,-244,299,0,-14,-244,-258,16720,11.514036441,12.344946288,-14.48157161,0,0,-0.830909846,-14.48157161
42,107,2001,1458,2180,-126,7450,21,-722,-105,-973,149114,9.7459567314,14.57214381,-0.842243174,-146,0.1403738624,-4.826187078,-0.701869312
42,107,2002,1388,2054,145,7754,15,-666,160,-643,148471,9.3284271721,13.80445923,0.9745114841,-137,0.1008115328,-4.476032058,1.075323017
42,107,2003,1444,2073,-344,7693,2,-629,-342,-1166,147305,9.7641458401,14.017364492,-2.326084605,-195,0.0135237477,-4.253218652,-2.312560857
42,107,2004,1385,2150,-43,7636,25,-765,-18,-877,146428,9.4303329895,14.639145074,-0.292782901,-94,0.1702226171,-5.208812084,-0.122560284
42,107,2005,1433,2097,480,7735,15,-664,495,-316,146112,9.7969508443,14.336500991,3.2816025159,-147,0.1025500786,-4.539550147,3.3841525945
42,107,2006,1544,1986,1329,8233,21,-442,1350,839,146951,10.536983515,13.553399781,9.0697222099,-69,0.143313895,-3.016416265,9.2130361049
42,107,2007,1455,1996,655,8285,14,-541,669,164,147115,9.8957376915,13.575183802,4.4547822598,36,0.0952167201,-3.679446111,4.5499989798
42,107,2008,1528,1928,462,8285,15,-400,477,139,147254,10.381527946,13.099205419,3.1389174811,62,0.1019129052,-2.717677473,3.2408303864
42,109,2001,485,316,75,2277,3,169,78,208,37744,12.88522848,8.3953241233,1.9925611052,-39,0.0797024442,4.4899043571,2.0722635494
42,109,2002,441,324,-32,2257,2,117,-30,52,37796,11.67593328,8.5782366958,-0.847233254,-35,0.0529520784,3.0976965846,-0.794281176
42,109,2003,474,325,7,2221,-2,149,5,97,37893,12.524937573,8.5877736527,0.1849674325,-57,-0.052847838,3.9371639208,0.1321195947
42,109,2004,468,335,-45,2259,3,133,-42,66,37959,12.339819649,8.8329905606,-1.18652112,-25,0.079101408,3.5068290882,-1.107419712
42,109,2005,449,324,-284,2195,1,125,-283,-184,37775,11.857289989,8.556262709,-7.499933979,-26,0.0264082182,3.3010272797,-7.473525761
42,109,2006,503,311,97,2195,4,192,101,274,38049,13.267566997,8.2032074277,2.5585566575,-19,0.105507491,5.0643595695,2.6640641486
42,109,2007,477,322,-21,2243,2,155,-19,100,38149,12.520013649,8.451665398,-0.551195569,-36,0.0524948161,4.0683482506,-0.498700753
42,109,2008,488,322,-197,2243,2,166,-195,-75,38074,12.804534065,8.4488933786,-5.169043465,-46,0.0524775986,4.3556406859,-5.116565866
42,111,2001,827,933,-426,3496,15,-106,-411,-586,79444,10.371596624,11.700966929,-5.342563678,-69,0.1881184394,-1.329370305,-5.154445239
42,111,2002,746,913,223,3919,11,-167,234,-2,79442,9.3903805244,11.492516647,2.8070440442,-69,0.138464056,-2.102136123,2.9455081001
42,111,2003,786,957,231,4271,5,-171,236,-32,79410,9.8960038275,12.048951225,2.9083675371,-97,0.0629516783,-2.152947398,2.9713192154
42,111,2004,744,945,-211,4290,12,-201,-199,-455,78955,9.3960155337,11.934455214,-2.664730212,-55,0.1515486376,-2.53843968,-2.513181574
42,111,2005,736,904,-268,4308,10,-168,-258,-501,78454,9.3514347972,11.486001436,-3.405142019,-75,0.127057538,-2.134566639,-3.278084481
42,111,2006,700,975,11,4414,13,-275,24,-286,78168,8.9387186985,12.450358187,0.1404655795,-35,0.1660047758,-3.511639489,0.3064703554
42,111,2007,726,955,-119,4442,10,-229,-109,-308,77860,9.3060219961,12.241392571,-1.525367242,30,0.1281821212,-2.935370575,-1.397185121
42,111,2008,744,965,-255,4442,10,-221,-245,-406,77454,9.5805915758,12.426439342,-3.2836705,60,0.1287713921,-2.845847766,-3.154899108
42,113,2001,52,99,57,443,2,-47,59,7,6573,7.9153664662,15.069640003,8.6764593957,-5,0.3044371718,-7.154273537,8.9808965675
42,113,2002,45,104,5,499,2,-59,7,-58,6515,6.8765281174,15.892420538,0.7640586797,-6,0.3056234719,-9.015892421,1.0696821516
42,113,2003,56,110,-7,491,1,-54,-6,-68,6447,8.6406418763,16.9726894,-1.080080235,-8,0.1542971764,-8.332047524,-0.925783058
42,113,2004,41,99,10,499,0,-58,10,-53,6394,6.3857954988,15.419359863,1.5575110973,-5,0,-9.033564364,1.5575110973
42,113,2005,54,114,-16,499,1,-60,-15,-81,6313,8.4992523806,17.942866137,-2.518297002,-6,0.1573935626,-9.443613756,-2.360903439
42,113,2006,53,88,-53,490,0,-35,-53,-91,6222,8.4563222976,14.040686079,-8.456322298,-3,0,-5.584363781,-8.456322298
42,113,2007,54,96,38,502,1,-42,39,-2,6220,8.6802764829,15.431602636,6.1083427102,1,0.1607458608,-6.751326153,6.269088571
42,113,2008,52,105,-47,502,0,-53,-47,-96,6124,8.4251458198,17.012313675,-7.615035645,4,0,-8.587167855,-7.615035645
42,115,2001,491,474,-57,434,3,17,-54,-80,42131,11.643072253,11.239951626,-1.351639752,-43,0.0711389343,0.4031206279,-1.280500818
42,115,2002,409,482,-268,434,2,-73,-266,-381,41750,9.7519104446,11.492471477,-6.390004888,-42,0.0476866036,-1.740561033,-6.342318284
42,115,2003,450,434,-15,434,-1,16,-16,-59,41691,10.786064405,10.402559893,-0.35953548,-59,-0.023969032,0.3835045122,-0.383504512
42,115,2004,436,460,-16,434,3,-24,-13,-66,41625,10.466176965,11.042296798,-0.384079889,-29,0.0720149791,-0.576119833,-0.31206491
42,115,2005,415,466,45,434,1,-51,46,-38,41587,9.9745229054,11.200307648,1.0815747729,-33,0.024034995,-1.225784743,1.1056097678
42,115,2006,385,462,-136,434,2,-77,-134,-231,41356,9.2834838383,11.140180606,-3.279360525,-20,0.0482258901,-1.856696768,-3.231134635
42,115,2007,414,434,-285,434,-1,-20,-286,-332,41024,10.050983248,10.536537995,-6.919155135,-26,-0.024277737,-0.485554746,-6.943432872
42,115,2008,441,454,-136,434,-1,-13,-137,-193,40831,10.775151182,11.092786024,-3.322949117,-43,-0.024433449,-0.317634842,-3.347382567
42,117,2001,457,404,67,1828,10,53,77,91,41418,11.045984652,9.7649404798,1.6194331984,-39,0.2417064475,1.2810441719,1.8611396459
42,117,2002,445,432,61,1860,9,13,70,41,41459,10.7388057,10.425087781,1.4720610061,-42,0.2171893288,0.3137179193,1.6892503348
42,117,2003,447,408,-74,1907,6,39,-68,-83,41376,10.792539386,9.8509084324,-1.786684373,-54,0.1448663005,0.9416309531,-1.641818072
42,117,2004,422,393,-71,1819,9,29,-62,-62,41314,10.206796469,9.5053815455,-1.717257226,-29,0.2176804934,0.7014149232,-1.499576732
42,117,2005,399,399,-225,1766,7,0,-218,-256,41058,9.687757976,9.687757976,-5.463021415,-38,0.1699606662,0,-5.293060749
42,117,2006,381,433,-311,1753,8,-52,-303,-371,40687,9.3216710502,10.593920117,-7.609028075,-16,0.1957306257,-1.272249067,-7.413297449
42,117,2007,450,428,-106,1719,5,22,-101,-71,40616,11.069702225,10.528516783,-2.607529857,8,0.1229966914,0.5411854421,-2.484533166
42,117,2008,425,423,-62,1719,5,2,-57,-42,40574,10.469269614,10.420002463,-1.527281685,13,0.1231678778,0.0492671511,-1.404113807
42,119,2001,383,346,291,8974,18,37,309,305,41953,9.1625698257,8.2774129496,6.9616392148,-41,0.4306168587,0.8851568761,7.3922560735
42,119,2002,404,351,58,9147,17,53,75,90,42043,9.6195056907,8.3575408353,1.3810181437,-38,0.4047811801,1.2619648555,1.7857993238
42,119,2003,417,363,17,8924,10,54,27,20,42063,9.9160583074,8.6319644258,0.4042517775,-61,0.2377951632,1.2840938815,0.6420469408
42,119,2004,441,353,415,9182,15,88,430,477,42540,10.425162228,8.3448577474,9.8105268135,-41,0.3545973547,2.0803044809,10.165124168
42,119,2005,396,388,237,9290,14,8,251,222,42762,9.2846592108,9.0970903379,5.556727861,-37,0.3282455277,0.1875688729,5.8849733887
42,119,2006,417,365,701,9898,18,52,719,748,43510,9.6670994065,8.4616097923,16.2509273,-23,0.4172848665,1.2054896142,16.668212166
42,119,2007,402,383,-73,9729,15,19,-58,-34,43476,9.2428666682,8.806014761,-1.678431012,5,0.3448830846,0.4368519072,-1.333547927
42,119,2008,449,373,52,9729,15,76,67,164,43640,10.308094954,8.5632949171,1.1938105514,21,0.3443684283,1.7448000367,1.5381789798
42,121,2001,615,649,-336,1830,4,-34,-332,-417,57052,10.740388226,11.334165786,-5.867919421,-51,0.0698561836,-0.59377756,-5.798063237
42,121,2002,593,654,-309,1830,2,-61,-307,-415,56637,10.431967912,11.505070851,-5.435882099,-47,0.0351837029,-1.073102939,-5.400698397
42,121,2003,574,666,-159,1830,-3,-92,-162,-331,56306,10.16441922,11.793559583,-2.81557954,-77,-0.053124142,-1.629140363,-2.868703682
42,121,2004,558,688,-327,1830,9,-130,-318,-490,55816,9.9534435704,12.272346194,-5.832931985,-42,0.1605394124,-2.318902624,-5.672392572
42,121,2005,604,721,-135,1830,3,-117,-132,-300,55516,10.850429346,12.952250925,-2.425178745,-51,0.053892861,-2.101821579,-2.371285884
42,121,2006,624,602,-382,1830,12,22,-370,-373,55143,11.277889733,10.880271826,-6.904092753,-25,0.2168824949,0.3976179073,-6.687210259
42,121,2007,643,642,-385,1830,7,1,-378,-388,54755,11.701759814,11.68356112,-7.006496934,-11,0.1273908533,0.0181986933,-6.87910608
42,121,2008,603,645,-292,1830,7,-42,-285,-332,54423,11.046181465,11.815567239,-5.349062998,-5,0.1282309623,-0.769385774,-5.220832036
42,123,2001,487,471,-240,1149,2,16,-238,-258,43528,11.155141214,10.788647869,-5.497400188,-36,0.0458116682,0.3664933459,-5.45158852
42,123,2002,422,492,-464,1018,1,-70,-463,-559,42969,9.7575638461,11.376117091,-10.72869579,-26,0.0231221892,-1.618553245,-10.7055736
42,123,2003,425,489,-336,1031,1,-64,-335,-439,42530,9.9416367443,11.438730278,-7.85974105,-40,0.0233920865,-1.497093533,-7.836348963
42,123,2004,405,485,-251,1033,2,-80,-249,-363,42167,9.5635028395,11.45258982,-5.927010402,-34,0.0472271745,-1.889086981,-5.879783227
42,123,2005,407,474,-494,1031,1,-67,-493,-598,41569,9.7210279927,11.3212955,-11.79898729,-38,0.0238845897,-1.600267507,-11.7751027
42,123,2006,371,477,-314,1009,2,-106,-312,-434,41135,8.9717546914,11.535113175,-7.593344941,-16,0.0483652544,-2.563358483,-7.544979687
42,123,2007,408,479,-109,1003,2,-71,-107,-171,40964,9.9392197225,11.668838841,-2.655330759,7,0.0487216653,-1.729619118,-2.606609094
42,123,2008,403,485,-173,1003,1,-82,-172,-236,40728,9.8663271801,11.873867698,-4.235420849,18,0.0244822014,-2.007540518,-4.210938648
42,125,2001,2055,2523,735,5452,50,-468,785,142,203089,10.122255169,12.427469485,3.6203686373,-175,0.2462835808,-2.305214316,3.866652218
42,125,2002,2025,2577,564,5570,39,-552,603,-122,202967,9.9739937349,12.692830546,2.7779419587,-173,0.1920917312,-2.718836811,2.9700336899
42,125,2003,2137,2329,985,5635,19,-192,1004,597,203564,10.513343386,11.457920798,4.8458789121,-215,0.0934738064,-0.944577412,4.9393527185
42,125,2004,2091,2449,643,5468,50,-358,693,183,203747,10.267338717,12.025209238,3.1572925848,-152,0.2455126427,-1.757870522,3.4028052275
42,125,2005,2006,2512,1824,6184,38,-506,1862,1158,204905,9.8176443527,12.29407907,8.9269109169,-198,0.1859773108,-2.476434717,9.1128882276
42,125,2006,2036,2298,537,6658,48,-262,585,231,205136,9.9307142456,11.208635234,2.6192502701,-92,0.2341229292,-1.277920988,2.8533731993
42,125,2007,2100,2421,504,6762,36,-321,540,296,205432,10.22973052,11.793417899,2.4551353247,77,0.1753668089,-1.563687379,2.6305021336
42,125,2008,2131,2356,1034,6762,37,-225,1071,975,206407,10.348704227,11.441364222,5.0213797139,129,0.179681866,-1.092659996,5.2010615799
42,127,2001,499,529,163,1848,7,-30,170,97,47990,10.408518716,11.034281364,3.3999770554,-43,0.1460112846,-0.625762648,3.54598834
42,127,2002,456,609,488,1728,5,-153,493,299,48289,9.4724706322,12.650733805,10.137205413,-41,0.1038648096,-3.178263173,10.241070223
42,127,2003,497,626,697,1819,-2,-129,695,544,48833,10.234550359,12.891003068,14.353081691,-22,-0.041185313,-2.656452709,14.311896378
42,127,2004,498,607,582,1807,8,-109,590,435,49268,10.152801704,12.375001274,11.865322474,-46,0.1630972161,-2.22219957,12.02841969
42,127,2005,444,603,1047,2461,4,-159,1051,849,50117,8.9349499421,12.134627962,21.069577904,-43,0.0804950445,-3.19967802,21.150072949
42,127,2006,474,575,1530,3523,8,-101,1538,1409,51526,9.3267613116,11.314109186,30.105368791,-28,0.157413693,-1.987347874,30.262782484
42,127,2007,477,635,339,3596,4,-158,343,189,51715,9.2405149117,12.3013144,6.5671583964,4,0.0774885946,-3.060799489,6.644646991
42,127,2008,495,634,417,3596,4,-139,421,301,52016,9.5439164763,12.223925345,8.0400266073,19,0.0771225574,-2.680008869,8.1171491647
42,129,2001,3513,4334,-315,8607,70,-821,-245,-1407,368283,9.5206735206,11.745687173,-0.853689769,-341,0.1897088376,-2.225013652,-0.663980932
42,129,2002,3405,4445,-186,8628,56,-1040,-130,-1508,366775,9.2645750403,12.094283716,-0.506082513,-338,0.1523689287,-2.829708676,-0.353713585
42,129,2003,3449,4374,870,8798,25,-925,895,-511,366264,9.4101405246,11.933880735,2.3736799816,-481,0.0682091949,-2.52374021,2.4418891764
42,129,2004,3447,4432,164,8948,51,-985,215,-1010,365254,9.4242383646,12.117268475,0.4483826782,-240,0.1394360768,-2.69303011,0.587818755
42,129,2005,3332,4450,557,9372,45,-1118,602,-879,364375,9.1334088969,12.197980069,1.526803348,-363,0.1233503603,-3.064571172,1.6501537083
42,129,2006,3382,4228,-250,9467,59,-846,-191,-1198,363177,9.2969299789,11.622536946,-0.687236101,-161,0.1621877199,-2.325606967,-0.525048381
42,129,2007,3339,4330,-155,9745,39,-991,-116,-1016,362161,9.206742236,11.93926142,-0.427386956,91,0.1075360728,-2.732519184,-0.319850883
42,129,2008,3403,4296,61,9745,41,-893,102,-572,361589,9.4037996546,11.871502591,0.168566494,219,0.113298791,-2.467702936,0.281865285
42,131,2001,333,269,1,734,4,64,5,40,28086,11.864889902,9.5845507019,0.0356303,-29,0.1425212,2.2803392005,0.1781515
42,131,2002,302,265,-175,735,4,37,-171,-155,27931,10.782441045,9.4614134995,-6.248103254,-21,0.1428137887,1.3210275452,-6.105289466
42,131,2003,306,266,-4,698,1,40,-3,-3,27928,10.956157468,9.5239800211,-0.143217745,-40,0.0358044362,1.4321774468,-0.107413309
42,131,2004,298,257,48,749,5,41,53,73,28001,10.656367895,9.1902233189,1.7164619428,-21,0.178798119,1.4661445762,1.8952600619
42,131,2005,313,285,-96,707,3,28,-93,-91,27910,11.196365653,10.194773837,-3.434029082,-26,0.1073134088,1.0015918156,-3.326715673
42,131,2006,303,277,-98,727,4,26,-94,-81,27829,10.872100325,9.9391808249,-3.516388884,-13,0.1435260769,0.9329194998,-3.372862807
42,131,2007,325,279,-64,741,3,46,-61,-21,27808,11.682872908,10.029297051,-2.30062728,-6,0.1078419038,1.6535758578,-2.192785377
42,131,2008,311,274,-84,741,3,37,-81,-49,27759,11.193694099,9.8619684345,-3.023377184,-5,0.1079777566,1.3317256645,-2.915399428
42,133,2001,4581,3408,1449,8015,308,1173,1757,2588,385297,11.9295943,8.8749306646,3.7734080202,-342,0.8020770671,3.0546636354,4.5754850874
42,133,2002,4656,3287,2095,8008,273,1369,2368,3411,388708,12.030930033,8.4934851842,5.4134017222,-326,0.7054217996,3.5374448485,6.1188235218
42,133,2003,4611,3292,3446,8187,212,1319,3658,4651,393359,11.791828577,8.4187160435,8.8125441938,-326,0.542153038,3.3731125338,9.3546972318
42,133,2004,4935,3416,4426,8131,243,1519,4669,5794,399153,12.454070096,8.6206896552,11.16954696,-394,0.6132399257,3.8333804409,11.782786885
42,133,2005,4905,3486,5697,8202,233,1419,5930,6968,406121,12.18218892,8.657922645,14.149221259,-381,0.578685019,3.5242662746,14.727906278
42,133,2006,5056,3395,6062,8311,337,1661,6399,7852,413973,12.330293844,8.279538687,14.78367114,-208,0.8218570066,4.0507551573,15.605528147
42,133,2007,5299,3440,4127,8300,274,1859,4401,6412,420385,12.701981643,8.2458608895,9.8926360148,152,0.6567924081,4.4561207539,10.549428423
42,133,2008,5433,3478,1792,8300,277,1955,2069,4198,424583,12.859658591,8.2322644171,4.2415807463,174,0.655646131,4.6273941735,4.8972268772
44,0,2001,12429,9855,2181,38945,3553,2574,5734,7340,1058065,11.787802484,9.3465921215,2.0684847709,-968,3.3697049019,2.4412103623,5.4381896728
44,0,2002,12385,9773,3053,38959,3162,2612,6215,7872,1065937,11.661947588,9.2024395457,2.8747618882,-955,2.9773983264,2.4595080419,5.8521602145
44,0,2003,12682,9912,1563,38932,2490,2770,4053,5365,1071302,11.867647933,9.2755185545,1.4626347358,-1458,2.33010908,2.5921293781,3.7927438157
44,0,2004,13263,9923,-5659,38921,2954,3340,-2705,-207,1071095,12.381458712,9.2634558394,-5.282867741,-842,2.7576588279,3.1180028725,-2.525208913
44,0,2005,12373,9989,-10937,38482,2825,2384,-8112,-6656,1064439,11.587734028,9.3550371944,-10.24287134,-928,2.6457082865,2.2326968337,-7.597163051
44,0,2006,12357,9538,-11100,39932,3285,2819,-7815,-5448,1058991,11.638716605,8.9835784556,-10.45478306,-452,3.0940506633,2.6551381491,-7.3607324
44,0,2007,12528,9318,-12013,38355,2816,3210,-9197,-5855,1053136,11.862923016,8.8233330666,-11.37526295,132,2.6665063228,3.0395899489,-8.708756623
44,0,2008,12743,9197,-8816,38355,2861,3546,-5955,-2348,1050788,12.113555433,8.7427112386,-8.380530856,61,2.7196799884,3.370844194,-5.660850867
44,1,2001,464,523,346,2774,25,-59,371,270,50994,9.1232623528,10.28333235,6.8031223579,-42,0.4915550837,-1.160069997,7.2946774416
44,1,2002,483,504,110,2774,23,-21,133,65,51059,9.465669799,9.8772206599,2.1557426043,-47,0.4507461809,-0.411550861,2.6064887852
44,1,2003,468,519,-60,2774,18,-51,-42,-163,50896,9.180520818,10.180962189,-1.176989848,-70,0.3530969545,-1.000441371,-0.823892894
44,1,2004,494,495,-23,2774,27,-1,4,-29,50867,9.7088332695,9.7284867781,-0.452030699,-32,0.5306447334,-0.019653509,0.0786140346
44,1,2005,459,526,-223,2774,23,-67,-200,-314,50553,9.0514691382,10.372707553,-4.397554723,-47,0.4535594557,-1.321238415,-3.943995267
44,1,2006,435,510,-328,2774,25,-75,-303,-399,50154,8.6389228157,10.128392267,-6.513946399,-21,0.496489817,-1.489469451,-6.017456582
44,1,2007,411,516,-148,2774,23,-105,-125,-213,49941,8.2121984115,10.310205305,-2.957190669,17,0.4595634148,-2.098006893,-2.497627254
44,1,2008,435,509,-87,2774,23,-74,-64,-103,49838,8.7192695858,10.20254763,-1.743853917,35,0.4610188517,-1.483278044,-1.282835065
44,3,2001,1894,1732,995,1871,151,162,1146,1171,168654,11.269214636,10.305321937,5.9202051544,-137,0.8984431943,0.9638926985,6.8186483487
44,3,2002,1834,1697,965,1871,137,137,1102,1109,169763,10.838699002,10.029047004,5.7030231933,-130,0.8096519974,0.8096519974,6.5126751907
44,3,2003,1831,1737,1206,1871,106,94,1312,1235,170998,10.746534961,10.194828634,7.0782748026,-171,0.6221369229,0.5517063279,7.7004117255
44,3,2004,1875,1719,-126,1871,137,156,11,58,171056,10.963181252,10.051044572,-0.73672578,-109,0.8010431102,0.9121366802,0.06431733
44,3,2005,1762,1763,-582,1871,128,-1,-454,-618,170438,10.319361394,10.325218013,-3.408551834,-163,0.7496471387,-0.005856618,-2.658904695
44,3,2006,1734,1697,-1288,1871,139,37,-1149,-1182,169256,10.209188269,9.9913451518,-7.583295554,-70,0.8183836041,0.2178431176,-6.76491195
44,3,2007,1721,1667,-1137,1871,117,54,-1020,-935,168321,10.196192276,9.8762652669,-6.736240917,31,0.6931751867,0.3199270092,-6.04306573
44,3,2008,1748,1600,-553,1871,119,148,-434,-263,168058,10.393038804,9.5130789972,-3.287957928,23,0.7075352504,0.8799598072,-2.580422678
44,5,2001,898,694,-472,2601,114,204,-358,-225,85433,10.497337674,8.1126418105,-5.517531606,-71,1.3326241591,2.3846958636,-4.184907447
44,5,2002,818,659,20,2615,-41,159,-21,56,85489,9.5716174629,7.711119692,0.2340248768,-82,-0.479750998,1.8604977709,-0.245726121
44,5,2003,847,721,27,2588,-288,126,-261,-260,85229,9.9227966588,8.4466781476,0.3163111095,-125,-3.373985169,1.4761185112,-3.057674059
44,5,2004,963,742,-1148,2577,272,221,-876,-744,84485,11.348503954,8.7441224649,-13.5286423,-89,3.2053926017,2.6043814889,-10.3232497
44,5,2005,821,756,-1768,2138,53,65,-1715,-1720,82765,9.8176382661,9.0403587444,-21.14200299,-70,0.6337817638,0.7772795217,-20.50822123
44,5,2006,837,709,120,3588,181,128,301,389,83154,10.089260422,8.5463388762,1.4464889494,-40,2.1817874987,1.5429215461,3.6282764481
44,5,2007,908,698,-2411,2011,70,210,-2341,-2061,81093,11.056518536,8.4993942051,-29.35822268,70,0.852374777,2.557124331,-28.5058479
44,5,2008,864,675,-932,2011,105,189,-827,-615,80478,10.694988581,8.3554598288,-11.53672379,23,1.2997381956,2.3395287521,-10.2369856
44,7,2001,7877,6012,494,26454,3145,1865,3639,4893,627759,12.596901549,9.6143928036,0.7900049975,-611,5.0294852574,2.9825087456,5.8194902549
44,7,2002,7991,6004,792,26454,2947,1987,3739,5127,632886,12.677637241,9.5252826926,1.256499649,-599,4.6753844262,3.1523545487,5.9318840752
44,7,2003,8254,6045,-319,26454,2608,2209,2289,3543,636429,13.005439942,9.5248224436,-0.50263331,-955,4.1093030493,3.4806174984,3.6066697392
44,7,2004,8613,5945,-4371,26454,2410,2668,-1961,176,636605,13.531453205,9.3398919432,-6.867059324,-531,3.7862303756,4.1915612623,-3.080828949
44,7,2005,8144,5958,-7690,26454,2534,2186,-5156,-3502,633103,12.828146314,9.3848349384,-12.11302126,-532,3.9914689047,3.4433113755,-8.121552357
44,7,2006,8152,5614,-8662,26454,2831,2538,-5831,-3560,629543,12.912566151,8.8924369934,-13.72039352,-267,4.4842339025,4.0201291573,-9.23615962
44,7,2007,8369,5429,-7737,26454,2521,2940,-5216,-2275,627268,13.317833787,8.6393260403,-12.31211375,1,4.0117408266,4.678507747,-8.300372928
44,7,2008,8496,5460,-6643,26454,2525,3036,-4118,-1118,626150,13.556531022,8.7121774221,-10.59981586,-36,4.0289831485,4.8443535995,-6.570832715
44,9,2001,1296,894,818,5245,118,402,936,1231,125225,10.400491134,7.1744128658,6.5645075215,-107,0.9469582977,3.2260782685,7.5114658192
44,9,2002,1259,909,1166,5245,96,350,1262,1515,126740,9.9934514714,7.2152878376,9.2552537059,-97,0.7620105967,2.7781636338,10.017264303
44,9,2003,1282,890,709,5245,46,392,755,1010,127750,10.075052065,6.9943809187,5.5719281701,-137,0.3615073284,3.0806711462,5.9334354984
44,9,2004,1318,1022,9,5245,108,296,117,332,128082,10.303636762,7.9896181869,0.0703586729,-81,0.8443040745,2.3140185747,0.9146627474
44,9,2005,1187,986,-674,5245,87,201,-587,-502,127580,9.2856975225,7.7133089783,-5.272586462,-116,0.6805860863,1.5723885442,-4.592000375
44,9,2006,1199,1008,-942,5245,109,191,-833,-696,126884,9.4237298793,7.9225352113,-7.403797787,-54,0.8567027163,1.501194668,-6.54709507
44,9,2007,1119,1008,-580,5245,85,111,-495,-371,126513,8.8319909075,7.9558952947,-4.577796896,13,0.6708840278,0.8760956128,-3.906912868
44,9,2008,1200,953,-601,5245,89,247,-512,-249,126264,9.4945347085,7.540242981,-4.755179466,16,0.7041779909,1.9542917275,-4.051001476
45,0,2001,56184,37063,14333,137625,6365,19121,20698,38448,4061844,13.897917687,9.1680642751,3.5454729853,-1371,1.5744739797,4.7298534119,5.1199469651
45,0,2002,55228,37122,19287,138122,4445,18106,23732,40367,4102211,13.529551185,9.0940102682,4.7248579291,-1471,1.0889196606,4.4355409169,5.8137775897
45,0,2003,54971,37820,26053,141098,-263,17151,25790,41209,4143420,13.333364057,9.1733428285,6.3192252964,-1732,-0.063791358,4.1600212282,6.2554339383
45,0,2004,56062,37763,29254,146202,7632,18299,36886,53379,4196799,13.44377168,9.0556375078,7.0151635107,-1806,1.830167769,4.3881341725,8.8453312797
45,0,2005,56965,38321,30133,140641,5306,18644,35439,52586,4249385,13.488931806,9.0741570394,7.1352932875,-1497,1.2564253869,4.4147747669,8.3917186744
45,0,2006,59321,38460,48538,143787,6594,20861,55132,75414,4324799,13.837118494,8.9711160852,11.321893722,-579,1.5381055503,4.8660024091,12.859999272
45,0,2007,61678,40178,54115,145561,4360,21500,58475,80115,4404914,14.130590547,9.2048845134,12.397887537,140,0.9988873632,4.9257060341,13.3967749
45,0,2008,60698,41085,49736,145971,5113,19613,54849,74886,4479800,13.663467389,9.2484687746,11.195858415,424,1.1509655798,4.4149986145,12.346823995
45,1,2001,322,248,1,801,15,74,16,63,26289,12.263162906,9.4449204989,0.0380843569,-27,0.5712653528,2.8182424069,0.6093497096
45,1,2002,330,252,-148,803,15,78,-133,-81,26208,12.57214698,9.6005486028,-5.638417433,-26,0.5714612264,2.9715983771,-5.066956207
45,1,2003,316,278,-106,802,12,38,-94,-96,26112,12.079510703,10.626911315,-4.051987768,-40,0.4587155963,1.4525993884,-3.593272171
45,1,2004,332,251,-205,807,10,81,-195,-135,25977,12.747413081,9.6373514562,-7.87114362,-21,0.3839582253,3.1100616253,-7.487185394
45,1,2005,271,227,-358,798,11,44,-347,-321,25656,10.497162667,8.7928262933,-13.8671005,-18,0.4260840935,1.704336374,-13.4410164
45,1,2006,304,265,-197,799,10,39,-187,-159,25497,11.885910895,10.361073642,-7.702383047,-11,0.390983911,1.5248372529,-7.311399136
45,1,2007,310,253,-115,799,9,57,-106,-51,25446,12.17046503,9.9326698467,-4.51484993,-2,0.3533360815,2.2377951829,-4.161513849
45,1,2008,290,266,-77,799,8,24,-69,-42,25404,11.406096362,10.462143559,-3.028515241,3,0.3146509341,0.9439528024,-2.713864307
45,3,2001,1892,1412,152,2048,174,480,326,654,143378,13.226052247,9.8706055882,1.0625581086,-152,1.2163494138,3.3554466589,2.2789075225
45,3,2002,1840,1429,847,2086,155,411,1002,1275,144653,12.77640254,9.9225430596,5.8813113866,-138,1.0762730401,2.8538594804,6.9575844267
45,3,2003,1780,1432,916,2101,115,348,1031,1213,145866,12.253931757,9.8582192559,6.3059558927,-166,0.7916866023,2.3957125007,7.097642495
45,3,2004,1780,1373,1185,2079,154,407,1339,1622,147488,12.135508635,9.3607041322,8.0789762539,-124,1.0499260279,2.7748045024,9.1289022819
45,3,2005,1926,1432,518,2087,143,494,661,1040,148528,13.012810118,9.6751526944,3.499810821,-115,0.9661639911,3.3376574239,4.4659748122
45,3,2006,1965,1393,952,2097,154,572,1106,1597,150125,13.159084288,9.3285518645,6.3752917265,-81,1.0312971911,3.8305324239,7.4065889176
45,3,2007,2059,1513,1597,2092,130,546,1727,2208,152333,13.615113503,10.004694867,10.560143888,-65,0.8596234849,3.6104186366,11.419767373
45,3,2008,1943,1568,1280,2085,136,375,1416,1738,154071,12.682602055,10.234853331,8.3549823109,-53,0.8877168705,2.4477487239,9.2426991815
45,5,2001,180,113,-308,1103,7,67,-301,-237,10963,16.243288363,10.197175473,-27.7940712,-3,0.6316834364,6.0461128909,-27.16238776
45,5,2002,180,114,-23,1251,7,66,-16,37,11000,16.391203388,10.381095479,-2.094431544,-13,0.6374356873,6.0101079088,-1.456995857
45,5,2003,178,119,-144,1314,5,59,-139,-87,10913,16.24606398,10.861132661,-13.14288322,-7,0.4563501118,5.3849313193,-12.68653311
45,5,2004,143,133,-111,1254,8,10,-103,-103,10810,13.165769001,12.245085854,-10.21958293,-10,0.7365465175,0.9206831469,-9.483036413
45,5,2005,144,133,-92,1293,7,11,-85,-83,10727,13.37233598,12.350838093,-8.543436876,-9,0.6500441101,1.0214978874,-7.893392766
45,5,2006,151,115,-220,1283,7,36,-213,-181,10546,14.196399191,10.811827199,-20.68349551,-4,0.6581112208,3.3845719927,-20.02538429
45,5,2007,143,114,-130,1294,4,29,-126,-93,10453,13.619696176,10.857659889,-12.38154198,4,0.3809705224,2.7620362874,-12.00057146
45,5,2008,148,135,-25,1360,6,13,-19,-6,10447,14.162679426,12.918660287,-2.392344498,0,0.5741626794,1.2440191388,-1.818181818
45,7,2001,2268,1747,1854,2666,126,521,1980,2377,168690,13.540177252,10.429757345,11.068557595,-124,0.7522320696,3.1104199067,11.820789665
45,7,2002,2145,1796,857,2710,118,349,975,1184,169874,12.671164093,10.609515483,5.0625583346,-140,0.6970617077,2.06164861,5.7596200423
45,7,2003,2207,1821,968,2773,96,386,1064,1258,171132,12.94405377,10.680163985,5.6773194607,-192,0.5630399465,2.2638897849,6.2403594072
45,7,2004,2210,1834,1112,2768,108,376,1220,1456,172588,12.859304085,10.671476783,6.4703828698,-140,0.6284184802,2.1878273013,7.0988013499
45,7,2005,2205,1808,1285,2770,107,397,1392,1644,174232,12.71552967,10.426157661,7.4101839571,-145,0.6170347731,2.2893720085,8.0272187302
45,7,2006,2328,1862,2245,2811,110,466,2355,2726,176958,13.257780689,10.603946582,12.785102081,-95,0.6264415274,2.6538341069,13.411543609
45,7,2007,2475,1866,2295,2816,98,609,2393,3006,179964,13.868576328,10.456066031,12.859952595,4,0.5491395879,3.4125102964,13.409092183
45,7,2008,2369,1924,2294,2816,101,445,2395,2861,182825,13.059932909,10.606716301,12.646469435,21,0.5567974773,2.453216608,13.203266913
45,9,2001,247,176,-272,1065,8,71,-264,-204,16406,14.962442452,10.661497456,-16.4768597,-11,0.4846135207,4.3009449964,-15.99224618
45,9,2002,202,175,-160,1065,6,27,-154,-143,16263,12.36646362,10.713520463,-9.795218709,-16,0.3673207016,1.6529431571,-9.427898007
45,9,2003,191,175,-327,1065,0,16,-327,-314,15949,11.858934559,10.865515957,-20.30299267,-3,0,0.9934186018,-20.30299267
45,9,2004,179,145,-172,1065,10,34,-162,-143,15806,11.273815147,9.1324200913,-10.83293969,-15,0.6298220753,2.1413950559,-10.20311762
45,9,2005,174,188,-58,1065,7,-14,-51,-79,15727,11.036057464,11.92401611,-3.678685821,-14,0.4439793232,-0.887958646,-3.234706498
45,9,2006,209,176,-123,1063,10,33,-113,-87,15640,13.326107055,11.221984889,-7.842637166,-7,0.6376127778,2.1041221666,-7.205024389
45,9,2007,214,176,-229,1063,7,38,-222,-175,15465,13.759845684,11.3165086,-14.72432085,9,0.4500884102,2.4433370841,-14.27423244
45,9,2008,182,191,-166,1063,9,-9,-157,-158,15307,11.828935396,12.413882751,-10.78902899,8,0.5849473547,-0.584947355,-10.20408163
45,11,2001,327,229,-133,277,3,98,-130,-52,23395,13.961829128,9.7775500619,-5.678664446,-20,0.1280901755,4.1842790658,-5.550574271
45,11,2002,350,255,-281,277,3,95,-278,-196,23199,15.02339357,10.945615315,-12.06163884,-13,0.1287719449,4.0777782547,-11.93286689
45,11,2003,341,258,10,277,1,83,11,60,23259,14.679925955,11.106806147,0.4304963623,-34,0.0430496362,3.5731198071,0.4735459985
45,11,2004,322,236,-280,277,4,86,-276,-212,23047,13.907484991,10.193063534,-12.09346521,-22,0.1727637887,3.7144214573,-11.92070142
45,11,2005,345,248,-85,277,3,97,-82,-6,23041,14.971359139,10.762020483,-3.68859573,-21,0.1301857316,4.2093386565,-3.558409998
45,11,2006,291,242,-127,277,3,49,-124,-86,22955,12.653274198,10.522654144,-5.522219323,-11,0.1304461258,2.1306200539,-5.391773198
45,11,2007,338,222,-119,277,2,116,-117,6,22961,14.722536806,9.6698318669,-5.183378343,7,0.0871156024,5.0527049395,-5.096262741
45,11,2008,326,274,-156,277,4,52,-152,-89,22872,14.225558004,11.956450592,-6.807322235,11,0.174546724,2.2691074117,-6.632775511
45,13,2001,1864,913,1443,6238,371,951,1814,2672,124740,15.104858838,7.398463583,11.693300055,-93,3.0063855305,7.7063952546,14.699685586
45,13,2002,1978,994,2810,6803,-64,984,2746,3675,128415,15.626789911,7.8528964468,22.199838044,-55,-0.505619087,7.7738934645,21.694218957
45,13,2003,2029,1048,2494,6191,-1093,981,1401,2378,130793,15.655381007,8.0861701799,19.243233234,-4,-8.433381686,7.5692108268,10.809851548
45,13,2004,2232,1054,1760,6133,1004,1178,2764,3802,134595,16.820655041,7.9430871027,13.263598957,-140,7.5662803141,8.8775679383,20.829879271
45,13,2005,2083,1090,3114,6200,363,993,3477,4374,138969,15.228611952,7.9688847948,22.766153441,-96,2.6538579638,7.2597271571,25.420011405
45,13,2006,2252,1042,2316,5910,683,1210,2999,4122,143091,15.968233709,7.3884989009,16.422037864,-87,4.8429412182,8.5797348082,21.264979082
45,13,2007,2419,1214,2251,5802,219,1205,2470,3631,146722,16.693523065,8.37781604,15.534154783,-44,1.511319368,8.3157070249,17.045474151
45,13,2008,2369,1275,2212,5802,398,1094,2610,3693,150415,15.945506618,8.5818999317,14.888755019,-11,2.6788989591,7.3636066865,17.567653978
45,15,2001,2112,933,451,5253,49,1179,500,1527,144763,14.666717593,6.4791891639,3.1319553193,-152,0.3402789593,8.1875284289,3.4722342786
45,15,2002,2096,982,947,4851,-219,1114,728,1709,146472,14.393874363,6.7436949542,6.5033392278,-133,-1.503940117,7.6501794084,4.9993991107
45,15,2003,2099,963,1756,4808,-886,1136,870,1920,148392,14.237072006,6.5318248413,11.910575723,-86,-6.009550166,7.7052471648,5.9010255575
45,15,2004,2223,942,1353,4697,506,1281,1859,3005,151397,14.830430736,6.2844200421,9.0263485318,-135,3.375707581,8.5460106942,12.402056113
45,15,2005,2155,1011,208,2982,78,1144,286,1291,152688,14.173668547,6.6494565664,1.3680385419,-139,0.5130144532,7.5242119802,1.8810529951
45,15,2006,2270,994,4218,5478,291,1276,4509,5694,158382,14.59478574,6.3908445045,27.119297907,-91,1.8709615199,8.2039412351,28.990259427
45,15,2007,2564,1058,3630,5421,-1,1506,3629,5173,163555,15.9285823,6.5727145373,22.550996002,38,-0.006212396,9.3558677629,22.544783607
45,15,2008,2594,1114,4191,5429,116,1480,4307,5772,169327,15.585102228,6.6930624065,25.180093847,-15,0.6969436617,8.8920398219,25.877037509
45,17,2001,192,159,14,160,7,33,21,37,15261,12.596358865,10.431359685,0.9184845006,-17,0.4592422503,2.1649991799,1.3777267509
45,17,2002,183,151,-147,152,6,32,-141,-122,15139,12.039473684,9.9342105263,-9.671052632,-13,0.3947368421,2.1052631579,-9.276315789
45,17,2003,183,168,-16,161,0,15,-16,-22,15117,12.096774194,11.105235325,-1.05764146,-21,0,0.9915388683,-1.05764146
45,17,2004,176,172,-142,153,6,4,-136,-143,14974,11.697849855,11.431989631,-9.438037952,-11,0.398790336,0.265860224,-9.039247616
45,17,2005,151,172,-83,160,4,-21,-79,-112,14862,10.122000268,11.52969567,-5.563748492,-12,0.2681324574,-1.407695402,-5.295616034
45,17,2006,173,169,-82,156,5,4,-77,-80,14782,11.671839158,11.401970045,-5.532316826,-7,0.3373363918,0.2698691135,-5.194980434
45,17,2007,167,143,-55,156,1,24,-54,-35,14747,11.310914694,9.6853940194,-3.725151546,-5,0.0677300281,1.6255206746,-3.657421518
45,17,2008,163,168,-162,156,3,-5,-159,-164,14583,11.11489942,11.455847255,-11.04670985,0,0.204568701,-0.340947835,-10.84214115
45,19,2001,4570,2810,761,11580,587,1760,1348,3389,314279,14.620046739,8.9895692205,2.4345416999,281,1.8778922179,5.6304775189,4.3124339179
45,19,2002,4546,2764,3014,12128,376,1782,3390,5444,319723,14.340648768,8.7192153968,9.5078564421,272,1.1861161321,5.6214333709,10.693972574
45,19,2003,4617,2825,3216,12212,-135,1792,3081,5177,324900,14.324651773,8.7648129217,9.9779250818,304,-0.418849467,5.5598388515,9.5590756147
45,19,2004,4715,2715,4653,12606,749,2000,5402,7661,332561,14.34305609,8.2590450232,14.154451747,259,2.2784621445,6.0840110668,16.432913891
45,19,2005,4815,2756,1456,12562,490,2059,1946,4304,336865,14.385458587,8.2339198059,4.3499953692,299,1.4639407492,6.151538781,5.8139361184
45,19,2006,4891,2753,1004,12520,628,2138,1632,3760,340625,14.438589499,8.1270572259,2.9638813857,-10,1.8539019026,6.3115322735,4.8177832883
45,19,2007,5025,2888,477,13039,396,2137,873,2897,343522,14.689825432,8.4426300196,1.3944371604,-113,1.1576459445,6.2471954127,2.5520831049
45,19,2008,4926,2934,2086,13040,475,1992,2561,4524,348046,14.245887606,8.4850658214,6.0326677926,-29,1.3736899336,5.7608217847,7.4063577262
45,21,2001,801,536,71,729,34,265,105,319,52986,15.162844406,10.146422723,1.344022413,-51,0.6436163668,5.0164216823,1.9876387798
45,21,2002,742,588,195,763,34,154,229,338,53324,13.959175995,11.061988524,3.6685166024,-45,0.6396387922,2.8971874706,4.3081553946
45,21,2003,697,570,-151,716,27,127,-124,-74,53250,13.080113348,10.696792839,-2.833711787,-77,0.5066901871,2.3833205097,-2.3270216
45,21,2004,701,598,68,752,24,103,92,160,53410,13.144571536,11.213200825,1.2750796925,-35,0.4500281268,1.9313707107,1.7251078192
45,21,2005,648,618,78,837,25,30,103,86,53496,12.122799469,11.561558753,1.459225862,-47,0.4677005968,0.5612407161,1.9269264588
45,21,2006,668,572,160,835,25,96,185,256,53752,12.457108757,10.666865583,2.9837386245,-25,0.4662091601,1.7902431747,3.4499477846
45,21,2007,684,554,30,847,25,130,55,181,53933,12.703719181,10.289269629,0.5571806658,-4,0.4643172215,2.4144495519,1.0214978874
45,21,2008,683,585,327,847,24,98,351,461,54394,12.609967967,10.800631422,6.0372760254,12,0.4431028275,1.8093365458,6.4803788529
45,23,2001,503,361,-296,316,12,142,-284,-174,33934,14.784985744,10.611093148,-8.700508509,-32,0.352723318,4.1738925957,-8.347785191
45,23,2002,509,316,-235,316,12,193,-223,-67,33867,15.014527809,9.3213964396,-6.93205115,-37,0.35397708,5.6931313697,-6.57807407
45,23,2003,432,328,-345,316,11,104,-334,-266,33601,12.806071026,9.7231280014,-10.22707061,-36,0.3260805122,3.0829430248,-9.900990099
45,23,2004,410,364,-389,316,12,46,-377,-364,33237,12.268470032,10.892007541,-11.64008498,-33,0.3590771717,1.3764624914,-11.28100781
45,23,2005,397,329,-407,316,12,68,-395,-350,32887,12.007743028,9.9510011494,-12.31020507,-23,0.3629544492,2.0567418789,-11.94725062
45,23,2006,449,393,-300,316,12,56,-288,-245,32642,13.703856308,11.994689374,-9.156251431,-13,0.3662500572,1.7091669337,-8.790001373
45,23,2007,468,366,-173,316,9,102,-164,-68,32574,14.352306183,11.22423945,-5.305446516,-6,0.2760058881,3.1280667321,-5.029440628
45,23,2008,408,369,8,316,9,39,17,44,32618,12.516873236,11.320407412,0.245428887,-12,0.2761074979,1.196465824,0.5215363848
45,25,2001,617,401,-175,661,49,216,-126,43,42876,14.397554516,9.3572436967,-4.083585154,-47,1.1434038432,5.0403108192,-2.940181311
45,25,2002,568,399,-76,658,49,169,-27,99,42975,13.23222793,9.2951741972,-1.770509371,-43,1.1415126207,3.9370537326,-0.62899675
45,25,2003,520,425,-241,653,44,95,-197,-149,42826,12.12107085,9.9066444447,-5.617650144,-47,1.0256290719,2.2144264053,-4.592021072
45,25,2004,525,437,-238,656,42,88,-196,-141,42685,12.279121984,10.220907252,-5.5665353,-33,0.9823297587,2.0582147326,-4.584205541
45,25,2005,548,474,-70,659,43,74,-27,9,42694,12.836880263,11.103432928,-1.639747479,-38,1.0072734513,1.7334473348,-0.632474028
45,25,2006,555,436,-229,657,43,119,-186,-87,42607,13.01274311,10.222623416,-5.369221932,-20,1.0081945112,2.7901196938,-4.361027421
45,25,2007,575,459,15,657,37,116,52,163,42770,13.469669817,10.752310341,0.3513826909,-5,0.8667439709,2.7173594762,1.2181266617
45,25,2008,535,457,4,657,39,78,43,112,42882,12.492411152,10.671087657,0.0934012049,-9,0.9106617475,1.8213234951,1.0040629524
45,27,2001,443,332,62,1590,23,111,85,162,32697,13.5822909,10.179053225,1.90090753,-34,0.705175374,3.4032376748,2.6060829041
45,27,2002,444,340,-102,1687,21,104,-81,-14,32683,13.58213521,10.400734169,-3.120220251,-37,0.6423982869,3.1814010401,-2.477821964
45,27,2003,387,340,-53,1701,17,47,-36,-34,32649,11.847180555,10.408375681,-1.622482091,-45,0.5204187841,1.4388048736,-1.102063307
45,27,2004,403,315,2,1681,23,88,25,91,32740,12.326232241,9.6346480295,0.0611723684,-22,0.7034822371,2.6915842114,0.7646546055
45,27,2005,430,349,-91,1581,21,81,-70,-19,32721,13.137593376,10.662837415,-2.780281389,-30,0.6416033974,2.4747559616,-2.138677991
45,27,2006,404,354,-39,1615,23,50,-16,19,32740,12.343227265,10.815600128,-1.191549167,-15,0.7027084829,1.5276271368,-0.488840684
45,27,2007,403,366,-129,1546,18,37,-111,-62,32678,12.320767984,11.189580849,-3.94386866,12,0.5503072549,1.131187135,-3.393561405
45,27,2008,425,368,378,1735,20,57,398,471,33149,12.912634633,11.180822459,11.484649156,16,0.6076533945,1.7318121743,12.092302551
45,29,2001,572,366,-101,332,24,206,-77,87,38424,14.903401467,9.536092547,-2.631544665,-42,0.6253175441,5.3673089199,-2.006227121
45,29,2002,554,386,19,331,18,168,37,167,38591,14.386807765,10.024021295,0.4934103746,-38,0.4674414075,4.3627864702,0.9608517821
45,29,2003,495,405,69,333,3,90,72,109,38700,12.808735817,10.479874759,1.7854601441,-53,0.0776287019,2.3288610576,1.863088846
45,29,2004,507,410,57,319,26,97,83,152,38852,13.075097999,10.57355065,1.4699814318,-28,0.6705178461,2.5015473489,2.1404992779
45,29,2005,514,406,-14,331,18,108,4,74,38926,13.217105094,10.439970172,-0.359998971,-38,0.4628558204,2.7771349225,0.102856849
45,29,2006,557,405,-238,334,22,152,-216,-82,38844,14.324289572,10.415327247,-6.120612061,-18,0.5657708628,3.9089623248,-5.554841198
45,29,2007,570,429,-92,334,17,141,-75,72,38916,14.660493827,11.033950617,-2.366255144,6,0.4372427984,3.6265432099,-1.929012346
45,29,2008,518,416,-17,334,20,102,3,103,39019,13.293128889,10.675562969,-0.436260987,-2,0.5132482197,2.6175659203,0.076987233
45,31,2001,924,778,4,1247,27,146,31,111,67551,13.689801542,11.526694372,0.0592632101,-66,0.4000266684,2.1631071701,0.4592898786
45,31,2002,927,682,-57,1268,24,245,-33,146,67697,13.708150952,10.08517686,-0.842896013,-66,0.3549035845,3.622974092,-0.487992429
45,31,2003,881,745,-200,1289,21,136,-179,-142,67555,13.027533789,11.016472954,-2.957442404,-99,0.3105314524,2.0110608346,-2.646910951
45,31,2004,831,731,-522,1272,21,100,-501,-459,67096,12.343020104,10.857698792,-7.753377249,-58,0.3119174755,1.4853213121,-7.441459774
45,31,2005,851,689,-358,1315,22,162,-336,-234,66862,12.70547485,10.286806312,-5.344958868,-60,0.3284611595,2.4186685379,-5.016497708
45,31,2006,912,743,-173,1354,22,169,-151,-12,66850,13.641258825,11.113437837,-2.587651071,-30,0.3290654541,2.5278209884,-2.258585617
45,31,2007,841,760,-152,1383,18,81,-134,-44,66806,12.5845454,11.372478602,-2.27449572,9,0.2693481774,1.2120667983,-2.005147543
45,31,2008,855,764,76,1383,19,91,95,225,67031,12.77673588,11.416872763,1.135709856,39,0.283927464,1.3598631171,1.41963732
45,33,2001,553,312,-27,428,21,241,-6,204,30883,17.965628147,10.136122933,-0.877164485,-31,0.6822390436,7.8295052143,-0.194925441
45,33,2002,511,353,-247,428,21,158,-226,-90,30793,16.570465011,11.446916142,-8.009598547,-22,0.6809780141,5.1235488683,-7.328620533
45,33,2003,491,345,-150,428,12,146,-138,-29,30764,15.952694251,11.209123252,-4.873531849,-37,0.3898825479,4.7435709992,-4.483649301
45,33,2004,466,379,-44,425,16,87,-28,39,30803,15.137979762,12.311790407,-1.429337145,-20,0.5197589618,2.8261893547,-0.909578183
45,33,2005,486,318,-269,428,15,168,-254,-113,30690,15.806677183,10.342640626,-8.748963297,-27,0.4878604069,5.464036557,-8.26110289
45,33,2006,451,309,-153,427,16,142,-137,-8,30682,14.697256078,10.069738643,-4.985987095,-13,0.5214104152,4.6275174347,-4.46457668
45,33,2007,483,357,-151,427,11,126,-140,-14,30668,15.745721271,11.638141809,-4.922575387,0,0.358598207,4.1075794621,-4.56397718
45,33,2008,474,348,-128,427,13,126,-115,30,30698,15.448293843,11.341785353,-4.171691164,19,0.4236873839,4.10650849,-3.748003781
45,35,2001,1274,704,1105,2096,92,570,1197,1687,98402,13.058831368,7.2161831106,11.326537411,-80,0.9430239292,5.8426482572,12.26956134
45,35,2002,1190,677,1640,2176,43,513,1683,2138,100540,11.963285782,6.8060037599,16.48721738,-58,0.4322867972,5.1572820219,16.919504177
45,35,2003,1335,793,2322,2303,-73,542,2249,2819,103359,13.094718464,7.7783608551,22.775982226,28,-0.716040785,5.3163576084,22.059941442
45,35,2004,1375,755,2165,2295,148,620,2313,2802,106161,13.125238641,7.2069492173,20.666284842,-131,1.4127529591,5.9182894234,22.079037801
45,35,2005,1551,755,4658,2361,85,796,4743,5448,111609,14.244386279,6.9339211094,42.779078845,-91,0.7806401249,7.3104651697,43.55971897
45,35,2006,1630,735,5081,2363,119,895,5200,6026,117635,14.220655721,6.4123815672,44.328313936,-69,1.0381951109,7.8082741533,45.366509047
45,35,2007,1820,862,4641,2346,62,958,4703,5722,123357,15.104235825,7.1537644403,38.515801354,61,0.5145399017,7.9504713849,39.030341256
45,35,2008,1837,876,2700,2303,82,961,2782,3776,127133,14.667252186,6.9942911893,21.557746816,33,0.6547167552,7.6729609964,22.212463571
45,37,2001,304,215,-107,2730,13,89,-94,-27,24511,12.395767498,8.7667434606,-4.362983955,-22,0.5300821627,3.6290240372,-3.832901792
45,37,2002,268,214,77,2664,13,54,90,122,24633,10.906723099,8.7090997884,3.1336480547,-22,0.5290574638,2.1976233111,3.6627055185
45,37,2003,269,202,224,3023,11,67,235,283,24916,10.857938606,8.1535449757,9.0415548245,-19,0.4440049244,2.7043936305,9.4855597489
45,37,2004,241,225,248,3239,10,16,258,249,25165,9.6244084583,8.9854435814,9.9039555919,-25,0.3993530481,0.6389648769,10.30330864
45,37,2005,272,209,161,3115,11,63,172,212,25377,10.763325551,8.2703494124,6.370939021,-23,0.435281548,2.4929761387,6.806220569
45,37,2006,244,239,-249,2917,10,5,-239,-244,25133,9.6614531776,9.4634725797,-9.859433775,-10,0.3959611958,0.1979805979,-9.46347258
45,37,2007,248,202,166,3002,9,46,175,225,25358,9.8235329069,8.0014259967,6.5754292844,4,0.3564991781,1.8221069101,6.9319284625
45,37,2008,265,244,148,3051,8,21,156,188,25546,10.411755461,9.586672953,5.814867201,11,0.314317146,0.8250825083,6.129184347
45,39,2001,322,272,21,430,6,50,27,52,23582,13.669553405,11.546951944,0.8914926133,-25,0.2547121752,2.1226014603,1.1462047886
45,39,2002,324,264,126,421,6,60,132,172,23754,13.689369613,11.154301166,5.3236437384,-20,0.2535068447,2.5350684468,5.5771505831
45,39,2003,295,280,-83,421,-1,15,-84,-96,23658,12.444106977,11.811355775,-3.501223319,-27,-0.042183413,0.6327512022,-3.543406732
45,39,2004,288,296,294,421,2,-8,296,263,23921,12.106181298,12.442464112,12.358393409,-25,0.0840707035,-0.336282814,12.442464112
45,39,2005,311,302,-232,421,1,9,-231,-244,23677,13.067775957,12.689608807,-9.748308752,-22,0.0420185722,0.3781671499,-9.70629018
45,39,2006,322,285,-97,435,2,37,-95,-69,23608,13.619541081,12.054562758,-4.102781009,-11,0.0845934229,1.5649783229,-4.018187586
45,39,2007,275,296,-317,435,1,-21,-316,-324,23284,11.729079587,12.624754756,-13.52042992,13,0.0426511985,-0.895675168,-13.47777873
45,39,2008,297,290,127,435,3,7,130,151,23435,12.714313234,12.414649286,5.4367602046,14,0.1284274064,0.2996639483,5.565187611
45,41,2001,1863,1306,-95,3864,76,557,-19,408,126234,14.782194716,10.362612076,-0.75378878,-130,0.6030310244,4.4195826391,-0.150757756
45,41,2002,1834,1338,309,3871,69,496,378,752,126986,14.485427691,10.567885633,2.4405655162,-122,0.5449806492,3.9175420583,2.9855461654
45,41,2003,1891,1251,463,3796,49,640,512,998,127984,14.833117622,9.812919167,3.6317998196,-154,0.3843589442,5.0201984547,4.0161587638
45,41,2004,1948,1342,367,3804,69,606,436,955,128939,15.164076396,10.446709715,2.8568870829,-87,0.5371259093,4.7173666818,3.3940129922
45,41,2005,1924,1388,388,3768,64,536,452,869,129808,14.87167001,10.728626805,2.9990685882,-119,0.4946917259,4.1430432044,3.4937603141
45,41,2006,1903,1334,370,3816,67,569,437,943,130751,14.607056367,10.239523486,2.8400477435,-63,0.5142789157,4.3675328812,3.3543266592
45,41,2007,1956,1340,288,3803,55,616,343,980,131731,14.903879123,10.210223939,2.1944361899,21,0.4190763557,4.693655184,2.6135125456
45,41,2008,1976,1363,325,3795,58,613,383,1069,132800,14.939647905,10.305030412,2.4571789318,73,0.4385119324,4.6346174928,2.8956908642
45,43,2001,750,565,555,584,60,185,615,743,56785,13.294690101,10.015333209,9.8380706746,-57,1.0635752081,3.2793568915,10.901645883
45,43,2002,751,548,684,581,54,203,738,894,57679,13.122029634,9.5750629019,11.951355885,-47,0.9435280962,3.5469667319,12.894883981
45,43,2003,698,570,564,583,39,128,603,676,58355,12.030956444,9.8247065515,9.7212885878,-55,0.6722167641,2.2062498923,10.393505352
45,43,2004,732,549,608,583,50,183,658,786,59141,12.459998638,9.3449989787,10.349288486,-55,0.8510928032,3.1149996596,11.20038129
45,43,2005,725,641,236,583,45,84,281,323,59464,12.225454239,10.808987817,3.9795961384,-42,0.7588212976,1.4164664222,4.738417436
45,43,2006,697,565,301,583,49,132,350,448,59912,11.67738909,9.465889291,5.0428896931,-34,0.8209355314,2.211499799,5.8638252245
45,43,2007,741,615,354,583,43,126,397,476,60388,12.319201995,10.224438903,5.885286783,-47,0.714879468,2.0947630923,6.600166251
45,43,2008,762,629,253,583,45,133,298,343,60731,12.582666634,10.386479413,4.1777095253,-88,0.7430708642,2.1961872208,4.9207803895
45,45,2001,5352,3472,2191,11053,1358,1880,3549,5093,386183,13.950705942,9.0502337499,5.7111354107,-336,3.5398091683,4.9004721918,9.250944579
45,45,2002,5471,3350,1383,11012,1271,2121,2654,4428,390611,14.086102622,8.6251953542,3.5607896045,-347,3.2724248642,5.4609072676,6.8332144687
45,45,2003,5429,3331,1217,11139,1100,2098,2317,3900,394511,13.829697805,8.4853054684,3.1001551351,-515,2.8021122832,5.3443923365,5.9022674183
45,45,2004,5637,3247,2020,11029,1037,2390,3057,5138,399649,14.196131762,8.1771935126,5.0871360935,-309,2.6115644203,6.0189382492,7.6987005138
45,45,2005,5775,3282,2971,10987,1076,2493,4047,6171,405820,14.339471786,8.1492894202,7.3770685154,-369,2.6717353492,6.1901823658,10.048803865
45,45,2006,6010,3380,6364,11123,1086,2630,7450,9855,415675,14.631860206,8.2288997498,15.493703553,-225,2.6439600971,6.4029604562,18.13766365
45,45,2007,6255,3494,7870,11134,995,2761,8865,11753,427428,14.838044699,8.2884297648,18.669130581,127,2.3603284533,6.5496149344,21.029459034
45,45,2008,6204,3566,6878,11112,1001,2638,7879,10691,438119,14.335443367,8.2398760553,15.892840019,174,2.3129882028,6.0955673118,18.205828222
45,47,2001,957,670,-116,2316,160,287,44,267,66553,14.408419214,10.087399032,-1.746475056,-64,2.4089311121,4.3210201823,0.6624560558
45,47,2002,920,677,81,2356,153,243,234,414,66967,13.78070701,10.140802876,1.2133013781,-63,2.2917914919,3.6399041342,3.50509287
45,47,2003,819,674,85,2536,130,145,215,264,67231,12.205845095,10.044859089,1.2667848999,-96,1.9374357293,2.1609860058,3.2042206292
45,47,2004,857,710,-270,2530,131,147,-139,-43,67188,12.751173569,10.56398277,-4.017289223,-51,1.9491292154,2.1871907989,-2.068160007
45,47,2005,877,672,129,2542,132,205,261,407,67595,13.013510606,9.9715839535,1.9141879911,-59,1.9587039909,3.0419266525,3.8728919819
45,47,2006,925,691,-50,2543,135,234,85,286,67881,13.655555227,10.201068824,-0.73813812,-33,1.9929729251,3.4544864035,1.2548348047
45,47,2007,947,723,-41,2513,121,224,80,292,68173,13.920943155,10.628132947,-0.602701868,-12,1.778705514,3.2928102077,1.1760036456
45,47,2008,886,708,66,2551,123,178,189,376,68549,12.960606194,10.356782376,0.9654627639,9,1.7992715145,2.6038238177,2.7647342783
45,49,2001,299,207,-85,1712,7,92,-78,-5,21352,14.001732656,9.6935072233,-3.980425671,-19,0.3277997612,4.3082254326,-3.65262591
45,49,2002,286,219,-204,1712,5,67,-199,-147,21205,13.440797049,10.292078859,-9.587141951,-15,0.2349789694,3.1487181897,-9.352162981
45,49,2003,284,205,-10,1712,-4,79,-14,34,21239,13.382339082,9.6597870135,-0.471209123,-31,-0.188483649,3.7225520686,-0.659692772
45,49,2004,276,205,-244,1715,6,71,-238,-187,21052,13.052422501,9.6947341042,-11.53909815,-20,0.2837483152,3.3576883971,-11.25534984
45,49,2005,270,218,-105,1718,2,52,-103,-70,20982,12.846743113,10.37255555,-4.995955655,-19,0.0951610601,2.4741875624,-4.900794595
45,49,2006,314,182,-33,1712,4,132,-29,93,21075,14.932115938,8.6549207029,-1.569298809,-10,0.1902180374,6.277195235,-1.379080771
45,49,2007,303,220,5,1712,0,83,5,91,21166,14.346251272,10.416420066,0.2367368197,3,0,3.9298312066,0.2367368197
45,49,2008,302,215,-192,1712,2,87,-190,-91,21075,14.298903909,10.179683246,-9.090693876,12,0.0946947279,4.1192206624,-8.995999148
45,51,2001,2518,1916,2794,2505,438,602,3232,3713,201833,12.591479499,9.5811257823,13.971641668,-121,2.1902573552,3.0103537166,16.161899023
45,51,2002,2596,1909,3282,2507,408,687,3690,4277,206110,12.72726827,9.3591506657,16.090483229,-100,2.0002794508,3.3681176047,18.09076268
45,51,2003,2608,1978,3754,2508,361,630,4115,4730,210840,12.509893273,9.4879481952,18.00695527,-15,1.7316224967,3.0219450773,19.738577767
45,51,2004,2753,1974,6276,2505,339,779,6615,7050,217890,12.842581578,9.2085928207,29.277167448,-344,1.5814148765,3.6339887575,30.858582325
45,51,2005,2833,2105,9422,2495,354,728,9776,10364,228254,12.699935447,9.4364151485,42.237483862,-140,1.5869315737,3.2635202984,43.824415435
45,51,2006,3092,2258,10203,2520,364,834,10567,11242,239496,13.220737573,9.6547300909,43.62586852,-159,1.5563869588,3.5660074826,45.182255478
45,51,2007,3336,2386,8986,2520,324,950,9310,10215,249711,13.638398469,9.7545619748,36.73700499,-45,1.3245926571,3.8838364946,38.061597647
45,51,2008,3318,2508,6627,2520,327,810,6954,7669,257380,13.086408554,9.8917156881,26.13732052,-95,1.2897093421,3.1946928658,27.427029862
45,53,2001,314,131,-111,1312,113,183,2,164,20867,15.107048352,6.3026220832,-5.340389704,-21,5.436612942,8.8044262689,0.0962232379
45,53,2002,283,183,-227,1324,107,100,-120,-35,20832,13.57346699,8.7771889014,-10.88755126,-15,5.1320175544,4.7962780882,-5.755533706
45,53,2003,297,181,-164,1367,78,116,-86,4,20836,14.255543823,8.6877219929,-7.871748104,-26,3.7438801958,5.5678218297,-4.127867908
45,53,2004,304,161,-137,1374,81,143,-56,71,20907,14.56531634,7.7138681935,-6.563974798,-16,3.8808902091,6.851448147,-2.683084589
45,53,2005,339,188,3,1383,79,151,82,215,21122,16.131718575,8.9462038117,0.1427585715,-18,3.7593090485,7.1855147636,3.90206762
45,53,2006,400,185,84,1396,81,215,165,368,21490,18.774054257,8.6830000939,3.942551394,-12,3.801745987,10.091054163,7.744297381
45,53,2007,342,189,193,1408,75,153,268,410,21900,15.764000922,8.71168472,8.8960589998,-11,3.457017746,7.0523162019,12.353076746
45,53,2008,337,206,228,1420,77,131,305,430,22330,15.238525887,9.3149446077,10.309744517,-6,3.4817996835,5.9235812797,13.791544201
45,55,2001,777,514,266,515,17,263,283,500,53335,14.63690308,9.6825845342,5.010831685,-46,0.3202411227,4.9543185457,5.3310728078
45,55,2002,677,524,4,520,12,153,16,116,53451,12.679564737,9.8140205645,0.0749161875,-53,0.2247485625,2.8655441725,0.2996647501
45,55,2003,708,456,527,511,-3,252,524,740,54191,13.15471656,8.4725293101,9.7917169878,-36,-0.055740324,4.6821872503,9.7359766634
45,55,2004,704,561,552,520,20,143,572,665,54856,12.911863692,10.289141379,10.12407494,-50,0.3668143094,2.6227223124,10.49088925
45,55,2005,726,512,754,526,12,214,766,929,55785,13.123525637,9.2551585759,13.629667122,-51,0.2169177791,3.868367061,13.846584901
45,55,2006,790,493,940,523,16,297,956,1225,57010,14.007713108,8.7415222306,16.66740547,-28,0.2837005186,5.2661908773,16.951105989
45,55,2007,829,550,817,523,11,279,828,1128,58138,14.398860597,9.5529231945,14.190433182,21,0.1910584639,4.8459374023,14.381491646
45,55,2008,802,555,468,523,14,247,482,763,58901,13.704833432,9.4840181478,7.9973342219,34,0.2392364938,4.2208152838,8.2365707157
45,57,2001,886,588,-228,2029,65,298,-163,1707,63100,14.233732017,9.4463142506,-3.662856546,1572,1.0442354189,4.7874177665,-2.618621127
45,57,2002,763,574,203,2079,61,189,264,1756,64856,11.925974554,8.971834068,3.172965707,1303,0.9534527494,2.9541404858,4.1264184563
45,57,2003,781,572,77,2086,54,209,131,1648,66504,11.890986602,8.7088915956,1.1723507917,1308,0.8221680877,3.1820950061,1.9945188794
45,57,2004,771,608,46,2074,54,163,100,1670,68174,11.449531475,9.0289431087,0.6831108273,1407,0.8019127103,2.4205883663,1.4850235376
45,57,2005,806,556,-120,2097,53,250,-67,1592,69766,11.686240394,8.0614760041,-1.739886907,1409,0.7684500507,3.6247643903,-0.971436857
45,57,2006,865,569,115,2096,53,296,168,1957,71723,12.227098926,8.0430280799,1.6255680654,1493,0.7491748475,4.1840708465,2.3747429129
45,57,2007,951,648,1430,2092,48,303,1478,1815,73538,13.093672768,8.9218716655,19.688698274,34,0.6608793826,4.1718011028,20.349577657
45,57,2008,965,706,2029,2117,50,259,2079,2375,75913,12.913931657,9.4479126938,27.15271226,37,0.6691156299,3.4660189627,27.82182789
45,59,2001,815,742,183,2638,93,73,276,280,69972,11.670867224,10.625501203,2.6205750945,-69,1.331767671,1.0453660213,3.9523427655
45,59,2002,789,739,-351,2601,86,50,-265,-273,69699,11.297978822,10.582010582,-5.026097042,-58,1.2314653722,0.7159682396,-3.79463167
45,59,2003,846,751,-185,2581,71,95,-114,-112,69587,12.147667389,10.783567623,-2.656404807,-93,1.0194850882,1.3640997659,-1.636919719
45,59,2004,788,703,-479,2671,70,85,-409,-379,69208,11.354875896,10.130047912,-6.902265932,-55,1.0086818689,1.2248279837,-5.893584063
45,59,2005,809,767,67,2666,72,42,139,120,69328,11.679274701,11.072934111,0.9672576081,-61,1.0394410117,0.6063405902,2.0066986199
45,59,2006,840,715,-123,2697,72,125,-51,42,69370,12.112647623,10.310170298,-1.773637688,-32,1.0382269391,1.8024773248,-0.735410749
45,59,2007,867,785,17,2660,62,82,79,163,69533,12.483531673,11.30285163,0.2447751308,2,0.8927093007,1.1806800429,1.1374844316
45,59,2008,792,745,-5,2660,64,47,59,148,69681,11.378165989,10.702946543,-0.071831856,42,0.9194477567,0.6752194463,0.8476159007
45,61,2001,262,207,-186,1693,57,55,-129,-92,20047,13.039366944,10.302095257,-9.256955159,-18,2.8368088389,2.7372716867,-6.42014632
45,61,2002,267,216,-43,1718,53,51,10,39,20086,13.305758353,10.764209005,-2.142874941,-22,2.6412179503,2.5415493484,0.4983430095
45,61,2003,246,201,-27,1745,42,45,15,29,20115,12.23850153,9.99975125,-1.343250168,-31,2.0895002612,2.2387502798,0.7462500933
45,61,2004,256,234,119,1857,41,22,160,165,20280,12.674835995,11.585592276,5.8918182943,-17,2.0299542023,1.0892437183,7.9217724966
45,61,2005,258,228,-123,1923,41,30,-82,-70,20210,12.74388738,11.26204001,-6.075574216,-18,2.0251914053,1.4818473697,-4.050382811
45,61,2006,249,226,-162,1875,42,23,-120,-107,20103,12.353335152,11.212264034,-8.037109617,-10,2.083695086,1.1410711185,-5.953414531
45,61,2007,266,237,-161,1956,35,29,-126,-92,20011,13.262202722,11.816323478,-8.0271227,5,1.745026674,1.4458792442,-6.282096026
45,61,2008,248,233,-176,1938,37,15,-139,-120,19891,12.430454614,11.678612601,-8.821612952,4,1.8545436319,0.7518420129,-6.96706932
45,63,2001,3046,1725,1464,2881,388,1321,1852,2950,219784,13.952700072,7.901644,6.7060909078,-223,1.7772973171,6.0510560719,8.4833882249
45,63,2002,2982,1745,957,2917,349,1237,1306,2332,222116,13.496266124,7.897714415,4.3312966735,-211,1.579542883,5.5985517085,5.9108395565
45,63,2003,3131,1788,2265,2931,249,1343,2514,3649,225765,13.981392379,7.9842636772,10.114293752,-208,1.111902492,5.9971287016,11.226196244
45,63,2004,3151,1847,2035,2933,329,1304,2364,3468,229233,13.850610332,8.1187170053,8.9450942642,-200,1.4461602029,5.731893327,10.391254467
45,63,2005,3109,1821,2337,2931,319,1288,2656,3756,232989,13.452410314,7.8793307112,10.112024092,-188,1.3802891251,5.5730796024,11.492313217
45,63,2006,3281,1859,3342,2910,335,1422,3677,4968,237957,13.933656937,7.8947480178,14.192709992,-131,1.4226684163,6.0389089195,15.615378409
45,63,2007,3369,1916,3138,2910,280,1453,3418,4840,242797,14.015484011,7.9708125153,13.054493566,-31,1.164836902,6.0446714952,14.219330468
45,63,2008,3378,1971,4022,2910,291,1407,4313,5721,248518,13.750852305,8.0233658651,16.372388386,1,1.1845760866,5.7274864395,17.556964473
45,65,2001,107,118,151,1435,1,-11,152,131,10116,10.646236506,11.740709417,15.024128153,-10,0.0994975374,-1.094472912,15.12362569
45,65,2002,80,115,62,1472,1,-35,63,18,10134,7.9012345679,11.358024691,6.1234567901,-10,0.0987654321,-3.456790123,6.2222222222
45,65,2003,71,115,85,1493,1,-44,86,26,10160,6.9971420124,11.333399034,8.3768601557,-16,0.0985512959,-4.336257022,8.4754114517
45,65,2004,81,125,-148,1479,0,-44,-148,-203,9957,8.05289059,12.427300293,-14.71392355,-11,0,-4.374409703,-14.71392355
45,65,2005,74,130,109,1521,1,-56,110,46,10003,7.4148296593,13.026052104,10.921843687,-8,0.1002004008,-5.611222445,11.022044088
45,65,2006,81,125,139,1515,0,-44,139,91,10094,8.0609046126,12.439667612,13.832910385,-4,0,-4.378762999,13.832910385
45,65,2007,92,125,14,1511,1,-33,15,-21,10073,9.1238161353,12.396489314,1.3884068032,-3,0.0991719145,-3.272673179,1.4875787177
45,65,2008,76,137,82,1510,0,-61,82,20,10093,7.5374392542,13.587226024,8.1325002479,-1,0,-6.04978677,8.1325002479
45,67,2001,525,386,-484,334,52,139,-432,-314,35154,14.867888193,10.931437796,-13.70677693,-21,1.4726289258,3.9364503979,-12.234148
45,67,2002,483,365,-456,334,48,118,-408,-314,34840,13.801182959,10.429465383,-13.02968826,-24,1.3715461325,3.3717175758,-11.65814213
45,67,2003,516,373,-243,334,37,143,-206,-96,34744,14.830995631,10.720855369,-6.984364222,-33,1.063462865,4.1101402621,-5.920901357
45,67,2004,458,343,-224,334,38,115,-186,-98,34646,13.200749388,9.8861507422,-6.456261709,-27,1.0952586828,3.3145986453,-5.361003026
45,67,2005,466,367,-353,334,39,99,-314,-242,34404,13.497465605,10.629978277,-10.22447502,-27,1.1296162201,2.867487328,-9.094858798
45,67,2006,466,417,-436,334,41,49,-395,-359,34045,13.615976859,12.18425397,-12.73941182,-13,1.1979722129,1.4317228886,-11.54143961
45,67,2007,489,386,-307,334,32,103,-275,-166,33879,14.398445321,11.365643955,-9.039514752,6,0.9422295507,3.0328013662,-8.097285201
45,67,2008,467,376,-158,334,34,91,-124,-36,33843,13.791677741,11.104220194,-4.666135082,-3,1.0041050176,2.687457547,-3.662030064
45,69,2001,415,364,-278,1641,3,51,-275,-250,28547,14.474051339,12.6953125,-9.695870536,-26,0.1046316964,1.7787388393,-9.591238839
45,69,2002,408,358,-97,1776,2,50,-95,-75,28472,14.311019134,12.55721777,-3.402374647,-30,0.0701520546,1.7538013645,-3.332222592
45,69,2003,361,333,-189,1789,0,28,-189,-193,28279,12.72224278,11.735476027,-6.660675583,-32,0,0.986766753,-6.660675583
45,69,2004,312,322,-158,1965,4,-10,-154,-185,28094,11.069128838,11.423908609,-5.605520373,-21,0.1419119082,-0.35477977,-5.463608465
45,69,2005,362,295,-556,1714,3,67,-553,-507,27587,13.002640039,10.596074065,-19.97090569,-21,0.1077566854,2.406565974,-19.86314901
45,69,2006,374,337,1332,3372,3,37,1335,1356,28943,13.231912259,11.922872811,47.125420131,-16,0.1061383336,1.3090394481,47.231558465
45,69,2007,361,345,14,3565,0,16,14,32,28975,12.465900066,11.9133948,0.4834421078,2,0,0.5525052661,0.4834421078
45,69,2008,335,341,-283,3637,2,-6,-281,-271,28704,11.61601276,11.82406075,-9.812930183,16,0.0693493299,-0.20804799,-9.743580853
45,71,2001,537,385,-20,971,124,152,104,222,36253,14.858059875,10.65242654,-0.553372807,-34,3.430911405,4.2056333352,2.8775385978
45,71,2002,454,438,184,1007,119,16,303,289,36542,12.473384161,12.03379353,5.0552922591,-30,3.2694553197,0.4395906312,8.3247475788
45,71,2003,455,382,-73,1026,104,73,31,53,36595,12.442402614,10.446149008,-1.996253606,-51,2.8439777404,1.9962536062,0.8477241342
45,71,2004,492,429,36,1057,97,63,133,172,36767,13.412938579,11.695428151,0.9814345301,-24,2.6444208173,1.7175104277,3.6258553475
45,71,2005,525,416,-36,1079,103,109,67,142,36909,14.251588034,11.292686899,-0.977251751,-34,2.7960258429,2.9589011347,1.818774092
45,71,2006,519,387,170,1019,105,132,275,389,37298,13.987898716,10.430282857,4.5817779994,-18,2.8299217055,3.5576158583,7.4116997049
45,71,2007,546,409,80,1102,85,137,165,301,37599,14.580023232,10.921665754,2.1362671402,-1,2.2697838365,3.6583574776,4.4060509767
45,71,2008,516,429,42,1102,87,87,129,224,37823,13.683010262,11.37599109,1.1137333934,8,2.3070191721,2.3070191721,3.4207525656
45,73,2001,781,678,381,643,78,103,459,505,66915,11.715732233,10.170635665,5.7153572098,-57,1.1700731296,1.5450965685,6.8854303394
45,73,2002,770,593,567,643,74,177,641,772,67687,11.441137576,8.8111617955,8.4248376696,-46,1.0995378969,2.6299757804,9.5243755665
45,73,2003,780,678,327,677,60,102,387,418,68105,11.48815836,9.9858607282,4.8161894662,-71,0.8837044892,1.5022976317,5.6998939555
45,73,2004,832,710,329,688,63,122,392,455,68560,12.175758241,10.390370614,4.8146928621,-59,0.921962463,1.7853876267,5.7366553251
45,73,2005,824,684,527,686,63,140,590,665,69225,11.960663352,9.9285118119,7.649599013,-65,0.9144681932,2.0321515404,8.5640672062
45,73,2006,793,766,595,675,64,27,659,652,69877,11.401705224,11.013500884,8.5548734023,-34,0.9201880634,0.3882043393,9.4750614657
45,73,2007,892,736,537,675,56,156,593,783,70660,12.694165949,10.474110021,7.6421155995,34,0.7969431538,2.2200559283,8.4390587532
45,73,2008,837,750,430,675,58,87,488,614,71274,11.794214212,10.568292305,6.0591542548,39,0.8172812716,1.2259219074,6.8764355264
45,75,2001,1329,937,-579,3847,38,392,-541,-228,91260,14.544618819,10.254558189,-6.336594655,-79,0.4158732243,4.2900606299,-5.920721431
45,75,2002,1231,940,-373,4002,35,291,-338,-132,91128,13.49869509,10.307695682,-4.090181372,-85,0.3837971796,3.1909994079,-3.706384192
45,75,2003,1251,977,-372,4224,15,274,-357,-197,90931,13.742797664,10.732784427,-4.086587315,-114,0.1647817466,3.0100132375,-3.921805569
45,75,2004,1243,988,-571,4339,26,255,-545,-361,90570,13.696894232,10.886992358,-6.291976353,-71,0.2864997989,2.8099018738,-6.005476554
45,75,2005,1331,963,-169,4360,22,368,-147,134,90704,14.684952062,10.624800026,-1.86458069,-87,0.2427264804,4.060152035,-1.62185421
45,75,2006,1358,998,-1330,3460,26,360,-1304,-978,89726,15.052929114,11.062461897,-14.74255944,-34,0.2882004101,3.9904672172,-14.45435903
45,75,2007,1341,1028,279,3952,18,313,297,631,90357,14.893132611,11.416957736,3.0985712144,21,0.1999078203,3.4761748749,3.2984790347
45,75,2008,1282,975,-387,3952,20,307,-367,-21,90336,14.189813662,10.791784961,-4.283508492,39,0.2213699479,3.3980287006,-4.062138544
45,77,2001,1295,876,-143,7191,236,419,93,405,111494,11.636108777,7.8712210726,-1.284913942,-107,2.1205572753,3.7648877048,0.835643333
45,77,2002,1315,904,-484,6577,226,411,-258,59,111553,11.791236825,8.1059148969,-4.339892489,-94,2.0264787242,3.6853219277,-2.313413765
45,77,2003,1235,956,360,6872,192,279,552,686,112239,11.037034389,8.5436476728,3.2172731822,-145,1.7158790305,2.4933867162,4.9331522128
45,77,2004,1259,855,206,7002,178,404,384,711,112950,11.181718468,7.5936213581,1.8295742687,-77,1.580894271,3.5880971095,3.4104685398
45,77,2005,1318,958,170,6864,188,360,358,616,113566,11.637147045,8.4585636335,1.500997722,-102,1.6599268926,3.1785834113,3.1609246146
45,77,2006,1354,921,332,6733,188,433,520,898,114464,11.8756304,8.0778844889,2.9118975573,-55,1.6489058457,3.7977459106,4.5608034031
45,77,2007,1326,992,635,6529,162,334,797,1142,115606,11.526926588,8.6234624245,5.5200591124,11,1.4082670492,2.9034641631,6.9283261616
45,77,2008,1354,987,720,6529,164,367,884,1309,116915,11.646259908,8.4895557821,6.1929890203,58,1.4106252769,3.1567041256,7.6036142972
45,79,2001,4454,2555,2701,30547,481,1899,3182,4820,326366,13.748780699,7.886873526,8.3375520132,-261,1.4847695366,5.8619071726,9.8223215498
45,79,2002,4450,2534,1598,29833,21,1916,1619,3260,329626,13.567238625,7.725703972,4.8720106343,-275,0.064025171,5.8415346529,4.9360358053
45,79,2003,4360,2585,4848,31837,-1093,1775,3755,5429,335055,13.119075165,7.7781672712,14.587448716,-101,-3.288795678,5.3409078942,11.298653038
45,79,2004,4601,2517,4793,35757,1138,2084,5931,7644,342699,13.577197626,7.4274736851,14.14377488,-371,3.3581505974,6.1497239411,17.501925477
45,79,2005,4692,2569,-231,32449,456,2123,225,2040,344739,13.650685589,7.474128576,-0.672060608,-308,1.3266650956,6.1765570131,0.654604488
45,79,2006,4887,2611,3216,31472,798,2276,4014,6108,350847,14.051461645,7.5073391356,9.2468796094,-182,2.2944682613,6.5441225097,11.541347871
45,79,2007,4928,2700,4613,31980,290,2228,4903,7173,358020,13.903877596,7.6177900791,13.01513542,42,0.8182070826,6.2860875171,13.833342503
45,79,2008,4858,2744,3302,31968,481,2114,3783,5981,364001,13.456672313,7.6008869548,9.1465483691,84,1.3323712191,5.855785358,10.478919588
45,81,2001,252,202,-228,262,131,50,-97,-68,19110,13.16339323,10.551608859,-11.90973673,-21,6.8428750522,2.6117843711,-5.06686168
45,81,2002,254,195,-259,263,122,59,-137,-92,19018,13.323541754,10.228703315,-13.5858162,-14,6.3994964331,3.0948384389,-7.186319765
45,81,2003,236,210,-296,262,99,26,-197,-181,18837,12.4686303,11.09496764,-15.63862105,-10,5.2304847444,1.3736626602,-10.40813631
45,81,2004,215,210,-360,262,96,5,-264,-281,18556,11.499478512,11.232048779,-19.25494076,-22,5.1346508705,0.2674297328,-14.12028989
45,81,2005,260,198,-36,262,100,62,64,109,18665,13.97060799,10.639155316,-1.934391876,-17,5.3733107654,3.3314526746,3.4389188899
45,81,2006,272,197,-121,262,100,75,-21,45,18710,14.555183946,10.54180602,-6.474916388,-9,5.3511705686,4.0133779264,-1.123745819
45,81,2007,269,188,-192,262,89,81,-103,-18,18692,14.384257526,10.052938346,-10.26683065,4,4.7591037912,4.3313191808,-5.50772686
45,81,2008,241,216,-194,262,91,25,-103,-67,18625,12.916365195,11.576493287,-10.39740601,11,4.877133746,1.3398719082,-5.520272262
45,83,2001,3413,2623,1246,7468,495,790,1741,2297,256693,13.355795175,10.264357088,4.875863108,-234,1.9370403198,3.0914380861,6.8129034278
45,83,2002,3385,2510,1130,7621,469,875,1599,2256,258949,13.129264102,9.7354366014,4.3828858006,-218,1.8190915403,3.3938275005,6.2019773409
45,83,2003,3465,2575,841,7619,391,890,1232,1794,260743,13.334821394,9.9097157547,3.2365324077,-328,1.5047374214,3.4251056395,4.7412698291
45,83,2004,3423,2618,826,7592,363,805,1189,1807,262550,13.082536934,10.005866694,3.156931203,-187,1.387368071,3.0766702402,4.544299274
45,83,2005,3441,2683,1797,7685,386,758,2183,2732,265282,13.03823944,10.16611346,6.8089846769,-209,1.4625865806,2.8721259795,8.2715712575
45,83,2006,3581,2559,2995,7873,390,1022,3385,4264,269546,13.391221103,9.5694316678,11.199862386,-143,1.4584127981,3.8217894351,12.658275184
45,83,2007,3833,2653,4233,7903,346,1180,4579,5739,275285,14.070418166,9.7387997379,15.538763396,-20,1.2701186239,4.3316184285,16.80888202
45,83,2008,3703,2704,4119,7886,349,999,4468,5453,280738,13.319592895,9.7262163616,14.815933873,-14,1.2553437538,3.593376533,16.071277627
45,85,2001,1775,913,-1246,3356,14,862,-1232,-442,104212,16.996543238,8.7424473107,-11.93109458,-72,0.1340572424,8.2540959275,-11.79703733
45,85,2002,1601,903,198,3424,-160,698,38,639,104851,15.315957391,8.6385443622,1.8941658734,-97,-1.53063909,6.6774130286,0.3635267838
45,85,2003,1609,947,42,3281,-590,662,-548,-34,104817,15.348074098,9.0333288819,0.4006333823,-148,-5.627945132,6.3147452162,-5.22731175
45,85,2004,1658,958,-621,3369,329,700,-292,325,105142,15.793559695,9.1255911869,-5.915440634,-83,3.1339451988,6.6679685081,-2.781495435
45,85,2005,1647,949,-1045,3172,46,698,-999,-393,104749,15.693860146,9.0427888761,-9.957549395,-92,0.4383227485,6.6510712703,-9.519226646
45,85,2006,1696,948,-1542,3094,189,748,-1353,-648,104101,16.241321523,9.0782858511,-14.76657888,-43,1.8099114197,7.1630356715,-12.95666746
45,85,2007,1659,1038,-750,3116,-4,621,-754,-93,104008,15.943568034,9.9755416633,-7.207761317,40,-0.038441394,5.9680263708,-7.246202711
45,85,2008,1625,1000,-587,3116,74,625,-513,140,104148,15.613290032,9.6081784815,-5.640000769,28,0.7110052076,6.005111551,-4.928995561
45,87,2001,362,346,-329,425,4,16,-325,-335,29542,12.18465474,11.646106464,-11.07389892,-26,0.134637069,0.5385482758,-10.93926185
45,87,2002,372,342,-300,426,1,30,-299,-292,29250,12.654782964,11.63423595,-10.20547013,-23,0.0340182338,1.0205470132,-10.1714519
45,87,2003,341,368,-272,431,-7,-27,-279,-334,28916,11.725062751,12.653440154,-9.352542723,-28,-0.240690438,-0.928377403,-9.59323316
45,87,2004,332,388,-374,428,8,-56,-366,-449,28467,11.571371312,13.523168883,-13.03521949,-27,0.2788282244,-1.951797571,-12.75639127
45,87,2005,312,385,-129,431,3,-73,-126,-222,28245,11.002962336,13.577373395,-4.549301735,-23,0.1057977148,-2.574411059,-4.44350402
45,87,2006,337,348,-163,425,6,-11,-157,-181,28064,11.969667371,12.36036868,-5.789483031,-13,0.2131098048,-0.390701309,-5.576373226
45,87,2007,329,397,-200,425,-1,-68,-201,-275,27789,11.780924928,14.215888135,-7.161656491,-6,-0.035808282,-2.434963207,-7.197464774
45,87,2008,307,380,-27,425,2,-73,-25,-117,27672,11.070842574,13.703323056,-0.973657164,-19,0.0721227529,-2.632480482,-0.901534412
45,89,2001,526,386,-603,335,7,140,-596,-482,36653,14.257060769,10.462405811,-16.344121,-26,0.1897327479,3.7946549574,-16.15438825
45,89,2002,527,377,-638,335,5,150,-633,-509,36144,14.478618624,10.35756968,-17.52819484,-26,0.1373682981,4.1210489443,-17.39082655
45,89,2003,451,434,-856,335,-1,17,-857,-843,35301,12.625096228,12.149205683,-23.96248863,-3,-0.027993561,0.4758905452,-23.99048219
45,89,2004,468,402,-88,807,9,66,-79,-35,35266,13.26399025,11.393427523,-2.494083637,-22,0.2550767356,1.8705627276,-2.239006901
45,89,2005,498,386,-573,677,5,112,-568,-486,34780,14.219227365,11.021328841,-16.36067727,-30,0.142763327,3.1978985238,-16.21791394
45,89,2006,432,407,545,1777,7,25,552,558,35338,12.322085627,11.609001968,15.545223766,-19,0.1996634245,0.713083659,15.74488719
45,89,2007,461,417,-13,2018,5,44,-8,43,35381,13.037514671,11.793153184,-0.367652258,7,0.1414047144,1.244361487,-0.226247543
45,89,2008,466,419,-370,2110,7,47,-363,-291,35090,13.22529835,11.891416327,-10.50077337,25,0.1986632799,1.3338820224,-10.30211009
45,91,2001,2287,1234,2612,4318,221,1053,2833,3769,169474,13.646439664,7.3632297966,15.585701968,-117,1.3186983671,6.283209867,16.904400335
45,91,2002,2392,1395,3021,4373,210,997,3231,4142,173616,13.943863126,8.1319770323,17.610539509,-86,1.2241685855,5.811886094,18.834708094
45,91,2003,2359,1409,3126,4536,176,950,3302,4213,177829,13.42457568,8.0183243466,17.789412284,-39,1.0015791945,5.4062513338,18.790991478
45,91,2004,2452,1392,3921,4313,173,1060,4094,4916,182745,13.600536922,7.7210225918,21.748656309,-238,0.9595811123,5.8795143299,22.708237421
45,91,2005,2487,1446,5338,4230,176,1041,5514,6425,189170,13.374023634,7.7759703158,28.70548378,-130,0.9464528185,5.5980533186,29.651936598
45,91,2006,2779,1500,7706,4335,178,1279,7884,9039,198209,14.347705993,7.7443537208,39.785326515,-124,0.9189966415,6.6033522726,40.704323156
45,91,2007,2909,1563,8836,4323,160,1346,8996,10355,208564,14.302817542,7.6848758398,43.444378068,13,0.7866795485,6.6179417021,44.231057617
45,91,2008,3054,1656,7424,4309,162,1398,7586,8884,217448,14.337624292,7.7744288893,34.853478306,-100,0.7605419566,6.5631954029,35.614020262
46,0,2001,10477,6989,-1715,28672,725,3488,-990,3048,758705,13.836850106,9.2302897194,-2.264980236,550,0.9574989335,4.6065603865,-1.307481302
46,0,2002,10448,6959,-1387,29350,520,3489,-867,3004,761709,13.743625092,9.1540856635,-1.824503063,382,0.6840242197,4.5895394281,-1.140478843
46,0,2003,10750,6851,361,30130,99,3899,460,4731,766440,14.069308687,8.9664031452,0.4724670173,372,0.1295685172,5.1029055413,0.6020355345
46,0,2004,11261,7067,1712,30526,774,4194,2486,7099,773539,14.624874755,9.1780472331,2.2234069426,419,1.0052085126,5.4468275217,3.2286154551
46,0,2005,11567,7061,160,30299,560,4506,720,5776,779315,14.897730244,9.0942226378,0.2060721742,550,0.7212526097,5.803507606,0.9273247839
46,0,2006,11549,6942,1988,31112,681,4607,2669,8065,787380,14.743137624,8.86196739,2.5378264436,789,0.8693459799,5.8811702342,3.4071724235
46,0,2007,12263,6490,2146,31325,499,5773,2645,8309,795689,15.492691727,8.1992635823,2.7111894681,-109,0.6304210366,7.293428145,3.3416105047
46,0,2008,12465,6539,2194,31280,542,5926,2736,8505,804194,15.582389462,8.1743477492,2.74270056,-157,0.6775495458,7.4080417131,3.4202501058
46,3,2001,33,47,-66,201,2,-14,-64,-79,2981,10.925343486,15.560337692,-21.85068697,-1,0.6621420295,-4.634994206,-21.18854494
46,3,2002,20,53,-31,201,2,-33,-29,-65,2916,6.783110056,17.975241648,-10.51382059,-3,0.6783110056,-11.19213159,-9.835509581
46,3,2003,28,33,8,201,2,-5,10,1,2917,9.6005486028,11.314932282,2.7430138865,-4,0.6857534716,-1.714383679,3.4287673581
46,3,2004,38,44,16,201,1,-6,17,9,2926,13.007016943,15.060756461,5.476638713,-2,0.3422899196,-2.053739517,5.8189286326
46,3,2005,27,28,-63,201,2,-1,-61,-64,2862,9.3296475466,9.6751900484,-21.76917761,-2,0.6910850035,-0.345542502,-21.07809261
46,3,2006,34,28,1,201,1,6,2,7,2869,11.865294015,9.7714186006,0.3489792357,-1,0.3489792357,2.0938754144,0.6979584715
46,3,2007,28,27,-22,201,2,1,-20,-22,2847,9.7970608817,9.4471658502,-7.697690693,-3,0.699790063,0.3498950315,-6.99790063
46,3,2008,34,30,16,201,1,4,17,20,2867,11.90059503,10.500525026,5.600280014,-1,0.3500175009,1.4000700035,5.9502975149
46,5,2001,171,222,-119,443,5,-51,-114,-178,16805,10.121936782,13.140760033,-7.043920919,-13,0.2959630638,-3.018823251,-6.747957855
46,5,2002,198,176,-305,443,5,22,-300,-287,16518,11.883683942,10.563274615,-18.30567476,-9,0.3000930288,1.3204093269,-18.00558173
46,5,2003,184,189,-369,443,3,-5,-366,-369,16149,11.265191172,11.571310497,-22.59160621,2,0.1836715952,-0.306119325,-22.40793461
46,5,2004,194,183,-235,443,6,11,-229,-236,15913,12.101553241,11.415382696,-14.659098,-18,0.3742748425,0.6861705446,-14.28482316
46,5,2005,178,216,-122,443,4,-38,-118,-170,15743,11.245893354,13.646702047,-7.70785949,-14,0.2527167046,-2.400808693,-7.455142785
46,5,2006,181,204,-269,443,6,-23,-263,-291,15452,11.604423786,13.079019074,-17.24635358,-5,0.3846770316,-1.474595288,-16.86167655
46,5,2007,244,196,201,443,5,48,206,254,15706,15.66210925,12.581038578,12.901983439,0,0.3209448617,3.0810706721,13.222928301
46,5,2008,236,182,117,443,6,54,123,172,15878,14.944275583,11.524822695,7.4088145897,-5,0.3799392097,3.4194528875,7.7887537994
46,7,2001,56,26,-91,48,1,30,-90,-64,3509,15.814741598,7.3425585993,-25.6989551,-4,0.2824061,8.4721829992,-25.416549
46,7,2002,64,32,-37,48,1,32,-36,-8,3501,18.259629101,9.1298145506,-10.55634807,-4,0.2853067047,9.1298145506,-10.27104137
46,7,2003,77,31,-60,48,1,46,-59,-16,3485,22.044088176,8.8748926424,-17.17721157,-3,0.2862868594,13.169195534,-16.89092471
46,7,2004,73,28,-43,48,0,45,-43,-2,3483,20.952927669,8.03673938,-12.34213548,-4,0,12.916188289,-12.34213548
46,7,2005,67,31,-17,48,1,36,-16,17,3500,19.189460117,8.8787054275,-4.868967492,-3,0.2864098525,10.31075469,-4.58255764
46,7,2006,57,27,-111,48,0,30,-111,-83,3417,16.481133439,7.8068526818,-32.0948388,-2,0,8.6742807576,-32.0948388
46,7,2007,59,15,-38,48,1,44,-37,-3,3414,17.274191187,4.3917435222,-11.12575026,-10,0.2927829015,12.882447665,-10.83296735
46,7,2008,65,14,-60,48,0,51,-60,-21,3393,19.097987366,4.1134126634,-17.62891141,-12,0,14.984574703,-17.62891141
46,9,2001,45,67,-43,1014,1,-22,-42,-69,7179,6.2383031815,9.2881402925,-5.961045262,-5,0.1386289596,-3.049837111,-5.822416303
46,9,2002,65,100,-44,1076,1,-35,-43,-85,7094,9.1081062145,14.012471099,-6.165487284,-7,0.140124711,-4.904364885,-6.025362573
46,9,2003,50,75,12,1092,-1,-25,11,-22,7072,7.059155725,10.588733587,1.694197374,-8,-0.141183114,-3.529577862,1.5530142595
46,9,2004,57,83,-48,1118,0,-26,-48,-79,6993,8.1052257376,11.80234625,-6.825453253,-5,0,-3.697120512,-6.825453253
46,9,2005,65,67,-26,1133,0,-2,-26,-35,6958,9.3183284352,9.6050462332,-3.727331374,-7,0,-0.286717798,-3.727331374
46,9,2006,71,76,190,1356,0,-5,190,181,7139,10.073065191,10.782435979,26.956089948,-4,0,-0.709370788,26.956089948
46,9,2007,59,86,-58,1303,0,-27,-58,-84,7055,8.3133718473,12.117796252,-8.17246724,1,0,-3.804424405,-8.17246724
46,9,2008,68,89,45,1383,0,-21,45,24,7079,9.6221876327,12.593745578,6.3676241687,0,0,-2.971557945,6.3676241687
46,11,2001,307,210,-64,2824,44,97,-20,50,28339,10.842692661,7.4168255986,-2.260365897,-27,1.554001554,3.4258670622,-0.706364343
46,11,2002,342,168,-19,3112,41,174,22,169,28508,12.032297219,5.9106021426,-0.668460957,-27,1.44246838,6.1216950763,0.7740074234
46,11,2003,283,170,-50,3362,27,113,-23,49,28557,9.9185139753,5.9581179357,-1.752387628,-41,0.9462893192,3.9603960396,-0.806098309
46,11,2004,339,207,-121,3312,35,132,-86,25,28582,11.865800942,7.2454890705,-4.235285882,-21,1.2250826931,4.6203118711,-3.010203189
46,11,2005,348,165,-300,2953,32,183,-268,-108,28474,12.198541784,5.7837913629,-10.5159843,-23,1.1217049916,6.4147504206,-9.394279305
46,11,2006,348,170,354,3212,34,178,388,551,29025,12.10455834,5.9131463156,12.313257622,-15,1.1826292631,6.1914120246,13.495886885
46,11,2007,360,189,104,3327,30,171,134,304,29329,12.338485794,6.4777050416,3.5644514515,-1,1.0282071495,5.860780752,4.592658601
46,11,2008,370,173,118,3313,32,197,150,339,29668,12.543010662,5.864704985,4.0002034002,-8,1.0848009221,6.6783056766,5.0850043223
46,13,2001,457,382,-329,1366,11,75,-318,-269,35115,12.964722904,10.837033149,-9.333465723,-26,0.312061164,2.1276897545,-9.021404559
46,13,2002,414,348,-259,1315,10,66,-249,-208,34907,11.824855046,9.9397332267,-7.397675016,-25,0.285624518,1.8851218189,-7.112050498
46,13,2003,483,325,-188,1319,7,158,-181,-60,34847,13.848668177,9.3184620237,-5.390371878,-37,0.2007053359,4.5302061531,-5.189666542
46,13,2004,459,337,-84,1277,9,122,-75,22,34869,13.167708991,9.6677950542,-2.409776809,-25,0.2581903724,3.4999139365,-2.151586436
46,13,2005,454,376,-45,1295,7,78,-38,6,34875,13.019041064,10.782289516,-1.290433586,-34,0.2007341133,2.2367515485,-1.089699472
46,13,2006,458,331,-134,1331,8,127,-126,-14,34861,13.135252954,9.4929448205,-3.843065275,-15,0.2294367328,3.6423081335,-3.613628542
46,13,2007,524,349,76,1331,8,175,84,267,35128,14.973781594,9.9729957565,2.1717698495,8,0.2286073526,5.0007858378,2.4003772021
46,13,2008,513,340,-172,1263,8,173,-164,26,35154,14.598332432,9.6753080447,-4.894567599,17,0.2276543069,4.9230243875,-4.666913292
46,15,2001,65,52,-131,382,0,13,-131,-119,5232,12.28385146,9.8270811679,-24.75668525,-1,0,2.456770292,-24.75668525
46,15,2002,54,51,-86,382,-1,3,-87,-88,5144,10.408635312,9.8303777949,-16.5767155,-4,-0.192752506,0.5782575173,-16.769468
46,15,2003,66,59,5,382,-1,7,4,5,5149,12.82424949,11.464101817,0.9715340523,-6,-0.19430681,1.3601476732,0.7772272418
46,15,2004,48,52,-9,382,0,-4,-9,-19,5130,9.3394299056,10.117715731,-1.751143107,-6,0,-0.778285825,-1.751143107
46,15,2005,79,55,-37,382,0,24,-37,-17,5113,15.425168408,10.739041296,-7.224445963,-4,0,4.6861271112,-7.224445963
46,15,2006,76,63,-23,382,0,13,-23,-12,5101,14.881535148,12.336009399,-4.503622479,-2,0,2.545525749,-4.503622479
46,15,2007,62,44,61,369,0,18,61,79,5180,12.061083552,8.5594786499,11.866549947,0,0,3.5016049022,11.866549947
46,15,2008,84,48,-15,351,0,36,-15,25,5205,16.177178623,9.2441020703,-2.888781897,4,0,6.9330765527,-2.888781897
46,17,2001,45,22,11,15,0,23,11,32,2040,22.233201581,10.869565217,5.4347826087,-2,0,11.363636364,5.4347826087
46,17,2002,43,21,-29,15,-1,22,-30,-9,2031,21.125030705,10.316875461,-14.24711373,-1,-0.491279784,10.808155244,-14.73839352
46,17,2003,57,11,-23,15,-1,46,-24,21,2052,27.920646583,5.3881949547,-11.26622581,-1,-0.489835905,22.532451629,-11.75606172
46,17,2004,68,17,-31,15,0,51,-31,18,2070,32.993692382,8.2484230956,-15.04124212,-2,0,24.745269287,-15.04124212
46,17,2005,54,17,-36,15,0,37,-36,-1,2069,26.093259241,8.214544576,-17.39550616,-2,0,17.878714665,-17.39550616
46,17,2006,61,14,-2,15,0,47,-2,44,2113,29.172644668,6.6953610713,-0.956480153,-1,0,22.477283596,-0.956480153
46,17,2007,62,11,-67,15,0,51,-67,-19,2094,29.474685049,5.2293796054,-31.85167578,-3,0,24.245305443,-31.85167578
46,17,2008,63,2,-6,15,0,61,-6,48,2142,29.745042493,0.9442870633,-2.83286119,-7,0,28.80075543,-2.83286119
46,19,2001,129,85,-62,131,3,44,-59,-22,9089,14.175824176,9.3406593407,-6.813186813,-7,0.3296703297,4.8351648352,-6.483516484
46,19,2002,119,110,-131,131,3,9,-128,-124,8965,13.1826742,12.185665227,-14.5120195,-5,0.3323363244,0.9970089731,-14.17968317
46,19,2003,111,99,86,131,3,12,89,94,9059,12.316910786,10.985352863,9.5428317798,-7,0.3328894807,1.3315579228,9.8757212605
46,19,2004,121,82,-1,131,2,39,1,34,9093,13.331864257,9.0348171,-0.110180696,-6,0.2203613927,4.2970471573,0.1101806963
46,19,2005,133,100,55,131,3,33,58,82,9175,14.56098095,10.948105978,6.0214582877,-9,0.3284431793,3.6128749726,6.349901467
46,19,2006,130,100,3,131,2,30,5,32,9207,14.14427157,10.8802089,0.326406267,-3,0.217604178,3.26406267,0.544010445
46,19,2007,136,100,197,131,3,36,200,242,9449,14.579759863,10.720411664,21.119210978,6,0.3216123499,3.859348199,21.440823328
46,19,2008,150,101,88,131,2,49,90,144,9593,15.754647621,10.608129398,9.2427266043,5,0.2100619683,5.1465182229,9.4527885726
46,21,2001,10,15,-28,19,2,-5,-26,-32,1748,5.6689342404,8.5034013605,-15.87301587,-1,1.1337868481,-2.83446712,-14.73922902
46,21,2002,17,16,-46,19,2,1,-44,-43,1705,9.8465102809,9.2673037938,-26.64349841,0,1.1584129742,0.5792064871,-25.48508543
46,21,2003,10,16,-59,19,2,-6,-57,-62,1643,5.9737156511,9.5579450418,-35.24492234,1,1.1947431302,-3.584229391,-34.05017921
46,21,2004,9,10,-52,19,1,-1,-51,-54,1589,5.5693069307,6.1881188119,-32.17821782,-2,0.6188118812,-0.618811881,-31.55940594
46,21,2005,4,17,-57,19,2,-13,-55,-68,1521,2.5723472669,10.932475884,-36.65594855,0,1.2861736334,-8.360128617,-35.36977492
46,21,2006,7,20,-43,19,1,-13,-42,-55,1466,4.6869768999,13.391362571,-28.79142953,0,0.6695681286,-8.704385671,-28.1218614
46,21,2007,13,9,-70,19,1,4,-69,-70,1396,9.0845562544,6.2893081761,-48.91684137,-5,0.6988120196,2.7952480783,-48.21802935
46,21,2008,8,5,-35,19,0,3,-35,-44,1352,5.8224163028,3.6390101892,-25.47307132,-12,0,2.1834061135,-25.47307132
46,23,2001,147,112,-172,189,4,35,-168,-138,9197,15.86445068,12.087200518,-18.56248651,-5,0.4316857328,3.7772501619,-18.13080078
46,23,2002,153,87,-115,189,4,66,-111,-52,9145,16.683022571,9.4864245993,-12.53952677,-7,0.4361574528,7.1965979719,-12.10336932
46,23,2003,139,106,-138,189,0,33,-138,-108,9037,15.289847102,11.659883401,-15.1798482,-3,0,3.6299637004,-15.1798482
46,23,2004,154,104,-78,189,1,50,-77,-35,9002,17.074117191,11.530572648,-8.647929486,-8,0.1108708908,5.5435445424,-8.537058595
46,23,2005,179,109,4,189,1,70,5,66,9068,19.811842833,12.064194798,0.4427227449,-9,0.1106806862,7.7476480354,0.5534034311
46,23,2006,157,96,-103,189,1,61,-102,-45,9023,17.3566967,10.613011995,-11.38687745,-4,0.1105522083,6.7436847051,-11.27632524
46,23,2007,153,87,-153,189,0,66,-153,-84,8939,17.035964815,9.6871172475,-17.03596481,3,0,7.3488475671,-17.03596481
46,23,2008,154,97,-95,189,0,57,-95,-33,8906,17.259736621,10.871392547,-10.64724012,5,0,6.388344074,-10.64724012
46,25,2001,36,42,0,81,2,-6,2,-9,4112,8.7452933317,10.20284222,0,-5,0.4858496295,-1.457548889,0.4858496295
46,25,2002,39,55,-154,81,2,-16,-152,-169,3943,9.6834264432,13.656114215,-38.2371198,-1,0.4965859714,-3.972687772,-37.74053383
46,25,2003,38,41,-74,81,2,-3,-72,-77,3866,9.7323600973,10.500704316,-18.95249072,-2,0.5122294788,-0.768344218,-18.44026124
46,25,2004,42,40,-89,81,1,2,-88,-90,3776,10.991886941,10.468463753,-23.29233185,-4,0.2617115938,0.5234231876,-23.03062026
46,25,2005,49,65,-86,81,2,-16,-84,-103,3673,13.156128339,17.452006981,-23.0903477,-3,0.5369848302,-4.295878641,-22.55336287
46,25,2006,36,50,-134,81,1,-14,-133,-148,3525,10.00277855,13.892747986,-37.2325646,-1,0.2778549597,-3.889969436,-36.95470964
46,25,2007,42,34,-55,81,2,8,-53,-58,3467,12.013729977,9.7254004577,-15.73226545,-13,0.5720823799,2.2883295195,-15.16018307
46,25,2008,43,34,-25,81,1,9,-24,-31,3436,12.458351441,9.8507895118,-7.243227582,-16,0.2897291033,2.6075619296,-6.953498479
46,27,2001,173,95,-9,2208,16,78,7,71,13568,12.784038426,7.0201367079,-0.665065583,-14,1.182338814,5.7639017181,0.5172732311
46,27,2002,141,98,-205,2276,14,43,-191,-155,13413,10.451799414,7.2643712242,-15.19587858,-7,1.0377673177,3.1874281902,-14.15811126
46,27,2003,166,93,-81,2301,7,73,-74,-16,13397,12.383439015,6.9377098098,-6.042521447,-15,0.5221932115,5.4457292055,-5.520328236
46,27,2004,156,99,-190,2283,16,57,-174,-132,13265,11.702047858,7.4262996024,-14.25249419,-15,1.2002100368,4.2757482559,-13.05228415
46,27,2005,137,94,-30,2283,13,43,-17,14,13279,10.322483424,7.0825798674,-2.26039783,-12,0.9795057263,3.2399035564,-1.280892104
46,27,2006,152,80,-49,2227,15,72,-34,33,13312,11.432439547,6.0170734459,-3.685457486,-5,1.1282012711,5.4153661013,-2.557256215
46,27,2007,160,83,58,2361,11,77,69,146,13458,11.953679492,6.2009712365,4.3332088158,0,0.8218154651,5.7527082555,5.1550242809
46,27,2008,161,75,47,2382,13,86,60,147,13605,11.898163544,5.5426227691,3.4733769353,1,0.96072128,6.3555407752,4.4340982153
46,29,2001,341,238,-97,417,16,103,-81,-2,25902,13.164498321,9.1881249276,-3.744739992,-24,0.6176890708,3.976373393,-3.127050921
46,29,2002,343,234,-126,417,15,109,-111,-22,25880,13.247846742,9.0378896142,-4.866555946,-20,0.5793518983,4.209957128,-4.287204048
46,29,2003,342,201,-139,417,10,141,-129,-17,25863,13.219179406,7.7691668438,-5.372707419,-29,0.3865257136,5.4500125621,-4.986181706
46,29,2004,372,240,-136,417,12,132,-124,-14,25849,14.387376238,9.2821782178,-5.25990099,-22,0.4641089109,5.1051980198,-4.795792079
46,29,2005,392,214,-154,417,12,178,-142,14,25863,15.160891089,8.2766089109,-5.956064356,-22,0.4641089109,6.8842821782,-5.491955446
46,29,2006,378,245,141,417,14,133,155,275,26138,14.538181958,9.4228957135,5.4229726351,-13,0.5384511836,5.1152862445,5.9614238188
46,29,2007,438,235,-4,417,9,203,5,206,26344,16.691437064,8.9554513929,-0.152433215,-2,0.3429747342,7.7359856713,0.190541519
46,29,2008,416,243,-214,417,11,173,-203,-27,26317,15.799168265,9.2288410778,-8.127456752,3,0.4177664685,6.5703271871,-7.709690283
46,31,2001,81,36,-66,3,1,45,-65,-23,4172,19.361778415,8.6052348512,-15.77626389,-3,0.2390343014,10.756543564,-15.53722959
46,31,2002,86,41,11,3,1,45,12,52,4224,20.485945688,9.7665555026,2.6202953788,-5,0.2382086708,10.719390186,2.8585040495
46,31,2003,88,32,-16,3,1,56,-15,35,4259,20.747377107,7.5445007662,-3.772250383,-6,0.2357656489,13.202876341,-3.536484734
46,31,2004,80,44,-4,3,0,36,-4,29,4288,18.72001872,10.296010296,-0.936000936,-3,0,8.424008424,-0.936000936
46,31,2005,100,39,-99,3,1,61,-98,-38,4250,23.424689623,9.1356289529,-23.19044273,-1,0.2342468962,14.28906067,-22.95619583
46,31,2006,84,42,-202,3,0,42,-202,-163,4087,20.151133501,10.075566751,-48.45867818,-3,0,10.075566751,-48.45867818
46,31,2007,96,25,33,3,1,71,34,100,4187,23.205221175,6.0430263476,7.9767947788,-5,0.2417210539,17.162194827,8.2185158327
46,31,2008,100,13,-123,3,0,87,-123,-51,4136,24.029796948,3.1238736033,-29.55665025,-15,0,20.905923345,-29.55665025
46,33,2001,67,71,57,342,1,-4,58,47,7334,9.1648998017,9.7120579988,7.7970043089,-7,0.1367895493,-0.547158197,7.9337938581
46,33,2002,55,86,173,362,0,-31,173,141,7475,7.4279154568,11.614558714,23.364170437,-1,0,-4.186643257,23.364170437
46,33,2003,71,67,92,380,-1,4,91,92,7567,9.4402340114,8.9083898418,12.232415902,-3,-0.132961042,0.5318441697,12.09945486
46,33,2004,68,64,166,349,2,4,168,160,7727,8.8923760952,8.3692951484,21.707859291,-12,0.2615404734,0.5230809468,21.969399765
46,33,2005,86,71,-18,328,0,15,-18,-8,7719,11.135569079,9.1933186586,-2.330700505,-5,0,1.9422504208,-2.330700505
46,33,2006,79,75,129,353,1,4,130,129,7848,10.149675596,9.6357679707,16.57352091,-5,0.1284769063,0.5139076251,16.701997816
46,33,2007,80,84,-34,300,0,-4,-34,-42,7806,10.221029769,10.732081257,-4.343937652,-4,0,-0.511051488,-4.343937652
46,33,2008,87,88,15,300,1,-1,16,5,7811,11.141704553,11.269770122,1.9209835436,-10,0.1280655696,-0.12806557,2.0490491131
46,35,2001,265,174,-29,686,12,91,-17,56,18784,14.128812113,9.27703135,-1.546171892,-18,0.6397952655,4.8517807635,-0.906376626
46,35,2002,225,182,-86,693,11,43,-75,-48,18736,11.993603412,9.7014925373,-4.584221748,-16,0.5863539446,2.2921108742,-3.997867804
46,35,2003,245,194,-38,694,4,51,-34,-8,18728,13.07922272,10.356609011,-2.028614136,-25,0.2135383301,2.7226137092,-1.815075806
46,35,2004,278,200,84,714,10,78,94,156,18884,14.782516218,10.634903754,4.4666595767,-16,0.5317451877,4.1476124641,4.9984047644
46,35,2005,296,200,-109,714,8,96,-101,-23,18861,15.684196582,10.597430123,-5.775599417,-18,0.4238972049,5.0867664591,-5.351702212
46,35,2006,281,171,67,714,10,110,77,178,19039,14.828496042,9.0237467018,3.5356200528,-9,0.5277044855,5.8047493404,4.0633245383
46,35,2007,301,193,-175,714,7,108,-168,-52,18987,15.831273339,10.15094935,-9.204228686,8,0.3681691474,5.6803239888,-8.836059538
46,35,2008,307,191,-195,714,9,116,-186,-56,18931,16.192837175,10.074371011,-10.2853526,14,0.4747085817,6.1184661638,-9.810644021
46,37,2001,67,92,-127,153,4,-25,-123,-150,6093,10.862516213,14.915693904,-20.59014267,-2,0.6485084306,-4.053177691,-19.94163424
46,37,2002,72,111,-24,153,4,-39,-20,-64,6029,11.87922785,18.313809602,-3.959742617,-5,0.6599571028,-6.434581752,-3.299785514
46,37,2003,56,76,-106,153,-2,-20,-108,-131,5898,9.3904586233,12.744193846,-17.77479668,-3,-0.335373522,-3.353735223,-18.1101702
46,37,2004,65,103,-28,153,2,-38,-26,-68,5830,11.084583902,17.564802183,-4.774897681,-4,0.3410641201,-6.480218281,-4.433833561
46,37,2005,79,93,-9,153,0,-14,-9,-29,5801,13.584386553,15.991746196,-1.547588342,-6,0,-2.407359642,-1.547588342
46,37,2006,57,88,-40,153,2,-31,-38,-71,5730,9.8863932009,15.263203538,-6.93781979,-2,0.3468909895,-5.376810337,-6.590928801
46,37,2007,72,69,-71,153,-1,3,-72,-74,5656,12.647110487,12.12014755,-12.47145617,-5,-0.175654312,0.5269629369,-12.64711049
46,37,2008,76,75,-129,153,1,1,-128,-130,5526,13.593274906,13.414416026,-23.07279556,-3,0.1788588803,0.1788588803,-22.89393668
46,39,2001,43,40,-31,68,0,3,-31,-35,4458,9.607865043,8.9375488772,-6.92660038,-7,0,0.6703161658,-6.92660038
46,39,2002,43,44,-23,68,0,-1,-23,-29,4429,9.6770563745,9.9021041971,-5.176099921,-5,0,-0.225047823,-5.176099921
46,39,2003,52,53,-88,68,-1,-1,-89,-93,4336,11.865373645,12.093553908,-20.07986309,-3,-0.228180262,-0.228180262,-20.30804335
46,39,2004,49,54,-66,68,0,-5,-66,-75,4261,11.399325346,12.56252181,-15.35419332,-4,0,-1.163196464,-15.35419332
46,39,2005,56,58,24,68,0,-2,24,18,4279,13.114754098,13.583138173,5.6206088993,-4,0,-0.468384075,5.6206088993
46,39,2006,62,49,-16,68,0,13,-16,-5,4274,14.497837016,11.457967964,-3.741377295,-2,0,3.0398690518,-3.741377295
46,39,2007,58,52,-42,68,0,6,-42,-39,4235,13.63262428,12.222352803,-9.871900341,-3,0,1.4102714773,-9.871900341
46,39,2008,55,45,38,68,0,10,38,41,4276,12.924450711,10.574550582,8.9296204911,-7,0,2.3499001292,8.9296204911
46,41,2001,144,50,-46,107,2,94,-44,45,6029,23.974028136,8.3243153251,-7.658370099,-5,0.332972613,15.649712811,-7.325397486
46,41,2002,142,44,-95,107,2,98,-93,-1,6028,23.554781455,7.2986646761,-15.75848055,-6,0.3317574853,16.256116779,-15.42672307
46,41,2003,158,50,-7,107,2,108,-5,94,6122,26.008230453,8.2304526749,-1.152263374,-9,0.329218107,17.777777778,-0.823045267
46,41,2004,143,59,-120,107,1,84,-119,-43,6079,23.440701582,9.6713384149,-19.67051881,-8,0.1639209901,13.769363167,-19.50659782
46,41,2005,172,69,-79,107,2,103,-77,23,6102,28.240702734,11.32911912,-12.97102044,-3,0.3283802643,16.911583614,-12.64264018
46,41,2006,153,62,-155,107,1,91,-154,-65,6037,25.208007249,10.215009474,-25.53752368,-2,0.1647582173,14.992997776,-25.37276547
46,41,2007,159,29,-174,107,2,130,-172,-52,5985,26.451505573,4.8244884379,-28.94693063,-10,0.3327233405,21.627017135,-28.61420729
46,41,2008,161,23,-175,107,1,138,-174,-54,5931,27.022490769,3.8603558241,-29.37227257,-18,0.1678415576,23.162134945,-29.20443102
46,43,2001,33,42,-13,108,0,-9,-13,-26,3415,9.6266044341,12.252042007,-3.792298716,-4,0,-2.625437573,-3.792298716
46,43,2002,25,46,-53,108,0,-21,-53,-75,3340,7.4019245004,13.619541081,-15.69207994,-1,0,-6.21761658,-15.69207994
46,43,2003,43,37,-66,108,-1,6,-67,-61,3279,12.992899229,11.179936546,-19.94258952,0,-0.302160447,1.8129626832,-20.24474996
46,43,2004,34,39,-14,108,0,-5,-14,-21,3258,10.402325226,11.932078935,-4.283310387,-2,0,-1.52975371,-4.283310387
46,43,2005,36,51,-26,108,0,-15,-26,-43,3215,11.123126835,15.757763016,-8.033369381,-2,0,-4.634636181,-8.033369381
46,43,2006,19,38,-114,108,0,-19,-114,-135,3080,6.0365369341,12.073073868,-36.2192216,-2,0,-6.036536934,-36.2192216
46,43,2007,35,32,-63,108,0,3,-63,-64,3016,11.482939633,10.498687664,-20.66929134,-4,0,0.9842519685,-20.66929134
46,43,2008,32,38,-58,108,0,-6,-58,-71,2945,10.736453615,12.749538668,-19.45982218,-7,0,-2.013085053,-19.45982218
46,45,2001,47,71,-34,134,2,-24,-32,-62,4291,10.874595095,16.427579824,-7.866728366,-6,0.4627487274,-5.552984729,-7.403979639
46,45,2002,39,50,-65,134,2,-11,-63,-77,4214,9.1710758377,11.757789536,-15.2851264,-3,0.4703115814,-2.586713698,-14.81481481
46,45,2003,35,43,-37,134,1,-8,-36,-47,4167,8.3522252714,10.261305333,-8.829495287,-3,0.2386350078,-1.909080062,-8.590860279
46,45,2004,45,56,-77,134,0,-11,-77,-95,4072,10.923655783,13.593882753,-18.69158879,-7,0,-2.670226969,-18.69158879
46,45,2005,54,56,10,134,1,-2,11,7,4079,13.249907987,13.74064532,2.4536866642,-2,0.2453686664,-0.490737333,2.6990553306
46,45,2006,44,46,-71,134,0,-2,-71,-75,4004,10.887046889,11.381912656,-17.56773475,-2,0,-0.494865768,-17.56773475
46,45,2007,32,53,12,134,1,-21,13,-8,3996,8,13.25,3,0,0.25,-5.25,3.25
46,45,2008,41,34,28,134,0,7,28,38,4034,10.211706102,8.4682440847,6.9738480697,3,0,1.7434620174,6.9738480697
46,47,2001,66,109,22,483,0,-43,22,-28,7372,8.9358245329,14.757649607,2.9786081776,-7,0,-5.821825074,2.9786081776
46,47,2002,54,114,-32,480,-1,-60,-33,-98,7274,7.3740270381,15.567390414,-4.3697938,-5,-0.136556056,-8.193363376,-4.506349857
46,47,2003,67,112,36,438,-1,-45,35,-17,7257,9.2216640286,15.415318973,4.9549239557,-7,-0.137636777,-6.193654945,4.8172871791
46,47,2004,76,122,24,423,0,-46,24,-28,7229,10.492889687,16.843849234,3.3135441116,-6,0,-6.350959547,3.3135441116
46,47,2005,66,102,81,421,0,-36,81,38,7267,9.1059602649,14.072847682,11.175496689,-7,0,-4.966887417,11.175496689
46,47,2006,65,113,14,382,0,-48,14,-36,7231,8.966754035,15.588357015,1.9313008691,-2,0,-6.62160298,1.9313008691
46,47,2007,67,104,3,382,0,-37,3,-33,7198,9.2868528658,14.415413404,0.4158292328,1,0,-5.128560538,0.4158292328
46,47,2008,67,105,-22,382,0,-38,-22,-53,7145,9.3425364289,14.641288433,-3.067698529,7,0,-5.298752004,-3.067698529
46,49,2001,22,23,-83,48,1,-1,-82,-84,2542,8.5139318885,8.9009287926,-32.12074303,-1,0.386996904,-0.386996904,-31.73374613
46,49,2002,27,35,-38,48,1,-8,-37,-48,2494,10.72279587,13.899920572,-15.09134234,-3,0.3971405878,-3.177124702,-14.69420175
46,49,2003,29,31,-40,48,1,-2,-39,-44,2450,11.731391586,12.540453074,-16.18122977,-3,0.4045307443,-0.809061489,-15.77669903
46,49,2004,24,32,-60,48,0,-8,-60,-71,2379,9.9399461586,13.253261545,-24.8498654,-3,0,-3.313315386,-24.8498654
46,49,2005,21,19,-56,48,1,2,-55,-53,2326,8.9266737513,8.0765143464,-23.80446334,0,0.4250797024,0.8501594049,-23.37938363
46,49,2006,31,32,-37,48,0,-1,-37,-40,2286,13.443191674,13.876843018,-16.04509974,-2,0,-0.433651344,-16.04509974
46,49,2007,21,27,-10,48,1,-6,-9,-20,2266,9.2267135325,11.862917399,-4.393673111,-5,0.4393673111,-2.636203866,-3.9543058
46,49,2008,24,24,-4,48,0,0,-4,-11,2255,10.617120106,10.617120106,-1.769520018,-7,0,0,-1.769520018
46,51,2001,78,111,-122,232,4,-33,-118,-155,7677,10.058675608,14.314269134,-15.73280031,-4,0.5158295183,-4.255593526,-15.21697079
46,51,2002,85,91,-45,232,3,-6,-42,-55,7622,11.111837375,11.896202366,-5.882737434,-7,0.3921824956,-0.784364991,-5.490554938
46,51,2003,75,89,13,232,3,-14,16,-9,7613,9.845749918,11.683623236,1.7065966524,-11,0.3938299967,-1.837873318,2.1004266492
46,51,2004,81,99,-134,232,4,-18,-130,-157,7456,10.750547482,13.139558033,-17.78485633,-9,0.5308912337,-2.389010551,-17.25396509
46,51,2005,62,109,-118,232,4,-47,-114,-166,7290,8.4090600841,14.783670148,-16.00434016,-5,0.5425200054,-6.374610064,-15.46182015
46,51,2006,76,79,-79,232,4,-3,-75,-81,7209,10.483481619,10.897303262,-10.89730326,-3,0.5517621905,-0.413821643,-10.34554107
46,51,2007,87,92,-52,232,3,-5,-49,-55,7154,12.114460767,12.810694145,-7.240827125,-1,0.4177400265,-0.696233377,-6.823087099
46,51,2008,81,86,-46,232,3,-5,-43,-53,7101,11.364433532,12.065941775,-6.453875833,-5,0.4209049456,-0.701508243,-6.032970887
46,53,2001,50,81,-132,92,0,-31,-132,-165,4595,10.689470871,17.316942811,-28.2202031,-2,0,-6.62747194,-28.2202031
46,53,2002,35,59,-86,92,0,-24,-86,-112,4483,7.7109495484,12.99845781,-18.9469046,-2,0,-5.287508262,-18.9469046
46,53,2003,33,77,-40,92,0,-44,-40,-90,4393,7.4357818837,17.350157729,-9.01306895,-6,0,-9.914375845,-9.01306895
46,53,2004,40,78,-49,92,0,-38,-49,-91,4302,9.2006900518,17.941345601,-11.27084531,-4,0,-8.740655549,-11.27084531
46,53,2005,41,55,-66,92,0,-14,-66,-83,4219,9.6232836522,12.909282948,-15.49113954,-3,0,-3.285999296,-15.49113954
46,53,2006,43,76,-37,92,0,-33,-37,-71,4148,10.278474961,18.166606908,-8.844269153,-1,0,-7.888131947,-8.844269153
46,53,2007,43,53,-42,92,0,-10,-42,-50,4098,10.429299054,12.854717439,-10.18675722,2,0,-2.425418385,-10.18675722
46,53,2008,49,53,-13,92,0,-4,-13,-14,4084,11.977511611,12.955267661,-3.177707162,3,0,-0.97775605,-3.177707162
46,55,2001,20,22,-40,49,1,-2,-39,-43,2133,9.2828962636,10.21118589,-18.56579253,-2,0.4641448132,-0.928289626,-18.10164771
46,55,2002,19,27,-51,49,1,-8,-50,-58,2075,9.030418251,12.83269962,-24.23954373,0,0.4752851711,-3.802281369,-23.76425856
46,55,2003,24,25,-44,49,1,-1,-43,-43,2032,11.687363039,12.174336499,-21.42683224,1,0.4869734599,-0.48697346,-20.93985878
46,55,2004,15,32,-31,49,0,-17,-31,-51,1981,7.4757039621,15.948168453,-15.44978819,-3,0,-8.47246449,-15.44978819
46,55,2005,21,21,-64,49,1,0,-63,-64,1917,10.774756285,10.774756285,-32.83735249,-1,0.5130836326,0,-32.32426886
46,55,2006,15,29,-35,49,0,-14,-35,-49,1868,7.9260237781,15.323645971,-18.49405548,0,0,-7.397622193,-18.49405548
46,55,2007,20,24,-25,49,1,-4,-24,-26,1842,10.781671159,12.938005391,-13.47708895,2,0.539083558,-2.156334232,-12.93800539
46,55,2008,21,20,-25,49,0,1,-25,-23,1819,11.472275335,10.925976509,-13.65747064,1,0,0.5462988255,-13.65747064
46,57,2001,88,63,-27,168,0,25,-27,-6,5543,15.867291742,11.359538406,-4.868373603,-4,0,4.5077533357,-4.868373603
46,57,2002,86,71,-9,168,0,15,-9,0,5543,15.515064045,12.808948223,-1.623669493,-6,0,2.7061158218,-1.623669493
46,57,2003,100,72,-46,168,0,28,-46,-23,5520,18.078278948,13.016360842,-8.316008316,-5,0,5.0619181054,-8.316008316
46,57,2004,88,65,-30,168,0,23,-30,-12,5508,15.959376133,11.788175553,-5.440696409,-5,0,4.1712005803,-5.440696409
46,57,2005,104,79,31,168,0,25,31,52,5560,18.792916516,14.275388507,5.6017347308,-4,0,4.5175280087,5.6017347308
46,57,2006,96,73,-54,168,0,23,-54,-35,5525,17.320703654,13.170951737,-9.742895805,-4,0,4.149751917,-9.742895805
46,57,2007,97,73,61,168,0,24,61,85,5610,17.422541536,13.111809609,10.956443646,0,0,4.3107319264,10.956443646
46,57,2008,111,67,7,168,0,44,7,50,5660,19.698314108,11.889973381,1.2422360248,-1,0,7.8083407276,1.2422360248
46,59,2001,37,50,-71,70,2,-13,-69,-84,3628,10.081743869,13.623978202,-19.34604905,-2,0.5449591281,-3.542234332,-18.80108992
46,59,2002,29,43,-65,70,2,-14,-63,-80,3548,8.0824972129,11.984392419,-18.11594203,-3,0.5574136009,-3.901895206,-17.55852843
46,59,2003,33,48,-45,70,2,-15,-43,-61,3487,9.381663113,13.646055437,-12.79317697,-3,0.5685856432,-4.264392324,-12.22459133
46,59,2004,20,54,-108,70,1,-34,-107,-145,3342,5.8573729682,15.814907014,-31.62981403,-4,0.2928686484,-9.957534046,-31.33694538
46,59,2005,40,38,-39,70,2,2,-37,-37,3305,12.035504739,11.433729502,-11.73461712,-2,0.6017752369,0.6017752369,-11.13284188
46,59,2006,27,42,-6,70,1,-15,-5,-22,3283,8.1967213115,12.750455373,-1.821493625,-2,0.3035822708,-4.553734062,-1.517911354
46,59,2007,44,31,-24,70,2,13,-22,-13,3270,13.428963833,9.461315428,-7.324889364,-4,0.610407447,3.9676484053,-6.714481917
46,59,2008,39,42,6,70,1,-3,7,4,3274,11.919315403,12.836185819,1.8337408313,0,0.3056234719,-0.916870416,2.1393643032
46,61,2001,72,17,81,0,2,55,83,136,3290,22.346368715,5.2762259466,25.139664804,-2,0.6207324643,17.070142768,25.760397269
46,61,2002,46,29,32,0,2,17,34,48,3338,13.88050694,8.7507543754,9.656004828,-3,0.6035003018,5.1297525649,10.25950513
46,61,2003,54,17,34,0,2,37,36,72,3410,16.004742146,5.0385299348,10.07705987,-1,0.5927682276,10.966212211,10.669828097
46,61,2004,50,17,186,0,1,33,187,210,3620,14.224751067,4.8364153627,52.916073969,-10,0.2844950213,9.3883357041,53.20056899
46,61,2005,54,16,-6,0,2,38,-4,33,3653,14.849443146,4.3998350062,-1.649938127,-1,0.5499793758,10.44960814,-1.099958752
46,61,2006,54,21,-115,0,1,33,-114,-82,3571,14.950166113,5.8139534884,-31.83831672,-1,0.276854928,9.1362126246,-31.56146179
46,61,2007,51,14,-1,0,1,37,0,28,3599,14.225941423,3.9051603905,-0.278940028,-9,0.2789400279,10.320781032,0
46,61,2008,49,11,-17,0,0,38,-17,10,3609,13.59600444,3.0521642619,-4.716981132,-11,0,10.543840178,-4.716981132
46,63,2001,19,4,-40,42,3,15,-37,-23,1318,14.291086875,3.0086498684,-30.08649868,-1,2.2564874013,11.282437006,-27.83001128
46,63,2002,13,9,-39,42,3,4,-36,-33,1285,9.9884748367,6.9150979639,-29.96542451,-1,2.3050326546,3.0733768728,-27.66039186
46,63,2003,17,10,-8,42,2,7,-6,-2,1283,13.239875389,7.7881619938,-6.230529595,-3,1.5576323988,5.4517133956,-4.672897196
46,63,2004,10,11,-62,42,1,-1,-61,-64,1219,7.9936051159,8.7929656275,-49.56035172,-2,0.7993605116,-0.799360512,-48.76099121
46,63,2005,9,9,-38,42,2,0,-36,-37,1182,7.4968763015,7.4968763015,-31.65347772,-1,1.6659725115,0,-29.98750521
46,63,2006,13,9,7,42,1,4,8,11,1193,10.947368421,7.5789473684,5.8947368421,-1,0.8421052632,3.3684210526,6.7368421053
46,63,2007,9,7,-18,42,1,2,-17,-20,1173,7.6077768385,5.9171597633,-15.21555368,-5,0.8453085376,1.6906170752,-14.37024514
46,63,2008,14,3,-31,42,0,11,-31,-28,1145,12.079378775,2.5884383089,-26.74719586,-8,0,9.4909404659,-26.74719586
46,65,2001,190,154,-138,819,14,36,-124,-102,16386,11.559286975,9.3691062846,-8.395692645,-14,0.851736935,2.1901806899,-7.54395571
46,65,2002,211,161,104,852,13,50,117,152,16538,12.817397643,9.7800996234,6.3175798809,-15,0.7896974851,3.0372980197,7.1072773661
46,65,2003,188,152,-19,839,11,36,-8,4,16542,11.366384522,9.1898428053,-1.148730351,-24,0.6650544135,2.176541717,-0.483675937
46,65,2004,199,140,30,900,12,59,42,90,16632,11.99734732,8.4403448484,1.8086453247,-11,0.7234581299,3.5570024718,2.5321034545
46,65,2005,219,133,10,888,12,86,22,92,16724,13.131070872,7.9745772874,0.5995922773,-16,0.7195107327,5.1564935844,1.31910301
46,65,2006,216,158,-32,899,12,58,-20,29,16753,12.904382113,9.4393165457,-1.911760313,-9,0.7169101174,3.4650655674,-1.194850196
46,65,2007,249,142,8,962,10,107,18,124,16877,14.808206958,8.4448409158,0.4757656854,-1,0.5947071067,6.3633660422,1.0704727921
46,65,2008,233,141,-241,906,10,92,-231,-131,16746,13.85956042,8.3871159623,-14.33542516,8,0.5948309193,5.4724444577,-13.74059424
46,67,2001,89,114,-124,328,2,-25,-122,-151,7918,11.134046413,14.26158754,-15.51260399,-4,0.2502032902,-3.127541127,-15.2624007
46,67,2002,74,157,-56,328,2,-83,-54,-142,7776,9.4303555499,20.007646234,-7.136485281,-5,0.2548744743,-10.57729068,-6.881610807
46,67,2003,87,118,-21,328,1,-31,-20,-60,7716,11.231603408,15.23366899,-2.711076685,-9,0.1290988897,-4.002065582,-2.581977795
46,67,2004,88,136,-76,328,0,-48,-76,-132,7584,11.503267974,17.777777778,-9.934640523,-8,0,-6.274509804,-9.934640523
46,67,2005,78,120,-43,328,1,-42,-42,-91,7493,10.346885985,15.918286131,-5.70405253,-7,0.1326523844,-5.571400146,-5.571400146
46,67,2006,73,106,-82,328,0,-33,-82,-118,7375,9.8197471079,14.258810869,-11.03040086,-3,0,-4.439063761,-11.03040086
46,67,2007,71,103,-24,328,1,-32,-23,-51,7324,9.6605211239,14.014558814,-3.265528267,4,0.1360636778,-4.35403769,-3.129464589
46,67,2008,73,103,-52,328,0,-30,-52,-74,7250,10.017839989,14.134760532,-7.135995609,8,0,-4.116920543,-7.135995609
46,69,2001,21,21,-55,37,1,0,-54,-54,1612,12.812690665,12.812690665,-33.55704698,0,0.6101281269,0,-32.94691885
46,69,2002,17,27,-51,37,1,-10,-50,-60,1552,10.745891277,17.067003793,-32.23767383,0,0.6321112516,-6.321112516,-31.60556258
46,69,2003,14,20,31,37,1,-6,32,26,1578,8.945686901,12.779552716,19.808306709,0,0.6389776358,-3.833865815,20.447284345
46,69,2004,26,31,30,37,0,-5,30,24,1602,16.352201258,19.496855346,18.867924528,-1,0,-3.144654088,18.867924528
46,69,2005,16,24,-13,37,1,-8,-12,-22,1580,10.056568196,15.084852294,-8.170961659,-2,0.6285355123,-5.028284098,-7.542426147
46,69,2006,11,23,-44,37,0,-12,-44,-55,1525,7.0853462158,14.814814815,-28.34138486,1,0,-7.729468599,-28.34138486
46,69,2007,14,15,-67,37,1,-1,-66,-69,1456,9.3928212009,10.063737001,-44.9513586,-2,0.6709158001,-0.6709158,-44.2804428
46,69,2008,13,15,-28,37,0,-2,-28,-32,1424,9.0277777778,10.416666667,-19.44444444,-2,0,-1.388888889,-19.44444444
46,71,2001,48,21,-160,23,1,27,-159,-131,2809,16.698556271,7.3056183684,-55.66185424,1,0.347886589,9.3929379022,-55.31396765
46,71,2002,44,30,-21,23,1,14,-20,-10,2799,15.691868759,10.699001427,-7.489300999,-4,0.3566333809,4.9928673324,-7.132667618
46,71,2003,66,27,-25,23,1,39,-24,11,2810,23.533606704,9.6273845605,-8.914244963,-4,0.3565697985,13.906222143,-8.557675165
46,71,2004,59,28,-51,23,0,31,-51,-23,2787,21.082722887,10.005360014,-18.2240486,-3,0,11.077362873,-18.2240486
46,71,2005,68,32,-32,23,1,36,-31,3,2790,24.38587054,11.475703783,-11.47570378,-2,0.3586157432,12.910166756,-11.11708804
46,71,2006,57,25,-56,23,0,32,-56,-25,2765,20.522052205,9.00090009,-20.1620162,-1,0,11.521152115,-20.1620162
46,71,2007,70,30,-29,23,1,40,-28,11,2776,25.266197437,10.82837033,-10.46742465,-1,0.3609456777,14.437827107,-10.10647897
46,71,2008,70,11,-120,23,0,59,-120,-65,2711,25.51485329,4.0094769455,-43.7397485,-4,0,21.505376344,-43.7397485
46,73,2001,17,33,-25,40,1,-16,-24,-43,2236,7.5304540421,14.617940199,-11.07419712,-3,0.4429678848,-7.087486157,-10.63122924
46,73,2002,21,29,-29,40,1,-8,-28,-37,2199,9.4701240135,13.077790304,-13.0777903,-1,0.4509582864,-3.607666291,-12.62683202
46,73,2003,27,33,-46,40,1,-6,-45,-52,2147,12.425218592,15.186378279,-21.16889093,-1,0.4601932812,-2.761159687,-20.70869765
46,73,2004,22,28,-54,40,0,-6,-54,-62,2085,10.396975425,13.232514178,-25.51984877,-2,0,-2.835538752,-25.51984877
46,73,2005,21,29,0,40,1,-8,1,-9,2076,10.093727469,13.938956981,0,-2,0.480653689,-3.845229512,0.480653689
46,73,2006,27,30,-33,40,0,-3,-33,-37,2039,13.12272175,14.580801944,-16.03888214,-1,0,-1.458080194,-16.03888214
46,73,2007,32,23,-62,40,1,9,-61,-53,1986,15.900621118,11.428571429,-30.80745342,-1,0.4968944099,4.4720496894,-30.31055901
46,73,2008,19,16,-1,40,0,3,-1,-4,1982,9.5766129032,8.064516129,-0.504032258,-6,0,1.5120967742,-0.504032258
46,75,2001,14,6,-50,0,1,8,-49,-42,1142,12.03783319,5.1590713672,-42.99226139,-1,0.8598452279,6.8787618229,-42.13241617
46,75,2002,7,5,-21,0,1,2,-20,-18,1124,6.1782877317,4.4130626655,-18.5348632,0,0.8826125331,1.7652250662,-17.65225066
46,75,2003,12,5,-46,0,1,7,-45,-38,1086,10.859728507,4.5248868778,-41.62895928,0,0.9049773756,6.334841629,-40.7239819
46,75,2004,10,15,6,0,0,-5,6,0,1086,9.2081031308,13.812154696,5.5248618785,-1,0,-4.604051565,5.5248618785
46,75,2005,13,11,-34,0,1,2,-33,-31,1055,12.14385801,10.275572163,-31.76085941,0,0.9341429239,1.8682858477,-30.82671649
46,75,2006,18,6,2,0,0,12,2,13,1068,16.957136128,5.6523787094,1.8841262365,-1,0,11.304757419,1.8841262365
46,75,2007,12,3,-30,0,1,9,-29,-21,1047,11.34751773,2.8368794326,-28.36879433,-1,0.9456264775,8.5106382979,-27.42316785
46,75,2008,16,2,-34,0,0,14,-34,-23,1024,15.451472718,1.9314340898,-32.83437953,-3,0,13.520038629,-32.83437953
46,77,2001,54,88,-107,179,1,-34,-106,-142,5668,9.4093047569,15.333681826,-18.64436313,-2,0.1742463844,-5.924377069,-18.47011675
46,77,2002,53,102,-36,179,1,-49,-35,-88,5580,9.4238975818,18.13655761,-6.40113798,-4,0.1778093883,-8.712660028,-6.223328592
46,77,2003,53,90,-31,179,-1,-37,-32,-74,5506,9.5616092369,16.236694931,-5.592639365,-5,-0.180407721,-6.675085694,-5.773047086
46,77,2004,45,101,-45,179,0,-56,-45,-106,5400,8.2523381625,18.521914542,-8.252338162,-5,0,-10.26957638,-8.252338162
46,77,2005,65,86,49,179,0,-21,49,24,5424,12.010347376,15.890613452,9.0539541759,-4,0,-3.880266075,9.0539541759
46,77,2006,50,79,-18,179,0,-29,-18,-50,5374,9.2609742545,14.632339322,-3.333950732,-3,0,-5.371365068,-3.333950732
46,77,2007,50,73,31,179,0,-23,31,4,5378,9.3005952381,13.578869048,5.7663690476,-4,0,-4.27827381,5.7663690476
46,77,2008,55,83,53,179,0,-28,53,16,5394,10.211659859,15.41032306,9.8403267731,-9,0,-5.198663201,9.8403267731
46,79,2001,105,125,32,800,1,-20,33,3,11247,9.3370681606,11.115557334,2.8455826775,-10,0.0889244587,-1.778489173,2.9345071362
46,79,2002,129,106,-164,710,0,23,-164,-147,11100,11.545173849,9.4867319998,-14.67758536,-6,0,2.058441849,-14.67758536
46,79,2003,119,107,-95,657,0,12,-95,-92,11008,10.765333816,9.6797539352,-8.594174055,-9,0,1.0855798806,-8.594174055
46,79,2004,113,110,-80,634,1,3,-79,-87,10921,10.305987505,10.032377217,-7.29627434,-11,0.0912034292,0.2736102877,-7.205070911
46,79,2005,134,95,56,662,1,39,57,86,11007,12.221816855,8.6647209048,5.1076249544,-10,0.0912075885,3.5570959504,5.1988325429
46,79,2006,140,94,70,654,1,46,71,111,11118,12.655367232,8.4971751412,6.3276836158,-6,0.0903954802,4.1581920904,6.418079096
46,79,2007,132,108,277,673,1,24,278,301,11419,11.714070196,9.584239251,24.58179882,-1,0.088742956,2.1298309447,24.670541776
46,79,2008,158,99,216,644,1,59,217,274,11693,13.672551056,8.5669781931,18.691588785,-2,0.0865351333,5.1055728626,18.778123918
46,81,2001,236,183,-92,1147,2,53,-90,-58,21705,10.858562621,8.419987117,-4.232998988,-21,0.0920217171,2.4385755038,-4.140977271
46,81,2002,249,211,-28,1121,1,38,-27,-9,21696,11.474389991,9.7232782655,-1.29029285,-20,0.0460818875,1.7511117255,-1.244210963
46,81,2003,225,181,289,1136,0,44,289,323,22019,10.293949445,8.2809104426,13.222006176,-10,0,2.0130390026,13.222006176
46,81,2004,252,193,408,1192,3,59,411,444,22463,11.33042579,8.6776673711,18.344498898,-26,0.1348860213,2.6527584191,18.47938492
46,81,2005,260,212,207,1276,1,48,208,242,22705,11.512575275,9.3871767623,9.165781084,-14,0.0442791357,2.1253985122,9.2100602196
46,81,2006,250,203,231,1299,2,47,233,266,22971,10.946667834,8.8886942815,10.114721079,-14,0.0875733427,2.0579735529,10.202294422
46,81,2007,306,217,348,1321,2,89,350,417,23388,13.201320132,9.3617204858,15.013266032,-22,0.0862831381,3.8395996462,15.099549171
46,81,2008,298,212,71,1284,2,86,73,136,23524,12.704638472,9.0381991814,3.0269440655,-23,0.08526603,3.6664392906,3.1122100955
46,83,2001,421,152,1275,279,19,269,1294,1639,26168,16.608477819,5.996410044,50.298834251,76,0.7495512555,10.612067775,51.048385506
46,83,2002,427,147,1183,279,18,280,1201,1558,27726,15.845919768,5.4551527072,43.900990834,77,0.6679778825,10.390767061,44.568968716
46,83,2003,449,181,1106,279,15,268,1121,1512,29238,15.764342392,6.3548908082,38.831542729,123,0.5266484095,9.4094515835,39.358191138
46,83,2004,554,202,2053,279,21,352,2074,2431,31669,18.191669266,6.6330635231,67.414254519,5,0.6895759108,11.558605743,68.10383043
46,83,2005,640,213,1522,279,19,427,1541,2034,33703,19.580248424,6.5165514287,46.564278284,66,0.5812886251,13.063696996,47.145566909
46,83,2006,703,233,1436,279,20,470,1456,1996,35699,20.258782168,6.7145039048,41.382092735,70,0.5763522665,13.544278263,41.958445002
46,83,2007,796,210,1407,279,11,586,1418,2033,37732,21.680216802,5.7196551865,38.32168975,29,0.299600986,15.960561616,38.621290736
46,83,2008,804,198,1357,279,13,606,1370,1981,39713,20.763122216,5.1133062173,35.044224934,5,0.3357221254,15.649815998,35.379947059
46,85,2001,68,35,-42,15,1,33,-41,-10,3898,17.422495516,8.9674609275,-10.76095311,-2,0.2562131694,8.4550345888,-10.50473994
46,85,2002,66,36,-23,15,0,30,-23,2,3900,16.927417286,9.2331367017,-5.898948448,-5,0,7.6942805848,-5.898948448
46,85,2003,80,34,-29,15,-1,46,-30,13,3913,20.478689364,8.7034429796,-7.423524894,-3,-0.255983617,11.775246384,-7.679508511
46,85,2004,81,27,-65,15,0,54,-65,-15,3898,20.739982077,6.9133273589,-16.64319549,-4,0,13.826654718,-16.64319549
46,85,2005,67,35,-86,15,0,32,-86,-56,3842,17.312661499,9.0439276486,-22.22222222,-2,0,8.2687338501,-22.22222222
46,85,2006,69,24,-25,15,0,45,-25,17,3859,17.919750682,6.2329567589,-6.49266329,-3,0,11.686793923,-6.49266329
46,85,2007,58,18,-15,15,0,40,-15,23,3882,14.985144038,4.6505619429,-3.875468286,-2,0,10.334582095,-3.875468286
46,85,2008,68,11,-127,15,0,57,-127,-71,3811,17.678408943,2.8597426232,-33.01702847,-1,0,14.81866632,-33.01702847
46,87,2001,70,64,20,154,0,6,20,20,5869,11.947431302,10.923365762,3.4135518006,-6,0,1.0240655402,3.4135518006
46,87,2002,82,66,-90,154,0,16,-90,-77,5792,14.06397393,11.319783895,-15.43606895,-3,0,2.7441900352,-15.43606895
46,87,2003,78,77,16,154,-2,1,14,6,5798,13.459879206,13.287316652,2.7610008628,-9,-0.345125108,0.1725625539,2.415875755
46,87,2004,87,78,27,154,1,9,28,32,5830,14.963880289,13.415892673,4.6439628483,-5,0.171998624,1.5479876161,4.8159614723
46,87,2005,86,70,-17,154,-1,16,-18,-7,5823,14.760147601,12.014073629,-2.917703596,-5,-0.171629623,2.7460739724,-3.089333219
46,87,2006,64,72,-91,154,0,-8,-91,-102,5721,11.088011088,12.474012474,-15.76576577,-3,0,-1.386001386,-15.76576577
46,87,2007,71,63,18,154,-1,8,17,26,5747,12.38228113,10.987094524,3.139169864,1,-0.174398326,1.3951866062,2.9647715382
46,87,2008,84,73,-89,154,1,11,-88,-76,5671,14.713610089,12.786827816,-15.58942021,1,0.1751620249,1.9267822736,-15.41425819
46,89,2001,28,54,-34,68,1,-26,-33,-63,2827,9.7953472101,18.891026762,-11.89435018,-4,0.3498338289,-9.095679552,-11.54451635
46,89,2002,22,38,-37,68,1,-16,-36,-57,2770,7.8613542969,13.578702877,-13.22136859,-5,0.3573342862,-5.71734858,-12.8640343
46,89,2003,28,26,-45,68,1,2,-44,-45,2725,10.191082803,9.4631483167,-16.37852593,-3,0.3639672429,0.7279344859,-16.01455869
46,89,2004,25,40,-54,68,0,-15,-54,-72,2653,9.297136482,14.875418371,-20.0818148,-3,0,-5.578281889,-20.0818148
46,89,2005,17,41,-17,68,1,-24,-16,-42,2611,6.4589665653,15.577507599,-6.458966565,-2,0.3799392097,-9.118541033,-6.079027356
46,89,2006,21,41,-66,68,0,-20,-66,-87,2524,8.1791626095,15.968841285,-25.70593963,-1,0,-7.789678676,-25.70593963
46,89,2007,21,35,-23,68,1,-14,-22,-39,2485,8.3849071671,13.974845278,-9.183469754,-3,0.3992812937,-5.589938111,-8.784188461
46,89,2008,18,33,10,68,0,-15,10,-5,2480,7.250755287,13.29305136,4.0281973817,0,0,-6.042296073,4.0281973817
46,91,2001,39,66,-95,89,1,-27,-94,-124,4457,8.6302279265,14.605001106,-21.02235008,-3,0.2212878956,-5.97477318,-20.80106218
46,91,2002,29,66,-78,89,1,-37,-77,-116,4341,6.5924073653,15.003409866,-17.73130257,-2,0.2273243919,-8.411002501,-17.50397818
46,91,2003,34,49,-60,89,1,-15,-59,-74,4267,7.8996282528,11.384758364,-13.94052045,0,0.2323420074,-3.485130112,-13.70817844
46,91,2004,40,47,87,89,0,-7,87,74,4341,9.2936802974,10.920074349,20.213754647,-6,0,-1.626394052,20.213754647
46,91,2005,61,55,31,89,1,6,32,34,4375,13.997246443,12.620468105,7.1133547499,-4,0.2294630564,1.3767783387,7.3428178063
46,91,2006,46,54,-11,89,0,-8,-11,-20,4355,10.538373425,12.371134021,-2.520045819,-1,0,-1.832760596,-2.520045819
46,91,2007,56,42,-60,89,1,14,-59,-45,4310,12.925562608,9.6941719561,-13.84881708,0,0.230813618,3.231390652,-13.61800346
46,91,2008,55,43,-4,89,0,12,-4,10,4320,12.746234067,9.9652375435,-0.926998841,2,0,2.7809965238,-0.926998841
46,93,2001,382,172,-199,883,-1,210,-200,-14,24199,15.78121127,7.1056762786,-8.221102206,-24,-0.041312071,8.6755349913,-8.262414277
46,93,2002,413,175,70,885,-80,238,-10,203,24402,16.995535071,7.2014979116,2.8805991646,-25,-3.292113331,9.7940371597,-0.411514166
46,93,2003,375,188,55,830,-226,187,-171,-20,24382,15.37389308,7.707445064,2.2548376517,-36,-9.265332896,7.6664480157,-7.010495244
46,93,2004,346,193,-19,858,114,153,95,233,24615,14.123313672,7.878033349,-0.775557687,-15,4.6533461232,6.2452803233,3.877788436
46,93,2005,357,242,-213,779,-8,115,-221,-125,24490,14.540270848,9.8564300988,-8.675287649,-19,-0.3258324,4.6838407494,-9.001120049
46,93,2006,380,235,-400,691,58,145,-342,-207,24283,15.582391897,9.6364791996,-16.40251779,-10,2.378365079,5.9459126976,-14.02415271
46,93,2007,376,194,-409,760,-12,182,-421,-226,24057,15.556474969,8.0264791063,-16.92180389,13,-0.496483244,7.5299958626,-17.41828713
46,93,2008,334,191,-234,760,14,143,-220,-68,23989,13.90334263,7.9507138992,-9.740665196,9,0.5827748408,5.9526287308,-9.157890355
46,95,2001,26,17,-26,45,1,9,-25,-18,2070,12.506012506,8.177008177,-12.50601251,-2,0.481000481,4.329004329,-12.02501203
46,95,2002,38,20,-50,45,1,18,-49,-30,2040,18.491484185,9.7323600973,-24.33090024,1,0.4866180049,8.7591240876,-23.84428224
46,95,2003,31,16,7,45,1,15,8,19,2059,15.1256404,7.806782142,3.4154671871,-4,0.4879238839,7.3188582581,3.903391071
46,95,2004,44,36,-61,45,0,8,-61,-56,2003,21.664204825,17.725258493,-30.03446578,-3,0,3.9389463319,-30.03446578
46,95,2005,37,20,-11,45,1,17,-10,6,2009,18.444666002,9.9700897308,-5.483549352,-1,0.4985044865,8.4745762712,-4.985044865
46,95,2006,41,25,-13,45,0,16,-13,1,2010,20.403085345,12.440905698,-6.469270963,-2,0,7.9621796467,-6.469270963
46,95,2007,50,8,-35,45,1,42,-34,6,2016,24.838549429,3.9741679086,-17.3869846,-2,0.4967709886,20.86438152,-16.89021361
46,95,2008,43,4,-70,45,0,39,-70,-34,1982,21.510755378,2.0010005003,-35.01750875,-3,0,19.509754877,-35.01750875
46,97,2001,33,41,-62,55,1,-8,-61,-71,2811,11.593184613,14.40365361,-21.78113473,-2,0.3513086246,-2.810468997,-21.4298261
46,97,2002,17,44,-33,55,1,-27,-32,-60,2751,6.1129090255,15.82164689,-11.86623517,-1,0.3595828839,-9.708737864,-11.50665228
46,97,2003,27,36,-121,55,1,-9,-120,-126,2625,10.044642857,13.392857143,-45.01488095,3,0.3720238095,-3.348214286,-44.64285714
46,97,2004,24,28,-35,55,0,-4,-35,-41,2584,9.214820503,10.75062392,-13.4382799,-2,0,-1.535803417,-13.4382799
46,97,2005,37,35,-48,55,1,2,-47,-48,2536,14.453125,13.671875,-18.75,-3,0.390625,0.78125,-18.359375
46,97,2006,29,35,-18,55,0,-6,-18,-25,2511,11.491975431,13.86962552,-7.132950267,-1,0,-2.377650089,-7.132950267
46,97,2007,25,33,-38,55,1,-8,-37,-43,2468,10.042177144,13.25567383,-15.26410926,2,0.4016870858,-3.213496686,-14.86242217
46,97,2008,29,34,-29,55,0,-5,-29,-33,2435,11.829492148,13.869059759,-11.82949215,1,0,-2.039567612,-11.82949215
46,99,2001,2338,1103,722,5407,434,1235,1156,3356,152435,15.508400937,7.3164098516,4.7891640189,965,2.8788049643,8.191991085,7.6679689832
46,99,2002,2369,1106,562,5700,399,1263,961,3001,155436,15.389562512,7.1848274115,3.6508797516,777,2.5919946991,8.2047351001,6.2428744507
46,99,2003,2441,1091,1148,6190,335,1350,1483,3656,159092,15.521670567,6.937379184,7.2998270424,823,2.1301760098,8.5842913826,9.4300030522
46,99,2004,2604,1087,777,6340,350,1517,1127,3580,162672,16.18577591,6.7565047675,4.8296266829,936,2.1755075148,9.4292711428,7.0051341977
46,99,2005,2561,1106,1299,6445,350,1455,1649,4068,166740,15.548917465,6.7149952036,7.8867800809,964,2.1249984821,8.8339222615,10.011778563
46,99,2006,2616,1170,2151,6808,363,1446,2514,4954,171694,15.459439654,6.914198928,12.711488798,994,2.1451745392,8.5452407264,14.856663338
46,99,2007,2696,1101,1580,6808,327,1595,1907,3448,175142,15.546252407,6.3488219216,9.1109342744,-54,1.88561741,9.1974304859,10.996551684
46,99,2008,2820,1192,2150,6808,332,1628,2482,4038,179180,15.917724556,6.7283431455,12.135853828,-72,1.8740016144,9.1893814101,14.009855442
46,101,2001,76,64,-13,77,8,12,-5,0,6579,11.551907585,9.7279221766,-1.975984192,-7,1.2159902721,1.8239854081,-0.75999392
46,101,2002,80,51,-108,77,8,29,-100,-76,6503,12.230545788,7.7969729399,-16.51123681,-5,1.2230545788,4.4335728482,-15.28818224
46,101,2003,80,57,-84,77,4,23,-80,-60,6443,12.359029816,8.805808744,-12.97698131,-3,0.6179514908,3.5532210721,-12.35902982
46,101,2004,72,53,13,77,3,19,16,31,6474,11.148099404,8.206239839,2.0128512813,-4,0.4645041418,2.9418595649,2.4773554231
46,101,2005,102,77,-13,77,4,25,-9,10,6484,15.743170242,11.884550085,-2.006482482,-6,0.6173792252,3.8586201574,-1.389103257
46,101,2006,93,61,-52,77,3,32,-49,-20,6464,14.365152919,9.422304603,-8.032128514,-3,0.4633920297,4.9428483163,-7.568736484
46,101,2007,91,46,-33,77,3,45,-30,12,6476,14.064914992,7.1097372488,-5.100463679,-3,0.4636785162,6.9551777434,-4.636785162
46,101,2008,97,53,-108,77,2,44,-106,-62,6414,15.050426687,8.2234290147,-16.75717611,0,0.310318076,6.8269976726,-16.44685803
46,103,2001,1388,650,487,2460,49,738,536,1185,89979,15.528071912,7.2717916016,5.4482500154,-89,0.548181213,8.2562803108,5.9964312284
46,103,2002,1338,659,296,2454,-20,679,276,864,90843,14.799084182,7.2889360808,3.2739379058,-91,-0.221212021,7.5101481014,3.0527258851
46,103,2003,1449,758,224,2454,-147,691,77,649,91492,15.893821812,8.3143664135,2.4570159322,-119,-1.612416706,7.579455398,0.8445992267
46,103,2004,1568,673,487,2534,126,895,613,1436,92928,17.004663269,7.2985576402,5.2814228392,-72,1.3664461555,9.7061056285,6.6478689947
46,103,2005,1552,678,-208,2540,31,874,-177,613,93541,16.646198564,7.2719862283,-2.230933828,-84,0.3324949455,9.3742123356,-1.898438883
46,103,2006,1537,655,204,2554,82,882,286,1121,94662,16.333427204,6.9605691726,2.1678719255,-47,0.8713994995,9.372858031,3.039271425
46,103,2007,1649,621,493,2564,22,1028,515,1568,96230,17.276784779,6.5062967542,5.1652243153,25,0.2304968254,10.770488025,5.3957211407
46,103,2008,1650,672,1230,2573,43,978,1273,2303,98533,16.943669999,6.9006946905,12.630735817,52,0.4415623091,10.042975308,13.072298126
46,105,2001,24,39,-50,68,3,-15,-47,-64,3276,7.2551390568,11.789600967,-15.11487304,-2,0.9068923821,-4.534461911,-14.20798065
46,105,2002,27,39,-19,68,3,-12,-16,-31,3245,8.2809385064,11.96135562,-5.827327097,-3,0.9201042785,-3.680417114,-4.907222819
46,105,2003,34,29,-122,68,1,5,-121,-113,3132,10.663321311,9.0951858241,-38.26250588,3,0.3136270974,1.5681354869,-37.94887878
46,105,2004,27,49,-75,68,0,-22,-75,-101,3031,8.7619665747,15.901346747,-24.33879604,-4,0,-7.139380172,-24.33879604
46,105,2005,31,33,-67,68,1,-2,-66,-70,2961,10.347129506,11.014686248,-22.36315087,-2,0.3337783712,-0.667556742,-22.0293725
46,105,2006,39,49,-1,68,0,-10,-1,-12,2949,13.197969543,16.582064298,-0.338409475,-1,0,-3.384094755,-0.338409475
46,105,2007,20,40,-24,68,1,-20,-23,-42,2907,6.8306010929,13.661202186,-8.196721311,1,0.3415300546,-6.830601093,-7.855191257
46,105,2008,28,40,2,68,0,-12,2,-7,2900,9.6435336663,13.776476666,0.6888238333,3,0,-4.132943,0.6888238333
46,107,2001,33,40,-105,68,1,-7,-104,-111,2562,12.607449857,15.281757402,-40.11461318,0,0.3820439351,-2.674307545,-39.73256925
46,107,2002,19,41,-39,68,1,-22,-38,-63,2499,7.5083975499,16.202331555,-15.41197392,-3,0.3951788184,-8.693934005,-15.0167951
46,107,2003,31,45,-13,68,1,-14,-12,-28,2471,12.474849095,18.108651911,-5.23138833,-2,0.4024144869,-5.633802817,-4.828973843
46,107,2004,21,41,-38,68,0,-20,-38,-62,2409,8.606557377,16.803278689,-15.57377049,-4,0,-8.196721311,-15.57377049
46,107,2005,25,40,-77,68,1,-15,-76,-91,2318,10.577533319,16.924053311,-32.57880262,0,0.4231013328,-6.346519992,-32.15570129
46,107,2006,19,40,-35,68,0,-21,-35,-57,2261,8.2987551867,17.471063551,-15.28718061,-1,0,-9.172308364,-15.28718061
46,107,2007,23,29,-70,68,1,-6,-69,-78,2183,10.351035104,13.051305131,-31.50315032,-3,0.4500450045,-2.700270027,-31.05310531
46,107,2008,25,31,-48,68,0,-6,-48,-60,2123,11.611704598,14.398513702,-22.29447283,-6,0,-2.786809104,-22.29447283
46,109,2001,138,134,17,213,1,4,18,12,10014,13.788968825,13.389288569,1.6986410871,-10,0.0999200639,0.3996802558,1.7985611511
46,109,2002,132,117,-185,213,0,15,-185,-174,9840,13.297068601,11.786038078,-18.63604311,-4,0,1.5110305228,-18.63604311
46,109,2003,152,94,71,213,-1,58,70,121,9961,15.352759962,9.4944699763,7.1713549821,-7,-0.101005,5.8582899854,7.0703499823
46,109,2004,152,127,24,213,0,25,24,42,10003,15.227409337,12.722901222,2.40432779,-7,0,2.5045081146,2.40432779
46,109,2005,160,138,-119,213,0,22,-119,-106,9897,16.08040201,13.869346734,-11.95979899,-9,0,2.2110552764,-11.95979899
46,109,2006,173,106,-68,213,0,67,-68,-5,9892,17.484461064,10.713022386,-6.872504927,-4,0,6.7714386781,-6.872504927
46,109,2007,166,84,-117,214,0,82,-117,-43,9849,16.817790385,8.510207183,-11.85350286,-8,0,8.3075832025,-11.85350286
46,109,2008,173,92,-68,214,0,81,-68,2,9851,17.563451777,9.3401015228,-6.903553299,-11,0,8.2233502538,-6.903553299
46,111,2001,26,33,-91,37,0,-7,-91,-99,2575,9.9066488855,12.573823585,-34.6732711,-1,0,-2.6671747,-34.6732711
46,111,2002,28,27,-5,37,0,1,-5,-6,2569,10.886469673,10.497667185,-1.944012442,-2,0,0.3888024883,-1.944012442
46,111,2003,27,27,38,37,-1,0,37,37,2606,10.434782609,10.434782609,14.685990338,0,-0.38647343,0,14.299516908
46,111,2004,30,34,-13,37,0,-4,-13,-20,2586,11.55624037,13.097072419,-5.00770416,-3,0,-1.540832049,-5.00770416
46,111,2005,25,29,-77,37,0,-4,-77,-82,2504,9.8231827112,11.394891945,-30.25540275,-1,0,-1.571709234,-30.25540275
46,111,2006,18,34,-30,37,0,-16,-30,-47,2457,7.2566014916,13.706913929,-12.09433582,-1,0,-6.450312437,-12.09433582
46,111,2007,31,20,-19,37,0,11,-19,-9,2448,12.640163099,8.1549439348,-7.747196738,-1,0,4.4852191641,-7.747196738
46,111,2008,31,16,-12,37,0,15,-12,-1,2447,12.6659857,6.5372829418,-4.902962206,-4,0,6.1287027579,-4.902962206
46,113,2001,335,114,-99,310,3,221,-96,114,12670,26.559898517,9.0382938238,-7.849044636,-11,0.2378498375,17.521604694,-7.611194799
46,113,2002,355,106,75,310,3,249,78,315,12985,27.67491717,8.2634963945,5.8468134866,-12,0.2338725395,19.411420776,6.0806860261
46,113,2003,364,136,-64,310,2,228,-62,152,13137,27.869229002,10.412678968,-4.90008422,-14,0.1531276319,17.456550034,-4.746956588
46,113,2004,370,129,-199,310,1,241,-198,28,13165,28.134742605,9.8091399894,-15.13192913,-15,0.0760398449,18.325602616,-15.05588929
46,113,2005,373,139,-27,310,2,234,-25,197,13362,28.122290496,10.479888416,-2.035661779,-12,0.1507897614,17.642402081,-1.884872017
46,113,2006,410,101,-21,310,1,309,-20,281,13643,30.364747269,7.4800962785,-1.555267543,-8,0.0740603592,22.884650991,-1.481207184
46,113,2007,395,113,-338,310,2,282,-336,-56,13587,29.012118986,8.2996694822,-24.82556004,-2,0.146896805,20.712449504,-24.67866324
46,113,2008,406,127,-223,310,1,279,-222,50,13637,29.826623567,9.3300029386,-16.38260359,-7,0.0734645901,20.496620629,-16.309139
46,115,2001,76,82,-198,485,0,-6,-198,-207,7213,10.387480353,11.207544591,-27.06211987,-3,0,-0.820064238,-27.06211987
46,115,2002,80,79,-119,493,-1,1,-120,-123,7090,11.186464378,11.046633573,-16.63986576,-4,-0.139830805,0.1398308047,-16.77969657
46,115,2003,76,81,-120,495,-1,-5,-121,-130,6960,10.818505338,11.53024911,-17.08185053,-4,-0.142348754,-0.711743772,-17.22419929
46,115,2004,90,90,-52,485,0,0,-52,-56,6904,12.983266013,12.983266013,-7.501442585,-4,0,0,-7.501442585
46,115,2005,77,68,-73,485,0,9,-73,-69,6835,11.208967174,9.8988281534,-10.62668316,-5,0,1.3101390203,-10.62668316
46,115,2006,76,79,-24,534,0,-3,-24,-30,6805,11.143695015,11.583577713,-3.519061584,-3,0,-0.439882698,-3.519061584
46,115,2007,76,74,-104,522,0,2,-104,-98,6707,11.249259917,10.953226761,-15.3937241,4,0,0.2960331557,-15.3937241
46,115,2008,86,76,-57,528,0,10,-57,-43,6664,12.86366016,11.367885723,-8.525914292,4,0,1.4957744372,-8.525914292
46,117,2001,34,28,-49,9,2,6,-47,-44,2731,12.350163458,10.170722848,-17.79876498,-3,0.7264802034,2.1794406102,-17.07228478
46,117,2002,37,11,-58,9,2,26,-56,-31,2700,13.625483336,4.0508193703,-21.35886577,-1,0.7365126128,9.5746639661,-20.62235316
46,117,2003,36,19,9,9,1,17,10,24,2724,13.274336283,7.005899705,3.3185840708,-3,0.3687315634,6.2684365782,3.6873156342
46,117,2004,44,13,37,9,0,31,37,65,2789,15.962270996,4.7161255215,13.422818792,-3,0,11.246145474,13.422818792
46,117,2005,38,15,-57,9,1,23,-56,-33,2756,13.706041479,5.4102795311,-20.55906222,0,0.3606853021,8.2957619477,-20.19837692
46,117,2006,39,24,-19,9,0,15,-19,-6,2750,14.166363967,8.717762441,-6.901561932,-2,0,5.4486015256,-6.901561932
46,117,2007,42,12,-2,9,1,30,-1,23,2773,15.209125475,4.3454644215,-0.72424407,-6,0.3621220351,10.863661054,-0.362122035
46,117,2008,39,3,-95,9,0,36,-95,-70,2703,14.243973703,1.0956902849,-34.69685902,-11,0,13.148283419,-34.69685902
46,119,2001,17,6,-25,0,1,11,-24,-16,1532,11.038961039,3.8961038961,-16.23376623,-3,0.6493506494,7.1428571429,-15.58441558
46,119,2002,20,10,-60,0,1,10,-59,-49,1483,13.266998342,6.6334991708,-39.80099502,0,0.6633499171,6.6334991708,-39.13764511
46,119,2003,19,7,-69,0,1,12,-68,-56,1427,13.058419244,4.8109965636,-47.42268041,0,0.6872852234,8.2474226804,-46.73539519
46,119,2004,25,16,-37,0,0,9,-37,-29,1398,17.699115044,11.327433628,-26.19469027,-1,0,6.3716814159,-26.19469027
46,119,2005,19,15,-12,0,1,4,-11,-8,1390,13.629842181,10.760401722,-8.608321377,-1,0.7173601148,2.8694404591,-7.890961263
46,119,2006,25,11,-11,0,0,14,-11,3,1393,17.9662235,7.9051383399,-7.90513834,0,0,10.06108516,-7.90513834
46,119,2007,22,6,-6,0,1,16,-5,3,1396,15.776263894,4.3026174256,-4.302617426,-8,0.7171029043,11.473646468,-3.585514521
46,119,2008,28,3,-58,0,0,25,-58,-40,1356,20.348837209,2.1802325581,-42.15116279,-7,0,18.168604651,-42.15116279
46,121,2001,251,76,-23,126,4,175,-19,147,9232,27.406234645,8.2983021237,-2.511328274,-9,0.4367527434,19.107932522,-2.074575531
46,121,2002,290,58,-100,126,4,232,-96,128,9360,31.196213425,6.239242685,-10.75731497,-8,0.430292599,24.95697074,-10.32702238
46,121,2003,253,77,-99,126,4,176,-95,73,9433,26.924918853,8.1945405204,-10.53583781,-8,0.4256904166,18.730378332,-10.1101474
46,121,2004,262,86,83,126,3,176,86,254,9687,27.405857741,8.9958158996,8.6820083682,-8,0.3138075314,18.410041841,8.9958158996
46,121,2005,264,75,-104,126,4,189,-100,81,9768,27.139552814,7.7101002313,-10.69133899,-8,0.4112053457,19.429452583,-10.28013364
46,121,2006,241,58,-68,126,3,183,-65,113,9881,24.530510459,5.9036083261,-6.921471831,-5,0.3053590514,18.626902132,-6.616112779
46,121,2007,301,52,-4,126,4,249,0,246,10127,30.087964814,5.1979208317,-0.399840064,-3,0.399840064,24.890043982,0
46,121,2008,292,61,-197,126,3,231,-194,40,10167,28.776978417,6.0116290529,-19.4146053,3,0.2956538878,22.765349364,-19.11895141
46,123,2001,75,77,-111,97,0,-2,-111,-116,6270,11.852085967,12.168141593,-17.54108723,-3,0,-0.316055626,-17.54108723
46,123,2002,81,98,-12,97,-1,-17,-13,-36,6234,12.955854127,15.674984005,-1.919385797,-6,-0.159948816,-2.719129878,-2.079334613
46,123,2003,70,84,-59,97,-1,-14,-60,-79,6155,11.300347082,13.560416499,-9.524578255,-5,-0.16143353,-2.260069416,-9.686011785
46,123,2004,49,68,-95,97,0,-19,-95,-122,6033,8.0406957663,11.158516574,-15.58910404,-8,0,-3.117820807,-15.58910404
46,123,2005,88,69,-29,97,0,19,-29,-15,6018,14.604597129,11.45133184,-4.812878599,-5,0,3.1532652892,-4.812878599
46,123,2006,78,85,-68,97,0,-7,-68,-78,5940,13.045659809,14.216424151,-11.37313932,-3,0,-1.170764342,-11.37313932
46,123,2007,76,72,-152,97,0,4,-152,-141,5799,12.948292018,12.266802964,-25.89658404,7,0,0.6814890536,-25.89658404
46,123,2008,69,72,-119,97,0,-3,-119,-118,5681,12.020905923,12.543554007,-20.73170732,4,0,-0.522648084,-20.73170732
46,125,2001,81,118,-63,203,0,-37,-63,-107,8742,9.2092547325,13.415951339,-7.162753681,-7,0,-4.206696606,-7.162753681
46,125,2002,87,120,-134,203,0,-33,-134,-172,8570,10.050831793,13.863216266,-15.4805915,-5,0,-3.812384473,-15.4805915
46,125,2003,77,105,31,203,-2,-28,29,-8,8562,8.9890263834,12.25776325,3.6189586738,-9,-0.233481205,-3.268736867,3.3854774691
46,125,2004,91,110,-29,203,2,-19,-27,-53,8509,10.661355515,12.887352821,-3.397574835,-7,0.2343155058,-2.225997305,-3.163259329
46,125,2005,78,105,-69,203,0,-27,-69,-104,8405,9.2231287691,12.415750266,-8.158921603,-8,0,-3.192621497,-8.158921603
46,125,2006,101,106,-50,203,1,-5,-49,-57,8348,12.057541933,12.654449949,-5.969080165,-3,0.1193816033,-0.596908016,-5.849698561
46,125,2007,102,102,24,203,0,0,24,24,8372,12.200956938,12.200956938,2.8708133971,0,0,0,2.8708133971
46,125,2008,94,102,-3,203,2,-8,-1,-6,8366,11.231927351,12.187836062,-0.358465767,3,0.2389771777,-0.955908711,-0.119488589
46,127,2001,168,117,-13,122,20,51,7,46,12636,13.319590898,9.2761436613,-1.030682629,-12,1.5856655831,4.043447237,0.5549829541
46,127,2002,169,96,89,122,20,73,109,169,12805,13.285641288,7.5468731575,6.9965803231,-13,1.5722652411,5.7387681302,8.5688455642
46,127,2003,175,105,105,122,18,70,123,180,12985,13.571151609,8.1426909655,8.1426909655,-13,1.3958898798,5.4284606437,9.5385808453
46,127,2004,160,88,90,122,21,72,111,172,13157,12.240838497,6.7324611736,6.8854716548,-11,1.6066100528,5.5083773238,8.4920817076
46,127,2005,175,97,59,122,20,78,79,145,13302,13.228013152,7.3320987188,4.4597301485,-12,1.5117729317,5.8959144337,5.9715030802
46,127,2006,178,85,181,122,22,93,203,289,13591,13.237645484,6.3213475626,13.460751869,-7,1.6361134868,6.9162979214,15.096865355
46,127,2007,188,112,252,122,18,76,270,342,13933,13.660805116,8.1383519837,18.311291963,-4,1.307949426,5.5224531318,19.619241389
46,127,2008,190,101,90,122,20,89,110,198,14131,13.540478905,7.1978335234,6.4139110604,-1,1.425313569,6.342645382,7.8392246294
46,129,2001,71,93,-112,176,2,-22,-110,-134,5791,12.120177535,15.875725504,-19.11915329,-2,0.3414134517,-3.755547969,-18.77773984
46,129,2002,63,85,-104,176,2,-22,-102,-127,5664,10.999563509,14.840680925,-18.1580096,-3,0.3491924924,-3.841117416,-17.80881711
46,129,2003,67,91,-143,176,2,-24,-141,-166,5498,12.005017022,16.305321627,-25.62264827,-1,0.3583587171,-4.300304605,-25.26428955
46,129,2004,82,90,-28,176,1,-8,-27,-38,5460,14.966234714,16.426355174,-5.11042161,-3,0.1825150575,-1.46012046,-4.927906552
46,129,2005,66,82,-11,176,2,-16,-9,-31,5429,12.122325282,15.061070805,-2.020387547,-6,0.3673431904,-2.938745523,-1.653044357
46,129,2006,66,92,-41,176,1,-26,-40,-69,5360,12.234683474,17.054407267,-7.600333673,-3,0.185373992,-4.819723793,-7.414959681
46,129,2007,62,64,-119,176,1,-2,-118,-120,5240,11.698113208,12.075471698,-22.45283019,0,0.1886792453,-0.377358491,-22.26415094
46,129,2008,64,69,0,176,0,-5,0,-2,5238,12.216071769,13.170452376,0,3,0,-0.954380607,0
46,135,2001,245,185,-188,1730,6,60,-182,-139,21467,11.376036032,8.5900680241,-8.729366424,-17,0.2785968008,2.7859680078,-8.450769624
46,135,2002,236,195,-15,1803,5,41,-10,9,21476,10.991314067,9.0818061151,-0.69860047,-22,0.2328668235,1.9095079524,-0.465733647
46,135,2003,248,206,33,1925,3,42,36,49,21525,11.534615474,9.5811725309,1.5348480268,-29,0.1395316388,1.9534429432,1.6743796656
46,135,2004,262,213,102,2089,9,49,111,142,21667,12.131876273,9.862937581,4.7230968698,-18,0.4167438415,2.2689386924,5.1398407112
46,135,2005,256,195,-100,2079,6,61,-94,-50,21617,11.828851308,9.010257832,-4.620645042,-17,0.2772387025,2.8185934756,-4.34340634
46,135,2006,252,185,-42,2080,8,67,-34,22,21639,11.651562789,8.5537266506,-1.941927131,-11,0.3698908822,3.0978361383,-1.572036249
46,135,2007,288,193,-70,1991,6,95,-64,33,21672,13.299161876,8.9122855626,-3.232435178,2,0.2770658724,4.3868763132,-2.955369306
46,135,2008,281,207,76,2052,8,74,84,163,21835,12.917461558,9.5157101156,3.4936906705,5,0.3677569127,3.4017514423,3.8614475831
46,137,2001,46,13,-18,0,2,33,-16,14,2489,18.533440774,5.237711523,-7.252215955,-3,0.8058017728,13.295729251,-6.446414182
46,137,2002,45,10,-9,0,2,35,-7,25,2514,17.989206476,3.9976014391,-3.597841295,-3,0.7995202878,13.991605037,-2.798321007
46,137,2003,44,17,-15,0,1,27,-14,10,2524,17.467248908,6.7487098055,-5.954743946,-3,0.3969829297,10.718539103,-5.557761016
46,137,2004,41,12,-12,0,0,29,-12,15,2539,16.195931266,4.7402725657,-4.740272566,-2,0,11.4556587,-4.740272566
46,137,2005,38,8,-21,0,1,30,-20,8,2547,14.942980731,3.1458906803,-8.257963036,-2,0.393236335,11.797090051,-7.864726701
46,137,2006,48,9,55,0,0,39,55,93,2640,18.507807981,3.4702139965,21.206863312,-1,0,15.037593985,21.206863312
46,137,2007,34,5,-50,0,1,29,-49,-24,2616,12.937595129,1.902587519,-19.02587519,-4,0.3805175038,11.03500761,-18.64535769
46,137,2008,43,2,-109,0,0,41,-109,-74,2542,16.67312912,0.7754943777,-42.26444358,-6,0,15.897634742,-42.26444358
47,0,2001,79221,55474,11645,151241,9305,23747,20950,50403,5753497,13.829768384,9.6842071084,2.0328909359,5706,1.6243924567,4.1455612756,3.6572833926
47,0,2002,77658,55693,11546,150840,7961,21965,19507,45596,5799093,13.444257954,9.6416474574,1.9988591303,4124,1.3782190833,3.8026104969,3.3770782136
47,0,2003,77684,56332,20658,152692,5168,21352,25826,50470,5849563,13.337847731,9.6718454043,3.5468469496,3292,0.8873126651,3.6660023268,4.4341596146
47,0,2004,79676,57291,24066,152369,8153,22385,32219,57373,5906936,13.554375329,9.746268851,4.094075966,2769,1.3869775347,3.808106478,5.4810535007
47,0,2005,80351,56842,42720,152407,7282,23509,50002,76275,5983211,13.515560405,9.5611938187,7.1857816392,2764,1.224879726,3.954366586,8.4106613652
47,0,2006,82762,56329,50821,152506,8011,26433,58832,85095,6068306,13.734702445,9.3480347744,8.4339589779,-170,1.3294591876,4.3866676701,9.7634181655
47,0,2007,84398,58056,47193,152483,6564,26342,53757,80810,6149116,13.816007993,9.5038053036,7.7255250739,711,1.0745311081,4.3122026889,8.8000561821
47,0,2008,85261,58789,31198,152483,6933,26472,38131,65772,6214888,13.791810485,9.5097025203,5.0465852324,1169,1.1214813583,4.2821079644,6.1680665907
47,1,2001,798,803,74,877,85,-5,159,85,71317,11.196150096,11.266301412,1.0382394826,-69,1.1925723786,-0.070151316,2.2308118612
47,1,2002,795,820,33,877,82,-25,115,23,71340,11.145615007,11.496106045,0.4626481701,-67,1.1496106045,-0.350491038,1.6122587745
47,1,2003,804,812,59,877,75,-8,134,25,71365,11.26800042,11.380119828,0.8268806279,-101,1.0511194422,-0.112119407,1.8780000701
47,1,2004,829,904,3,877,73,-75,76,-46,71319,11.620083541,12.671357686,0.0420509658,-47,1.0232401671,-1.051274144,1.0652911329
47,1,2005,870,786,316,877,75,84,391,406,71725,12.164089371,10.98962557,4.418220967,-69,1.0486283941,1.1744638013,5.466849361
47,1,2006,835,815,949,877,77,20,1026,1010,72735,11.560293507,11.283400249,13.138585075,-36,1.0660390419,0.2768932576,14.204624117
47,1,2007,854,853,431,877,67,1,498,511,73246,11.70015276,11.686452347,5.9048780321,12,0.9179276755,0.0137004131,6.8228057076
47,1,2008,903,819,721,877,69,84,790,923,74169,12.251127769,11.111487976,9.7819082183,49,0.9361326866,1.1396397924,10.718040905
47,3,2001,591,384,276,513,235,207,511,687,38502,15.48803019,10.063288651,7.2329887181,-31,6.1585230027,5.4247415386,13.391511721
47,3,2002,599,377,182,513,224,222,406,596,39098,15.43814433,9.7164948454,4.6907216495,-32,5.7731958763,5.7216494845,10.463917526
47,3,2003,579,408,406,513,202,171,608,753,39851,14.667696868,10.335786394,10.285120774,-26,5.1172275773,4.3319104739,15.402348351
47,3,2004,639,380,511,513,182,259,693,908,40759,15.854112393,9.4281106562,12.678327751,-44,4.515568788,6.4260017368,17.193896539
47,3,2005,700,396,613,513,192,304,805,1067,41826,16.952231035,9.5901192711,14.845310892,-42,4.6497547981,7.3621117636,19.49506569
47,3,2006,673,402,637,513,192,271,829,1077,42903,15.885942239,9.4890769394,15.036174155,-23,4.5320964487,6.3968653,19.568270604
47,3,2007,733,380,414,513,182,353,596,952,43855,16.897577169,8.7599990779,9.5437884691,3,4.1955785057,8.1375780908,13.739366975
47,3,2008,709,404,353,513,182,305,535,841,44696,16.013370826,9.1246852097,7.9728066312,1,4.1106255152,6.8886856162,12.083432146
47,5,2001,166,214,151,273,2,-48,153,92,16627,10.011458899,12.90633858,9.1068089983,-13,0.1206199867,-2.894879682,9.227428985
47,5,2002,175,240,-69,273,2,-65,-67,-148,16479,10.572101734,14.498882378,-4.168428684,-16,0.1208240198,-3.926780644,-4.047604664
47,5,2003,150,218,-7,273,2,-68,-5,-97,16382,9.1293630748,13.268007669,-0.426036943,-24,0.121724841,-4.138644594,-0.304312102
47,5,2004,165,206,-7,273,1,-41,-6,-58,16324,10.089891763,12.597076989,-0.428056014,-11,0.0611508592,-2.507185226,-0.366905155
47,5,2005,182,225,-1,273,2,-43,1,-58,16266,11.169070267,13.807916539,-0.061368518,-16,0.1227370359,-2.638846272,0.061368518
47,5,2006,159,230,-13,273,2,-71,-11,-89,16177,9.8018062448,14.178713436,-0.801405542,-7,0.1232931603,-4.376907191,-0.678112382
47,5,2007,159,222,124,273,2,-63,126,66,16243,9.8087600247,13.695249846,7.649599013,3,0.1233806292,-3.886489821,7.7729796422
47,5,2008,166,215,-5,273,1,-49,-4,-50,16193,10.235540757,13.256875077,-0.30829942,3,0.0616598841,-3.02133432,-0.246639536
47,7,2001,135,117,54,1147,3,18,57,65,12479,10.846422689,9.4002329972,4.3385690756,-10,0.2410316153,1.4461896919,4.579600691
47,7,2002,122,114,-15,1156,3,8,-12,-18,12461,9.7834803528,9.1419406576,-1.202886929,-14,0.2405773857,0.6415396953,-0.962309543
47,7,2003,123,109,66,1145,3,14,69,70,12531,9.8431498079,8.7227912932,5.2816901408,-13,0.2400768246,1.1203585147,5.5217669654
47,7,2004,134,121,108,1163,2,13,110,113,12644,10.645481629,9.6127110228,8.5799404171,-10,0.1588877855,1.0327706058,8.7388282026
47,7,2005,117,104,68,1163,3,13,71,73,12717,9.2267655061,8.2015693387,5.3625645676,-11,0.2365837309,1.0251961673,5.5991482986
47,7,2006,135,102,118,1163,2,33,120,147,12864,10.554708573,7.9746686994,9.2255971229,-6,0.1563660529,2.5800398733,9.3819631758
47,7,2007,132,109,169,1163,3,23,172,201,13065,10.18164989,8.4075745304,13.035597208,6,0.2314011339,1.7740753596,13.266998342
47,7,2008,137,116,49,1163,2,21,51,77,13142,10.455221887,8.8525966345,3.7394589232,5,0.1526309765,1.6026252528,3.8920898996
47,9,2001,1311,1065,1442,2131,93,246,1535,1709,107926,12.244154607,9.9466244519,13.467636112,-72,0.8685784733,2.2975301551,14.336214586
47,9,2002,1249,1141,1453,2161,79,108,1532,1573,109499,11.489019202,10.495573186,13.365528343,-67,0.7266873635,0.9934460159,14.092215707
47,9,2003,1294,1213,1516,2142,42,81,1558,1574,111073,11.733130225,10.998676169,13.746078378,-65,0.3808280289,0.7344540558,14.126906407
47,9,2004,1348,1222,1872,2142,91,126,1963,1960,113033,12.030021508,10.905553622,16.706380017,-129,0.8121156953,1.1244678857,17.518495712
47,9,2005,1329,1141,1945,2142,74,188,2019,2119,115152,11.648443149,10.000657361,17.04757105,-88,0.6485965335,1.6477857878,17.696167583
47,9,2006,1287,1114,2405,2142,84,173,2489,2596,117748,11.051953628,9.5663374839,20.652640618,-66,0.7213396307,1.4856161443,21.373980249
47,9,2007,1394,1184,1585,2142,69,210,1654,1854,119602,11.746366126,9.97682747,13.355803665,-10,0.5814198441,1.769538656,13.93722351
47,9,2008,1434,1227,1632,2142,75,207,1707,1909,121511,11.89483769,10.17780045,13.537221137,-5,0.622114942,1.7170372398,14.159336079
47,11,2001,1147,792,256,2362,117,355,373,645,88840,12.957889683,8.9473832858,2.8920834863,-83,1.3217725309,4.010506397,4.2138560172
47,11,2002,1196,767,223,2280,113,429,336,685,89525,13.410702772,8.6003419953,2.5004905671,-80,1.2670647268,4.8103607771,3.7675552939
47,11,2003,1164,805,182,2053,100,359,282,519,90044,12.964375811,8.9659128246,2.027075943,-122,1.1137779906,3.9984629864,3.1408539336
47,11,2004,1232,839,658,2053,88,393,746,1061,91105,13.602062391,9.2630928131,7.2647378677,-78,0.971575885,4.3389695775,8.2363137528
47,11,2005,1163,830,734,2053,96,333,830,1080,92185,12.690272246,9.0566861258,8.0091658028,-83,1.047520323,3.6335861204,9.0566861258
47,11,2006,1226,866,1002,2053,96,360,1098,1411,93596,13.198335675,9.3228048078,10.786894246,-47,1.0334748979,3.875530867,11.820369144
47,11,2007,1258,857,1151,2053,87,401,1238,1679,95275,13.321261602,9.0749771008,12.188213119,40,0.9212637197,4.2462845011,13.109476839
47,11,2008,1279,869,664,2053,86,410,750,1197,96472,13.340495549,9.0640270773,6.9257928416,37,0.8970153379,4.2764684715,7.8228081795
47,13,2001,493,438,-97,499,28,55,-69,-56,39807,12.376051211,10.995355843,-2.435044559,-42,0.7028994603,1.3806953684,-1.732145099
47,13,2002,455,508,94,499,27,-53,121,32,39839,11.425558095,12.756447279,2.360444969,-36,0.6780001507,-1.330889185,3.0384451197
47,13,2003,487,456,113,499,21,31,134,119,39958,12.205972656,11.42900109,2.8321866737,-46,0.5263355765,0.7769715653,3.3585222502
47,13,2004,523,470,388,499,25,53,413,425,40383,13.019504363,11.700128204,9.6588292404,-41,0.6223472449,1.3193761591,10.281176485
47,13,2005,474,476,40,499,24,-2,64,23,40406,11.734270755,11.783782446,0.990233819,-39,0.5941402914,-0.049511691,1.5843741103
47,13,2006,484,445,91,499,26,39,117,138,40544,11.957998765,10.994441013,2.2483014206,-18,0.6423718345,0.9635577517,2.8906732551
47,13,2007,488,542,156,499,20,-54,176,135,40679,12.016300801,13.345973431,3.8412764857,13,0.4924713443,-1.32967263,4.33374783
47,13,2008,496,498,227,499,22,-2,249,257,40936,12.154628438,12.203639037,5.5627029345,10,0.539116584,-0.049010599,6.1018195185
47,15,2001,152,149,83,165,8,3,91,82,12988,11.740171468,11.508457558,6.4107515254,-12,0.6179037615,0.2317139106,7.0286552869
47,15,2002,153,136,-35,165,7,17,-28,-22,12966,11.79009016,10.480080142,-2.697079448,-11,0.5394158897,1.3100100177,-2.157663559
47,15,2003,151,146,56,165,4,5,60,50,13016,11.623431606,11.238549765,4.3106766223,-15,0.307905473,0.3848818413,4.6185820953
47,15,2004,138,144,108,165,5,-6,113,95,13111,10.563784591,11.023079573,8.2673096796,-12,0.3827458185,-0.459294982,8.6500554981
47,15,2005,135,153,58,165,5,-18,63,34,13145,10.283363803,11.654478976,4.4180377818,-11,0.380865326,-1.371115174,4.7989031079
47,15,2006,151,139,135,165,5,12,140,145,13290,11.424248156,10.516360885,10.213731795,-7,0.3782863628,0.9078872707,10.592018158
47,15,2007,156,138,124,165,4,18,128,144,13434,11.674898967,10.32779524,9.280047897,-2,0.2993563838,1.347103727,9.5794042808
47,15,2008,141,146,373,165,4,-5,377,370,13804,10.353183053,10.720317204,27.388207651,-2,0.2937073207,-0.367134151,27.681914972
47,17,2001,361,453,151,1056,5,-92,156,37,29514,12.239155125,15.358274991,5.119424997,-27,0.169517384,-3.119119866,5.288942381
47,17,2002,368,422,-226,1048,5,-54,-221,-296,29218,12.531499012,14.370360281,-7.695974937,-21,0.1702649322,-1.838861268,-7.525710005
47,17,2003,347,406,86,1145,3,-59,89,-4,29214,11.877053669,13.896495071,2.943592552,-34,0.1026834611,-2.019441402,3.0462760131
47,17,2004,349,430,-10,1145,7,-81,-3,-103,29111,11.967423918,14.744963566,-0.342906129,-19,0.2400342906,-2.777539649,-0.102871839
47,17,2005,335,415,-298,1145,5,-80,-293,-400,28711,11.587285116,14.35439798,-10.30749542,-27,0.172944554,-2.767112864,-10.13455086
47,17,2006,358,411,134,1145,6,-53,140,73,28784,12.453256805,14.296895382,4.6612748935,-14,0.2087138012,-1.843638577,4.8699886947
47,17,2007,343,422,122,1145,3,-79,125,59,28843,11.904142156,14.645912506,4.2341263644,13,0.1041178614,-2.741770351,4.3382442258
47,17,2008,348,393,-102,1145,5,-45,-97,-124,28719,12.091310239,13.654841736,-3.544004725,18,0.1737257218,-1.563531496,-3.370279004
47,19,2001,557,632,141,1479,21,-75,162,34,56869,9.7973686062,11.11658341,2.4801238303,-53,0.3693801449,-1.319214803,2.8495039752
47,19,2002,569,618,31,1525,21,-49,52,-53,56816,10.01011567,10.872146721,0.5453665831,-56,0.3694418789,-0.862031051,0.914808462
47,19,2003,585,651,1437,3008,18,-66,1455,1423,58239,10.169049585,11.316326974,24.979357698,34,0.3128938334,-1.147277389,25.292251532
47,19,2004,645,687,211,3012,17,-42,228,144,58383,11.061377785,11.781653547,3.6185282365,-42,0.2915401897,-0.720275763,3.9100684262
47,19,2005,623,641,297,3012,18,-18,315,245,58628,10.648571502,10.956234884,5.0764458042,-52,0.3076633821,-0.307663382,5.3841091863
47,19,2006,635,685,403,3012,17,-50,420,340,58968,10.799687064,11.650056124,6.853974625,-30,0.2891254805,-0.85036906,7.1431001054
47,19,2007,615,673,216,3012,17,-58,233,174,59142,10.414020828,11.396156126,3.6576073152,-1,0.2878672424,-0.982135298,3.9454745576
47,19,2008,636,670,342,3012,16,-34,358,350,59492,10.7220527,11.295244196,5.7656321122,26,0.2697371748,-0.573191497,6.0353692871
47,21,2001,471,252,256,401,10,219,266,453,36549,12.96716911,6.937848441,7.0479730195,-32,0.2753114461,6.029320669,7.3232844656
47,21,2002,489,279,202,401,7,210,209,386,36935,13.309019651,7.5934897393,5.4977954385,-33,0.1905176637,5.7155299113,5.6883131022
47,21,2003,475,277,78,401,1,198,79,225,37160,12.821377961,7.4768877792,2.105405223,-52,0.0269923747,5.3444901815,2.1323975977
47,21,2004,487,298,242,401,11,189,253,413,37573,13.033064376,7.9750578727,6.4763892792,-29,0.2943813309,5.0580065032,6.77077061
47,21,2005,487,295,287,401,8,192,295,451,38024,12.884109158,7.8045425083,7.5928938979,-36,0.2116486104,5.0795666495,7.8045425083
47,21,2006,487,290,273,401,10,197,283,461,38485,12.730528435,7.5808074867,7.1364153237,-19,0.2614071547,5.1497209479,7.3978224784
47,21,2007,462,312,351,401,6,150,357,514,38999,11.925042589,8.0532755149,9.0599349543,7,0.154870683,3.8717670745,9.2148056373
47,21,2008,508,306,184,401,8,202,192,397,39396,12.960010205,7.8066203202,4.6941769245,3,0.2040946489,5.1533898846,4.8982715734
47,23,2001,174,179,287,1272,2,-5,289,275,15828,11.089512762,11.408176922,18.291322775,-9,0.1274656639,-0.31866416,18.418788439
47,23,2002,185,138,-25,1242,2,47,-23,10,15838,11.684456515,8.7159729679,-1.57898061,-14,0.1263184488,2.968483547,-1.452662161
47,23,2003,190,162,-339,948,2,28,-337,-306,15532,12.113484221,10.328339178,-21.61300606,3,0.1275103602,1.785145043,-21.4854957
47,23,2004,182,136,214,948,1,46,215,244,15776,11.626421362,8.6878753034,13.670627316,-17,0.0638814361,2.9385460585,13.734508752
47,23,2005,169,139,70,948,2,30,72,87,15863,10.683017794,8.7866241032,4.4249186131,-15,0.1264262461,1.8963936913,4.5513448592
47,23,2006,175,146,95,948,1,29,96,117,15980,10.991426687,9.1699902647,5.9667744873,-8,0.0628081525,1.8214364224,6.0295826398
47,23,2007,194,157,71,948,2,37,73,114,16094,12.097025628,9.7898609466,4.4272619567,4,0.1247116044,2.3071646817,4.5519735611
47,23,2008,196,150,161,948,1,46,162,215,16309,12.09764528,9.2584019998,9.9373514798,7,0.06172268,2.8392432799,9.9990741598
47,25,2001,352,358,139,647,10,-6,149,118,30111,11.713030747,11.91268468,4.6253161187,-25,0.3327565553,-0.199653933,4.958072674
47,25,2002,361,377,-32,647,9,-16,-23,-68,30043,12.002526848,12.534494797,-1.063935898,-29,0.2992319713,-0.531967949,-0.764703927
47,25,2003,348,328,299,647,7,20,306,302,30345,11.525468636,10.863085381,9.9026296615,-24,0.2318341392,0.662383255,10.134463801
47,25,2004,356,341,224,647,8,15,232,221,30566,11.689185861,11.196663985,7.354993351,-26,0.262678334,0.4925218762,7.6176716849
47,25,2005,366,385,289,647,8,-19,297,254,30820,11.924543055,12.543576711,9.4158277132,-24,0.2606457498,-0.619033656,9.676473463
47,25,2006,369,335,139,647,8,34,147,166,30986,11.940588292,10.840371485,4.4979451833,-15,0.2588745429,1.1002168074,4.7568197262
47,25,2007,357,376,218,647,8,-19,226,198,31184,11.484638893,12.095866173,7.013028792,-9,0.2573588548,-0.61122728,7.2703876468
47,25,2008,377,385,273,647,8,-8,281,277,31461,12.036076303,12.291483758,8.7157793918,4,0.2554074547,-0.255407455,8.9711868465
47,27,2001,88,92,-41,89,5,-4,-36,-47,7936,11.055970852,11.558514982,-5.151077329,-7,0.6281801621,-0.50254413,-4.522897167
47,27,2002,79,107,32,89,5,-28,37,1,7937,9.954009954,13.482013482,4.032004032,-8,0.63000063,-3.528003528,4.662004662
47,27,2003,79,113,15,89,2,-34,17,-27,7910,9.9703413895,14.261374393,1.8931027955,-10,0.2524137061,-4.291033003,2.1455165015
47,27,2004,79,111,62,89,6,-32,68,29,7939,9.9690832229,14.007192883,7.8238374661,-7,0.7571455612,-4.03810966,8.5809830273
47,27,2005,108,109,-2,89,4,-1,2,-6,7933,13.608870968,13.734879032,-0.252016129,-7,0.5040322581,-0.126008065,0.252016129
47,27,2006,97,86,-4,89,6,11,2,9,7942,12.220472441,10.834645669,-0.503937008,-4,0.7559055118,1.3858267717,0.2519685039
47,27,2007,83,101,-86,89,4,-18,-82,-95,7847,10.513648743,12.793717145,-10.89366014,5,0.5066818671,-2.280068402,-10.38697828
47,27,2008,90,99,-52,89,6,-9,-46,-53,7794,11.508215587,12.659037146,-6.649191228,2,0.7672143725,-1.150821559,-5.881976856
47,29,2001,405,427,88,364,7,-22,95,40,33667,12.03673433,12.690581627,2.6153891877,-33,0.2080423218,-0.653847297,2.8234315095
47,29,2002,419,401,312,364,7,18,319,314,33981,12.387653737,11.855487228,9.2242194891,-23,0.2069536424,0.532166509,9.4311731315
47,29,2003,428,429,332,364,4,-1,336,307,34288,12.538633933,12.567929807,9.7262300605,-28,0.1171834947,-0.029295874,9.8434135552
47,29,2004,418,442,214,364,8,-24,222,171,34459,12.160530641,12.858742927,6.2257262135,-27,0.2327374285,-0.698212286,6.458463642
47,29,2005,402,421,294,364,6,-19,300,253,34712,11.623368175,12.172731347,8.500672247,-28,0.1734831071,-0.549363172,8.6741553541
47,29,2006,420,437,319,364,7,-17,326,291,35003,12.049056874,12.536756796,9.1515455784,-18,0.2008176146,-0.487699921,9.352363193
47,29,2007,439,432,311,364,6,7,317,314,35317,12.485779295,12.28668942,8.8452787258,-10,0.1706484642,0.1990898749,9.01592719
47,29,2008,422,437,372,364,8,-15,380,371,35688,11.886486867,12.308992324,10.478135343,6,0.2253362439,-0.422505457,10.703471587
47,31,2001,663,561,238,784,63,102,301,360,48557,13.704859747,11.596419786,4.9196932427,-43,1.3022717407,2.1084399611,6.2219649834
47,31,2002,627,541,350,784,55,86,405,454,49011,12.852574615,11.089701541,7.1744834372,-37,1.1274188258,1.7628730731,8.301902263
47,31,2003,653,564,393,784,42,89,435,482,49493,13.258344839,11.451311622,7.9793713961,-42,0.8527572484,1.8070332169,8.8321286445
47,31,2004,656,582,352,784,55,74,407,438,49931,13.196009012,11.707434825,7.0807853235,-43,1.1063727068,1.4885741873,8.1871580303
47,31,2005,676,570,596,784,52,106,648,706,50637,13.443640124,11.335613714,11.852676796,-48,1.0341261634,2.10802641,12.886802959
47,31,2006,746,533,441,784,55,213,496,683,51320,14.633620056,10.455388056,8.6507056897,-26,1.0788861971,4.1782319998,9.7295918868
47,31,2007,721,593,232,784,44,128,276,414,51734,13.99266404,11.508529509,4.5024938382,10,0.8539212452,2.4841345314,5.3564150834
47,31,2008,695,581,218,784,47,114,265,400,52134,13.382369931,11.187276158,4.1976354604,21,0.9049948011,2.1950937729,5.1026302615
47,33,2001,190,179,-53,298,37,11,-16,-17,14532,13.06695093,12.310443245,-3.644991575,-12,2.5446167601,0.7565076854,-1.100374815
47,33,2002,216,197,-121,298,36,19,-85,-79,14453,14.904260825,13.593237882,-8.34914611,-13,2.4840434708,1.3110229429,-5.865102639
47,33,2003,180,192,-159,298,20,-12,-139,-165,14288,12.525660207,13.36070422,-11.06433318,-14,1.391740023,-0.835044014,-9.67259316
47,33,2004,184,190,30,298,22,-6,52,36,14324,12.861736334,13.28114078,2.0970222284,-10,1.5378163009,-0.419404446,3.6348385293
47,33,2005,189,193,-49,298,21,-4,-28,-45,14279,13.215396986,13.495087928,-3.426214033,-13,1.4683774429,-0.279690942,-1.957836591
47,33,2006,174,180,-116,298,24,-6,-92,-104,14175,12.230266395,12.651999719,-8.15351093,-6,1.6869332958,-0.421733324,-6.466577634
47,33,2007,184,161,-22,298,14,23,-8,8,14183,12.976937725,11.354820509,-1.55159038,-7,0.9873756965,1.6221172156,-0.564214684
47,33,2008,193,180,-25,298,16,13,-9,3,14186,13.606401354,12.689907998,-1.762487222,-1,1.1279918221,0.9164933554,-0.6344954
47,35,2001,515,550,729,540,10,-35,739,669,47693,10.874499826,11.613543503,15.393224025,-35,0.2111553364,-0.739043677,15.604379362
47,35,2002,477,538,976,540,10,-61,986,905,48598,9.9074679877,11.174460749,20.271884184,-20,0.2077037314,-1.266992762,20.479587916
47,35,2003,535,598,576,540,5,-63,581,494,49092,10.953014638,12.242808885,11.792404545,-24,0.1023646228,-1.289794247,11.894769168
47,35,2004,496,525,884,540,9,-29,893,802,49894,10.021619219,10.607560665,17.861111672,-62,0.1818438971,-0.585941446,18.042955569
47,35,2005,534,574,1060,540,7,-40,1067,976,50870,10.599023461,11.392957802,21.039260053,-51,0.1389385098,-0.793934342,21.178198563
47,35,2006,525,597,1205,540,8,-72,1213,1114,51984,10.208645264,11.608688043,23.431271511,-27,0.1555603088,-1.400042779,23.58683182
47,35,2007,541,640,995,540,7,-99,1002,948,52932,10.313012315,12.20023638,18.967554996,45,0.1334400854,-1.887224065,19.100995082
47,35,2008,576,672,702,540,9,-96,711,658,53590,10.814667393,12.617111958,13.180375885,43,0.168979178,-1.802444565,13.349355063
47,37,2001,8930,5062,-3508,25493,2829,3868,-679,8555,578832,15.542476823,8.8103043314,-6.105600078,5366,4.9238148861,6.7321724919,-1.181785192
47,37,2002,8798,5063,-7252,24524,2646,3735,-4606,3514,582346,15.153576799,8.7204545729,-12.49076369,4385,4.5574408058,6.4331222259,-7.933322884
47,37,2003,8716,5218,-3904,25462,2315,3498,-1589,6166,588512,14.888227266,8.9131218303,-6.668613957,4257,3.9543650895,5.9751054355,-2.714248867
47,37,2004,9032,5057,-2077,25411,2141,3975,64,8751,597263,15.233918745,8.5294427695,-3.503194114,4712,3.6111403934,6.7044759756,0.1079462799
47,37,2005,9167,4873,-1066,25411,2239,4294,1173,10150,607413,15.219029847,8.0901420797,-1.769770461,4683,3.7171820473,7.1288877673,1.9474115862
47,37,2006,9708,4912,-276,25411,2267,4796,1991,6787,614200,15.893740489,8.0418266669,-0.451861596,0,3.7114863709,7.8519138221,3.2596247748
47,37,2007,9715,5200,-464,25411,2049,4515,1585,6067,620267,15.739586396,8.4246885498,-0.75174144,-33,3.3196513151,7.3148978466,2.5679098753
47,37,2008,9590,5317,-547,25411,2057,4273,1510,5877,626144,15.38818255,8.5316962061,-0.87772011,94,3.3006769035,6.8564863436,2.4229567935
47,39,2001,135,150,-20,230,15,-15,-5,-32,11672,11.550308008,12.833675565,-1.711156742,-12,1.2833675565,-1.283367556,-0.427789185
47,39,2002,134,162,-43,230,15,-28,-28,-71,11601,11.515490053,13.921711855,-3.695269196,-15,1.289047394,-2.406221802,-2.406221802
47,39,2003,120,183,-40,230,14,-63,-26,-106,11495,10.391409768,15.846899896,-3.463803256,-17,1.2123311396,-5.455490128,-2.251472116
47,39,2004,130,161,41,230,12,-31,53,12,11507,11.303364925,13.998782715,3.5649073994,-10,1.0433875315,-2.69541779,4.6082949309
47,39,2005,121,190,-41,230,14,-69,-27,-102,11405,10.562150838,16.585195531,-3.578910615,-6,1.2220670391,-6.023044693,-2.356843575
47,39,2006,125,164,-101,230,13,-39,-88,-132,11273,11.023899815,14.463356557,-8.90731105,-5,1.1464855807,-3.439456742,-7.76082547
47,39,2007,134,163,92,230,11,-29,103,53,11326,11.858931811,14.425417054,8.1419531838,-21,0.9734944024,-2.566485243,9.1154475862
47,39,2008,125,173,30,230,10,-48,40,-38,11288,11.055098611,15.300256478,2.6532236668,-30,0.8844078889,-4.245157867,3.5376315557
47,41,2001,229,206,30,315,39,23,69,75,17524,13.095816773,11.780516398,1.7156091842,-17,2.2302919395,1.3153003746,3.9459011237
47,41,2002,207,177,133,315,39,30,172,189,17713,11.749013821,10.046258195,7.5488832761,-13,2.213582314,1.7027556262,9.7624655901
47,41,2003,221,174,137,315,33,47,170,203,17916,12.405624632,9.7673243706,7.6903645906,-14,1.8524235875,2.638300261,9.5427881782
47,41,2004,254,242,153,315,29,12,182,177,18093,14.107584215,13.441084173,8.4978755311,-17,1.610708434,0.6665000417,10.108583965
47,41,2005,244,225,57,315,32,19,89,91,18184,13.452049508,12.40455385,3.1424869752,-17,1.7642032142,1.0474956584,4.9066901894
47,41,2006,235,199,41,315,31,36,72,99,18283,12.888364823,10.91397702,2.2486083308,-9,1.7001672745,1.9743878027,3.9487756053
47,41,2007,274,223,57,315,30,51,87,142,18425,14.928625913,12.149940068,3.1055900621,4,1.6345210853,2.778685845,4.7401111474
47,41,2008,240,214,210,315,29,26,239,269,18694,12.93138285,11.530483041,11.314959994,4,1.5625420943,1.4008998087,12.877502088
47,43,2001,624,354,265,536,9,270,274,508,43861,14.309629188,8.1179627124,6.0770059853,-36,0.2063888825,6.1916664756,6.2833948678
47,43,2002,653,430,275,536,7,223,282,469,44330,14.808767335,9.7515619508,6.2364640383,-36,0.1587463573,5.0572053838,6.3952103956
47,43,2003,649,446,334,536,-1,203,333,498,44828,14.55842437,10.004710738,7.4923170103,-38,-0.022432087,4.553713632,7.4698849234
47,43,2004,611,447,223,536,7,164,230,359,45187,13.575515192,9.9316780537,4.9547297673,-35,0.1555296339,3.6438371383,5.1102594012
47,43,2005,674,416,271,536,4,258,275,491,45678,14.83519507,9.1564408738,5.9648929731,-42,0.0880427007,5.6787541958,6.0529356738
47,43,2006,668,419,406,536,6,249,412,638,46316,14.522686262,9.1092897363,8.8266626084,-23,0.1304432898,5.4133965259,8.9571058982
47,43,2007,720,471,757,536,3,249,760,1021,47337,15.37590894,10.058407099,16.166059817,12,0.0640662873,5.3175018419,16.230126104
47,43,2008,701,450,303,536,5,251,308,547,47884,14.723642894,9.4516965795,6.3641423636,-12,0.1050188509,5.2719463144,6.4691612144
47,45,2001,522,449,-295,609,39,73,-256,-214,37107,14.026979094,12.065351749,-7.927124201,-31,1.0479926909,1.9616273445,-6.87913151
47,45,2002,520,426,-142,609,38,94,-104,-43,37064,14.021652667,11.486969301,-3.828989767,-33,1.0246592334,2.5346833668,-2.804330533
47,45,2003,457,415,71,609,25,42,96,84,37148,12.316067482,11.184175066,1.91343718,-54,0.6737454859,1.1318924163,2.5871826659
47,45,2004,511,446,54,609,27,65,81,121,37269,13.733421127,11.986508459,1.4512812933,-25,0.7256406466,1.7469126678,2.1769219399
47,45,2005,499,406,205,609,24,93,229,285,37554,13.338144688,10.852278043,5.4795985192,-37,0.641513973,2.4858666453,6.1211124921
47,45,2006,513,414,-31,609,26,99,-5,77,37631,13.64633903,11.012835007,-0.824632573,-17,0.6916273193,2.6335040234,-0.133005254
47,45,2007,515,398,-132,609,23,117,-109,11,37642,13.683525301,10.574840912,-3.507233669,3,0.6111088969,3.1086843888,-2.896124772
47,45,2008,497,410,-168,609,25,87,-143,-42,37600,13.210706786,10.898168576,-4.465591026,14,0.6645224742,2.31253821,-3.801068552
47,47,2001,424,287,953,392,8,137,961,1092,30192,14.302098091,9.680901302,32.145989341,-6,0.2698509074,4.6211967888,32.415840248
47,47,2002,385,300,740,392,7,85,747,827,31019,12.579438336,9.8021597425,24.178660698,-5,0.2287170607,2.7772785937,24.407377759
47,47,2003,408,282,851,392,5,126,856,1007,32026,12.943135855,8.9459909588,26.996589737,25,0.158616861,3.9971448965,27.155206598
47,47,2004,384,331,1114,392,6,53,1120,1114,33140,11.785286806,10.1586717,34.189608078,-59,0.1841451063,1.626615106,34.373753184
47,47,2005,437,313,748,392,6,124,754,853,33993,13.018932567,9.3247732114,22.284122563,-25,0.1787496462,3.6941593553,22.462872209
47,47,2006,489,309,1573,392,6,180,1579,1737,35730,14.026935158,8.8636461426,45.121409004,-22,0.1721096338,5.1632890151,45.293518638
47,47,2007,462,312,1238,392,5,150,1243,1405,37135,12.680985384,8.5637823372,33.980649146,12,0.1372401016,4.1172030467,34.117889247
47,47,2008,505,364,888,392,5,141,893,1038,38173,13.411589738,9.6669676528,23.583151856,4,0.1327880172,3.7446220853,23.715939874
47,49,2001,201,199,66,153,5,2,71,57,16696,12.05939703,11.93940303,3.9598020099,-16,0.2999850007,0.1199940003,4.2597870106
47,49,2002,216,214,128,153,5,2,133,124,16820,12.889366273,12.770020289,7.6381429765,-11,0.29836496,0.119345984,7.9365079365
47,49,2003,203,228,73,153,5,-25,78,29,16849,12.058570198,13.543615789,4.3363331254,-24,0.2970091182,-1.485045591,4.6333422436
47,49,2004,199,206,14,153,4,-7,18,-1,16848,11.811140458,12.22660771,0.8309345046,-12,0.2374098584,-0.415467252,1.068344363
47,49,2005,187,228,223,153,5,-41,228,174,17022,11.042220254,13.463241807,13.167995276,-13,0.2952465309,-2.421021553,13.463241807
47,49,2006,214,242,307,153,4,-28,311,273,17295,12.471952677,14.103796952,17.892006877,-10,0.2331206108,-1.631844275,18.125127488
47,49,2007,210,231,102,153,4,-21,106,81,17376,12.113870382,13.32525742,5.8838798996,-4,0.2307403882,-1.211387038,6.1146202878
47,49,2008,207,239,318,153,3,-32,321,291,17667,11.814057016,13.64038467,18.149131068,2,0.1712182176,-1.826327655,18.320349285
47,51,2001,449,437,305,1755,24,12,329,308,39638,11.371694864,11.067774288,7.7246479587,-33,0.6078411508,0.3039205754,8.3324891095
47,51,2002,449,410,307,1934,21,39,328,337,39975,11.279564895,10.299825405,7.7123082914,-30,0.527552033,0.9797394898,8.2398603243
47,51,2003,476,398,139,1864,8,78,147,176,40151,11.881286973,9.9343533934,3.4695354816,-49,0.1996854953,1.9469335796,3.669220977
47,51,2004,447,430,202,1864,18,17,220,206,40357,11.104486511,10.682168232,5.0181348437,-31,0.4471605306,0.4223182789,5.4652953744
47,51,2005,426,446,207,1864,15,-20,222,166,40523,10.534124629,11.028684471,5.118694362,-36,0.3709198813,-0.494559842,5.4896142433
47,51,2006,447,419,186,1864,17,28,203,211,40734,11.002129047,10.312957653,4.5780671204,-20,0.4184254895,0.6891713945,4.9964926099
47,51,2007,451,385,274,1864,11,66,285,365,41099,11.022448157,9.409406963,6.6965649555,14,0.2688401989,1.6130411937,6.9654051544
47,51,2008,476,411,-38,1864,13,65,-25,66,41165,11.572498298,9.9922201692,-0.923854906,26,0.3160556258,1.580278129,-0.60779928
47,53,2001,633,717,-51,1068,23,-84,-28,-157,48000,13.165968156,14.91311085,-1.060765207,-45,0.478384309,-1.747142694,-0.582380898
47,53,2002,629,685,-13,1068,22,-56,9,-92,47908,13.116736873,14.284522668,-0.271093131,-45,0.4587729908,-1.167785795,0.1876798599
47,53,2003,587,725,-34,1068,16,-138,-18,-222,47686,12.281105509,15.168316003,-0.711341716,-66,0.3347490428,-2.887210494,-0.376592673
47,53,2004,611,697,206,1068,16,-86,222,100,47786,12.79956427,14.601139601,4.3154013742,-36,0.3351768058,-1.801575331,4.65057818
47,53,2005,600,639,134,1068,16,-39,150,65,47851,12.547445027,13.363028953,2.8022627226,-46,0.334598534,-0.815583927,3.1368612566
47,53,2006,594,686,284,1068,17,-92,301,187,48038,12.389325157,14.308210535,5.9235157317,-22,0.3545766459,-1.918885378,6.2780923776
47,53,2007,678,687,467,1068,14,-9,481,473,48511,14.044681975,14.231115806,9.6738443692,1,0.2900081824,-0.186433832,9.9638525516
47,53,2008,635,667,741,1068,16,-32,757,746,49257,12.989935357,13.644546273,15.158334015,21,0.3273054578,-0.654610916,15.485639473
47,55,2001,349,326,92,527,9,23,101,95,29563,11.824295709,11.045044129,3.1170063187,-29,0.3049245312,0.7792515797,3.4219308499
47,55,2002,318,341,-151,531,9,-23,-142,-192,29371,10.791733125,11.572267282,-5.124376421,-27,0.3054264092,-0.780534157,-4.818950012
47,55,2003,339,386,-158,531,5,-47,-153,-237,29134,11.588753098,13.19545338,-5.401247757,-37,0.1709255619,-1.606700282,-5.230322195
47,55,2004,348,380,-31,531,6,-32,-25,-76,29058,11.960406929,13.060214462,-1.065438548,-19,0.2062139126,-1.099807534,-0.859224636
47,55,2005,327,377,79,531,6,-50,85,9,29067,11.251612903,12.972043011,2.7182795699,-26,0.2064516129,-1.720430108,2.9247311828
47,55,2006,304,313,14,531,6,-9,20,-1,29066,10.458775566,10.768410369,0.4816541379,-12,0.206423202,-0.309634803,0.6880773399
47,55,2007,339,323,-106,531,6,16,-100,-78,28988,11.678781824,11.127570882,-3.651772488,6,0.2067041031,0.5512109415,-3.445068385
47,55,2008,333,335,181,531,6,-2,187,196,29184,11.448806986,11.51756859,6.2229251186,11,0.2062848106,-0.068761604,6.4292099292
47,57,2001,255,199,40,178,17,56,57,94,20831,12.269053118,9.5746728253,1.9245573518,-19,0.8179368745,2.6943802925,2.7424942263
47,57,2002,265,232,211,178,17,33,228,248,21079,12.646146504,11.071343355,10.069195896,-13,0.8112622286,1.5748031496,10.880458125
47,57,2003,290,228,272,178,16,62,288,333,21412,13.649949401,10.731684357,12.802711162,-17,0.7531006566,2.9182650444,13.555811819
47,57,2004,251,219,263,178,14,32,277,287,21699,11.644359908,10.15982,12.201062374,-22,0.64948621,1.4845399086,12.850548584
47,57,2005,256,232,373,178,15,24,388,391,22090,11.692434173,10.596268469,17.036241979,-21,0.6851035648,1.0961657037,17.721345543
47,57,2006,262,222,203,178,14,40,217,246,22336,11.794894881,9.9941475712,9.1387925989,-11,0.6302615585,1.8007473101,9.7690541575
47,57,2007,264,248,157,178,12,16,169,192,22528,11.768901569,11.055634807,6.9989300999,7,0.5349500713,0.7132667618,7.5338801712
47,57,2008,269,243,144,178,11,26,155,180,22708,11.893182421,10.743655496,6.3666106641,-1,0.4863383146,1.1495269255,6.8529489787
47,59,2001,748,701,186,1574,49,47,235,225,63262,11.844907719,11.100642127,2.9453914916,-57,0.7759364682,0.744265592,3.7213279598
47,59,2002,704,775,220,1674,45,-71,265,140,63402,11.116023495,12.237099728,3.4737573423,-54,0.7105412746,-1.121076233,4.1842986168
47,59,2003,705,772,320,1718,36,-67,356,226,63628,11.099740219,12.154609147,5.0381799575,-63,0.5667952452,-1.054868929,5.6049752027
47,59,2004,731,707,470,1718,40,24,510,475,64103,11.445929336,11.07013959,7.3592158521,-59,0.6263162427,0.3757897456,7.9855320948
47,59,2005,751,725,691,1718,39,26,730,692,64795,11.652624556,11.249204798,10.721655883,-64,0.6051296374,0.4034197583,11.32678552
47,59,2006,722,771,604,1718,43,-49,647,568,65363,11.094208577,11.84713963,9.2810276741,-30,0.6607354139,-0.752931053,9.9417630879
47,59,2007,721,798,497,1718,38,-77,535,483,65846,10.990099764,12.163799739,7.5756998377,25,0.579228559,-1.173699975,8.1549283967
47,59,2008,754,778,286,1718,40,-24,326,311,66157,11.423982788,11.787610888,4.3332348507,9,0.6060468323,-0.363628099,4.939281683
47,61,2001,208,205,-105,205,2,3,-103,-111,14222,14.568376817,14.358255997,-7.354228681,-11,0.1400805463,0.2101208195,-7.214148135
47,61,2002,191,170,26,205,2,21,28,35,14257,13.413392324,11.93862144,1.8259068085,-14,0.1404543699,1.4747708838,1.9663611784
47,61,2003,196,171,-34,205,1,25,-33,-27,14230,13.760662758,12.005476182,-2.387053744,-19,0.0702074631,1.7551865763,-2.316846281
47,61,2004,210,150,34,205,0,60,34,83,14313,14.714641068,10.510457906,2.3823704586,-11,0,4.2041831622,2.3823704586
47,61,2005,182,180,31,205,1,2,32,20,14333,12.70683516,12.567199609,2.1643510438,-14,0.0698177756,0.1396355512,2.2341688194
47,61,2006,180,192,-31,205,0,-12,-31,-50,14283,12.580374616,13.419066257,-2.166620073,-7,0,-0.838691641,-2.166620073
47,61,2007,187,176,-36,205,1,11,-35,-25,14258,13.103955713,12.333134789,-2.522686661,-1,0.0700746295,0.7708209243,-2.452612032
47,61,2008,185,185,-38,205,0,0,-38,-38,14220,12.992485427,12.992485427,-2.668726736,0,0,0,-2.668726736
47,63,2001,852,574,-37,790,333,278,296,517,58760,14.563729135,9.8117142295,-0.632462415,-57,5.6921617394,4.7520149056,5.0596993239
47,63,2002,807,640,-867,790,312,167,-555,-423,58337,13.783444495,10.931108397,-14.80823591,-35,5.3289153437,2.8523360974,-9.479320563
47,63,2003,826,634,-85,790,268,192,183,285,58622,14.124607769,10.841405963,-1.453500799,-90,4.5828025205,3.2832018058,3.1293017211
47,63,2004,807,668,130,790,245,139,375,469,59091,13.711314808,11.349638528,2.2087619889,-45,4.1626668252,2.3616762804,6.3714288141
47,63,2005,853,621,317,790,261,232,578,756,59847,14.343607594,10.442415376,5.3305083321,-54,4.388841245,3.9011922178,9.7193495771
47,63,2006,880,607,189,790,260,273,449,691,60538,14.619761598,10.08431283,3.1399260705,-31,4.3194750177,4.5354487685,7.4594010882
47,63,2007,886,645,541,790,230,241,771,1027,61565,14.512337944,10.564850986,8.8613711375,15,3.7673112045,3.9474869577,12.628682342
47,63,2008,886,663,77,790,232,223,309,567,62132,14.325327211,10.719742597,1.244977647,35,3.7511014818,3.605584614,4.9960791288
47,65,2001,4078,3243,-366,8389,484,835,118,3443,311526,13.16313998,10.467891848,-1.181390199,2490,1.5622755641,2.6952481323,0.3808853648
47,65,2002,3895,3155,-369,8581,454,740,85,2793,314319,12.447171424,10.082368638,-1.179205714,1968,1.4508384664,2.3648027866,0.2716327525
47,65,2003,3878,3099,-830,8460,390,779,-440,2240,316559,12.293977599,9.8244034504,-2.631253586,1901,1.236372167,2.469574149,-1.394881419
47,65,2004,4030,3260,-428,8460,379,770,-49,2904,319463,12.672517617,10.251217725,-1.345865395,2183,1.1917826742,2.4212998921,-0.15408272
47,65,2005,3955,3247,474,8460,399,708,873,3699,323162,12.308889321,10.10542696,1.4751993776,2118,1.2417817545,2.2034623614,2.7169811321
47,65,2006,4060,3139,921,8460,404,921,1325,4458,327620,12.477296545,9.6468556291,2.8304409157,2212,1.241583203,2.8304409157,4.0720241187
47,65,2007,4308,3295,1017,8460,360,1013,1377,2457,330077,13.100257413,10.019811555,3.0926095147,67,1.0947290318,3.0804458588,4.1873385465
47,65,2008,4329,3373,1263,8460,364,956,1627,2771,332848,13.060300939,10.176113437,3.8103857902,188,1.0981634423,2.8841875024,4.9085492326
47,67,2001,75,90,24,162,1,-15,25,4,6785,11.057054401,13.268465281,3.5382574082,-6,0.147427392,-2.21141088,3.6856848002
47,67,2002,66,90,-6,162,1,-24,-5,-37,6748,9.753934826,13.300820217,-0.886721348,-8,0.1477868913,-3.546885391,-0.738934457
47,67,2003,61,82,-96,162,1,-21,-95,-123,6625,9.122859493,12.26351604,-14.35728707,-7,0.1495550737,-3.140656547,-14.207732
47,67,2004,86,82,24,162,0,4,24,23,6648,12.958637836,12.355910495,3.6163640473,-5,0,0.6027273412,3.6163640473
47,67,2005,94,81,41,162,1,13,42,50,6698,14.086617713,12.138468455,6.1441630451,-5,0.1498576352,1.9481492582,6.2940206804
47,67,2006,77,99,-33,162,0,-22,-33,-60,6638,11.547690462,14.847030594,-4.949010198,-5,0,-3.299340132,-4.949010198
47,67,2007,83,92,88,162,1,-9,89,79,6717,12.429801572,13.777611382,13.1785848,-1,0.1497566455,-1.347809809,13.328341445
47,67,2008,86,87,-24,162,0,-1,-24,-24,6693,12.826249068,12.975391499,-3.579418345,1,0,-0.149142431,-3.579418345
47,69,2001,316,292,2,3980,0,24,2,-2,28130,11.233159148,10.380007821,0.071095944,-28,0,0.8531513277,0.071095944
47,69,2002,339,288,-77,3985,-1,51,-78,-54,28076,12.062769099,10.248016226,-2.739921005,-27,-0.03558339,1.8147528734,-2.775504395
47,69,2003,350,293,-212,3909,-1,57,-213,-182,27894,12.506700018,10.469894586,-7.575486868,-26,-0.035733429,2.0368054315,-7.611220297
47,69,2004,327,283,-104,3935,0,44,-104,-81,27813,11.739996769,10.160303014,-3.733821602,-21,0,1.5796937548,-3.733821602
47,69,2005,313,292,-2,3935,0,21,-2,-5,27808,11.254741914,10.499631434,-0.071915284,-24,0,0.7551104799,-0.071915284
47,69,2006,339,281,-73,3935,0,58,-73,-27,27781,12.196657612,10.109913832,-2.626418896,-12,0,2.0867437802,-2.626418896
47,69,2007,337,287,10,3935,0,50,10,55,27836,12.118596832,10.320585433,0.3596022799,-5,0,1.7980113994,0.3596022799
47,69,2008,320,307,0,3935,0,13,0,12,27848,11.493427196,11.026506716,0,-1,0,0.4669204799,0
47,71,2001,281,342,267,464,6,-61,273,189,25764,10.94684353,13.323204581,10.401449191,-23,0.2337404313,-2.376361051,10.635189622
47,71,2002,281,328,108,464,6,-47,114,41,25805,10.898020128,12.720820648,4.1885628963,-26,0.2326979387,-1.82280052,4.421260835
47,71,2003,253,321,8,464,1,-68,9,-97,25708,9.822763186,12.462873449,0.3106012075,-38,0.0388251509,-2.640110263,0.3494263584
47,71,2004,294,356,-51,464,5,-62,-46,-124,25584,11.463776027,13.881307026,-1.988614209,-16,0.1949621773,-2.417530999,-1.793652032
47,71,2005,276,346,296,464,3,-70,299,205,25789,10.744943842,13.470110759,11.523562961,-24,0.1167928678,-2.725166916,11.640355829
47,71,2006,304,330,169,464,4,-26,173,134,25923,11.757425743,12.76299505,6.536200495,-13,0.1547029703,-1.005569307,6.6909034653
47,71,2007,299,306,148,464,3,-7,151,152,26075,11.500442325,11.769683449,5.6925266356,8,0.1153890534,-0.269241125,5.8079156891
47,71,2008,292,337,178,464,5,-45,183,152,26227,11.165920997,12.886696493,6.8066230737,14,0.1911972774,-1.720775496,6.997820351
47,73,2001,647,516,353,463,19,131,372,458,54148,11.999480703,9.5699104212,6.546857323,-45,0.3523804225,2.4295702813,6.8992377455
47,73,2002,610,545,318,463,17,65,335,357,54505,11.228406027,10.031936532,5.8534969122,-43,0.3129227909,1.1964694946,6.1664197031
47,73,2003,650,564,467,463,4,86,471,495,55000,11.871604036,10.300899502,8.5292909,-62,0.0730560248,1.570704534,8.6023469248
47,73,2004,660,588,336,463,15,72,351,379,55379,11.95879651,10.654200527,6.088114587,-44,0.2717908298,1.3045959829,6.3599054168
47,73,2005,641,565,547,463,12,76,559,587,55966,11.513763528,10.148637119,9.8253177062,-48,0.2155462751,1.3651264089,10.040863981
47,73,2006,643,590,454,463,15,53,469,493,56459,11.438736936,10.495886146,8.0764954414,-29,0.266844563,0.9428507894,8.3433400044
47,73,2007,629,609,437,463,12,20,449,469,56928,11.094746311,10.741972184,7.7081146869,0,0.2116644765,0.3527741275,7.9197791634
47,73,2008,666,599,435,463,14,67,449,549,57477,11.642847778,10.471570299,7.6045627376,33,0.2447445479,1.1712774791,7.8493072855
47,75,2001,291,233,-36,253,19,58,-17,19,19839,14.675105272,11.750170201,-1.815476941,-22,0.9581683855,2.9249350715,-0.857308555
47,75,2002,289,229,-372,253,18,60,-354,-301,19538,14.678619499,11.631155243,-18.89427839,-7,0.9142392767,3.0474642558,-17.98003911
47,75,2003,285,224,-134,253,17,61,-117,-79,19459,14.616508962,11.488063184,-6.872323512,-23,0.8718619381,3.1284457779,-6.000461574
47,75,2004,282,210,38,253,18,72,56,114,19573,14.449682312,10.760401722,1.9471203115,-14,0.9223201476,3.6892805903,2.8694404591
47,75,2005,287,234,-247,253,19,53,-228,-192,19381,14.735328849,12.01417056,-12.68162448,-17,0.9755095754,2.7211582893,-11.7061149
47,75,2006,242,213,-164,253,18,29,-146,-125,19256,12.526852499,11.025700753,-8.489271941,-8,0.9317493594,1.5011517457,-7.557522582
47,75,2007,276,205,-222,253,16,71,-206,-127,19129,14.380617429,10.681255699,-11.56701837,8,0.8336589814,3.6993617298,-10.73335939
47,75,2008,263,227,-164,253,16,36,-148,-105,19024,13.786596074,11.899457448,-8.596964852,7,0.8387282782,1.8871386261,-7.758236574
47,77,2001,351,302,56,352,1,49,57,83,25664,13.698897453,11.786515758,2.1855790809,-23,0.0390281979,1.9123816958,2.2246072788
47,77,2002,363,319,86,352,1,44,87,109,25773,14.114353481,12.403522756,3.343896417,-22,0.0388825165,1.710830725,3.3827789335
47,77,2003,349,307,62,352,-2,42,60,65,25838,13.524248707,11.89668869,2.4025885955,-37,-0.077502858,1.6275600163,2.3250857375
47,77,2004,376,358,61,352,1,18,62,64,25902,14.534209509,13.838422884,2.357943564,-16,0.0386548125,0.6957866254,2.3965983765
47,77,2005,336,299,235,352,-1,37,234,247,26149,12.910414785,11.488732205,9.0296055791,-24,-0.038423854,1.4216825805,8.9911817256
47,77,2006,376,303,263,352,0,73,263,323,26472,14.290872465,11.516314779,9.9960091978,-13,0,2.7745576861,9.9960091978
47,77,2007,368,318,165,352,-1,50,164,215,26687,13.845256683,11.964107677,6.2077917192,1,-0.03762298,1.8811490058,6.1701687391
47,77,2008,373,315,164,352,1,58,165,229,26916,13.917131504,11.753073522,6.1190605003,6,0.0373113445,2.1640579818,6.1563718449
47,79,2001,373,435,129,524,14,-62,143,51,31171,11.976047904,13.96670466,4.1418503476,-30,0.4495031385,-1.990656756,4.5913534861
47,79,2002,381,428,151,524,12,-47,163,91,31262,12.20508385,13.710697868,4.8371854628,-25,0.3844120898,-1.505614018,5.2215975526
47,79,2003,329,410,-89,524,4,-81,-85,-205,31057,10.558577641,13.158105875,-2.856271763,-39,0.1283717646,-2.599528234,-2.727899998
47,79,2004,332,447,153,524,14,-115,167,26,31083,10.685548761,14.386868362,4.9243643386,-26,0.4505954297,-3.701319601,5.3749597683
47,79,2005,396,448,288,524,10,-52,298,217,31300,12.695766475,14.362887325,9.233284709,-29,0.3206001635,-1.66712085,9.5538848725
47,79,2006,395,462,256,524,12,-67,268,186,31486,12.582422833,14.716656579,8.1546841653,-15,0.3822508202,-2.134233746,8.5369349855
47,79,2007,354,451,172,524,8,-97,180,89,31575,11.227224433,14.30361079,5.4550356005,6,0.2537225861,-3.076386356,5.7087581865
47,79,2008,367,447,244,524,10,-80,254,195,31770,11.587339174,14.113189676,7.7038440287,21,0.3157313127,-2.525850501,8.0195753414
47,81,2001,310,234,210,1384,0,76,210,267,22704,13.734742252,10.367515119,9.3041802353,-19,0,3.3672271328,9.3041802353
47,81,2002,280,225,306,1392,0,55,306,349,23053,12.238564591,9.8345608322,13.375002732,-12,0,2.404003759,13.375002732
47,81,2003,279,249,23,1367,-2,30,21,18,23071,12.097823259,10.796982048,0.9973115948,-33,-0.086722747,1.3008412106,0.9105888475
47,81,2004,274,226,287,1361,2,48,289,314,23385,11.796108145,9.7296366454,12.35577751,-23,0.0861029792,2.0664714999,12.441880489
47,81,2005,267,237,-17,1361,0,30,-17,-9,23376,11.419772888,10.136652338,-0.727101645,-22,0,1.2831205492,-0.727101645
47,81,2006,274,224,96,1361,2,50,98,137,23513,11.687176097,9.5544797287,4.0947770266,-11,0.0853078547,2.132696368,4.1800848813
47,81,2007,272,253,212,1361,0,19,212,240,23753,11.509330174,10.70536961,8.9705073414,9,0,0.8039605636,8.9705073414
47,81,2008,273,240,51,1361,2,33,53,88,23841,11.47203429,10.08530487,2.143127285,2,0.0840442073,1.3867294197,2.2271714922
47,83,2001,108,86,-11,190,10,22,-1,13,8033,13.455428892,10.714508192,-1.37046035,-8,1.2458730455,2.7409207002,-0.124587305
47,83,2002,92,114,-30,190,9,-22,-21,-49,7984,11.487794219,14.234875445,-3.746019854,-6,1.1238059562,-2.747081226,-2.622213898
47,83,2003,97,112,27,190,4,-15,31,9,7993,12.142454779,14.020153971,3.3798585467,-7,0.5007197847,-1.877699193,3.8805783314
47,83,2004,100,120,-103,190,5,-20,-98,-126,7867,12.610340479,15.132408575,-12.98865069,-8,0.630517024,-2.522068096,-12.35813367
47,83,2005,114,116,56,190,5,-2,61,52,7919,14.443177499,14.696566578,7.0948942101,-7,0.6334726973,-0.253389079,7.7283669074
47,83,2006,95,103,18,190,5,-8,23,11,7930,11.988138053,12.997665468,2.2714366837,-4,0.6309546344,-1.009527415,2.9023913181
47,83,2007,110,113,144,190,4,-3,148,145,8075,13.745704467,14.120587316,17.994376757,0,0.4998437988,-0.374882849,18.494220556
47,83,2008,107,119,67,190,4,-12,71,62,8137,13.200098692,14.680483592,8.2654823587,3,0.4934616334,-1.4803849,8.7589439921
47,85,2001,214,191,116,233,4,23,120,129,18039,11.905755376,10.626164845,6.4535870261,-14,0.2225374837,1.279590531,6.6761245097
47,85,2002,219,215,-93,233,3,4,-90,-101,17938,12.174444784,11.952080496,-5.169969703,-15,0.1667732162,0.2223642883,-5.003196487
47,85,2003,219,205,-19,233,2,14,-17,-30,17908,12.218936562,11.43781733,-1.060090387,-27,0.1115884618,0.7811192323,-0.948501925
47,85,2004,212,221,-39,233,3,-9,-36,-56,17852,11.856823266,12.360178971,-2.181208054,-11,0.1677852349,-0.503355705,-2.013422819
47,85,2005,217,216,77,233,3,1,80,66,17918,12.133072407,12.077159631,4.3052837573,-15,0.1677383282,0.0559127761,4.4730220855
47,85,2006,225,214,134,233,3,11,137,140,18058,12.508338893,11.896820102,7.4494107183,-8,0.1667778519,0.6115187903,7.6161885702
47,85,2007,209,213,103,233,3,-4,106,94,18152,11.543772439,11.764705882,5.6890361779,-8,0.1657000829,-0.220933444,5.8547362607
47,85,2008,224,213,3,233,3,11,6,-3,18149,12.341257817,11.735213906,0.1652847029,-20,0.1652847029,0.6060439106,0.3305694058
47,87,2001,106,156,137,136,4,-50,141,83,11114,9.5732671032,14.088959133,12.372996162,-8,0.3612553624,-4.51569203,12.734251524
47,87,2002,97,139,23,136,4,-42,27,-25,11089,8.7375579877,12.520830518,2.0717921002,-10,0.3603116696,-3.783272531,2.4321037698
47,87,2003,94,129,31,136,3,-35,34,-14,11075,8.4822234254,11.640498105,2.797329002,-13,0.2707092583,-3.15827468,3.0680382602
47,87,2004,126,136,7,136,2,-10,9,-9,11066,11.381599747,12.284901314,0.6323110971,-8,0.1806603134,-0.903301567,0.8129714105
47,87,2005,107,170,-20,136,3,-63,-17,-88,10978,9.7078570132,15.423698058,-1.814552713,-8,0.2721829069,-5.715841045,-1.542369806
47,87,2006,98,120,-135,136,3,-22,-132,-160,10818,8.9924756836,11.011194715,-12.38759405,-6,0.2752798679,-2.018719031,-12.11231419
47,87,2007,107,148,17,136,4,-41,21,-29,10789,9.9041977137,13.699264127,1.5735641227,-9,0.3702503818,-3.795066414,1.9438145046
47,87,2008,101,142,110,136,3,-41,113,58,10847,9.3362913662,13.12627103,10.168238122,-14,0.2773155851,-3.789979664,10.445553707
47,89,2001,520,430,471,1607,56,90,527,578,45160,11.588776715,9.5830268993,10.496757371,-39,1.2480221078,2.0057498161,11.744779479
47,89,2002,525,435,458,1607,52,90,510,564,45724,11.55318868,9.5726420492,10.078781744,-36,1.1443158312,1.9805466309,11.223097575
47,89,2003,507,470,886,1607,45,37,931,962,46686,10.972838437,10.172059301,19.175413916,-6,0.9739205714,0.8007791365,20.149334488
47,89,2004,526,451,489,1607,47,75,536,568,47254,11.198637428,9.6018735363,10.410900575,-43,1.0006387056,1.5967638918,11.41153928
47,89,2005,547,508,564,1607,46,39,610,607,47861,11.501866162,10.681806235,11.859328182,-42,0.9672501708,0.8200599275,12.826578353
47,89,2006,590,464,1031,1607,50,126,1081,1180,49041,12.177251244,9.5766857237,21.279230563,-27,1.0319704444,2.6005655198,22.311201007
47,89,2007,569,497,969,1607,44,72,1013,1113,50154,11.472352437,10.020666364,19.537275064,28,0.887141489,1.4516860729,20.424416553
47,89,2008,586,495,753,1607,46,91,799,920,51074,11.577824317,9.7799027937,14.877306674,30,0.9088394515,1.7979215237,15.786146126
47,91,2001,148,191,207,1653,3,-43,210,155,17672,8.4117195715,10.855665123,11.765040211,-12,0.1705078292,-2.443945551,11.935548041
47,91,2002,155,226,132,1678,3,-71,135,52,17724,8.7580517573,12.769804498,7.4584698836,-12,0.1695106792,-4.01175274,7.6279805628
47,91,2003,160,187,208,1742,3,-27,211,175,17899,8.9829604469,10.498835022,11.677848581,-9,0.1684305084,-1.515874575,11.846279089
47,91,2004,160,207,85,1745,2,-47,87,26,17925,8.9325591782,11.556498437,4.7454220634,-14,0.1116569897,-2.623939259,4.8570790531
47,91,2005,177,204,158,1745,3,-27,161,117,18042,9.8423554925,11.343731754,8.7858314566,-17,0.1668195846,-1.501376262,8.9526510412
47,91,2006,182,234,-3,1745,2,-52,-1,-60,17982,10.104374861,12.991339107,-0.16655563,-7,0.1110370864,-2.886964246,-0.055518543
47,91,2007,166,215,146,1745,3,-49,149,104,18086,9.2048353111,11.921925252,8.0958190085,4,0.1663524454,-2.717089941,8.2621714539
47,91,2008,168,205,58,1745,2,-37,60,26,18112,9.282280789,11.326592629,3.2045969391,3,0.1105033427,-2.04431184,3.3151002818
47,93,2001,4828,3710,1521,12891,459,1118,1980,4684,387712,12.528219633,9.627111607,3.946856268,1586,1.1910631341,2.9011080261,5.1379194021
47,93,2002,4749,3592,2149,12437,424,1157,2573,5011,392723,12.170135886,9.2051227841,5.5071850955,1281,1.0865735135,2.9650131017,6.593758609
47,93,2003,4864,3579,2875,12590,363,1285,3238,5848,398571,12.293787139,9.0459424689,7.266578541,1325,0.9174845253,3.2478446696,8.1840630663
47,93,2004,5060,3755,2554,12590,349,1305,2903,4259,402830,12.627885416,9.3710888806,6.3738378165,51,0.8709747055,3.2567965351,7.2448125221
47,93,2005,5009,3621,4232,12590,359,1388,4591,5979,408809,12.342925857,8.922686071,10.428281539,0,0.884629743,3.4202397864,11.312911282
47,93,2006,5190,3488,5133,12590,366,1702,5499,7205,416014,12.584518133,8.4575721094,12.446306662,4,0.8874631285,4.1269460236,13.333769791
47,93,2007,5457,3753,5504,12590,327,1704,5831,7589,423603,12.998783969,8.9397904044,13.110739778,54,0.778926582,4.0589935649,13.88966636
47,93,2008,5498,3793,4275,12590,331,1705,4606,6416,430019,12.881579903,8.8868374995,10.016142977,105,0.7755189065,3.9947424035,10.791661883
47,95,2001,81,122,62,2454,1,-41,63,16,7956,10.19124308,15.349773528,7.8007045798,-6,0.1258178158,-5.158530448,7.9265223956
47,95,2002,61,102,-23,2461,1,-41,-22,-72,7884,7.702020202,12.878787879,-2.904040404,-9,0.1262626263,-5.176767677,-2.777777778
47,95,2003,92,103,-32,2453,0,-11,-32,-52,7832,11.707813693,13.107660982,-4.072283024,-9,0,-1.399847289,-4.072283024
47,95,2004,73,94,-182,2444,1,-21,-181,-213,7619,9.4492265873,12.167497249,-23.55834574,-11,0.1294414601,-2.718270662,-23.42890428
47,95,2005,56,98,-58,2444,1,-42,-57,-105,7514,7.4010440759,12.951827133,-7.665367079,-6,0.1321615014,-5.550783057,-7.533205577
47,95,2006,72,77,-75,2444,1,-5,-74,-81,7433,9.6340402756,10.30307085,-10.03545862,-2,0.1338061149,-0.669030575,-9.901652506
47,95,2007,73,77,-17,2444,0,-4,-17,-26,7407,9.8382749326,10.377358491,-2.291105121,-5,0,-0.539083558,-2.291105121
47,95,2008,67,93,-56,2444,0,-26,-56,-84,7323,9.0970807875,12.627291242,-7.60353021,-2,0,-3.530210455,-7.60353021
47,97,2001,417,301,-1,2824,12,116,11,97,27160,15.380926913,11.102299762,-0.036884717,-30,0.4426166018,4.2786271508,0.405731885
47,97,2002,405,299,-195,2794,11,106,-184,-100,27060,14.93913685,11.029140539,-7.192917743,-22,0.4057543342,3.9099963113,-6.787163408
47,97,2003,395,291,-264,2809,10,104,-254,-173,26887,14.644002447,10.78836636,-9.787383914,-23,0.3707342392,3.8556360873,-9.416649675
47,97,2004,390,258,-394,2751,9,132,-385,-280,26607,14.581074513,9.6459416009,-14.730624,-27,0.3364863349,4.9351329121,-14.39413766
47,97,2005,346,286,-105,2751,11,60,-94,-58,26549,13.0182858,10.760779592,-3.950635864,-24,0.4138761382,2.2575062081,-3.536759726
47,97,2006,371,248,-98,2751,11,123,-87,24,26573,13.967847596,9.336997854,-3.68962012,-12,0.4141410338,4.6308497421,-3.275479086
47,97,2007,382,254,-32,2751,8,128,-24,108,26681,14.346340181,9.5391895444,-1.201787659,4,0.3004469148,4.8071506366,-0.901340744
47,97,2008,375,276,-110,2751,8,99,-102,11,26692,14.052048789,10.342307908,-4.121934311,14,0.2997770408,3.7097408802,-3.822157271
47,99,2001,633,399,-178,367,14,234,-164,32,39994,15.83370854,9.9804892691,-4.452448847,-38,0.3501926059,5.8532192706,-4.102256241
47,99,2002,579,423,357,367,14,156,371,500,40494,14.387237849,10.51088361,8.8708875857,-27,0.3478779445,3.8763542391,9.2187655303
47,99,2003,596,434,-143,367,10,162,-133,-25,40469,14.722774601,10.720946605,-3.532477799,-54,0.2470264195,4.0018279955,-3.285451379
47,99,2004,598,485,-72,367,12,113,-60,26,40495,14.771997431,11.980633368,-1.778568253,-27,0.2964280421,2.791364063,-1.48214021
47,99,2005,540,485,132,367,12,55,144,160,40655,13.308687616,11.953173136,3.2532347505,-39,0.2957486137,1.3555144794,3.5489833641
47,99,2006,550,486,-122,367,13,64,-109,-62,40593,13.538794801,11.963371406,-3.003150847,-17,0.3200078771,1.575423395,-2.68314297
47,99,2007,566,455,159,367,7,111,166,288,40881,13.894002995,11.169207354,3.903085647,11,0.1718339593,2.7247956403,4.0749196063
47,99,2008,555,459,-37,367,9,96,-28,73,40954,13.563878536,11.217694141,-0.904258569,5,0.2199547871,2.3461843954,-0.684303782
47,101,2001,131,118,17,233,3,13,20,20,11393,11.508389704,10.366335764,1.4934551524,-13,0.2635509093,1.1420539401,1.7570060617
47,101,2002,121,121,9,233,2,0,11,0,11393,10.620556482,10.620556482,0.7899587466,-11,0.1755463881,0,0.9655051347
47,101,2003,171,145,-6,233,1,26,-5,4,11397,15.006581834,12.724879333,-0.526546731,-17,0.0877577885,2.2817025011,-0.438788943
47,101,2004,182,161,-42,233,4,21,-38,-25,11372,15.986648513,14.142035223,-3.68922658,-8,0.3513549124,1.84461329,-3.337871668
47,101,2005,151,121,-61,233,2,30,-59,-39,11333,13.301035014,10.658445276,-5.3732658,-10,0.1761726492,2.6425897379,-5.197093151
47,101,2006,139,145,130,233,3,-6,133,121,11454,12.199938561,12.726554614,11.410014482,-6,0.2633080265,-0.526616053,11.673322508
47,101,2007,158,144,92,233,2,14,94,106,11560,13.730772573,12.514121839,7.9951333971,-2,0.1738072478,1.2166507343,8.1689406448
47,101,2008,168,136,-39,233,4,32,-35,4,11564,14.53035807,11.762670818,-3.373118838,7,0.3459609064,2.7676872513,-3.027157931
47,103,2001,389,384,172,468,15,5,187,165,31565,12.356070833,12.197252442,5.4633526562,-27,0.4764551735,0.1588183912,5.9398078297
47,103,2002,374,394,87,468,14,-20,101,52,31617,11.838814852,12.471906556,2.7539489095,-29,0.4431641923,-0.633091703,3.1971131018
47,103,2003,400,347,109,468,9,53,118,130,31747,12.625465564,10.952591377,3.4404393662,-41,0.2840729752,1.6728741872,3.7245123414
47,103,2004,389,381,17,468,13,8,30,18,31765,12.249653609,11.997732712,0.5353319058,-20,0.4093714574,0.2519208968,0.9447033631
47,103,2005,432,375,318,468,10,57,328,353,32118,13.524724888,11.740212576,9.9557002645,-32,0.3130723354,1.7845123116,10.2687726
47,103,2006,420,373,210,468,12,47,222,254,32372,13.025275236,11.567684912,6.5126376182,-15,0.372150721,1.4575903241,6.8847883393
47,103,2007,451,352,181,468,9,99,190,293,32665,13.869028399,10.824607531,5.5660623953,4,0.2767655335,3.0444208681,5.8428279287
47,103,2008,437,354,353,468,11,83,364,451,33116,13.286511303,10.762986273,10.732582357,4,0.3344430763,2.52352503,11.067025433
47,105,2001,490,428,677,433,35,62,712,749,39963,12.377331801,10.81122043,17.100925774,-25,0.8840951286,1.5661113707,17.985020903
47,105,2002,481,442,725,433,33,39,758,769,40732,11.921432555,10.954829915,17.968895223,-28,0.8178945412,0.9666026396,18.786789764
47,105,2003,478,470,636,433,31,8,667,657,41389,11.641358483,11.446524032,15.489338902,-18,0.7549835,0.1948344516,16.244322402
47,105,2004,493,470,722,433,27,23,749,726,42115,11.80781759,11.256945775,17.292584786,-46,0.6466756084,0.5508718145,17.939260395
47,105,2005,509,458,1022,433,31,51,1053,1079,43194,11.933090295,10.737436847,23.959957332,-25,0.7267697429,1.1956534481,24.686727075
47,105,2006,478,505,1112,433,30,-27,1142,1087,44281,10.928836811,11.546156045,25.424406973,-28,0.6859102601,-0.617319234,26.110317233
47,105,2007,558,517,1043,433,28,41,1071,1082,45363,12.449243675,11.534514301,23.269822855,-30,0.624693231,0.914729374,23.894516086
47,105,2008,561,534,1057,433,27,27,1084,1082,46445,12.221157198,11.632973161,23.026315789,-29,0.5881840362,0.5881840362,23.614499826
47,107,2001,630,483,466,716,31,147,497,605,49775,12.734347365,9.7629996463,9.4193743999,-39,0.6266107433,2.9713477184,10.045985143
47,107,2002,613,558,210,728,28,55,238,253,50028,12.284199874,11.182028596,4.208290332,-40,0.5611053776,1.1021712774,4.7693957095
47,107,2003,598,543,193,728,25,55,218,212,50240,11.928032872,10.830972992,3.84968285,-61,0.4986635816,1.0970598795,4.3483464316
47,107,2004,604,588,196,728,31,16,227,208,50448,11.997457492,11.679644049,3.893214683,-35,0.6157635468,0.3178134435,4.5089782298
47,107,2005,628,575,538,728,29,53,567,576,51024,12.377798802,11.333175654,10.603910438,-44,0.5715862504,1.0446231473,11.175496689
47,107,2006,610,554,488,728,32,56,520,550,51574,11.891070001,10.799430788,9.5128560011,-26,0.6237938361,1.0916392132,10.136649837
47,107,2007,596,573,432,728,27,23,459,477,52051,11.503015682,11.059107358,8.3377563329,-5,0.5211097708,0.4439083233,8.8588661037
47,107,2008,622,575,373,728,29,47,402,460,52511,11.897247566,10.998259406,7.1345230581,11,0.5546948222,0.8989881601,7.6892178803
47,109,2001,341,329,-109,528,14,12,-95,-105,24606,13.828902812,13.342255206,-4.420382424,-22,0.5677555407,0.4866476063,-3.852626883
47,109,2002,354,307,-39,528,14,47,-25,-1,24605,14.387027291,12.476885249,-1.585011481,-23,0.5689784804,1.9101420414,-1.016033001
47,109,2003,326,314,154,528,7,12,161,145,24750,13.210414345,12.724141424,6.240502482,-28,0.2836592037,0.4862729207,6.5241616857
47,109,2004,336,352,135,528,8,-16,143,109,24859,13.545929166,14.190973412,5.4425608257,-18,0.322522123,-0.645044246,5.7650829487
47,109,2005,330,295,183,528,8,35,191,205,25064,13.220359353,11.818200028,7.3312901869,-21,0.3204935601,1.4021593254,7.651783747
47,109,2006,296,308,271,528,8,-12,279,254,25318,11.750228256,12.226588861,10.757810329,-13,0.3175737367,-0.476360605,11.075384066
47,109,2007,308,288,147,528,6,20,153,172,25490,12.124074949,11.336797355,5.7864903165,-1,0.2361832782,0.7872775941,6.0226735947
47,109,2008,341,317,205,528,6,24,211,234,25724,13.316671223,12.3794275,8.0056234623,-1,0.2343109306,0.9372437224,8.2399343929
47,111,2001,275,205,274,213,35,70,309,363,20808,13.332363707,9.9386711269,13.283882384,-16,1.69684629,3.3936925799,14.980728674
47,111,2002,259,232,-88,213,33,27,-55,-46,20762,12.46090931,11.161895598,-4.233822468,-18,1.5876834255,1.2990137118,-2.646139043
47,111,2003,271,222,68,213,29,49,97,120,20882,13.015080204,10.661800019,3.2657765825,-26,1.3927576602,2.3532801844,4.6585342426
47,111,2004,257,225,189,213,27,32,216,228,21110,12.240426748,10.716326919,9.0017146123,-20,1.2859592303,1.5240998285,10.287673843
47,111,2005,267,251,72,213,30,16,102,98,21208,12.618743797,11.862564393,3.402807316,-20,1.4178363817,0.7561794036,4.8206436977
47,111,2006,314,190,69,213,30,124,99,213,21421,14.731755378,8.9141194961,3.2372328696,-10,1.407492552,5.8176358817,4.6447254217
47,111,2007,293,228,47,213,26,65,73,138,21559,13.634248488,10.609585854,2.1870637506,0,1.2098650535,3.0246626338,3.3969288041
47,111,2008,276,238,211,213,26,38,237,279,21838,12.719773256,10.968500127,9.7241744821,4,1.1982395096,1.7512731295,10.922413992
47,113,2001,1372,865,370,3713,151,507,521,945,92960,14.834437086,9.3526152183,4.0005406136,-83,1.6326530612,5.4818218678,5.6331936748
47,113,2002,1326,865,-20,3697,148,461,128,497,93457,14.22617036,9.2802695033,-0.214572705,-92,1.5878380191,4.9459008567,1.3732653138
47,113,2003,1320,908,-198,3600,123,412,-75,212,93669,14.108141039,9.7046909569,-2.116221156,-125,1.3146222331,4.4034500818,-0.801598923
47,113,2004,1363,863,-79,3600,112,500,33,470,94139,14.51482365,9.1902368376,-0.841284716,-63,1.1927074459,5.3245868121,0.3514227296
47,113,2005,1354,914,182,3600,122,440,304,661,94800,14.332668216,9.6750803169,1.9265477218,-83,1.2914220992,4.6575878987,3.2179698209
47,113,2006,1349,892,684,3600,124,457,808,1216,96016,14.139275532,9.3493208117,7.1692101291,-49,1.2996813684,4.7899547208,8.4688914976
47,113,2007,1397,909,-319,3600,105,488,-214,280,96296,14.528474562,9.4533882441,-3.317525687,6,1.0919755397,5.0750863181,-2.225550148
47,113,2008,1389,918,-526,3600,107,471,-419,80,96376,14.418285999,9.5291479821,-5.460056469,28,1.1106958977,4.8891380169,-4.349360571
47,115,2001,372,293,0,249,10,79,10,61,27829,13.382017015,10.540137058,0,-28,0.3597316402,2.8418799576,0.3597316402
47,115,2002,308,313,13,249,10,-5,23,-8,27821,11.06918239,11.248876909,0.4672057502,-26,0.3593890386,-0.179694519,0.8265947889
47,115,2003,320,320,146,249,3,0,149,123,27944,11.476732718,11.476732718,5.2362593024,-26,0.1075943692,0,5.3438536717
47,115,2004,379,293,-258,249,3,86,-255,-192,27752,13.609594944,10.521401896,-9.264579144,-23,0.1077276645,3.088193048,-9.156851479
47,115,2005,318,314,-17,249,3,4,-14,-35,27717,11.465863816,11.321639114,-0.612954984,-25,0.1081685266,0.1442247021,-0.504786457
47,115,2006,340,324,250,249,3,16,253,255,27972,12.210669971,11.636050207,8.978433802,-14,0.1077412056,0.5746197633,9.0861750076
47,115,2007,344,324,116,249,2,20,118,146,28118,12.26600107,11.552861473,4.136209663,8,0.0713139597,0.7131395971,4.2075236227
47,115,2008,353,322,90,249,2,31,92,129,28247,12.525503415,11.425530027,3.1934711257,6,0.070966025,1.0999733877,3.2644371507
47,117,2001,358,260,132,348,43,98,175,247,27124,13.259013722,9.6294513065,4.8887983556,-26,1.5925631007,3.6295624155,6.4813614563
47,117,2002,389,266,14,348,41,123,55,150,27274,14.301996397,9.7797713151,0.5147248061,-28,1.5074083606,4.5222250818,2.0221331667
47,117,2003,361,243,13,348,31,118,44,122,27396,13.206511798,8.8897018474,0.4755807573,-40,1.1340771904,4.3168099506,1.6096579477
47,117,2004,367,282,240,348,31,85,271,331,27727,13.315675852,10.231663734,8.7077989224,-25,1.1247573608,3.0840121184,9.8325562832
47,117,2005,356,283,214,348,31,73,245,295,28022,12.771529534,10.152648478,7.6772677537,-23,1.1121275718,2.6188810562,8.7893953255
47,117,2006,395,267,405,348,31,128,436,548,28570,13.959570257,9.4359626802,14.312977099,-16,1.0955612101,4.523607577,15.408538309
47,117,2007,390,272,416,348,26,118,442,572,29142,13.515386748,9.4261158858,14.416412531,12,0.9010257832,4.0892708622,15.317438314
47,117,2008,397,261,415,348,26,136,441,589,29731,13.486657721,8.8665432371,14.098143461,12,0.8832571807,4.6201144837,14.981400642
47,119,2001,1028,728,106,1238,113,300,219,443,70135,14.703884085,10.412867329,1.5161592539,-76,1.6162829783,4.2910167564,3.1324422322
47,119,2002,987,661,694,1238,106,326,800,1073,71208,13.966025909,9.3531338658,9.8200830604,-53,1.4998974127,4.6128920428,11.319980473
47,119,2003,998,697,1089,1238,89,301,1178,1448,72656,13.874214536,9.6897069454,15.139298226,-31,1.237279653,4.1845075905,16.376577879
47,119,2004,1026,718,1116,1238,92,308,1208,1436,74092,13.983154796,9.785482596,15.209747322,-80,1.2538501377,4.1976722,16.46359746
47,119,2005,988,706,1026,1238,95,282,1121,1345,75437,13.214827893,9.442984304,13.723090504,-58,1.2706565282,3.7718435889,14.993747032
47,119,2006,1035,693,1547,1238,96,342,1643,1942,77379,13.545702021,9.0697309182,20.24657104,-43,1.2564129411,4.4759711025,21.502983981
47,119,2007,1138,748,1956,1238,84,390,2040,2414,79793,14.480950805,9.5182348001,24.889929504,-16,1.0688926781,4.9627160054,25.958822182
47,119,2008,1151,763,1699,1238,86,388,1785,2145,81938,14.233511201,9.435420544,21.010195943,-28,1.0634943208,4.7980906567,22.073690263
47,121,2001,158,116,72,114,2,42,74,107,11231,14.135540148,10.377991501,6.441511966,-9,0.1789308879,3.7575486468,6.6204428539
47,121,2002,145,109,-3,114,2,36,-1,24,11255,12.896913635,9.6949212844,-0.266832696,-11,0.1778884639,3.2019923508,-0.088944232
47,121,2003,138,133,7,114,1,5,8,-5,11250,12.263941346,11.819595645,0.6220839813,-18,0.0888691402,0.444345701,0.7109531215
47,121,2004,140,111,121,114,0,29,121,139,11389,12.368037457,9.8060868413,10.689518088,-11,0,2.5619506162,10.689518088
47,121,2005,97,115,72,114,1,-18,73,47,11436,8.4994523549,10.076670318,6.308871851,-8,0.0876232202,-1.577217963,6.3964950712
47,121,2006,105,113,100,114,0,-8,100,85,11521,9.147536699,9.8444918761,8.7119397134,-7,0,-0.696955177,8.7119397134
47,121,2007,128,124,109,114,1,4,110,107,11628,11.058793036,10.713205754,9.4172534451,-7,0.0863968206,0.3455872824,9.5036502657
47,121,2008,121,116,173,114,0,5,173,162,11790,10.333931164,9.9069092151,14.774959433,-16,0,0.4270219489,14.774959433
47,123,2001,529,432,292,586,35,97,327,390,39566,13.436285591,10.972543242,7.4166264509,-34,0.8889791979,2.4637423484,8.3056056488
47,123,2002,532,413,535,597,30,119,565,661,40227,13.334503027,10.351785244,13.409697593,-23,0.7519456594,2.9827177823,14.161643252
47,123,2003,533,407,511,597,18,126,529,631,40858,13.14669791,10.038848122,12.604057471,-24,0.443978541,3.1078497873,13.048036012
47,123,2004,561,351,801,597,31,210,832,991,41849,13.565961769,8.4877942617,19.369581777,-51,0.749634251,5.078167507,20.119216028
47,123,2005,534,445,910,597,27,89,937,997,42846,12.609953362,10.508294468,21.488871834,-29,0.6375819116,2.1016588937,22.126453746
47,123,2006,502,436,825,597,30,66,855,896,43742,11.595140204,10.07067954,19.055758304,-25,0.6929366656,1.5244606643,19.748694969
47,123,2007,596,464,852,597,23,132,875,991,44733,13.47273241,10.488838655,19.259677875,-16,0.5199208816,2.9838937553,19.779598757
47,123,2008,588,457,772,597,25,131,797,915,45648,13.011584293,10.112744935,17.083236521,-13,0.5532136179,2.8988393578,17.636450139
47,125,2001,2475,850,-1123,4253,47,1625,-1076,440,135659,18.273909288,6.2758880382,-8.291555608,-109,0.3470196915,11.998021249,-7.944535917
47,125,2002,2351,874,249,4253,-549,1477,-300,1040,136699,17.26404218,6.4180233369,1.8284757562,-137,-4.031458595,10.846018843,-2.202982839
47,125,2003,2300,826,2334,4403,-1742,1474,592,2053,138752,16.699884916,5.9974369307,16.94675278,-13,-12.64834762,10.702447985,4.298405161
47,125,2004,2161,911,467,4403,883,1250,1350,2495,141247,15.435769413,6.507166097,3.335726199,-105,6.3071653827,8.9286033164,9.6428915818
47,125,2005,2817,929,4515,4403,-22,1888,4493,6248,147495,19.51222891,6.4348103151,31.273593727,-133,-0.152385174,13.077418595,31.121208553
47,125,2006,2776,934,-1784,4403,475,1842,-1309,466,147961,18.791292104,6.3224304127,-12.07624824,-67,3.2153687859,12.468861692,-8.860879454
47,125,2007,2559,1001,4843,4403,-53,1558,4790,6441,154402,16.926674229,6.6211805016,32.034342826,93,-0.350571995,10.305493728,31.683770832
47,125,2008,2796,968,-1687,4403,164,1828,-1523,354,154756,18.087838581,6.2621701525,-10.91351348,49,1.0609461829,11.825668428,-9.852567296
47,127,2001,51,50,30,112,-1,1,29,24,5789,8.8281114765,8.6550112515,5.1930067509,-6,-0.173100225,0.173100225,5.0199065259
47,127,2002,67,50,110,112,-2,17,108,123,5912,11.452012648,8.5462780959,18.801811811,-2,-0.341851124,2.9057345526,18.459960687
47,127,2003,51,51,-43,112,-4,0,-47,-53,5859,8.6653640302,8.6653640302,-7.306091241,-6,-0.679636395,0,-7.985727636
47,127,2004,59,50,60,112,1,9,61,65,5924,10.014427565,8.4868030213,10.184163626,-5,0.1697360604,1.5276245438,10.353899686
47,127,2005,50,58,73,112,-1,-8,72,59,5983,8.3984210968,9.7421684723,12.261694801,-5,-0.167968422,-1.343747375,12.093726379
47,127,2006,62,47,2,112,1,15,3,15,5998,10.349720391,7.84575578,0.3338619481,-3,0.166930974,2.5039646106,0.5007929221
47,127,2007,54,49,104,112,-1,5,103,105,6103,8.9248822411,8.0985042558,17.188662094,-3,-0.165275597,0.8263779853,17.023386497
47,127,2008,59,55,90,112,1,4,91,92,6195,9.5950561067,8.9445438283,14.636526264,-3,0.1626280696,0.6505122784,14.799154334
47,129,2001,231,169,147,1713,1,62,148,190,19966,11.624981128,8.5048563233,7.3977152634,-20,0.0503245936,3.120124805,7.4480398571
47,129,2002,213,193,30,1721,1,20,31,31,19997,10.659860371,9.6589345144,1.5013887846,-20,0.0500462928,1.0009258564,1.5514350774
47,129,2003,227,194,63,1695,1,33,64,72,20069,11.331303349,9.6840213647,3.1448110617,-25,0.0499176359,1.6472819847,3.1947286976
47,129,2004,218,191,-53,1695,0,27,-53,-41,20028,10.873631444,9.5268972741,-2.643589296,-15,0,1.3467341696,-2.643589296
47,129,2005,207,206,42,1695,1,1,43,26,20054,10.328825907,10.278928197,2.0957038072,-18,0.0498977097,0.0498977097,2.1456015169
47,129,2006,237,177,-23,1695,0,60,-23,28,20082,11.809846522,8.8200119593,-1.146103249,-9,0,2.9898345625,-1.146103249
47,129,2007,221,209,246,1695,1,12,247,269,20351,10.931664729,10.338090174,12.168278386,10,0.0494645463,0.5935745554,12.217742933
47,129,2008,230,193,15,1695,0,37,15,53,20404,11.286958655,9.4712305239,0.7361059993,1,0,1.8157281315,0.7361059993
47,131,2001,424,387,-231,522,29,37,-202,-195,32291,13.091066274,11.94868549,-7.132161107,-30,0.8953795329,1.1423807833,-6.236781574
47,131,2002,432,384,-124,522,28,48,-96,-78,32213,13.394518169,11.906238373,-3.844722808,-30,0.8681632147,1.4882797966,-2.976559593
47,131,2003,423,405,-83,522,19,18,-64,-88,32125,13.149305232,12.589760328,-2.580123722,-42,0.5906307314,0.5595449035,-1.98949299
47,131,2004,381,383,-75,522,23,-2,-52,-75,32050,11.873782626,11.936112193,-2.337358785,-21,0.7167900273,-0.062329568,-1.620568757
47,131,2005,388,372,-251,522,21,16,-230,-241,31809,12.151771872,11.650667878,-7.861068917,-27,0.6576989931,0.5011039947,-7.203369924
47,131,2006,358,426,-181,522,22,-68,-159,-240,31569,11.297295592,13.44315062,-5.711761179,-13,0.6942472151,-2.145855029,-5.017513964
47,131,2007,355,371,-65,522,21,-16,-44,-72,31497,11.258047125,11.765452066,-2.061332572,-12,0.6659689849,-0.507404941,-1.395363587
47,131,2008,383,388,-135,522,23,-5,-112,-122,31375,12.183483904,12.342537218,-4.294439496,-5,0.7316452475,-0.159053315,-3.562794249
47,133,2001,241,216,7,177,0,25,7,12,20183,11.944293007,10.705258463,0.3469296724,-20,0,1.2390345443,0.3469296724
47,133,2002,226,270,91,177,-1,-44,90,30,20213,11.189226656,13.367660164,4.5053965739,-16,-0.049509852,-2.178433508,4.4558867215
47,133,2003,210,282,-48,177,-2,-72,-50,-149,20064,10.427787571,14.003029024,-2.383494302,-27,-0.099312263,-3.575241453,-2.482806565
47,133,2004,259,246,310,177,1,13,311,301,20365,12.812585026,12.169482302,15.335526479,-23,0.0494694403,0.6431027233,15.384995919
47,133,2005,255,265,112,177,0,-10,112,84,20449,12.495712256,12.985740187,5.4883128338,-18,0,-0.490027932,5.4883128338
47,133,2006,259,242,265,177,0,17,265,272,20721,12.581977168,11.756133107,12.873451542,-10,0,0.8258440612,12.873451542
47,133,2007,260,262,226,177,-1,-2,225,233,20954,12.477504499,12.573485303,10.845830834,10,-0.047990402,-0.095980804,10.797840432
47,133,2008,270,291,25,177,1,-21,26,21,20975,12.878914355,13.880607694,1.1924920699,16,0.0476996828,-1.001693339,1.2401917527
47,135,2001,83,83,-138,141,3,0,-135,-141,7496,10.969404612,10.969404612,-18.23828719,-6,0.3964845041,0,-17.84180268
47,135,2002,95,107,59,141,3,-12,62,46,7542,12.634658864,14.230615773,7.8467881367,-4,0.3989892273,-1.595956909,8.245777364
47,135,2003,105,97,70,141,3,8,73,76,7618,13.852242744,12.796833773,9.234828496,-5,0.3957783641,1.055408971,9.6306068602
47,135,2004,92,102,-13,141,2,-10,-11,-25,7593,12.096509105,13.411347051,-1.70928933,-4,0.2629675892,-1.314837946,-1.446321741
47,135,2005,82,100,16,141,3,-18,19,-6,7587,10.803689065,13.175230567,2.1080368906,-7,0.395256917,-2.371541502,2.5032938076
47,135,2006,89,103,20,141,2,-14,22,4,7591,11.727500329,13.572275662,2.6353933325,-4,0.2635393332,-1.844775333,2.8989326657
47,135,2007,99,106,89,141,3,-7,92,84,7675,12.96999869,13.887069304,11.659897812,-1,0.3930302633,-0.917070614,12.052928075
47,135,2008,93,109,88,141,2,-16,90,78,7753,12.056002074,14.130152969,11.40782992,4,0.2592688618,-2.074150894,11.667098781
47,137,2001,46,75,63,70,1,-29,64,32,4962,9.3004448039,15.163768702,12.73756571,-3,0.2021835827,-5.863323898,12.939749292
47,137,2002,59,70,73,70,1,-11,74,58,5020,11.821278301,14.025245442,14.626327389,-5,0.2003606492,-2.203967141,14.826688038
47,137,2003,46,67,-79,70,1,-21,-78,-103,4917,9.258327463,13.484955218,-15.90017108,-4,0.2012679883,-4.226627755,-15.69890309
47,137,2004,60,62,-73,70,0,-2,-73,-78,4839,12.300123001,12.710127101,-14.96514965,-3,0,-0.4100041,-14.96514965
47,137,2005,60,61,-22,70,1,-1,-21,-26,4813,12.432656444,12.639867385,-4.558640696,-4,0.2072109407,-0.207210941,-4.351429755
47,137,2006,54,57,-27,70,0,-3,-27,-33,4780,11.258209111,11.883665173,-5.629104555,-3,0,-0.625456062,-5.629104555
47,137,2007,60,64,-5,70,1,-4,-4,-13,4767,12.569393527,13.407353095,-1.047449461,-5,0.2094898921,-0.837959568,-0.837959568
47,137,2008,53,61,54,70,0,-8,54,34,4801,11.078595318,12.75083612,11.287625418,-12,0,-1.672240803,11.287625418
47,139,2001,197,174,100,194,6,23,106,116,16221,12.188331374,10.765328219,6.1869702407,-13,0.3712182144,1.4230031554,6.5581884551
47,139,2002,208,207,-204,194,5,1,-199,-207,16014,12.905227237,12.843182876,-12.65704979,-9,0.3102218086,0.0620443617,-12.34682798
47,139,2003,207,219,-5,194,0,-12,-5,-41,15973,12.942757995,13.693062807,-0.312627005,-24,0,-0.750304811,-0.312627005
47,139,2004,205,191,-193,194,3,14,-190,-189,15784,12.910539409,12.028844034,-12.15480052,-13,0.1889347231,0.8816953742,-11.96586579
47,139,2005,181,220,24,194,1,-39,25,-29,15755,11.477852817,13.950981325,1.5219252354,-15,0.0634135515,-2.473128508,1.5853387869
47,139,2006,185,225,19,194,2,-40,21,-26,15729,11.752001016,14.292974209,1.2069622665,-7,0.1270486596,-2.540973193,1.3340109262
47,139,2007,175,207,-61,194,1,-32,-60,-94,15635,11.159290907,13.199846958,-3.889809973,-2,0.0637673766,-2.040556052,-3.826042597
47,139,2008,180,199,62,194,3,-19,65,36,15671,11.499393088,12.713217913,3.9609020635,-10,0.1916565515,-1.213824826,4.152558615
47,141,2001,836,620,393,2617,159,216,552,708,63209,13.300453425,9.8639726354,6.2524858802,-60,2.529631692,3.4364807891,8.7821175722
47,141,2002,811,618,660,2794,147,193,807,952,64161,12.734552877,9.7040119337,10.36350789,-48,2.3082358483,3.0305409437,12.671743739
47,141,2003,876,658,526,2831,123,218,649,799,64960,13.568668148,10.191990459,8.147396628,-68,1.9051897058,3.3766776899,10.052586334
47,141,2004,898,648,665,2831,128,250,793,981,65941,13.720292435,9.9006119128,10.160350188,-62,1.9556764272,3.8196805219,12.116026616
47,141,2005,893,634,718,2831,128,259,846,1059,67000,13.434531108,9.5380657585,10.80178425,-46,1.925666273,3.8964653493,12.727450523
47,141,2006,974,693,1265,2831,128,281,1393,1631,68631,14.362498249,10.218902758,18.653552654,-43,1.8874741025,4.1435954907,20.541026756
47,141,2007,964,681,770,2831,116,283,886,1127,69758,13.93174313,9.8418226882,11.128052085,-42,1.6764338206,4.0899204417,12.804485906
47,141,2008,983,711,1065,2831,118,272,1183,1402,71160,13.951375978,10.090974893,15.115173363,-53,1.6747328233,3.8604010843,16.789906187
47,143,2001,401,283,32,912,12,118,44,134,28566,14.070669146,9.9301729885,1.1228464157,-28,0.4210674059,4.1404961578,1.5439138215
47,143,2002,365,304,190,956,11,61,201,239,28805,12.724198637,10.597688728,6.6235554548,-23,0.383469,2.1265099092,7.0070244549
47,143,2003,405,302,249,956,8,103,257,337,29142,13.978290507,10.423317859,8.5940600894,-23,0.2761143804,3.5549726474,8.8701744698
47,143,2004,394,331,116,956,9,63,125,165,29307,13.481838868,11.326113364,3.9692723571,-23,0.3079607863,2.1557255043,4.2772331434
47,143,2005,463,321,262,956,9,142,271,386,29693,15.694915254,10.881355932,8.8813559322,-27,0.3050847458,4.813559322,9.186440678
47,143,2006,403,366,330,956,9,37,339,361,30054,13.490217082,12.251661171,11.046579745,-15,0.3012703567,1.2385559108,11.347850101
47,143,2007,420,336,131,956,9,84,140,233,30287,13.920882982,11.136706385,4.3419896919,9,0.2983046353,2.7841765963,4.6402943272
47,143,2008,419,318,373,956,9,101,382,494,30781,13.722407808,10.414619768,12.215890483,11,0.2947533897,3.3077880396,12.510643872
47,145,2001,629,617,115,695,24,12,139,105,52048,12.097200719,11.866411516,2.2117298612,-46,0.4615784058,0.2307892029,2.6733082671
47,145,2002,545,595,126,695,23,-50,149,51,52099,10.465975976,11.426157258,2.4196568312,-48,0.4416833898,-0.960181282,2.861340221
47,145,2003,530,586,394,695,16,-56,410,311,52410,10.142667139,11.214345176,7.5400204767,-43,0.3061937249,-1.071678037,7.8462142016
47,145,2004,511,627,364,695,20,-116,384,223,52633,9.7293489333,11.937968261,6.9304951306,-45,0.3807964357,-2.208619327,7.3112915663
47,145,2005,501,685,147,695,19,-184,166,-64,52569,9.5245337541,13.022566111,2.7946236764,-46,0.3612098629,-3.498032357,3.1558335393
47,145,2006,545,555,484,695,21,-10,505,471,53040,10.321090059,10.510467858,9.1658854832,-24,0.3976933784,-0.189377799,9.5635788617
47,145,2007,516,660,372,695,14,-144,386,266,53306,9.7041731706,12.412314521,6.9960318207,24,0.2632915201,-2.70814135,7.2593233408
47,145,2008,538,621,164,695,16,-83,180,124,53430,10.080947384,11.636186479,3.0730025483,27,0.2998051267,-1.555239095,3.372807675
47,147,2001,832,494,675,516,142,338,817,1117,55943,15.022253519,8.9194630267,12.187525391,-38,2.5638942303,6.1027904919,14.751419621
47,147,2002,863,443,456,516,126,420,582,962,56905,15.294909967,7.8512689636,8.0816673756,-40,2.2330923011,7.4436410038,10.314759677
47,147,2003,870,504,474,516,103,366,577,886,57791,15.170537769,8.7884494664,8.2653274744,-57,1.7960521727,6.382088303,10.061379647
47,147,2004,941,550,509,516,111,391,620,958,58749,16.14896173,9.4388192895,8.7351982152,-53,1.9049253475,6.7101424404,10.640123563
47,147,2005,975,553,623,516,110,422,733,1098,59847,16.442375797,9.3257782725,10.506256535,-57,1.8550372694,7.1165975244,12.361293804
47,147,2006,1013,521,1161,516,114,492,1275,1735,61582,16.684646995,8.5811461842,19.122285451,-32,1.8776404319,8.1035008112,20.999925883
47,147,2007,1053,534,943,516,101,519,1044,1580,63162,16.882575515,8.5615340217,15.118963638,17,1.6193163599,8.321041493,16.738279997
47,147,2008,1064,547,1108,516,104,517,1212,1736,64898,16.617210682,8.5428705294,17.304388568,7,1.6242386381,8.0743401531,18.928627206
47,149,2001,2935,1179,4054,5797,357,1756,4411,6057,189626,15.729042458,6.3184126261,21.725907367,-110,1.9132089122,9.4106298316,23.63911628
47,149,2002,2957,1157,4270,5954,324,1800,4594,6313,195939,15.338529171,6.0015820938,22.149313345,-81,1.680650474,9.3369470777,23.829963819
47,149,2003,3059,1179,4372,5867,258,1880,4630,6519,202458,15.356541339,5.9187192675,21.947956435,9,1.2951904758,9.437822072,23.243146911
47,149,2004,3222,1281,6110,5858,282,1941,6392,8010,210468,15.605701748,6.204501533,29.593680224,-323,1.3658621642,9.4012002151,30.959542388
47,149,2005,3424,1212,6758,5884,279,2212,7037,9084,219552,15.924840705,5.6369471187,31.431096228,-165,1.2976140645,10.287893586,32.728710293
47,149,2006,3542,1293,8633,5915,292,2249,8925,11029,230581,15.737570896,5.7449687092,38.357552101,-145,1.2973943257,9.9926021865,39.654946427
47,149,2007,3761,1359,7624,5913,258,2402,7882,10296,240877,15.954761612,5.7650946638,32.342223485,12,1.0944771326,10.189666948,33.436700618
47,149,2008,3979,1403,5615,5913,264,2576,5879,8393,249270,16.235945543,5.7248131683,22.911493899,-62,1.0772278521,10.511132375,23.988721751
47,151,2001,304,193,182,200,4,111,186,278,21450,14.264933602,9.0563558726,8.5401905119,-19,0.1876964948,5.2085777298,8.7278870067
47,151,2002,348,193,-54,200,3,155,-51,84,21534,16.192071468,8.9800856133,-2.512562814,-20,0.139586823,7.2119858552,-2.372975991
47,151,2003,319,223,-144,200,2,96,-142,-69,21465,14.837554362,10.37233424,-6.697830182,-23,0.0930254192,4.4652201214,-6.604804763
47,151,2004,331,240,7,200,5,91,12,90,21555,15.388191539,11.157601116,0.3254300325,-13,0.2324500232,4.2305904231,0.5578800558
47,151,2005,325,224,52,200,4,101,56,137,21692,15.029944274,10.359100053,2.4047910838,-20,0.1849839295,4.6708442204,2.5897750133
47,151,2006,316,192,-18,200,4,124,-14,100,21792,14.534081501,8.8308343299,-0.827890718,-10,0.1839757152,5.7032471714,-0.643915003
47,151,2007,315,205,51,200,2,110,53,165,21957,14.40032915,9.3716427804,2.3314818624,2,0.0914306613,5.02868637,2.4229125237
47,151,2008,318,229,-18,200,4,89,-14,82,22039,14.455859624,10.410037276,-0.818256205,7,0.1818347122,4.0458223475,-0.636421493
47,153,2001,126,127,112,125,9,-1,121,111,11533,10.978000436,11.065127423,9.7582226095,-9,0.7841428883,-0.087126988,10.542365498
47,153,2002,156,96,166,125,9,60,175,229,11762,13.393432067,8.2421120412,14.251985405,-6,0.7726980039,5.1513200258,15.024683408
47,153,2003,157,93,204,125,8,64,212,270,12032,13.196604186,7.8170967471,17.147179961,-6,0.6724384299,5.3795074389,17.819618391
47,153,2004,173,104,259,125,6,69,265,318,12350,14.190796489,8.5308834386,21.245180871,-16,0.4921663522,5.6599130506,21.737347223
47,153,2005,143,131,333,125,8,12,341,344,12694,11.419900974,10.461587606,26.593195975,-9,0.638875579,0.9583133685,27.232071554
47,153,2006,167,113,285,125,7,54,292,339,13033,12.982469779,8.7845454192,22.155711898,-7,0.54417538,4.1979243596,22.699887278
47,153,2007,181,122,264,125,7,59,271,327,13360,13.715757966,9.2448755352,20.005304437,-3,0.5304436782,4.4708824309,20.535748115
47,153,2008,172,126,167,125,6,46,173,220,13580,12.769116555,9.3541202673,12.397921307,1,0.4454342984,3.414996288,12.843355605
47,155,2001,929,630,1198,637,53,299,1251,1501,73200,12.822724795,8.6957121857,16.535655871,-49,0.731544041,4.1270126088,17.267199912
47,155,2002,902,691,950,637,49,211,999,1165,74365,12.225121133,9.3653644157,12.875681903,-45,0.6641141192,2.8597567174,13.539796022
47,155,2003,977,676,924,637,38,301,962,1220,75585,13.031010337,9.0163387796,12.324108036,-43,0.5068356119,4.0146715572,12.830943648
47,155,2004,927,746,1533,637,43,181,1576,1659,77244,12.131205465,9.7625450667,20.061637516,-98,0.5627204261,2.3686603982,20.624357943
47,155,2005,1016,707,1991,637,41,309,2032,2275,79519,12.962242366,9.0199855833,25.401402117,-66,0.5230826152,3.9422567825,25.924484732
47,155,2006,1039,677,1746,637,44,362,1790,2108,81627,12.89513857,8.4023183945,21.669790128,-44,0.5460886401,4.4928201755,22.215878768
47,155,2007,1072,759,1506,637,41,313,1547,1886,83513,12.98292358,9.1922005571,18.23906988,26,0.4965483832,3.7907230229,18.735618263
47,155,2008,1078,790,940,637,43,288,983,1322,84835,12.806804952,9.3853208829,11.167343835,51,0.5108465797,3.4214840687,11.678190415
47,157,2001,14579,8067,-7893,19290,1845,6512,-6048,-288,897963,16.233032367,8.9822259486,-8.788485114,-752,2.0543209217,7.2508064184,-6.734164192
47,157,2002,14272,7858,-5686,18994,1619,6414,-4067,1566,899529,15.879903777,8.7432934333,-6.32659283,-781,1.8013988379,7.1366103437,-4.525193993
47,157,2003,14148,7790,-4400,19242,1214,6358,-3186,2056,901585,15.710277084,8.6502020416,-4.885865081,-1116,1.3480545929,7.0600750424,-3.537810488
47,157,2004,14328,7688,-6553,19080,1468,6640,-5085,819,902404,15.884797524,8.523333568,-7.265011039,-736,1.6275043806,7.3614639557,-5.637506659
47,157,2005,14236,7726,-5515,19101,1418,6510,-4097,1596,904000,15.761701148,8.5540111736,-6.106053795,-817,1.5699699514,7.2076899741,-4.536083844
47,157,2006,14879,7589,-2700,19203,1490,7290,-1210,5658,909658,16.407724058,8.3687222177,-2.977408089,-422,1.6430881677,8.0390018405,-1.334319921
47,157,2007,14802,7661,-9132,19178,1270,7141,-7862,-596,909062,16.277381895,8.4246063165,-10.0422275,125,1.3965866104,7.8527755784,-8.64564089
47,157,2008,14564,7735,-10533,19178,1306,6829,-9227,-2237,906825,16.040645701,8.5192525746,-11.60094213,161,1.4384154961,7.5213931263,-10.16252663
47,159,2001,236,194,131,148,8,42,139,167,17958,13.203166522,10.853450446,7.3288763322,-14,0.4475649669,2.349716076,7.7764412991
47,159,2002,205,173,108,148,7,32,115,132,18090,11.373723924,9.59831336,5.9920106525,-15,0.3883710608,1.7754105637,6.3803817133
47,159,2003,214,208,120,148,6,6,126,114,18204,11.792582796,11.461949634,6.6126632501,-18,0.3306331625,0.3306331625,6.9432964126
47,159,2004,218,197,38,148,9,21,47,55,18259,11.957326605,10.805474042,2.0843046376,-13,0.4936510984,1.1518525629,2.577955736
47,159,2005,222,228,215,148,8,-6,223,200,18459,12.092161882,12.418977068,11.710877499,-17,0.4357535813,-0.326815186,12.14663108
47,159,2006,220,198,96,148,9,22,105,119,18578,11.88001188,10.692010692,5.184005184,-8,0.486000486,1.188001188,5.67000567
47,159,2007,247,214,173,148,7,33,180,217,18795,13.218098627,11.452117839,9.2580204961,4,0.3746019854,1.7659807883,9.6326224815
47,159,2008,241,188,250,148,9,53,259,312,19107,12.717007018,9.9203208274,13.191915994,0,0.4749089758,2.7966861907,13.66682497
47,161,2001,156,135,99,100,-1,21,98,108,12555,12.47900168,10.799136069,7.9193664507,-11,-0.079993601,1.6798656108,7.8393728502
47,161,2002,152,154,144,100,-10,-2,134,125,12680,12.046760452,12.205270458,11.412720428,-7,-0.79255003,-0.158510006,10.620170398
47,161,2003,158,146,66,100,-27,12,39,40,12720,12.440944882,11.496062992,5.1968503937,-11,-2.125984252,0.9448818898,3.0708661417
47,161,2004,138,138,-48,100,12,0,-36,-46,12674,10.868709144,10.868709144,-3.780420572,-10,0.9451051429,0,-2.835315429
47,161,2005,150,150,216,100,-2,0,214,203,12877,11.741223435,11.741223435,16.907361747,-11,-0.156549646,0,16.750812101
47,161,2006,130,152,17,100,6,-22,23,-6,12871,10.097871679,11.806742271,1.3204909119,-7,0.466055616,-1.708870592,1.7865465279
47,161,2007,142,158,170,100,-2,-16,168,157,13028,10.96567435,12.201243291,13.127919997,5,-0.154446118,-1.235568941,12.973473879
47,161,2008,152,150,194,100,2,2,196,198,13226,11.579187933,11.426830197,14.778700389,0,0.152357736,0.152357736,14.931058124
47,163,2001,1767,1750,-485,2799,96,17,-389,-508,152411,11.574362166,11.463007238,-3.176890577,-136,0.6288278256,0.1113549275,-2.548062752
47,163,2002,1632,1749,341,2745,91,-117,432,181,152592,10.701534083,11.468739652,2.2360435799,-134,0.5967154421,-0.767205568,2.832759022
47,163,2003,1582,1832,174,2689,69,-250,243,-215,152377,10.374824982,12.014335883,1.1410995872,-208,0.4525050087,-1.639510901,1.5936045959
47,163,2004,1617,1888,-488,2689,82,-271,-406,-785,151592,10.639242818,12.422319381,-3.210853738,-108,0.5395287019,-1.783076564,-2.671325036
47,163,2005,1590,1758,605,2689,78,-168,683,367,151959,10.475999091,11.582897108,3.9861505974,-148,0.5139169365,-1.106898017,4.500067534
47,163,2006,1704,1859,560,2689,80,-155,640,414,152373,11.198296597,12.216920994,3.68019137,-71,0.5257416243,-1.018624397,4.2059329942
47,163,2007,1674,1837,1008,2689,71,-163,1079,984,153357,10.950838976,12.017139306,6.5940535767,68,0.4644621071,-1.06630033,7.0585156838
47,163,2008,1663,1839,547,2689,74,-176,621,543,153900,10.824814406,11.970435173,3.5605372701,98,0.4816814588,-1.145620767,4.0422187289
47,165,2001,1806,1033,1614,1391,168,773,1782,2454,133610,13.64223503,7.8031167144,12.191897751,-101,1.2690451191,5.8391183158,13.46094287
47,165,2002,1786,1091,1607,1391,160,695,1767,2370,135980,13.24974962,8.0937720242,11.921807189,-92,1.1869876479,5.1559775956,13.108794837
47,165,2003,1777,1134,1267,1391,132,643,1399,1930,137910,12.976012268,8.28069663,9.2518894447,-112,0.963890613,4.6953156377,10.215780058
47,165,2004,1912,1173,2166,1391,141,739,2307,2892,140802,13.720256035,8.417290967,15.542926031,-154,1.0117971239,5.3029650679,16.554723155
47,165,2005,1844,1117,2173,1391,140,727,2313,2925,143727,12.961771911,7.8515722475,15.274365706,-115,0.9840824661,5.1101996633,16.258448172
47,165,2006,1976,1177,3720,1391,142,799,3862,4576,148303,13.532856213,8.0608156696,25.476834572,-85,0.9725028251,5.4720405438,26.449337397
47,165,2007,2074,1171,3055,1391,128,903,3183,4108,152411,13.793837334,7.7881309151,20.318309091,22,0.8513072221,6.0057064187,21.169616313
47,165,2008,2141,1223,1991,1391,131,918,2122,3063,155474,13.907790246,7.9445247414,12.933400458,23,0.8509670819,5.963265505,13.78436754
47,167,2001,706,437,725,889,15,269,740,975,52511,13.570790124,8.4000499774,13.936009688,-34,0.2883312349,5.1707401463,14.224340923
47,167,2002,734,481,330,889,0,253,330,540,53051,13.906519391,9.1131278301,6.2522498626,-43,0,4.7933915614,6.2522498626
47,167,2003,664,468,388,889,-34,196,354,498,53549,12.457786116,8.7804878049,7.2795497186,-52,-0.637898687,3.6772983114,6.6416510319
47,167,2004,748,482,95,889,33,266,128,358,53907,13.921977367,8.9711137582,1.7681655747,-36,0.6142048839,4.9508636093,2.3823704586
47,167,2005,741,486,1028,889,9,255,1037,1243,55150,13.589223984,8.9127703861,18.85252666,-49,0.1650513034,4.6764535977,19.017577964
47,167,2006,734,514,1008,889,22,220,1030,1221,56371,13.16344007,9.2179948171,18.077312793,-29,0.3945445252,3.9454452525,18.471857318
47,167,2007,800,493,913,889,8,307,921,1251,57622,14.035949576,8.6496539261,16.018527453,23,0.1403594958,5.3862956497,16.158886949
47,167,2008,814,539,778,889,15,275,793,1084,58706,13.994910941,9.2669004883,13.375971391,16,0.2578914793,4.7280104532,13.633862871
47,169,2001,92,88,-29,164,12,4,-17,-20,7287,12.607921063,12.059750582,-3.974235987,-7,1.6445114431,0.548170481,-2.329724544
47,169,2002,84,82,-8,164,11,2,3,-2,7285,11.528959649,11.254460609,-1.097996157,-7,1.5097447159,0.2744990393,0.4117485589
47,169,2003,78,90,-12,164,7,-12,-5,-28,7257,10.727547793,12.377939761,-1.650391968,-11,0.9627286481,-1.650391968,-0.68766332
47,169,2004,94,92,28,164,6,2,34,31,7288,12.925403919,12.650395325,3.8501203163,-5,0.8250257821,0.275008594,4.6751460983
47,169,2005,93,96,127,164,7,-3,134,126,7414,12.651339954,13.059447694,17.276561012,-5,0.9522513944,-0.40810774,18.228812406
47,169,2006,92,96,99,164,6,-4,105,97,7511,12.328308208,12.864321608,13.266331658,-4,0.8040201005,-0.5360134,14.070351759
47,169,2007,89,76,167,164,7,13,174,188,7699,11.702827087,9.993425378,21.959237344,1,0.9204470743,1.7094017094,22.879684418
47,169,2008,90,85,110,164,6,5,116,123,7822,11.597190903,10.952902519,14.174344437,2,0.7731460602,0.6442883835,14.947490497
47,171,2001,177,240,-24,292,-1,-63,-25,-108,17557,10.050536596,13.627846232,-1.362784623,-20,-0.056782693,-3.577309636,-1.419567316
47,171,2002,184,249,136,292,-1,-65,135,54,17611,10.464058235,14.160600546,7.7343039126,-16,-0.056869882,-3.696542311,7.6774340309
47,171,2003,167,248,172,292,-2,-81,170,75,17686,9.4625605576,14.052185738,9.7458707539,-14,-0.113324079,-4.589625181,9.6325466754
47,171,2004,181,267,46,292,1,-86,47,-53,17633,10.249440811,15.119340865,2.6048302613,-14,0.0566267448,-4.869900054,2.6614570061
47,171,2005,194,239,-9,292,-1,-45,-10,-72,17561,11.024606467,13.581860544,-0.511450815,-17,-0.056827868,-2.557254077,-0.568278684
47,171,2006,173,258,153,292,0,-85,153,60,17621,9.8345744983,14.66659087,8.6976294696,-8,0,-4.832016372,8.6976294696
47,171,2007,194,253,116,292,-1,-59,115,62,17683,10.990256062,14.332653524,6.5714933152,6,-0.056650804,-3.342397462,6.5148425108
47,171,2008,182,255,92,292,1,-73,93,35,17718,10.282195418,14.406372701,5.1975932883,15,0.0564955792,-4.124177283,5.2540888675
47,173,2001,224,163,373,138,0,61,373,425,18284,12.395207924,9.0197271948,20.640234624,-9,0,3.3754807293,20.640234624
47,173,2002,243,161,57,138,-1,82,56,121,18405,13.246477146,8.7764725122,3.1071983428,-17,-0.054512252,4.4700046335,3.0526860912
47,173,2003,249,161,108,138,-2,88,106,178,18583,13.463826106,8.7055261166,5.8397318049,-16,-0.108143182,4.7582999892,5.7315886233
47,173,2004,234,158,-73,138,1,76,-72,-8,18575,12.59486517,8.5042252005,-3.929167339,-12,0.0538242101,4.0906399699,-3.875343129
47,173,2005,254,171,1,138,-1,83,0,70,18645,13.648576034,9.1886082751,0.0537345513,-13,-0.053734551,4.4599677593,0
47,173,2006,251,168,33,138,0,83,33,107,18752,13.423536647,8.9846779153,1.7648474477,-9,0,4.438858732,1.7648474477
47,173,2007,224,178,53,138,-1,46,52,86,18838,11.918063315,9.470603884,2.8198989093,-12,-0.05320564,2.4474594307,2.7666932695
47,173,2008,240,179,128,138,1,61,129,170,19008,12.682978386,9.4593880463,6.7642551392,-20,0.0528457433,3.2235903398,6.8171008825
47,175,2001,49,55,-26,78,0,-6,-26,-41,5470,8.9245059648,10.017302614,-4.735452145,-9,0,-1.092796649,-4.735452145
47,175,2002,63,49,13,78,-1,14,12,22,5492,11.494252874,8.9399744572,2.371829958,-4,-0.182448458,2.5542784163,2.1893814997
47,175,2003,55,59,-94,78,-1,-4,-95,-100,5392,10.106578464,10.841602352,-17.27306137,-1,-0.183755972,-0.735023888,-17.45681735
47,175,2004,56,49,-16,78,0,7,-16,-14,5378,10.399257196,9.0993500464,-2.971216342,-5,0,1.2999071495,-2.971216342
47,175,2005,61,73,9,78,0,-12,9,-8,5370,11.350949014,13.58392259,1.6747301824,-5,0,-2.232973576,1.6747301824
47,175,2006,53,53,-18,78,0,0,-18,-20,5350,9.8880597015,9.8880597015,-3.358208955,-2,0,0,-3.358208955
47,175,2007,63,54,54,78,0,9,54,63,5413,11.706773204,10.034377032,10.034377032,0,0,1.6723961721,10.034377032
47,175,2008,62,58,63,78,0,4,63,68,5481,11.382412337,10.648063154,11.565999633,1,0,0.734349183,11.565999633
47,177,2001,541,380,16,723,118,161,134,255,38651,14.043376121,9.8641089205,0.4153309019,-40,3.0630654016,4.1792672005,3.4783963036
47,177,2002,610,404,-305,723,112,206,-193,-19,38632,15.786136667,10.455080678,-7.893068333,-32,2.8984382076,5.331055989,-4.994630126
47,177,2003,561,407,147,723,97,154,244,348,38980,14.456527341,10.488068855,3.7880740092,-50,2.4996134618,3.9684584858,6.287687471
47,177,2004,499,441,-41,723,88,58,47,77,39057,12.78880531,11.302330946,-1.050783603,-28,2.2553404154,1.4864743647,1.2045568128
47,177,2005,539,446,-10,723,93,93,83,139,39196,13.775829681,11.398924003,-0.255581256,-37,2.3769056777,2.3769056777,2.1213244221
47,177,2006,555,462,28,723,101,93,129,203,39399,14.123035817,11.756473058,0.7125135187,-19,2.5701380495,2.3665627584,3.2826515682
47,177,2007,547,434,41,723,89,113,130,247,39646,13.840217598,10.981086723,1.0373837687,4,2.2518818395,2.8591308748,3.2892656082
47,177,2008,534,433,-18,723,89,101,71,196,39842,13.435990338,10.894726248,-0.452898551,24,2.239331723,2.5412640902,1.7864331723
47,179,2001,1279,1124,3,3644,108,155,111,154,107650,11.88960055,10.448718545,0.0278880388,-112,1.0039693975,1.4408820057,1.0318574363
47,179,2002,1263,1144,1473,4170,98,119,1571,1627,109277,11.64447026,10.547326981,13.580605457,-63,0.9035297589,1.0971432786,14.484135216
47,179,2003,1326,1155,731,4009,79,171,810,866,110143,12.086409625,10.52775499,6.6630206909,-115,0.7200802115,1.5586546349,7.3831009024
47,179,2004,1375,1216,788,3970,95,159,883,950,111093,12.430165073,10.992785984,7.1236146016,-92,0.858811405,1.4373790884,7.9824260066
47,179,2005,1318,1179,1370,3961,91,139,1461,1512,112605,11.783744155,10.540997237,12.248656671,-88,0.813596903,1.2427469177,13.062253574
47,179,2006,1359,1190,1826,3927,97,169,1923,2031,114636,11.960869737,10.473462095,16.071043518,-61,0.8537191792,1.4874076421,16.924762697
47,179,2007,1380,1212,1614,3931,85,168,1699,1834,116470,11.942571807,10.4886935,13.967616592,-33,0.735593191,1.4538783069,14.703209783
47,179,2008,1447,1188,1834,3931,88,259,1922,2169,118639,12.309184251,10.105950857,15.601274303,-12,0.7485889524,2.2032333939,16.349863255
47,181,2001,173,175,205,2360,7,-2,212,198,17031,10.217339948,10.335459485,12.10725254,-12,0.4134183794,-0.118119537,12.520670919
47,181,2002,159,174,-36,2336,7,-15,-29,-61,16970,9.3526660981,10.234993088,-2.117584777,-17,0.4117525955,-0.88232699,-1.705832181
47,181,2003,155,173,-84,2344,3,-18,-81,-121,16849,9.1664448978,10.230935273,-4.967621751,-22,0.1774150625,-1.064490375,-4.790206689
47,181,2004,173,182,-67,2304,4,-9,-63,-83,16766,10.293023948,10.828499182,-3.986315633,-11,0.237988993,-0.535475234,-3.74832664
47,181,2005,167,190,-31,2304,4,-23,-27,-66,16700,9.9802784916,11.354807865,-1.852626546,-16,0.2390485866,-1.374529373,-1.61357796
47,181,2006,174,182,-15,2304,5,-8,-10,-26,16674,10.42727872,10.906693834,-0.898903338,-8,0.299634446,-0.479415114,-0.599268892
47,181,2007,174,199,-34,2304,1,-25,-33,-54,16620,10.452333754,11.954105845,-2.042410044,4,0.0600708836,-1.501772091,-1.98233916
47,181,2008,175,177,-6,2304,1,-2,-5,-6,16614,10.531383523,10.651742192,-0.361076006,1,0.0601793344,-0.120358669,-0.300896672
47,183,2001,407,360,-619,2098,44,47,-575,-550,34345,11.756210283,10.398613518,-17.87983824,-22,1.2709416522,1.3575967649,-16.60889659
47,183,2002,384,384,-168,2079,43,0,-125,-154,34191,11.205789658,11.205789658,-4.902532975,-29,1.2548149877,0,-3.647717988
47,183,2003,348,381,-239,1972,36,-33,-203,-270,33921,10.218463707,11.187455955,-7.017852948,-34,1.0570824524,-0.968992248,-5.960770496
47,183,2004,341,333,-421,1972,39,8,-382,-407,33514,10.113442574,9.8761770594,-12.48609772,-33,1.1566693853,0.2372655149,-11.32942834
47,183,2005,356,383,12,1972,38,-27,50,-9,33505,10.623852937,11.429594593,0.3581074024,-32,1.1340067742,-0.805741655,1.4921141766
47,183,2006,358,396,-228,1972,41,-38,-187,-238,33267,10.723057569,11.86125921,-6.829209848,-13,1.2280596657,-1.138201641,-5.601150183
47,183,2007,340,356,-116,1972,38,-16,-78,-93,33174,10.234644271,10.716274589,-3.49181981,1,1.1438720067,-0.481630319,-2.347947803
47,183,2008,363,356,152,1972,40,7,192,201,33375,10.909254835,10.698883529,4.5680626305,2,1.2021217449,0.2103713054,5.7701843754
47,185,2001,320,297,266,305,5,23,271,276,23408,13.751611517,12.763214439,11.431027073,-18,0.21486893,0.9883970778,11.645896003
47,185,2002,268,283,172,305,4,-15,176,143,23551,11.414212398,12.05306757,7.3255393002,-18,0.1703613791,-0.638855172,7.4959006793
47,185,2003,295,328,109,305,4,-33,113,54,23605,12.511663415,13.911273221,4.6229536008,-26,0.1696496734,-1.399609806,4.7926032742
47,185,2004,304,315,305,305,4,-11,309,273,23878,12.804582693,13.267906409,12.846703031,-25,0.1684813512,-0.463323716,13.015184382
47,185,2005,319,313,376,305,5,6,381,367,24245,13.257693826,13.008332814,15.626623444,-20,0.2078008437,0.2493610124,15.834424288
47,185,2006,295,249,199,305,5,46,204,237,24482,12.108276725,10.220206456,8.1679561639,-13,0.2052250292,1.8880702691,8.3731811932
47,185,2007,325,303,326,305,4,22,330,365,24847,13.1768331,12.28486286,13.217377202,13,0.1621764074,0.8919702406,13.379553609
47,185,2008,335,322,247,305,4,13,251,282,25129,13.406435089,12.886185369,9.8847446774,18,0.1600768369,0.5202497199,10.044821514
47,187,2001,1702,701,2941,991,248,1001,3189,4109,132194,13.078273699,5.3865275339,22.598826644,-81,1.9056474014,7.6917461647,24.504474045
47,187,2002,1682,686,2867,991,229,996,3096,4040,136234,12.532224656,5.1112402581,21.361407901,-52,1.7062303485,7.4209843981,23.067638249
47,187,2003,1758,681,3139,991,204,1077,3343,4427,140661,12.697954098,4.9188320482,22.672854331,7,1.4734827281,7.7791220499,24.146337059
47,187,2004,1944,728,3918,991,191,1216,4109,5114,145775,13.573712801,5.083159938,27.356896479,-211,1.3336312475,8.4905528635,28.690527727
47,187,2005,1935,825,4906,991,197,1110,5103,6096,151871,13.002022537,5.5434979808,32.965334659,-117,1.3237201239,7.458524556,34.289054783
47,187,2006,2139,843,5598,991,196,1296,5794,6995,158866,13.767269427,5.4258102511,36.030469497,-95,1.2615169742,8.3414591761,37.291986471
47,187,2007,2187,857,5253,991,183,1330,5436,6824,165690,13.47687302,5.2810608955,32.370376761,58,1.1276944503,8.1958121249,33.498071211
47,187,2008,2358,880,4068,991,185,1478,4253,5762,171452,13.988171156,5.2203522551,24.132264743,31,1.0974604173,8.7678189012,25.22972516
47,189,2001,1289,703,1205,1263,51,586,1256,1776,91042,14.297757171,7.7977682632,13.366018147,-66,0.5656986933,6.4999889079,13.93171684
47,189,2002,1254,740,1456,1304,46,514,1502,1964,93006,13.626879944,8.0413805094,15.821959489,-52,0.4998695992,5.5854994349,16.321829088
47,189,2003,1250,754,1317,1304,33,496,1350,1788,94794,13.312034079,8.0298189563,14.025559105,-58,0.3514376997,5.2822151225,14.376996805
47,189,2004,1293,780,1717,1304,43,513,1760,2160,96954,13.486450967,8.1356780775,17.908922127,-113,0.4485053299,5.3507728894,18.357427457
47,189,2005,1327,755,2198,1304,42,572,2240,2735,99689,13.496539414,7.6788901715,22.355232579,-77,0.4271700493,5.8176492425,22.782402628
47,189,2006,1308,765,2824,1304,46,543,2870,3354,103043,12.90373498,7.5469092201,27.859440049,-59,0.4538010773,5.3568257601,28.313241126
47,189,2007,1480,779,2396,1304,37,701,2433,3134,106177,14.147787018,7.4467068158,22.904120065,0,0.3536946755,6.7010802027,23.25781474
47,189,2008,1522,839,2908,1304,39,683,2947,3626,109803,14.093897583,7.7692378924,26.928419298,-4,0.3611445504,6.3246596907,27.289563849
48,0,2001,365067,152907,40485,568051,126719,212160,167204,387879,21333928,17.269025477,7.2330692138,1.9150909188,8515,5.9942795144,10.035956264,7.9093704332
48,0,2002,368001,155417,45853,572575,114685,212584,160538,379469,21713397,17.097508382,7.2207506506,2.1303530475,6347,5.3283217947,9.8767577312,7.4586748422
48,0,2003,375677,152305,30039,581815,88348,223372,118387,348722,22062119,17.163795396,6.9584559552,1.3724110071,6963,4.0364115868,10.205339441,5.4088225939
48,0,2004,380621,155068,32414,588935,103002,225553,135416,362765,22424884,17.111559527,6.9713844288,1.4572345995,1796,4.6306558345,10.140175098,6.087890434
48,0,2005,384023,155202,53582,595247,100037,228821,153619,386244,22811128,16.978640823,6.8618780984,2.3689975146,3804,4.4228920976,10.116762724,6.7918896122
48,0,2006,391606,155369,219742,594660,103881,236237,323623,556406,23367534,16.960474082,6.7290386196,9.517036245,-3454,4.4990909438,10.231435463,14.016127189
48,0,2007,402233,158040,138088,597202,89945,244193,228033,475898,23843432,17.039812318,6.695054704,5.8498273473,3672,3.8103435545,10.344757614,9.6601709018
48,0,2008,412757,161298,140862,597202,92249,251459,233111,483542,24326974,17.137368533,6.696974902,5.8484871396,-1028,3.8301109607,10.440393631,9.6785981003
48,1,2001,648,595,-1049,13647,65,53,-984,-958,54102,11.872263242,10.901229366,-19.21914219,-27,1.190890603,0.9710338763,-18.02825159
48,1,2002,700,591,137,13486,63,109,200,255,54357,12.908103523,10.898127403,2.5263002609,-54,1.1617293171,2.00997612,3.688029578
48,1,2003,640,592,1102,14674,54,48,1156,1206,55563,11.644832606,10.77147016,20.050946143,2,0.9825327511,0.8733624454,21.033478894
48,1,2004,660,613,-56,14802,48,47,-8,-1,55562,11.878515186,11.032620922,-1.007874016,-40,0.8638920135,0.8458942632,-0.143982002
48,1,2005,666,567,354,14872,51,99,405,458,56020,11.93740926,10.162929505,6.3451094263,-46,0.9141259343,1.7744797548,7.2592353605
48,1,2006,659,602,253,14820,50,57,303,334,56354,11.72869169,10.714222151,4.5028209372,-26,0.8898855607,1.0144695392,5.3927064979
48,1,2007,677,569,228,14903,43,108,271,362,56716,11.974882816,10.064561776,4.0328999735,-17,0.7605907845,1.9103210401,4.7934907579
48,1,2008,684,608,-6,14903,42,76,36,122,56838,12.047131761,10.708561565,-0.105676594,10,0.7397361608,1.3385701957,0.6340595664
48,3,2001,206,94,-272,31,16,112,-256,-152,12761,16.047363091,7.3225831581,-21.18875127,-8,1.2463971333,8.724779933,-19.94235413
48,3,2002,204,116,18,31,16,88,34,109,12870,15.918224026,9.0515391518,1.4045491787,-13,1.2484881589,6.8666848738,2.6530373376
48,3,2003,206,106,-185,63,12,100,-173,-81,12789,16.056744222,8.2622081921,-14.41989166,-8,0.9353443236,7.7945360302,-13.48454733
48,3,2004,199,117,-112,63,11,82,-101,-31,12758,15.579128665,9.15958821,-8.768152816,-12,0.8611578659,6.4195404548,-7.90699495
48,3,2005,214,111,-167,92,12,103,-155,-62,12696,16.814646028,8.7216154632,-13.12170975,-10,0.9428773474,8.0930305649,-12.1788324
48,3,2006,203,133,71,88,11,70,82,145,12841,15.898500215,10.416258762,5.5605591886,-7,0.8614950856,5.4822414536,6.4220542742
48,3,2007,247,111,135,93,12,136,147,279,13120,19.028542814,8.5512884712,10.400215708,-4,0.9244636185,10.477254343,11.324679327
48,3,2008,241,110,399,93,11,131,410,525,13645,18.008593312,8.2196898935,29.815056977,-16,0.8219689894,9.7889034186,30.637025967
48,5,2001,1261,844,-805,2573,181,417,-624,-279,79950,15.744885409,10.538210377,-10.05125516,-72,2.2599716567,5.2066750323,-7.791283502
48,5,2002,1286,750,-378,2655,168,536,-210,258,80208,16.059141598,9.3657513206,-4.720338666,-68,2.0979282958,6.6933902771,-2.62241037
48,5,2003,1288,785,-175,2681,147,503,-28,367,80575,16.021594323,9.7647139312,-2.176847055,-108,1.828551526,6.2568803916,-0.348295529
48,5,2004,1321,770,-339,2718,136,551,-203,284,80859,16.365821326,9.5395022114,-4.199858766,-64,1.6848990919,6.8263191149,-2.514959674
48,5,2005,1269,767,-365,2699,141,502,-224,206,81065,15.674019911,9.4735801981,-4.508287839,-72,1.7415577678,6.2004397125,-2.766730071
48,5,2006,1386,780,336,2706,142,606,478,1042,82107,16.988208761,9.5604638051,4.1183536391,-42,1.7404946927,7.4277449562,5.8588483318
48,5,2007,1321,763,-236,2638,124,558,-112,463,82570,16.043527633,9.2666249689,-2.866216897,17,1.5059783698,6.776902664,-1.360238528
48,5,2008,1355,773,-287,2638,126,582,-161,468,83038,16.363943771,9.3352978117,-3.466016134,47,1.52166562,7.0286459591,-1.944350514
48,7,2001,258,289,-12,261,37,-31,25,-26,22514,11.452923159,12.829049585,-0.5326941,-20,1.6424734763,-1.376126426,1.1097793759
48,7,2002,256,257,462,280,33,-1,495,486,23000,11.249285934,11.293228457,20.301445709,-8,1.4501032649,-0.043942523,21.751548974
48,7,2003,243,244,360,306,18,-1,378,371,23371,10.480688361,10.523818766,15.52694572,-6,0.776347286,-0.043130405,16.303293006
48,7,2004,263,281,367,356,36,-18,403,359,23730,11.167491136,11.931806119,15.583533258,-26,1.5286299654,-0.764314983,17.112163224
48,7,2005,268,287,653,369,31,-19,684,650,24380,11.141134899,11.930991478,27.146123467,-15,1.2887133652,-0.789856579,28.434836832
48,7,2006,282,272,-13,378,33,10,20,16,24396,11.563063802,11.153026078,-0.533049041,-14,1.3531244875,0.4100377235,0.8200754469
48,7,2007,267,307,161,284,28,-40,189,153,24549,10.910205333,12.544693023,6.5788129533,4,1.1441413832,-1.63448769,7.7229543365
48,7,2008,281,283,336,284,31,-2,367,351,24900,11.365245,11.446136423,13.589759146,-14,1.253817064,-0.080891423,14.84357621
48,9,2001,84,83,-117,61,0,1,-117,-123,8794,9.4856303992,9.3727062278,-13.21212806,-7,0,0.1129241714,-13.21212806
48,9,2002,91,67,66,64,0,24,66,83,8877,10.299360534,7.583045668,7.469865882,-7,0,2.7163148662,7.469865882
48,9,2003,97,67,35,64,-2,30,33,53,8930,10.894592014,7.5251305666,3.9310383557,-10,-0.224630763,3.3694614477,3.7064075925
48,9,2004,126,74,5,66,2,52,7,51,8981,14.069566188,8.2630785551,0.5583161186,-8,0.2233264474,5.8064876333,0.781642566
48,9,2005,107,80,-45,66,0,27,-45,-24,8957,11.929981046,8.9196119969,-5.017281748,-6,0,3.0103690489,-5.017281748
48,9,2006,82,81,3,58,1,1,4,1,8958,9.1543399386,9.0427016467,0.3349148758,-4,0.1116382919,0.1116382919,0.4465531677
48,9,2007,100,71,-30,60,0,29,-30,-4,8954,11.165698973,7.9276462707,-3.349709692,-3,0,3.2380527021,-3.349709692
48,9,2008,117,83,132,60,2,34,134,165,9119,12.947490732,9.1849720578,14.607425441,-3,0.2213246279,3.7625186743,14.828750069
48,11,2001,17,23,-9,83,1,-6,-8,-16,2150,7.8776645042,10.658016682,-4.170528267,-2,0.4633920297,-2.780352178,-3.707136237
48,11,2002,26,27,-78,81,1,-1,-77,-78,2072,12.316437707,12.79014685,-36.94931312,0,0.4737091426,-0.473709143,-36.47560398
48,11,2003,19,28,-9,80,1,-9,-8,-19,2053,9.2121212121,13.575757576,-4.363636364,-2,0.4848484848,-4.363636364,-3.878787879
48,11,2004,24,29,49,81,0,-5,49,41,2094,11.574632264,13.986013986,23.631540873,-3,0,-2.411381722,23.631540873
48,11,2005,27,27,31,80,1,0,32,31,2125,12.799241526,12.799241526,14.695425456,-1,0.4740459825,0,15.169471439
48,11,2006,21,23,-28,79,0,-2,-28,-31,2094,9.9549656317,10.903057597,-13.27328751,-1,0,-0.948091965,-13.27328751
48,11,2007,26,17,-29,82,1,9,-28,-18,2076,12.470023981,8.1534772182,-13.9088729,1,0.479616307,4.3165467626,-13.42925659
48,11,2008,24,20,42,82,0,4,42,47,2123,11.431293165,9.5260776375,20.004763039,1,0,1.9052155275,20.004763039
48,13,2001,672,301,618,348,37,371,655,997,39871,17.067750333,7.6449298368,15.696234682,-29,0.9397422059,9.4228204965,16.635976887
48,13,2002,642,321,618,395,36,321,654,949,40820,15.912555304,7.9562776518,15.317693423,-26,0.8922928208,7.9562776518,16.209986244
48,13,2003,650,309,163,391,28,341,191,477,41297,15.831070302,7.5258472667,3.9699453219,-55,0.6819537976,8.3052230354,4.6518991195
48,13,2004,680,322,418,386,35,358,453,772,42069,16.313605067,7.7249718111,10.028068997,-39,0.839670849,8.5886332558,10.867739846
48,13,2005,650,299,30,451,32,351,62,375,42444,15.382248885,7.075834487,0.7099499485,-38,0.7572799451,8.3064143978,1.4672298936
48,13,2006,651,304,146,422,34,347,180,506,42950,15.246972855,7.119938169,3.419443989,-21,0.7963088742,8.1270346863,4.2157528632
48,13,2007,679,346,173,430,31,333,204,527,43477,15.712682379,8.0067571477,4.0033785738,-10,0.717368415,7.7059252317,4.7207469888
48,13,2008,712,338,-13,430,33,374,20,400,43877,16.301485908,7.7386267372,-0.29763949,6,0.7555463974,8.5628591707,0.4579069075
48,15,2001,330,298,369,277,65,32,434,443,24185,13.77094331,12.43557911,15.398418428,-23,2.7124585307,1.3353641997,18.110876959
48,15,2002,353,281,276,287,60,72,336,386,24571,14.480269095,11.526786447,11.321683485,-22,2.4612355402,2.9534826483,13.782919025
48,15,2003,359,286,348,305,51,73,399,448,25019,14.47872555,11.534583585,14.035087719,-24,2.0568663037,2.9441419641,16.091954023
48,15,2004,330,284,414,321,49,46,463,482,25501,13.064133017,11.243072051,16.389548694,-27,1.9398258116,1.821060966,18.329374505
48,15,2005,332,294,176,318,51,38,227,243,25744,12.957361694,11.474290175,6.8689628256,-22,1.9904380915,1.4830715192,8.8594009172
48,15,2006,335,259,204,306,51,76,255,318,26062,12.932864919,9.998841833,7.8755356522,-13,1.9688839131,2.9340230861,9.8444195653
48,15,2007,362,277,308,281,47,85,355,448,26510,13.771589439,10.537928936,11.717263943,8,1.7880240432,3.2336605037,13.505287986
48,15,2008,372,262,175,281,47,110,222,341,26851,13.94276719,9.8199059238,6.5590974682,9,1.7615861772,4.1228612657,8.3206836454
48,17,2001,136,55,-133,61,11,81,-122,-44,6539,20.728547478,8.3828684652,-20.27130011,-3,1.676573693,12.345679012,-18.59472641
48,17,2002,126,65,-158,54,11,61,-147,-89,6450,19.401031642,10.008468704,-24.32827777,-3,1.6937408576,9.3925629379,-22.63453692
48,17,2003,104,73,18,61,10,31,28,53,6503,16.058056049,11.271520111,2.7792789315,-6,1.5440438508,4.7865359376,4.3233227824
48,17,2004,133,57,-24,66,11,76,-13,57,6560,20.362856924,8.7269386818,-3.674500498,-6,1.6841460614,11.635918242,-1.990354436
48,17,2005,141,73,-97,55,11,68,-86,-21,6539,21.528360944,11.145888999,-14.81029086,-3,1.6795175204,10.382471944,-13.13077334
48,17,2006,114,68,-160,58,11,46,-149,-105,6434,17.574963385,10.483311493,-24.66661528,-2,1.6958298004,7.0916518924,-22.97078548
48,17,2007,118,47,-214,58,11,71,-203,-140,6294,18.541797612,7.385292269,-33.62664991,-8,1.7284726587,11.156505343,-31.89817725
48,17,2008,131,51,-90,58,11,80,-79,-15,6279,20.838304303,8.1126222859,-14.31639227,-16,1.7497812773,12.725682017,-12.56661099
48,19,2001,197,164,345,192,20,33,365,389,18201,10.940493711,9.1078221753,19.159747869,-9,1.1107100214,1.8326715353,20.27045789
48,19,2002,182,161,501,195,18,21,519,536,18737,9.8543505333,8.7173100872,27.126536358,-4,0.9746060967,1.1370404462,28.101142455
48,19,2003,205,159,330,196,7,46,337,385,19122,10.829657413,8.3995879447,17.433107055,2,0.36979318,2.4300694683,17.802900235
48,19,2004,202,145,121,197,18,57,139,178,19300,10.514809224,7.5477590964,6.2984748321,-18,0.9369631982,2.9670501275,7.2354380303
48,19,2005,175,171,188,195,14,4,202,191,19491,9.0227114537,8.816478049,9.6929700188,-15,0.7218169163,0.2062334047,10.414786935
48,19,2006,158,176,161,192,16,-18,177,150,19641,8.0752325463,8.9951957477,8.2285597465,-9,0.817745068,-0.919963201,9.0463048145
48,19,2007,191,177,443,197,11,14,454,471,20112,9.6093376601,8.9049883028,22.287626091,3,0.5534173521,0.7043493573,22.841043443
48,19,2008,207,169,153,197,13,38,166,191,20303,10.243721391,8.3632314735,7.5714462452,-13,0.643325498,1.8804899171,8.2147717432
48,21,2001,891,458,2381,2029,161,433,2542,2972,61258,14.906645252,7.6624506458,39.834705213,-3,2.6935688951,7.2441946062,42.528274108
48,21,2002,942,445,1857,2048,157,497,2014,2493,63751,15.070914894,7.1194873969,29.70986089,-18,2.511819149,7.9514274972,32.221680039
48,21,2003,931,500,1773,2070,135,431,1908,2377,66128,14.336420822,7.6994741259,27.302335251,38,2.078858014,6.6369466965,29.381193265
48,21,2004,852,518,1019,2064,126,334,1145,1408,67536,12.748384008,7.7507780704,15.247186976,-71,1.8853243955,4.9976059373,17.132511372
48,21,2005,919,467,686,2068,135,452,821,1215,68751,13.486245937,6.8531848232,10.066990982,-58,1.9811133857,6.6330611137,12.048104368
48,21,2006,941,511,1019,2085,132,430,1151,1542,70293,13.535283795,7.3501913063,14.657230805,-39,1.8986795547,6.1850924887,16.555910359
48,21,2007,951,482,1246,2113,119,469,1365,1834,72127,13.35486589,6.7687122595,17.49754248,0,1.6711136076,6.5861536301,19.168656088
48,21,2008,958,546,834,2113,121,412,955,1364,73491,13.157714019,7.4990729168,11.454627862,-3,1.6618824596,5.6586411021,13.116510322
48,23,2001,38,67,-111,41,3,-29,-108,-139,3941,9.4751277896,16.706146366,-27.67734696,-2,0.7480364044,-7.231018576,-26.92931056
48,23,2002,43,78,-4,47,3,-35,-1,-40,3901,10.966590156,19.892884468,-1.020147921,-4,0.7651109411,-8.926294313,-0.25503698
48,23,2003,56,73,46,41,2,-17,48,29,3930,14.30213255,18.64385136,11.748180309,-2,0.5107904482,-4.34171881,12.258970757
48,23,2004,50,65,18,58,1,-15,19,1,3931,12.721027859,16.537336217,4.5795700293,-3,0.2544205572,-3.816308358,4.8339905864
48,23,2005,52,67,-64,52,2,-15,-62,-79,3852,13.362456636,17.217011435,-16.44610048,-2,0.5139406399,-3.854554799,-15.93215984
48,23,2006,49,54,-29,56,1,-5,-28,-34,3818,12.777053455,14.08083442,-7.561929596,-1,0.260756193,-1.303780965,-7.301173403
48,23,2007,56,49,22,65,2,7,24,30,3848,14.609966084,12.783720324,5.739629533,-1,0.521784503,1.8262457605,6.261414036
48,23,2008,58,58,-111,65,1,0,-110,-111,3737,15.293342123,15.293342123,-29.26829268,-1,0.2636783125,0,-29.00461437
48,25,2001,425,227,-621,7213,5,198,-616,-433,31818,13.266946573,7.0861102873,-19.38535017,-15,0.1560817244,6.1808362859,-19.22926844
48,25,2002,371,239,50,7508,4,132,54,155,31973,11.631734884,7.4932200467,1.5676192566,-31,0.1254095405,4.1385148375,1.6930287972
48,25,2003,389,221,704,8303,3,168,707,884,32857,12.000616998,6.817831251,21.718340275,9,0.0925497455,5.1827857473,21.81089002
48,25,2004,341,221,-312,8349,6,120,-306,-214,32643,10.41221374,6.7480916031,-9.526717557,-28,0.1832061069,3.6641221374,-9.34351145
48,25,2005,385,229,-323,8322,4,156,-319,-192,32451,11.829047224,7.0359787384,-9.924109749,-29,0.1228991919,4.7930684856,-9.801210557
48,25,2006,401,229,-145,8199,5,172,-140,18,32469,12.353666051,7.0548367221,-4.467036352,-14,0.1540357363,5.2988293284,-4.313000616
48,25,2007,421,209,-35,8151,4,212,-31,185,32654,12.929379789,6.4186232207,-1.074889056,4,0.1228444636,6.5107565683,-0.952044593
48,25,2008,387,237,-162,8151,6,150,-156,7,32661,11.850264105,7.2571384827,-4.960575672,13,0.1837250249,4.593125622,-4.776850647
48,27,2001,5462,1532,-1055,9187,239,3930,-816,3423,242546,22.679474909,6.3612148592,-4.380601616,309,0.9923827359,16.31826005,-3.388218881
48,27,2002,5466,1628,2312,9396,-1010,3838,1302,5412,247958,22.287280022,6.6380702298,9.4270383116,272,-4.118213103,15.649209792,5.3088252084
48,27,2003,5613,1648,5111,9472,-3718,3965,1393,5884,253842,22.371462734,6.5683539259,20.370665604,526,-14.81865285,15.803108808,5.5520127541
48,27,2004,5356,1585,-4215,9458,2114,3771,-2101,1613,255455,21.032913997,6.224265998,-16.55222787,-57,8.3016393185,14.808647999,-8.250588556
48,27,2005,5248,1689,2435,9517,167,3559,2602,6165,261620,20.298796113,6.5329014166,9.4183629067,4,0.6459411111,13.765894696,10.064304018
48,27,2006,5960,1727,-1088,9582,1223,4233,135,4368,265988,22.592530818,6.546526967,-4.124274082,0,4.6360176495,16.046003851,0.5117435672
48,27,2007,5797,1695,7501,9582,22,4102,7523,11785,277773,21.321867512,6.2343566383,27.589326929,160,0.0809179033,15.087510873,27.670244832
48,27,2008,5890,1789,2598,9582,540,4101,3138,7311,285084,20.928939322,6.3568544053,9.2314744242,72,1.9187822129,14.572084917,11.150256637
48,29,2001,24049,10161,-73,34158,4386,13888,4313,16803,1414634,17.101723933,7.2256899197,-0.051911757,-1398,3.1189721472,9.8760340129,3.0670603901
48,29,2002,24085,10216,9883,34673,2849,13869,12732,25458,1440092,16.873773525,7.1572543214,6.9239569752,-1143,1.9959884066,9.7165192036,8.9199453818
48,29,2003,24884,10360,9822,34881,-460,14524,9362,22458,1462550,17.145758933,7.1383243266,6.7676275614,-1428,-0.316952625,10.007434606,6.4506749368
48,29,2004,25405,10478,6670,35724,5283,14927,11953,25714,1488264,17.218977543,7.1017692067,4.5207864677,-1166,3.5807068829,10.117208336,8.1014933506
48,29,2005,25520,10535,7447,35763,3423,14985,10870,24390,1512654,17.008128846,7.0211848508,4.9631479434,-1465,2.2813019216,9.9869439951,7.244449865
48,29,2006,26211,10514,19381,35895,4452,15697,23833,38708,1551362,17.108918491,6.8628884444,12.650717229,-822,2.905990047,10.246030047,15.556707276
48,29,2007,26990,10813,19338,36567,2915,16177,22253,38784,1590146,17.182830666,6.8839550942,12.311284899,354,1.8557966429,10.298875572,14.167081542
48,29,2008,28018,11011,11941,36567,3458,17007,15399,32753,1622899,17.440154122,6.8539345076,7.4328246259,347,2.1524752999,10.586219614,9.5852999258
48,31,2001,105,110,171,156,17,-5,188,176,8632,12.289325843,12.874531835,20.014044944,-7,1.9897003745,-0.585205993,22.003745318
48,31,2002,111,88,37,160,17,23,54,66,8698,12.810155799,10.155799192,4.2700519331,-11,1.961915753,2.654356607,6.2319676861
48,31,2003,97,84,8,157,12,13,20,27,8725,11.134706996,9.6424266774,0.9183263502,-6,1.3774895253,1.4922803191,2.2958158756
48,31,2004,83,119,163,155,11,-36,174,125,8850,9.4452347084,13.541963016,18.549075391,-13,1.2517780939,-4.096728307,19.800853485
48,31,2005,131,78,31,152,12,53,43,92,8942,14.725719424,8.7679856115,3.4847122302,-4,1.3489208633,5.9577338129,4.8336330935
48,31,2006,116,110,35,158,11,6,46,48,8990,12.93776489,12.268570154,3.9036359581,-4,1.2268570154,0.6691947357,5.1304929735
48,31,2007,114,69,-20,128,7,45,-13,11,9001,12.673003168,7.6705019176,-2.223333889,-21,0.7781668612,5.0025012506,-1.445167028
48,31,2008,116,95,68,128,6,21,74,81,9082,12.82972958,10.507106122,7.5208759608,-14,0.6636067024,2.3226234585,8.1844826633
48,33,2001,4,3,-39,0,2,1,-37,-38,677,5.7471264368,4.3103448276,-56.03448276,-2,2.8735632184,1.4367816092,-53.16091954
48,33,2002,2,5,7,0,2,-3,9,6,683,2.9411764706,7.3529411765,10.294117647,0,2.9411764706,-4.411764706,13.235294118
48,33,2003,4,4,-20,0,1,0,-19,-21,662,5.9479553903,5.9479553903,-29.73977695,-2,1.4869888476,0,-28.2527881
48,33,2004,3,4,6,0,0,-1,6,4,666,4.5180722892,6.0240963855,9.0361445783,-1,0,-1.506024096,9.0361445783
48,33,2005,2,1,-37,0,1,1,-36,-34,632,3.0816640986,1.5408320493,-57.01078582,1,1.5408320493,1.5408320493,-55.46995378
48,33,2006,5,3,-6,0,0,2,-6,-4,628,7.9365079365,4.7619047619,-9.523809524,0,0,3.1746031746,-9.523809524
48,33,2007,0,3,-41,0,1,-3,-40,-44,584,0,4.9504950495,-67.65676568,-1,1.6501650165,-4.95049505,-66.00660066
48,33,2008,2,0,10,0,0,2,10,9,593,3.3984706882,0,16.992353441,-3,0,3.3984706882,16.992353441
48,35,2001,206,272,147,561,35,-66,182,101,17338,11.916124367,15.733911786,8.5032537961,-15,2.0245842372,-3.817787419,10.527838033
48,35,2002,235,259,97,504,34,-24,131,93,17431,13.517788835,14.898328971,5.579683051,-14,1.9557651931,-1.380540136,7.5354482441
48,35,2003,181,256,190,519,22,-75,212,122,17553,10.347587469,14.635261834,10.862108392,-15,1.2577178139,-4.287674365,12.119826206
48,35,2004,210,253,216,502,21,-43,237,177,17730,11.903749681,14.34118414,12.243856815,-17,1.1903749681,-2.437434459,13.434231783
48,35,2005,220,240,81,489,22,-20,103,66,17796,12.385295277,13.511231211,4.5600405337,-17,1.2385295277,-1.125935934,5.7985700614
48,35,2006,191,228,32,492,22,-37,54,8,17804,10.730337079,12.808988764,1.797752809,-9,1.2359550562,-2.078651685,3.0337078652
48,35,2007,213,240,26,474,17,-27,43,19,17823,11.957223454,13.472927836,1.4595671822,3,0.9543323884,-1.515704382,2.4138995706
48,35,2008,226,237,-72,474,18,-11,-54,-63,17760,12.702695107,13.320967878,-4.046876317,2,1.0117190793,-0.618272771,-3.035157238
48,37,2001,1193,1038,-145,6855,55,155,-90,-18,89230,13.368594449,11.631685698,-1.624850122,-83,0.6163224599,1.7369087507,-1.008527662
48,37,2002,1119,977,-139,6827,49,142,-90,-31,89199,12.542804141,10.951134625,-1.558042695,-83,0.5492380723,1.5916695156,-1.008804623
48,37,2003,1139,1016,89,6827,30,123,119,110,89309,12.761332825,11.383243328,0.9971541892,-132,0.3361193896,1.3780894974,1.3332735788
48,37,2004,1134,1007,247,6850,45,127,292,357,89666,12.672160916,11.252968292,2.7601620338,-62,0.5028635284,1.4191926247,3.2630255622
48,37,2005,1121,979,182,6807,42,142,224,287,89953,12.481975738,10.900851246,2.0265116719,-79,0.4676565397,1.5811244913,2.4941682116
48,37,2006,1233,925,870,6863,45,308,915,1176,91129,13.618139848,10.216366066,9.6089064623,-47,0.4970124032,3.401773782,10.105918865
48,37,2007,1186,960,41,6813,34,226,75,310,91439,12.992419263,10.51662942,0.4491477148,9,0.3724639586,2.4757898427,0.8216116735
48,37,2008,1193,981,593,6813,37,212,630,844,92283,12.987012987,10.679178324,6.4554054495,2,0.4027824648,2.3078346632,6.8581879143
48,39,2001,4112,1600,2134,11027,757,2512,2891,5209,248339,16.733507098,6.5110922561,8.6841692965,-194,3.0805605237,10.222414842,11.76472982
48,39,2002,4156,1767,3978,11172,711,2389,4689,6958,255297,16.503983035,7.0169725754,15.797123319,-120,2.8234677426,9.4870104599,18.620591062
48,39,2003,4358,1717,2780,11153,620,2641,3400,5852,261149,16.876885483,6.6492915039,10.765888399,-189,2.4010254702,10.227593979,13.166913869
48,39,2004,4333,1728,3875,11113,578,2605,4453,6774,267923,16.379623189,6.5321922158,14.648289836,-284,2.1849578129,9.8474309735,16.833247649
48,39,2005,4327,1812,3324,10748,601,2515,3925,6199,274122,15.965464122,6.6857917701,12.264664373,-241,2.217528065,9.2796723519,14.482192438
48,39,2006,4598,1809,6350,10845,605,2789,6955,9582,283704,16.485427355,6.4858934506,22.766956004,-162,2.1691351784,9.9995339048,24.936091183
48,39,2007,4825,1852,5760,10459,547,2973,6307,9387,293091,16.730380811,6.4216922824,19.97243388,107,1.8966877313,10.308688529,21.869121612
48,39,2008,4982,1976,4314,10459,550,3006,4864,7953,301044,16.770599275,6.6516869062,14.521952082,83,1.8514310721,10.118912368,16.373383154
48,41,2001,2223,769,-1199,13322,1198,1454,-1,1318,154220,14.476331881,5.0077819238,-7.807972076,-135,7.8014600061,9.4685499573,-0.00651207
48,41,2002,2208,713,253,13734,1111,1495,1364,2697,156917,14.193104645,4.5831900417,1.6262932406,-162,7.1415485783,9.6099146035,8.7678418189
48,41,2003,2310,788,399,13149,947,1522,1346,2633,159550,14.598678535,4.979982115,2.5215899288,-235,5.984826222,9.6186964202,8.5064161508
48,41,2004,2328,806,-666,12815,923,1522,257,1654,161204,14.515797153,5.0256582926,-4.152715165,-125,5.7551893351,9.4901388603,1.6024741702
48,41,2005,2438,785,-55,13005,946,1653,891,2404,163608,15.011760649,4.8335652624,-0.338657439,-140,5.8249079468,10.178195387,5.486250508
48,41,2006,2454,824,1500,13015,952,1630,2452,3989,167597,14.818616869,4.9757702933,9.0578342718,-93,5.7487054845,9.8428465754,14.806539756
48,41,2007,2587,795,659,13724,858,1792,1517,3287,170884,15.28593924,4.6974571689,3.8938670117,-22,5.0697084918,10.588482071,8.9635755035
48,41,2008,2698,864,1552,13724,866,1834,2418,4238,175122,15.595105287,4.9941330497,8.9709427004,-14,5.0056935429,10.600972237,13.976636243
48,43,2001,109,74,10,479,34,35,44,70,8949,12.227956024,8.3015481265,1.1218308279,-9,3.8142248149,3.9264078977,4.9360556428
48,43,2002,116,85,91,493,34,31,125,149,9098,12.855322214,9.4198481742,10.084778634,-7,3.7679392697,3.43547404,13.852717903
48,43,2003,126,65,52,507,30,61,82,137,9235,13.745704467,7.0910380189,5.6728304151,-6,3.2727867779,6.6546664485,8.945617193
48,43,2004,134,84,-119,449,29,50,-90,-50,9185,14.549402823,9.1205211726,-12.92073833,-10,3.1487513572,5.4288816504,-9.771986971
48,43,2005,125,75,-203,457,30,50,-173,-131,9054,13.706891825,8.2241350951,-22.25999232,-8,3.2896540381,5.4827567301,-18.97033829
48,43,2006,119,78,8,515,29,41,37,73,9127,13.090589077,8.5803861174,0.8800396018,-5,3.1901435565,4.5102029591,4.0701831582
48,43,2007,120,52,15,520,25,68,40,111,9238,13.06833651,5.6629458209,1.6335420637,3,2.7225701062,7.4053906888,4.3561121699
48,43,2008,121,71,17,520,24,50,41,93,9331,13.032473477,7.6471538586,1.8310086704,2,2.584953417,5.3853196187,4.4159620873
48,45,2001,26,12,-67,0,2,14,-65,-52,1724,14.857142857,6.8571428571,-38.28571429,-1,1.1428571429,8,-37.14285714
48,45,2002,18,23,-33,0,2,-5,-31,-38,1686,10.557184751,13.48973607,-19.35483871,-2,1.1730205279,-2.93255132,-18.18181818
48,45,2003,22,17,-9,0,1,5,-8,-6,1680,13.071895425,10.101010101,-5.347593583,-3,0.5941770648,2.9708853238,-4.753416518
48,45,2004,18,20,-12,0,0,-2,-12,-14,1666,10.759115362,11.954572624,-7.172743574,0,0,-1.195457262,-7.172743574
48,45,2005,13,21,-54,0,1,-8,-53,-62,1604,7.9510703364,12.844036697,-33.02752294,-1,0.6116207951,-4.892966361,-32.41590214
48,45,2006,17,14,-44,0,0,3,-44,-42,1562,10.739102969,8.843967151,-27.79532533,-1,0,1.8951358181,-27.79532533
48,45,2007,18,12,-93,0,1,6,-92,-89,1473,11.861614498,7.9077429984,-61.28500824,-3,0.6589785832,3.9538714992,-60.62602965
48,45,2008,14,12,-8,0,0,2,-8,-11,1462,9.5400340716,8.1771720613,-5.451448041,-5,0,1.3628620102,-5.451448041
48,47,2001,127,76,-331,51,5,51,-326,-277,7670,16.264327336,9.7329832874,-42.38970353,-2,0.6403278479,6.5313440482,-41.74937568
48,47,2002,129,76,-45,53,5,53,-40,5,7675,16.813294233,9.9055066797,-5.865102639,-8,0.651678071,6.9077875529,-5.213424568
48,47,2003,130,67,-92,47,3,63,-89,-34,7641,16.975711674,8.749020632,-12.01358057,-8,0.3917471925,8.226691042,-11.62183338
48,47,2004,144,66,-99,47,2,78,-97,-26,7615,18.877818563,8.6523335081,-12.97850026,-7,0.2621919245,10.225485055,-12.71630834
48,47,2005,121,53,-95,45,3,68,-92,-29,7586,15.920005263,6.9732254457,-12.49917769,-5,0.3947108743,8.9467798171,-12.10446681
48,47,2006,153,80,-83,39,2,73,-81,-13,7573,20.186028102,10.554785936,-10.95059041,-5,0.2638696484,9.6312421664,-10.68672076
48,47,2007,148,73,-108,44,3,75,-105,-30,7543,19.581899974,9.6586398518,-14.28949458,0,0.3969304049,9.9232601217,-13.89256417
48,47,2008,149,63,-77,44,2,86,-75,6,7549,19.745560562,8.3487940631,-10.20408163,-5,0.2650410814,11.396766499,-9.939040551
48,49,2001,501,478,-107,2123,27,23,-80,-92,37618,13.301826678,12.691163976,-2.840909091,-35,0.7168649108,0.6106627018,-2.12404418
48,49,2002,497,479,175,2263,25,18,200,185,37803,13.179353231,12.70203259,4.6406173347,-33,0.6629453335,0.4773206401,5.3035626682
48,49,2003,468,503,-120,2015,17,-35,-103,-186,37617,12.410501193,13.338636966,-3.182179793,-48,0.450808804,-0.928135773,-2.731370989
48,49,2004,532,454,264,2255,26,78,290,335,37952,14.079847557,12.015509005,6.9869920205,-33,0.6881128505,2.0643385515,7.675104871
48,49,2005,491,503,261,2267,23,-12,284,241,38193,12.896447567,13.211635695,6.8553417821,-31,0.6041105785,-0.315188128,7.4594523606
48,49,2006,489,441,232,2255,25,48,257,285,38478,12.755800759,11.503697617,6.051831853,-20,0.6521370531,1.252103142,6.7039689061
48,49,2007,495,465,-275,1977,17,30,-258,-217,38261,12.900871786,12.119000769,-7.167150992,11,0.4430602432,0.7818710173,-6.724090749
48,49,2008,499,457,52,1977,19,42,71,118,38379,13.021920668,11.925887265,1.356993737,5,0.4958246347,1.0960334029,1.8528183716
48,51,2001,218,159,19,115,12,59,31,74,16607,13.156306578,9.5956547978,1.1466505733,-16,0.7242003621,3.5606517803,1.8708509354
48,51,2002,215,153,-108,111,12,62,-96,-51,16556,12.966257576,9.2271507403,-6.513282875,-17,0.7236980973,3.7391068359,-5.789584778
48,51,2003,211,169,99,125,10,42,109,134,16690,12.693256332,10.166636588,5.9556036816,-17,0.6015761295,2.5266197437,6.5571798111
48,51,2004,236,158,-50,121,9,78,-41,23,16713,14.130467323,9.4602281232,-2.993743077,-14,0.5388737539,4.6702392001,-2.454869323
48,51,2005,239,159,49,124,10,80,59,125,16838,14.246967304,9.4781079551,2.9209263509,-14,0.5961074186,4.7688593485,3.5170337695
48,51,2006,206,163,-296,126,9,43,-287,-250,16588,12.325734458,9.7528869742,-17.71076408,-6,0.5385029618,2.572847484,-17.17226111
48,51,2007,224,162,-95,126,10,62,-85,-26,16562,13.514328808,9.7737556561,-5.731523379,-3,0.6033182504,3.7405731523,-5.128205128
48,51,2008,226,151,-24,126,9,75,-15,48,16610,13.625949596,9.1040636682,-1.447003497,-12,0.5426263113,4.5218859279,-0.904377186
48,53,2001,486,389,1299,914,75,97,1374,1449,35972,13.78821193,11.036243705,36.853677566,-22,2.127810483,2.7519682247,38.981488049
48,53,2002,499,400,1190,940,73,99,1263,1312,37284,13.623457464,10.920607186,32.488806378,-50,1.9930108114,2.7028502785,34.481817189
48,53,2003,459,409,1053,976,51,50,1104,1127,38411,12.127617412,10.806526191,27.822181122,-27,1.3475130458,1.3210912213,29.169694167
48,53,2004,483,399,1341,1110,55,84,1396,1422,39833,12.345994581,10.198865089,34.277388682,-58,1.4058585962,2.1471294924,35.683247278
48,53,2005,501,409,956,1117,54,92,1010,1085,40918,12.408515065,10.129905512,23.677725353,-17,1.3374447375,2.2786095528,25.015170091
48,53,2006,519,413,1289,1096,56,106,1345,1421,42339,12.467420157,9.9210877163,30.964363357,-30,1.3452322327,2.5463324405,32.30959559
48,53,2007,520,434,1176,1093,51,86,1227,1248,43587,12.103437842,10.10171543,27.372390196,-65,1.1870679422,2.0017224123,28.559458138
48,53,2008,559,498,902,1093,53,61,955,901,44488,12.693726937,11.308543855,20.482543287,-115,1.2035197275,1.3851830826,21.686063014
48,55,2001,535,300,956,1695,51,235,1007,1234,33705,16.169003868,9.0667311412,28.892649903,-8,1.541344294,7.1022727273,30.433994197
48,55,2002,499,293,739,1671,50,206,789,987,34692,14.591283243,8.5676272351,21.609134904,-8,1.4620524292,6.0236560083,23.071187333
48,55,2003,536,259,267,1685,33,277,300,539,35231,15.331149979,7.4081489639,7.6369720979,-38,0.9438954278,7.9230010154,8.5808675257
48,55,2004,539,299,579,1688,36,240,615,813,36044,15.124517713,8.390038583,16.246930901,-42,1.0101718695,6.7344791301,17.257102771
48,55,2005,559,266,-174,1698,34,293,-140,123,36167,15.482405728,7.367298611,-4.81921037,-30,0.9416847849,8.1151071166,-3.877525585
48,55,2006,541,289,-234,1670,36,252,-198,39,36206,14.950326779,7.9864037694,-6.466499938,-15,0.9948461443,6.96392301,-5.471653794
48,55,2007,519,273,128,1677,32,246,160,394,36600,14.257066725,7.4993819191,3.5161937203,-12,0.8790484301,6.7576848062,4.3952421504
48,55,2008,543,272,-10,1677,34,271,24,299,36899,14.775711234,7.4014612444,-0.272112546,4,0.9251826555,7.3742499898,0.6530701098
48,57,2001,318,163,-242,167,93,155,-149,-11,20648,15.396906093,7.8921248215,-11.71714237,-17,4.5028687632,7.5047812719,-7.21427361
48,57,2002,337,184,-525,196,90,153,-435,-284,20364,16.434214376,8.972983517,-25.60226275,-2,4.388959329,7.4612308593,-21.21330342
48,57,2003,340,179,-300,196,78,161,-222,-74,20290,16.726521376,8.8060215477,-14.75869533,-13,3.8372607861,7.9204998278,-10.92143455
48,57,2004,306,169,-169,206,76,137,-93,25,20315,15.072035464,8.3240980175,-8.324098017,-19,3.743381357,6.7479374461,-4.580716661
48,57,2005,275,210,-200,213,76,65,-124,-76,20239,13.562164028,10.356561622,-9.863392021,-17,3.7480889678,3.2056024067,-6.115303053
48,57,2006,282,187,-127,208,78,95,-49,37,20276,13.920770085,9.2311489572,-6.269282982,-9,3.8504257682,4.689621128,-2.418857213
48,57,2007,310,180,-209,202,67,130,-142,-19,20257,15.296178423,8.8816519873,-10.31258481,-7,3.3059482397,6.4145264353,-7.006636568
48,57,2008,305,187,-25,202,69,118,44,149,20406,15.001352581,9.1975505988,-1.229619064,-13,3.3937486167,5.8038019821,2.1641295527
48,59,2001,145,159,-182,113,5,-14,-177,-200,12717,11.313099789,12.405399079,-14.19989077,-9,0.3901068893,-1.09229929,-13.80978388
48,59,2002,130,136,102,139,4,-6,106,85,12802,10.18848701,10.658724872,7.9940436537,-15,0.313491908,-0.470237862,8.3075355617
48,59,2003,116,142,122,114,-2,-26,120,87,12889,9.0303997509,11.054454867,9.4974893932,-7,-0.155696547,-2.024055117,9.3417928457
48,59,2004,147,154,236,112,6,-7,242,218,13107,11.30943222,11.847976612,18.156639483,-17,0.4616094784,-0.538544391,18.618248961
48,59,2005,129,132,115,106,3,-3,118,104,13211,9.8031765332,10.031157383,8.7392659017,-11,0.2279808496,-0.22798085,8.9672467513
48,59,2006,159,140,60,106,5,19,65,77,13288,12.000452847,10.566436469,4.5284727726,-7,0.377372731,1.434016378,4.9058455036
48,59,2007,156,159,153,84,3,-3,156,158,13446,11.670531907,11.894965213,11.446098601,5,0.2244333059,-0.224433306,11.670531907
48,59,2008,164,136,47,84,5,28,52,87,13533,12.157604062,10.081915564,3.4841914081,7,0.3706586604,2.0756884985,3.8548500686
48,61,2001,8369,1882,-2445,4222,2184,6487,-261,5933,342449,24.652228024,5.5437320039,-7.202138549,-293,6.4333213052,19.10849602,-0.768817244
48,61,2002,8453,2135,-585,4165,2052,6318,1467,7419,349868,24.419449472,6.1676948565,-1.689977279,-366,5.9279203024,18.251754615,4.2379430232
48,61,2003,8692,2004,-216,4198,1790,6688,1574,7727,357595,24.572309789,5.6653139457,-0.610632641,-535,5.0603353108,18.906995843,4.44970267
48,61,2004,8634,2030,-809,4234,1657,6604,848,7214,364809,23.903522129,5.6201239196,-2.239743966,-238,4.587460756,18.283398209,2.3477167901
48,61,2005,8734,2010,-1404,4253,1728,6724,324,6683,371492,23.723993313,5.4597236728,-3.81365773,-365,4.6937325903,18.26426964,0.8800748607
48,61,2006,8613,2039,-1424,4258,1733,6574,309,6689,378181,22.978018416,5.4397050447,-3.798989693,-194,4.6233491135,17.538313371,0.8243594207
48,61,2007,8766,2191,-1463,4276,1571,6575,108,6724,384905,22.975129933,5.7424720149,-3.834430195,41,4.1174913444,17.232657918,0.2830611491
48,61,2008,9123,2298,-664,4276,1576,6825,912,7831,392736,23.463269041,5.9101822049,-1.707728888,94,4.0532842276,17.553086836,2.3455553398
48,63,2001,165,153,-223,174,75,12,-148,-143,11451,14.319809069,13.27836841,-19.35343892,-7,6.5090041224,1.0414406596,-12.8444348
48,63,2002,191,144,78,179,73,47,151,185,11636,16.546108199,12.474552779,6.7570494218,-13,6.3239052281,4.0715554208,13.08095465
48,63,2003,190,130,-63,164,62,60,-1,47,11683,16.295724516,11.149706248,-5.403319182,-12,5.3175522106,5.1460182684,-0.085766971
48,63,2004,195,147,66,160,56,48,122,160,11843,16.577403724,12.496812038,5.610813568,-10,4.7606903001,4.0805916858,10.371503868
48,63,2005,202,125,179,157,59,77,238,303,12146,16.841052149,10.421443161,14.923506607,-12,4.9189211722,6.4196089875,19.842427779
48,63,2006,201,138,-48,141,58,63,10,67,12213,16.503140523,11.330514389,-3.941048483,-6,4.7621002504,5.1726261341,0.8210517673
48,63,2007,203,128,103,138,52,75,155,232,12445,16.465244545,10.382026117,8.3542866413,2,4.2176981101,6.0832184281,12.571984751
48,63,2008,228,127,68,138,51,101,119,221,12666,18.159372387,10.115089005,5.4159531679,1,4.061964876,8.0442833818,9.4779180439
48,65,2001,83,58,-149,98,8,25,-141,-119,6386,12.877201148,8.9985261035,-23.11690327,-3,1.2411760143,3.8786750446,-21.87572725
48,65,2002,73,70,107,95,7,3,114,113,6499,11.331005045,10.865347303,16.608459449,-4,1.0865347303,0.4656577416,17.694994179
48,65,2003,75,65,-144,95,1,10,-143,-132,6367,11.658635162,10.104150474,-22.38457951,1,0.1554484688,1.5544846883,-22.22913104
48,65,2004,76,57,-41,95,2,19,-39,-26,6341,11.960969468,8.970727101,-6.452628266,-6,0.3147623544,2.990242367,-6.137865911
48,65,2005,77,67,41,93,2,10,43,47,6388,12.09835808,10.527142745,6.4419828738,-6,0.314243067,1.5712153351,6.7562259408
48,65,2006,60,56,-44,93,2,4,-42,-41,6347,9.4228504122,8.7946603848,-6.910090302,-3,0.3140950137,0.6281900275,-6.595995289
48,65,2007,73,60,-45,93,1,13,-44,-30,6317,11.528742893,9.4756790903,-7.106759318,1,0.1579279848,2.0530638029,-6.948831333
48,65,2008,78,67,-83,93,2,11,-81,-66,6251,12.41247613,10.661998727,-13.20814768,4,0.3182686187,1.7504774029,-12.88987906
48,67,2001,324,384,-318,487,10,-60,-308,-390,30015,10.724925521,12.71102284,-10.52631579,-22,0.3310162198,-1.986097319,-10.19529957
48,67,2002,351,403,-74,457,9,-52,-65,-144,29871,11.722272317,13.458905253,-2.471362255,-27,0.3005710851,-1.736632936,-2.17079117
48,67,2003,383,390,-156,461,6,-7,-150,-189,29682,12.862492234,13.097576948,-5.239030779,-32,0.2015011838,-0.235084714,-5.037529595
48,67,2004,329,373,-66,459,7,-44,-59,-125,29557,11.107547393,12.593055251,-2.228261787,-22,0.2363307956,-1.485507858,-1.991930991
48,67,2005,317,419,24,435,7,-102,31,-100,29457,10.743213475,14.200020334,0.8133663199,-29,0.2372318433,-3.456806859,1.0505981631
48,67,2006,348,378,-69,453,7,-30,-62,-104,29353,11.834721986,12.85495664,-2.346539704,-12,0.2380547526,-1.020234654,-2.108484952
48,67,2007,355,368,-32,431,4,-13,-28,-42,29311,12.102822856,12.546024819,-1.09095868,-1,0.136369835,-0.443201964,-0.954588845
48,67,2008,347,390,-13,431,5,-43,-8,-27,29284,11.844013994,13.311716017,-0.443723867,24,0.1706630259,-1.467702022,-0.273060841
48,69,2001,143,67,-259,56,21,76,-238,-163,8057,17.570805431,8.2324752719,-31.8240462,-1,2.5803280703,9.3383301591,-29.24371813
48,69,2002,115,66,-223,59,20,49,-203,-156,7901,14.412833688,8.2717132473,-27.94836446,-2,2.5065797719,6.1411204412,-25.44178468
48,69,2003,126,75,-203,60,16,51,-187,-134,7767,16.083737554,9.5736533061,-25.91268828,2,2.042379372,6.5100842481,-23.87030891
48,69,2004,144,63,-253,50,15,81,-238,-169,7598,18.743898471,8.2004555809,-32.93198829,-12,1.952489424,10.54344289,-30.97949886
48,69,2005,136,58,-210,54,16,78,-194,-121,7477,18.043117745,7.6948590381,-27.86069652,-5,2.1227197347,10.348258706,-25.73797678
48,69,2006,134,65,-249,57,15,69,-234,-167,7310,18.124027862,8.7915060526,-33.67823088,-2,2.0288090891,9.3325218097,-31.64942179
48,69,2007,121,44,-213,57,16,77,-197,-125,7185,16.695412211,6.0710589859,-29.38944464,-5,2.207657813,10.624353225,-27.18178682
48,69,2008,126,58,-133,57,15,68,-118,-56,7129,17.605141819,8.1039541707,-18.58320525,-6,2.0958502166,9.5011876485,-16.48735504
48,71,2001,279,180,248,249,61,99,309,386,26551,10.585021625,6.8290462099,9.4089081114,-22,2.3142878822,3.7559754154,11.723195994
48,71,2002,334,215,247,273,59,119,306,406,26957,12.484114525,8.0361815056,9.2322643343,-19,2.2052777155,4.4479330194,11.43754205
48,71,2003,358,194,74,260,46,164,120,250,27207,13.219112326,7.1634295842,2.7324422125,-34,1.6985451591,6.0556827413,4.4309873717
48,71,2004,343,206,291,268,45,137,336,447,27654,12.504329123,7.5098886276,10.608629081,-26,1.6405096517,4.9944404951,12.249138732
48,71,2005,356,203,172,274,46,153,218,346,28000,12.793330219,7.2950731304,6.1810471844,-25,1.6530707586,5.4982570884,7.834117943
48,71,2006,408,194,57,281,46,214,103,302,28302,14.493268445,6.8914070548,2.0247948563,-15,1.6340449718,7.6018613904,3.6588398281
48,71,2007,406,185,183,280,36,221,219,438,28740,14.235124996,6.4864485817,6.4163248133,-2,1.2622278321,7.7486764139,7.6785526454
48,71,2008,383,188,389,280,37,195,426,616,29356,13.185072983,6.4720462682,13.391627651,-5,1.2737537868,6.7130267144,14.665381438
48,73,2001,692,535,-302,2747,211,157,-91,24,46721,14.815131987,11.453895395,-6.465563382,-42,4.5173307071,3.3612365925,-1.948232675
48,73,2002,763,562,-406,2593,200,201,-206,-43,46678,16.338504695,12.03439009,-8.693883232,-38,4.2827010996,4.3041146051,-4.411182133
48,73,2003,736,522,132,2679,167,214,299,457,47135,15.690789123,11.128521633,2.8141089188,-56,3.5602741624,4.5622674896,6.3743830812
48,73,2004,735,532,-54,2794,149,203,95,266,47401,15.549631886,11.254971651,-1.142421935,-32,3.1522383008,4.2946602353,2.0098163663
48,73,2005,776,516,-178,2739,162,260,-16,201,47602,16.336326221,10.862814858,-3.747250087,-43,3.4104186184,5.4735113628,-0.336831468
48,73,2006,745,441,-275,2775,162,304,-113,167,47769,15.623197827,9.2480942844,-5.766952218,-24,3.3972591249,6.375103543,-2.369693093
48,73,2007,741,462,-120,2863,140,279,20,287,48056,15.465692669,9.6425776154,-2.504565614,-12,2.9219932168,5.8231150535,0.4174276024
48,73,2008,768,476,-170,2863,142,292,-28,265,48321,15.937412453,9.8778754267,-3.527812652,1,2.9467611567,6.0595370265,-0.581051496
48,75,2001,89,102,-83,1747,13,-13,-70,-88,7602,11.640073241,13.340308658,-10.8553492,-5,1.7002354172,-1.700235417,-9.155113785
48,75,2002,107,108,-59,1741,12,-1,-47,-54,7548,14.125412541,14.257425743,-7.788778878,-6,1.5841584158,-0.132013201,-6.204620462
48,75,2003,72,75,21,1874,9,-3,30,18,7566,9.5275903136,9.9245732434,2.7788805081,-9,1.1909487892,-0.39698293,3.9698292973
48,75,2004,78,55,2,1916,7,23,9,27,7593,10.290916287,7.2564153308,0.2638696484,-5,0.9235437694,3.0345009565,1.1874134178
48,75,2005,77,83,-111,1885,8,-6,-103,-115,7478,10.218300046,11.014531219,-14.73027669,-6,1.0616415633,-0.796231172,-13.66863513
48,75,2006,84,81,32,1872,7,3,39,40,7518,11.202987463,10.802880768,4.2678047479,-2,0.9335822886,0.4001066951,5.2013870365
48,75,2007,90,74,-23,1862,8,16,-15,0,7518,11.971268955,9.8430433626,-3.059324288,-1,1.064112796,2.1282255919,-1.995211492
48,75,2008,84,78,2,1862,7,6,9,18,7536,11.159824631,10.362694301,0.2657101103,3,0.9299853859,0.7971303308,1.1956954962
48,77,2001,86,103,106,94,2,-17,108,80,11156,7.7365958978,9.2659229939,9.5358042461,-11,0.1799208348,-1.529327096,9.715725081
48,77,2002,90,102,188,90,0,-12,188,169,11325,8.0067612651,9.0743294337,16.725234643,-7,0,-1.067568169,16.725234643
48,77,2003,96,107,19,94,-7,-11,12,-12,11313,8.4813146038,9.4531319021,1.6785935153,-13,-0.61842919,-0.971817298,1.0601643255
48,77,2004,96,90,11,94,4,6,15,13,11326,8.4809399708,7.9508812227,0.9717743717,-8,0.3533724988,0.5300587482,1.3251468704
48,77,2005,109,115,55,92,0,-6,55,43,11369,9.6056400088,10.134390835,4.8468825733,-6,0,-0.528750826,4.8468825733
48,77,2006,96,112,-131,85,2,-16,-129,-150,11219,8.5000885426,9.9167699664,-11.59907916,-5,0.177085178,-1.416681424,-11.42199398
48,77,2007,108,94,-103,89,-1,14,-104,-108,11111,9.6730855352,8.4191670399,-9.225257501,-18,-0.089565607,1.2539184953,-9.314823108
48,77,2008,110,103,-204,89,1,7,-203,-223,10888,10.000454566,9.3640620028,-18.54629756,-27,0.0909132233,0.6363925633,-18.45538434
48,79,2001,52,46,-63,75,10,6,-53,-49,3657,14.124677441,12.494906967,-17.11258998,-2,2.7162841233,1.629770474,-14.39630585
48,79,2002,55,41,-188,75,10,14,-178,-166,3491,15.388919978,11.471740347,-52.60212647,-2,2.7979854505,3.9171796307,-49.80414102
48,79,2003,57,34,-80,75,7,23,-73,-52,3439,16.45021645,9.8124098124,-23.08802309,-2,2.0202020202,6.6378066378,-21.06782107
48,79,2004,62,40,-148,75,6,22,-142,-126,3313,18.36492891,11.848341232,-43.83886256,-6,1.7772511848,6.5165876777,-42.06161137
48,79,2005,58,42,-76,75,7,16,-69,-52,3261,17.645269242,12.777608762,-23.12138728,1,2.1296014603,4.8676604807,-20.99178582
48,79,2006,56,41,-107,75,6,15,-101,-88,3173,17.407522537,12.744793286,-33.26080199,-2,1.8650917003,4.6627292509,-31.39571029
48,79,2007,62,15,-127,75,6,47,-121,-91,3082,19.824140687,4.7961630695,-40.60751399,-17,1.9184652278,15.027977618,-38.68904876
48,79,2008,58,11,-130,75,5,47,-125,-105,2977,19.145073444,3.630962205,-42.91137151,-27,1.6504373659,15.514111239,-41.26093415
48,81,2001,30,47,-7,290,1,-17,-6,-29,3820,7.8237058287,12.257139132,-1.82553136,-6,0.2607901943,-4.433433303,-1.564741166
48,81,2002,28,63,-24,295,1,-35,-23,-61,3759,7.3888375775,16.624884549,-6.333289352,-3,0.2638870563,-9.236046972,-6.069402296
48,81,2003,31,60,-10,297,-1,-29,-11,-44,3715,8.295424137,16.05565962,-2.67594327,-4,-0.267594327,-7.760235483,-2.943537597
48,81,2004,24,61,-66,299,0,-37,-66,-107,3608,6.5546907005,16.659838864,-18.02539943,-4,0,-10.10514816,-18.02539943
48,81,2005,38,48,-3,296,0,-10,-3,-16,3592,10.555555556,13.333333333,-0.833333333,-3,0,-2.777777778,-0.833333333
48,81,2006,34,53,31,322,0,-19,31,9,3601,9.4536354789,14.736549423,8.619491172,-3,0,-5.282913944,8.619491172
48,81,2007,21,60,-98,246,0,-39,-98,-134,3467,5.9422750424,16.977928693,-27.73061686,3,0,-11.03565365,-27.73061686
48,81,2008,30,59,45,246,0,-29,45,13,3480,8.6368216496,16.985749244,12.955232474,-3,0,-8.348927595,12.955232474
48,83,2001,105,152,-61,170,8,-47,-53,-110,9071,11.505588429,16.655708963,-6.684198992,-10,0.8766162612,-5.150120535,-5.807582731
48,83,2002,94,153,-150,160,8,-59,-142,-209,8862,10.483466235,17.063514192,-16.72893548,-8,0.8922098924,-6.580047956,-15.83672559
48,83,2003,97,157,-80,176,5,-60,-75,-142,8720,11.034012058,17.859174155,-9.10021613,-7,0.5687635081,-6.825162098,-8.531452622
48,83,2004,118,158,-15,164,3,-40,-12,-60,8660,13.578826237,18.181818182,-1.726121979,-8,0.3452243959,-4.602991945,-1.380897583
48,83,2005,104,142,-79,170,5,-38,-74,-119,8541,12.092320214,16.510667984,-9.18551247,-7,0.5813615487,-4.41834777,-8.604150921
48,83,2006,85,139,97,175,4,-54,101,43,8584,9.9270072993,16.233576642,11.328467153,-4,0.4671532847,-6.306569343,11.795620438
48,83,2007,103,146,-39,176,4,-43,-35,-77,8507,12.053127377,17.085015505,-4.563805512,1,0.4680826166,-5.031888128,-4.095722895
48,83,2008,106,148,110,176,3,-42,113,70,8577,12.409271833,17.326153126,12.877546242,-1,0.3512058066,-4.916881292,13.228752049
48,85,2001,9127,1886,26299,3429,3556,7241,29855,37706,537904,17.584013902,3.6335543135,50.667468129,610,6.8509645488,13.950459589,57.518432678
48,85,2002,9467,2032,19759,3417,3341,7435,23100,31086,568990,17.105522299,3.6715349437,35.701702241,551,6.0367117357,13.433987356,41.738413976
48,85,2003,9801,2101,16277,3417,2929,7700,19206,27849,596839,16.813786584,3.6043021747,27.923477628,943,5.0247506281,13.20948441,32.948228256
48,85,2004,10301,2155,20605,3467,2648,8146,23253,31171,628010,16.82003251,3.518801093,33.644963583,-228,4.3237982804,13.301231417,37.968761864
48,85,2005,10423,2353,20882,3507,2794,8070,23676,32114,660124,16.183098963,3.6533466239,32.422092733,368,4.3380579971,12.529752339,36.76015073
48,85,2006,10730,2352,26146,3536,2783,8378,28929,37487,697611,15.805735287,3.4645936063,38.51414304,180,4.0994744924,12.341141681,42.613617532
48,85,2007,11130,2714,22205,3664,2532,8416,24737,33295,730906,15.582593697,3.7997447703,31.08818446,142,3.544935062,11.782848927,34.633119522
48,85,2008,11891,2839,19645,3664,2537,9052,22182,31104,762010,15.929898266,3.803295028,26.317622693,-130,3.3987176774,12.126603238,29.71634037
48,87,2001,27,42,-79,56,4,-15,-75,-92,3101,8.5795996187,13.346043851,-25.10327296,-2,1.2710517954,-4.766444233,-23.83222116
48,87,2002,42,55,12,64,4,-13,16,0,3101,13.544018059,17.736214124,3.8697194453,-3,1.2899064818,-4.192196066,5.1596259271
48,87,2003,27,43,-56,67,1,-16,-55,-72,3029,8.8091353997,14.029363785,-18.27079935,-1,0.3262642741,-5.220228385,-17.94453507
48,87,2004,45,57,9,64,4,-12,13,-1,3028,14.85884101,18.821198613,2.9717682021,-2,1.3207858676,-3.962357603,4.2925540697
48,87,2005,45,45,-49,63,3,0,-46,-48,2980,14.980026631,14.980026631,-16.31158455,-2,0.9986684421,0,-15.31291611
48,87,2006,52,48,-41,55,3,4,-38,-36,2944,17.555705604,16.205266712,-13.84199865,-2,1.0128291695,1.3504388926,-12.82916948
48,87,2007,51,30,0,57,1,21,1,19,2963,17.267648553,10.157440325,0,-3,0.3385813442,7.1102082275,0.3385813442
48,87,2008,51,33,3,57,3,18,6,22,2985,17.148621385,11.096166779,1.0087424344,-2,1.0087424344,6.0524546066,2.0174848689
48,89,2001,252,272,-211,922,78,-20,-133,-168,20165,12.445059015,13.432762112,-10.42026767,-15,3.8520420762,-0.987703096,-6.568225591
48,89,2002,273,274,96,902,76,-1,172,155,20320,13.486476473,13.535877485,4.7424972212,-16,3.7544769668,-0.049401013,8.496974188
48,89,2003,273,234,50,904,65,39,115,128,20448,13.392857143,11.479591837,2.4529042386,-26,3.1887755102,1.9132653061,5.6416797488
48,89,2004,237,245,-124,910,60,-8,-64,-89,20359,11.615654177,12.007743769,-6.077388683,-17,2.9406719435,-0.392089592,-3.13671674
48,89,2005,262,243,-66,897,64,19,-2,-3,20356,12.86994965,11.936632691,-3.242048385,-20,3.1438044947,0.9333169594,-0.09824389
48,89,2006,271,222,17,909,62,49,79,118,20474,13.274553025,10.87435709,0.8327210385,-10,3.0369826108,2.4001959344,3.8697036493
48,89,2007,274,226,-87,856,57,48,-30,18,20492,13.376946736,11.033540009,-4.247424694,0,2.7827954889,2.3434067275,-1.464629205
48,89,2008,279,219,114,856,56,60,170,242,20734,13.535147722,10.624363266,5.5304904672,12,2.7167321593,2.9107844564,8.2472226265
48,91,2001,1103,680,2171,1284,109,423,2280,2675,81419,13.773468279,8.4913494378,27.109881808,-28,1.3611133658,5.2821188414,28.470995174
48,91,2002,1104,740,2352,1252,95,364,2447,2803,84222,13.330033023,8.9349859032,28.398766006,-8,1.1470590011,4.39504712,29.545825007
48,91,2003,1137,742,2198,1220,60,395,2258,2697,86919,13.287289428,8.6712126258,25.686422307,44,0.7011762231,4.6160768022,26.38759853
48,91,2004,1205,707,3611,1211,100,498,3711,4031,90950,13.549297517,7.9496708252,40.602915629,-178,1.1244230304,5.5996266916,41.727338659
48,91,2005,1164,792,3289,1229,88,372,3377,3676,94626,12.544725611,8.5355864983,35.44639393,-73,0.9483984998,4.0091391128,36.39479243
48,91,2006,1178,743,4681,1266,100,435,4781,5153,99779,12.11902986,7.6438363211,48.157197603,-63,1.028780124,4.4751935393,49.185977727
48,91,2007,1414,827,4264,1292,80,587,4344,4972,104751,13.826822471,8.0868332274,41.695594778,41,0.7822813279,5.7399892436,42.477876106
48,91,2008,1553,841,4080,1292,86,712,4166,4884,109635,14.487886336,7.8456615637,38.062186897,6,0.8022911944,6.6422247721,38.864478091
48,93,2001,139,211,-288,328,36,-72,-252,-332,13660,10.053522349,15.261102271,-20.83031969,-8,2.6037899609,-5.207579922,-18.22652973
48,93,2002,160,197,-167,312,35,-37,-132,-176,13484,11.788977306,14.515178308,-12.30474506,-7,2.5788387857,-2.726201002,-9.725906278
48,93,2003,158,196,-81,320,31,-38,-50,-102,13382,11.762078463,14.590932777,-6.029926301,-14,2.3077495719,-2.828854314,-3.722176729
48,93,2004,185,181,57,333,30,4,87,81,13463,13.782827342,13.484820264,4.2466008568,-10,2.2350530825,0.2980070777,6.4816539393
48,93,2005,177,154,3,326,31,23,34,46,13509,13.124721934,11.419249592,0.2224529141,-11,2.2986801127,1.7054723417,2.5211330268
48,93,2006,188,177,-15,319,30,11,15,19,13528,13.906868366,13.093168621,-1.109590561,-7,2.2191811222,0.8136997448,1.1095905611
48,93,2007,192,191,-97,307,29,1,-68,-62,13466,14.225383419,14.15129288,-7.186782248,5,2.1486256205,0.0740905386,-5.038156627
48,93,2008,196,168,-46,307,28,28,-18,17,13483,14.545994286,12.467995102,-3.413855802,7,2.0779991836,2.0779991836,-1.335856618
48,95,2001,27,41,-78,1378,1,-14,-77,-94,3860,6.9106731508,10.493985155,-19.96416688,-3,0.2559508574,-3.583312004,-19.70821602
48,95,2002,20,43,-14,1364,1,-23,-13,-41,3819,5.2090115901,11.199374919,-3.646308113,-5,0.2604505795,-5.990363329,-3.385857534
48,95,2003,25,23,-32,1355,1,2,-31,-35,3784,6.5763514402,6.050243325,-8.417729843,-6,0.2630540576,0.5261081152,-8.154675786
48,95,2004,30,32,-35,1360,0,-2,-35,-40,3744,7.9702444208,8.5015940489,-9.298618491,-3,0,-0.531349628,-9.298618491
48,95,2005,37,33,-43,1356,1,4,-42,-39,3705,9.9342193583,8.8602496979,-11.54517385,-1,0.2684924151,1.0739696604,-11.27668143
48,95,2006,24,30,-105,1348,0,-6,-105,-112,3593,6.5771444231,8.2214305289,-28.77500685,-1,0,-1.644286106,-28.77500685
48,95,2007,39,18,-19,1346,1,21,-18,-4,3589,10.860484545,5.0125313283,-5.291005291,-7,0.2784739627,5.8479532164,-5.012531328
48,95,2008,32,17,16,1346,0,15,16,21,3610,8.8901236283,4.7228781775,4.4450618141,-10,0,4.1672454508,4.4450618141
48,97,2001,532,395,207,846,127,137,334,437,36895,14.505200878,10.769838998,5.6439409431,-34,3.4627077284,3.7353618802,9.1066486715
48,97,2002,503,383,351,832,122,120,473,560,37455,13.530598521,10.30262273,9.4418291863,-33,3.2817753867,3.2279757902,12.723604573
48,97,2003,522,369,22,984,107,153,129,227,37682,13.894619162,9.8220583734,0.5855969762,-55,2.8481307478,4.072560789,3.433727724
48,97,2004,524,402,37,910,100,122,137,232,37914,13.863167363,10.635483359,0.9788877718,-27,2.6456426266,3.2276840044,3.6245303984
48,97,2005,566,364,59,917,106,202,165,335,38249,14.862859919,9.558447015,1.5493087195,-32,2.7835038011,5.3044129039,4.3328125205
48,97,2006,575,367,-248,899,107,208,-141,49,38298,15.023449645,9.5888800345,-6.479679151,-18,2.795668021,5.4345696108,-3.68401113
48,97,2007,590,380,-246,864,96,210,-150,61,38359,15.393245235,9.9142935414,-6.418200556,1,2.5046636315,5.4789516939,-3.913536924
48,97,2008,569,353,-257,864,98,216,-159,48,38407,14.824271162,9.1967798244,-6.695672563,-9,2.5532136623,5.6274913373,-4.142458901
48,99,2001,1030,334,-1796,16653,-117,696,-1913,-1248,73764,13.846319299,4.4899715008,-24.14367909,-31,-1.572834328,9.356347798,-25.71651342
48,99,2002,959,322,-211,16684,-802,637,-1013,-444,73320,13.040167523,4.3784504093,-2.869108809,-68,-10.90533301,8.661717114,-13.77444182
48,99,2003,917,335,1893,17058,-2304,582,-411,218,73538,12.48825396,4.5622301815,25.780005175,47,-31.37724877,7.9260237781,-5.597243596
48,99,2004,860,340,-2311,16880,988,520,-1323,-919,72619,11.768167108,4.6525311822,-31.62352812,-116,13.519708259,7.1156359258,-18.10381986
48,99,2005,854,385,171,17153,-117,469,54,471,73090,11.721993837,5.2845054183,2.347143965,-52,-1.605940608,6.4374884187,0.7412033574
48,99,2006,1044,376,-2652,16968,442,668,-2210,-1567,71523,14.438535955,5.2000857461,-36.67720053,-25,6.1128667547,9.2384502085,-30.56433377
48,99,2007,892,336,303,16927,-211,556,92,585,72108,12.420716976,4.678655722,4.2191448921,-63,-2.938084397,7.7420612542,1.2810604953
48,99,2008,872,313,-8,16927,80,559,72,546,72654,12.047360495,4.3243392603,-0.110526243,-85,1.1052624307,7.7230212349,0.9947361877
48,101,2001,23,36,-97,35,2,-13,-95,-107,1783,12.523822488,19.602504764,-52.81786006,1,1.0890280425,-7.078682276,-51.72883202
48,101,2002,20,24,-41,34,2,-4,-39,-45,1738,11.360408975,13.63249077,-23.2888384,-2,1.1360408975,-2.272081795,-22.1527975
48,101,2003,29,21,-35,30,2,8,-33,-27,1711,16.816468542,12.177442737,-20.2957379,-2,1.1597564511,4.6390258046,-19.13598144
48,101,2004,15,10,-12,34,1,5,-11,-7,1704,8.78477306,5.8565153734,-7.027818448,-1,0.5856515373,2.9282576867,-6.442166911
48,101,2005,21,14,-38,27,2,7,-36,-30,1674,12.43339254,8.28892836,-22.49851983,-1,1.1841326229,4.14446418,-21.31438721
48,101,2006,11,17,-46,32,1,-6,-45,-51,1623,6.6727327874,10.312405217,-27.90415529,0,0.6066120716,-3.639672429,-27.29754322
48,101,2007,14,24,-32,26,2,-10,-30,-39,1584,8.7309011537,14.967259121,-19.95634549,1,1.2472715934,-6.236357967,-18.7090739
48,101,2008,20,8,22,26,1,12,23,33,1617,12.49609497,4.9984379881,13.745704467,-2,0.6248047485,7.4976569822,14.370509216
48,103,2001,41,31,-85,66,20,10,-65,-58,3892,10.456516195,7.9061463912,-21.67814333,-3,5.1007396072,2.5503698036,-16.57740372
48,103,2002,53,34,-60,65,20,19,-40,-23,3869,13.658033759,8.7617575055,-15.46192501,-2,5.1539750032,4.8962762531,-10.30795001
48,103,2003,53,42,-88,67,16,11,-72,-64,3805,13.812874642,10.946051603,-22.93458431,-3,4.1699244201,2.8668230388,-18.76465989
48,103,2004,58,46,-22,67,15,12,-7,2,3807,15.239096164,12.086179716,-5.780346821,-3,3.9411455596,3.1529164477,-1.839201261
48,103,2005,60,51,-79,55,16,9,-63,-56,3751,15.877216195,13.495633766,-20.90500132,-2,4.2339243186,2.3815824292,-16.671077
48,103,2006,57,44,-46,55,15,13,-31,-20,3731,15.236567763,11.76156108,-12.29617749,-2,4.0096230954,3.4750066827,-8.286554397
48,103,2007,59,25,91,80,8,34,99,136,3867,15.530402738,6.5806791261,23.953672019,3,2.1058173203,8.9497236115,26.059489339
48,103,2008,67,22,107,80,7,45,114,150,4017,16.996448503,5.5809233891,27.143581938,-9,1.7757483511,11.415525114,28.919330289
48,105,2001,39,34,-173,61,4,5,-169,-164,3862,9.8884381339,8.6206896552,-43.86409736,0,1.014198783,1.2677484787,-42.84989858
48,105,2002,56,40,-19,61,4,16,-15,-3,3859,14.505893019,10.361352156,-4.921642274,-4,1.0361352156,4.1445408626,-3.885507059
48,105,2003,54,30,-4,63,3,24,-1,17,3876,13.96250808,7.7569489334,-1.034259858,-6,0.7756948933,6.2055591467,-0.258564964
48,105,2004,60,38,-25,68,2,22,-23,-5,3871,15.489867045,9.8102491287,-6.454111269,-4,0.5163289015,5.6796179166,-5.937782367
48,105,2005,60,37,-34,65,3,23,-31,-10,3861,15.519917227,9.5706156234,-8.794619762,-2,0.7759958614,5.9493016037,-8.018623901
48,105,2006,56,37,-110,63,2,19,-108,-90,3771,14.675052411,9.6960167715,-28.82599581,-1,0.5241090147,4.9790356394,-28.30188679
48,105,2007,64,18,-36,64,3,46,-33,4,3775,16.962629208,4.7707394646,-9.541478929,-9,0.7951232441,12.191889743,-8.746355685
48,105,2008,62,18,-5,64,2,44,-3,27,3802,16.365316088,4.7512207998,-1.319783555,-14,0.5279134222,11.614095288,-0.791870133
48,107,2001,116,67,-144,92,6,49,-138,-93,6963,16.548969256,9.5584563806,-20.54354804,-4,0.8559811684,6.9905128754,-19.68756687
48,107,2002,92,76,-120,85,6,16,-114,-103,6860,13.311148087,10.996165811,-17.36236707,-5,0.8681183535,2.3149822759,-16.49424872
48,107,2003,105,65,-181,93,3,40,-178,-134,6726,15.457088179,9.5686736346,-26.64507581,4,0.4416310908,5.8884145444,-26.20344472
48,107,2004,125,70,-142,91,2,55,-140,-92,6634,18.71257485,10.479041916,-21.25748503,-7,0.2994011976,8.2335329341,-20.95808383
48,107,2005,99,98,-106,88,3,1,-103,-107,6527,15.04444951,14.892485373,-16.10819847,-5,0.4558924094,0.1519641365,-15.65230606
48,107,2006,124,81,-84,93,2,43,-82,-43,6484,19.060794712,12.451002997,-12.91215126,-4,0.3074321728,6.6097917147,-12.60471908
48,107,2007,99,52,-267,78,2,47,-265,-226,6258,15.539161827,8.16198399,-41.90864856,-8,0.3139224612,7.3771778371,-41.5947261
48,107,2008,110,57,-109,78,1,53,-108,-66,6192,17.670682731,9.156626506,-17.51004016,-11,0.1606425703,8.5140562249,-17.34939759
48,109,2001,38,20,-111,9,4,18,-107,-89,2855,13.105707881,6.8977409898,-38.28246249,0,1.379548198,6.2079668908,-36.9029143
48,109,2002,50,19,-75,9,4,31,-71,-42,2813,17.642907551,6.7043048694,-26.46436133,-2,1.4114326041,10.938602682,-25.05292872
48,109,2003,48,15,-97,9,2,33,-95,-60,2753,17.24757456,5.3898670499,-34.85447359,2,0.71864894,11.85770751,-34.13582465
48,109,2004,30,26,-91,9,1,4,-90,-90,2663,11.078286558,9.6011816839,-33.60413589,-4,0.3692762186,1.4771048744,-33.23485968
48,109,2005,27,25,-58,9,2,2,-56,-56,2607,10.246679317,9.4876660342,-22.0113852,-2,0.7590132827,0.7590132827,-21.25237192
48,109,2006,38,16,-94,9,1,22,-93,-72,2535,14.780241151,6.2232594321,-36.56164916,-1,0.3889537145,8.5569817192,-36.17269545
48,109,2007,30,14,-77,9,1,16,-76,-62,2473,11.980830671,5.5910543131,-30.75079872,-2,0.3993610224,6.3897763578,-30.3514377
48,109,2008,29,5,-58,9,0,24,-58,-42,2431,11.827079935,2.0391517129,-23.65415987,-8,0,9.7879282219,-23.65415987
48,111,2001,89,41,-103,16,15,48,-88,-44,6182,14.345583495,6.6086395874,-16.60219213,-4,2.417794971,7.7369439072,-14.18439716
48,111,2002,98,59,-131,16,15,39,-116,-79,6103,15.954415954,9.6052096052,-21.32682133,-2,2.442002442,6.3492063492,-18.88481888
48,111,2003,106,41,-121,16,10,65,-111,-47,6056,17.435644379,6.7439756559,-19.90295255,-1,1.6448721112,10.691668723,-18.25808043
48,111,2004,90,51,-16,16,8,39,-8,26,6082,14.829461196,8.4033613445,-2.636348657,-5,1.3181743286,6.4260998517,-1.318174329
48,111,2005,104,54,-59,16,10,50,-49,-4,6078,17.105263158,8.8815789474,-9.703947368,-5,1.6447368421,8.2236842105,-8.059210526
48,111,2006,130,43,-174,16,8,87,-166,-81,5997,21.532091097,7.1221532091,-28.81987578,-2,1.3250517598,14.409937888,-27.49482402
48,111,2007,121,50,59,42,8,71,67,132,6129,19.957116939,8.2467425367,9.7311561933,-6,1.3194788059,11.710374402,11.050634999
48,111,2008,113,30,53,42,7,83,60,138,6267,18.231687641,4.8402710552,8.5511455308,-5,1.1293965795,13.391416586,9.6805421104
48,113,2001,43052,14403,-18696,37810,28299,28649,9603,42250,2267698,19.163410225,6.4110981482,-8.322008677,3998,12.596519232,12.752312077,4.2745105545
48,113,2002,42885,14133,-46499,36865,26757,28752,-19742,12952,2280650,18.857396136,6.2145640571,-20.44654455,3942,11.765590496,12.642832079,-8.680954052
48,113,2003,42673,13760,-50812,37271,23516,28913,-27296,6756,2287406,18.683221046,6.024444534,-22.24666248,5139,10.29584576,12.658776512,-11.95081672
48,113,2004,42389,13901,-41880,38058,21208,28488,-20672,10540,2297946,18.488875009,6.0632204463,-18.2668637,2724,9.2503258201,12.425654563,-9.01653788
48,113,2005,42544,13911,-35195,39910,22404,28633,-12791,19228,2317174,18.436790376,6.0284456309,-15.25204112,3386,9.7089566468,12.408344745,-5.54308447
48,113,2006,43163,13742,-17273,38297,22236,29421,4963,38026,2355200,18.475832628,5.8822345985,-7.393671825,3642,9.5180736816,12.59359803,2.1244018565
48,113,2007,42963,13988,-24814,38011,20291,28975,-4523,27979,2383179,18.13404964,5.904128817,-10.473624,3527,8.564532301,12.229920823,-1.909091696
48,113,2008,42533,14191,-18847,38011,20305,28342,1458,29648,2412827,17.736841864,5.9178408034,-7.859456389,-152,8.4674623009,11.81900106,0.6080059116
48,115,2001,219,151,-172,2332,30,68,-142,-85,14857,14.698479815,10.134568274,-11.54401154,-11,2.0134903856,4.5639115407,-9.530521158
48,115,2002,187,143,-513,2271,30,44,-483,-439,14418,12.775405636,9.7694278395,-35.0469684,0,2.049530316,3.0059777968,-32.99743809
48,115,2003,188,148,-138,2335,21,40,-117,-89,14329,13.0796257,10.296726615,-9.601001844,-12,1.4610220197,2.7828990851,-8.139979824
48,115,2004,199,153,-361,2257,18,46,-343,-316,14013,14.04276339,10.796697481,-25.47456072,-19,1.2701997036,3.2460659093,-24.20436102
48,115,2005,193,148,-33,2261,20,45,-13,20,14033,13.763103473,10.55408971,-2.35327676,-12,1.4262283392,3.2090137631,-0.92704842
48,115,2006,215,141,-179,2271,21,74,-158,-91,13942,15.370866845,10.080428954,-12.7971403,-7,1.5013404826,5.290437891,-11.29579982
48,115,2007,199,115,-275,2217,18,84,-257,-181,13761,14.366675089,8.302349926,-19.85344548,-8,1.2994982493,6.0643251633,-18.55394723
48,115,2008,203,125,-159,2217,17,78,-142,-69,13692,14.788911959,9.1064728809,-11.5834335,-5,1.2384803118,5.6824390777,-10.34495319
48,117,2001,346,142,-460,264,61,204,-399,-202,18293,18.810481679,7.7199086659,-25.00815483,-7,3.3162987931,11.090573013,-21.69185604
48,117,2002,382,167,-302,264,60,215,-242,-38,18255,20.904016636,9.1386669585,-16.5262121,-11,3.2833533983,11.765349677,-13.24285871
48,117,2003,337,137,-334,238,51,200,-283,-92,18163,18.507331539,7.5237519908,-18.34257785,-9,2.8008127849,10.983579549,-15.54176506
48,117,2004,355,164,-82,245,47,191,-35,143,18306,19.468589761,8.9939400587,-4.496970029,-13,2.5775316022,10.474649702,-1.919438427
48,117,2005,358,155,-255,249,51,203,-204,-16,18290,19.564979779,8.4708711335,-13.93594928,-15,2.7871898568,11.094108646,-11.14875943
48,117,2006,381,141,-277,251,50,240,-227,5,18295,20.828208282,7.7080770808,-15.14281809,-8,2.7333606669,13.120131201,-12.40945743
48,117,2007,372,130,-181,252,43,242,-138,99,18394,20.278557606,7.0865927117,-9.866717545,-5,2.34402682,13.191964894,-7.522690725
48,117,2008,379,145,-164,252,42,234,-122,107,18501,20.544789267,7.8601436509,-8.890093509,-5,2.2767312644,12.684645616,-6.613362244
48,119,2001,55,74,15,96,0,-19,15,-10,5327,10.31507877,13.878469617,2.8132033008,-6,0,-3.563390848,2.8132033008
48,119,2002,58,58,113,127,-1,0,112,106,5433,10.780669145,10.780669145,21.003717472,-6,-0.185873606,0,20.817843866
48,119,2003,66,77,-22,112,-1,-11,-23,-43,5390,12.19624873,14.228956851,-4.065416243,-9,-0.184791647,-2.032708122,-4.250207891
48,119,2004,65,84,146,108,0,-19,146,120,5510,11.926605505,15.412844037,26.788990826,-7,0,-3.486238532,26.788990826
48,119,2005,56,45,-80,104,0,11,-80,-74,5436,10.232048237,8.2221816189,-14.61721177,-5,0,2.0098666179,-14.61721177
48,119,2006,59,66,66,102,0,-7,66,56,5492,10.79795022,12.079062958,12.079062958,-3,0,-1.281112738,12.079062958
48,119,2007,62,53,-136,99,0,9,-136,-124,5368,11.418047882,9.7605893186,-25.04604052,3,0,1.6574585635,-25.04604052
48,119,2008,62,58,85,99,1,4,86,90,5458,11.45390726,10.714945502,15.702937373,0,0.1847404397,0.7389617587,15.887677813
48,121,2001,7667,1770,17562,9122,1976,5897,19538,25825,464792,16.966912639,3.9169734409,38.86434326,390,4.372847186,13.049939198,43.237190446
48,121,2002,8071,1849,16113,9099,1844,6222,17957,24602,489394,16.91703714,3.8755546613,33.773289484,423,3.8650745243,13.041482478,37.638364009
48,121,2003,8524,1991,13745,9536,1624,6533,15369,22687,512081,17.022891235,3.9761352006,27.44951197,785,3.243216256,13.046756035,30.692728226
48,121,2004,8815,1953,12814,10127,1491,6862,14305,21070,533151,16.867068746,3.7369694001,24.51895847,-97,2.8529551334,13.130099346,27.371913604
48,121,2005,8969,2017,15952,10174,1567,6952,17519,24678,557829,16.44209793,3.6975929898,29.24343251,207,2.8726466113,12.744504941,32.116079122
48,121,2006,9261,2091,21411,10319,1566,7170,22977,30252,588081,16.163573055,3.6495012697,37.369426918,105,2.7331989423,12.514071786,40.102625861
48,121,2007,9651,2286,16646,10772,1426,7365,18072,25579,613660,16.061697154,3.8044803331,27.703140693,142,2.3732235149,12.257216821,30.076364208
48,121,2008,10275,2399,13704,10772,1431,7876,15135,22897,636557,16.437146511,3.8377337694,21.922594238,-114,2.2892025944,12.599412742,24.211796832
48,123,2001,252,250,90,1793,20,2,110,96,20076,12.582384661,12.482524466,4.4937088077,-16,0.9986019573,0.0998601957,5.4923107649
48,123,2002,210,263,-47,1788,20,-53,-27,-99,19977,10.48610591,13.132599306,-2.34689037,-19,0.9986767533,-2.646493396,-1.348213617
48,123,2003,230,254,9,1790,15,-24,24,-28,19949,11.521314432,12.723538546,0.450834043,-28,0.7513900716,-1.202224115,1.2022241146
48,123,2004,229,246,116,1781,16,-17,132,98,20047,11.451145115,12.301230123,5.800580058,-17,0.800080008,-0.850085009,6.600660066
48,123,2005,236,245,129,1794,16,-9,145,117,20164,11.738081619,12.185720325,6.4161547835,-19,0.7958021437,-0.447638706,7.2119569272
48,123,2006,262,280,-273,1774,17,-18,-256,-281,19883,13.084625565,13.983569306,-13.63398007,-7,0.8490024222,-0.898943741,-12.78497765
48,123,2007,247,237,-195,1787,14,10,-181,-162,19721,12.473487527,11.968488032,-9.847490153,9,0.706999293,0.504999495,-9.14049086
48,123,2008,235,229,-149,1787,14,6,-135,-125,19596,11.95411654,11.648905054,-7.579418572,4,0.7121601343,0.3052114861,-6.867258438
48,125,2001,15,52,-25,522,3,-37,-22,-62,2667,5.5596738325,19.273535953,-9.266123054,-3,1.1119347665,-13.71386212,-8.154188288
48,125,2002,34,37,34,525,3,-3,37,33,2700,12.670020496,13.787963481,12.670020496,-1,1.1179429849,-1.117942985,13.787963481
48,125,2003,22,44,6,518,2,-22,8,-16,2684,8.1723625557,16.344725111,2.2288261516,-2,0.7429420505,-8.172362556,2.9717682021
48,125,2004,28,35,-20,516,1,-7,-19,-29,2655,10.488855591,13.111069489,-7.492039708,-3,0.3746019854,-2.622213898,-7.117437722
48,125,2005,25,27,-72,518,2,-2,-70,-73,2582,9.5474508306,10.311246897,-27.49665839,-1,0.7637960665,-0.763796066,-26.73286233
48,125,2006,27,35,-77,519,1,-8,-76,-85,2497,10.632014176,13.782240599,-30.32092932,-1,0.3937783028,-3.150226423,-29.92715101
48,125,2007,17,19,1,519,2,-2,3,-2,2495,6.8108974359,7.6121794872,0.4006410256,-3,0.8012820513,-0.801282051,1.2019230769
48,125,2008,22,20,-44,519,1,2,-43,-45,2450,8.8978766431,8.0889787664,-17.79575329,-4,0.4044489383,0.8088978766,-17.39130435
48,127,2001,194,105,-227,124,1,89,-226,-146,10062,19.141588555,10.360138135,-22.39763197,-9,0.0986679822,8.7814504193,-22.29896399
48,127,2002,150,93,-52,120,0,57,-52,-7,10055,14.912760352,9.2459114182,-5.169756922,-12,0,5.6668489337,-5.169756922
48,127,2003,168,87,-56,128,0,81,-56,12,10067,16.698141338,8.6472517642,-5.566047113,-13,0,8.0508895736,-5.566047113
48,127,2004,182,76,-220,129,1,106,-219,-126,9941,18.192722911,7.5969612155,-21.99120352,-13,0.099960016,10.595761695,-21.8912435
48,127,2005,183,66,-65,131,1,117,-64,46,9987,18.366118025,6.623845845,-6.523484544,-7,0.1003613007,11.74227218,-6.423123244
48,127,2006,184,79,-173,116,1,105,-172,-72,9915,18.490603959,7.938900613,-17.38518742,-5,0.1004924128,10.551703346,-17.28469501
48,127,2007,168,81,-217,111,1,87,-216,-128,9787,17.054106182,8.2225154807,-22.02822049,1,0.1015125368,8.8315907015,-21.92670795
48,127,2008,176,65,-137,111,2,111,-135,-29,9758,18.009721156,6.6513174725,-14.01893067,-5,0.2046559222,11.358403684,-13.81427475
48,129,2001,31,62,54,234,2,-31,56,24,3853,8.070814892,16.141629784,14.058838844,-1,0.520697735,-8.070814892,14.579536579
48,129,2002,29,39,10,208,2,-10,12,-2,3851,7.528556594,10.124610592,2.5960539979,-4,0.5192107996,-2.596053998,3.1152647975
48,129,2003,48,49,73,265,2,-1,75,75,3926,12.344091552,12.601260126,18.773305902,1,0.514337148,-0.257168574,19.28764305
48,129,2004,34,50,41,294,1,-16,42,21,3947,8.6371141877,12.701638511,10.415343579,-5,0.2540327702,-4.064524324,10.66937635
48,129,2005,32,43,-67,301,2,-11,-65,-79,3868,8.1893793986,11.004478567,-17.14651312,-3,0.5118362124,-2.815099168,-16.6346769
48,129,2006,36,50,-7,309,1,-14,-6,-21,3847,9.3324692158,12.9617628,-1.814646792,-1,0.259235256,-3.629293584,-1.555411536
48,129,2007,38,37,57,315,1,1,58,57,3904,9.8051864276,9.5471552058,14.707779641,-2,0.2580312218,0.2580312218,14.965810863
48,129,2008,38,40,-52,315,0,-2,-52,-54,3850,9.8013928295,10.31725561,-13.41243229,0,0,-0.515862781,-13.41243229
48,131,2001,197,139,-210,576,2,58,-208,-160,12880,15.200617284,10.725308642,-16.2037037,-10,0.1543209877,4.475308642,-16.04938272
48,131,2002,176,123,-181,595,2,53,-179,-136,12744,13.737121449,9.6003746488,-14.12738058,-10,0.1561036528,4.1367467999,-13.97127693
48,131,2003,199,129,-217,689,0,70,-217,-154,12590,15.710112892,10.183942528,-17.13112813,-7,0,5.5261703639,-17.13112813
48,131,2004,201,126,-102,701,4,75,-98,-33,12557,15.986002306,10.021076073,-8.112299678,-10,0.3181293991,5.9649262337,-7.794170279
48,131,2005,225,121,-206,687,2,104,-204,-106,12451,17.994241843,9.6769033909,-16.47472809,-6,0.1599488164,8.3173384517,-16.31477927
48,131,2006,186,118,-206,701,3,68,-203,-141,12310,15.023625863,9.5311174831,-16.6390695,-6,0.2423165462,5.4925083801,-16.39675296
48,131,2007,199,124,-245,696,1,75,-244,-172,12138,16.279450262,10.143979058,-20.04253927,-3,0.0818062827,6.1354712042,-19.96073298
48,131,2008,211,119,-187,696,3,92,-184,-105,12033,17.458938397,9.8465102809,-15.47308758,-13,0.2482313516,7.6124281163,-15.22485623
48,133,2001,192,307,-189,769,36,-115,-153,-282,18019,10.572687225,16.905286344,-10.40748899,-14,1.9823788546,-6.332599119,-8.425110132
48,133,2002,222,287,181,801,34,-65,215,138,18157,12.273330385,15.866873065,10.006634233,-12,1.8796992481,-3.59354268,11.886333481
48,133,2003,245,256,31,721,27,-11,58,20,18177,13.485991083,14.09148456,1.7063907084,-27,1.4862112622,-0.605493477,3.1926019706
48,133,2004,219,292,126,846,24,-73,150,60,18237,12.028340748,16.037787664,6.9204152249,-17,1.3181743286,-4.009446916,8.2385895535
48,133,2005,239,294,76,844,26,-55,102,29,18266,13.094814125,16.108265074,4.1640413117,-18,1.4245404487,-3.013450949,5.5885817604
48,133,2006,239,262,-31,840,26,-23,-5,-36,18230,13.097325734,14.357737834,-1.698816309,-8,1.4248136782,-1.2604121,-0.27400263
48,133,2007,250,238,41,854,24,12,65,77,18307,13.684757917,13.027889537,2.2443002983,0,1.31373676,0.65686838,3.5580370583
48,133,2008,254,248,-154,854,23,6,-131,-121,18186,13.9204779,13.591647713,-8.43997479,4,1.2605157153,0.3288301866,-7.179459074
48,135,2001,2180,969,-1402,1661,220,1211,-1182,-69,120596,18.071714865,8.0327943596,-11.622268,-98,1.8237510414,10.038920505,-9.798516959
48,135,2002,2229,1034,-80,1711,211,1195,131,1206,121802,18.391240852,8.5314235266,-0.660071453,-120,1.7409384566,9.8598173252,1.0808670039
48,135,2003,2309,1074,-1026,1860,193,1235,-833,294,122096,18.934144601,8.8069602867,-8.413353123,-108,1.5826288038,10.127184315,-6.830724319
48,135,2004,2331,1086,-74,2000,172,1245,98,1264,123360,18.993220781,8.8488364513,-0.60295939,-79,1.4014731765,10.14438433,0.7985137866
48,135,2005,2292,1093,-275,2079,180,1199,-95,990,124350,18.505510476,8.8248354931,-2.220338299,-114,1.453312341,9.6806749828,-0.767025958
48,135,2006,2326,1096,754,2133,178,1230,932,2099,126449,18.548718296,8.7400667467,6.0127831451,-63,1.419463395,9.8086515496,7.4322465401
48,135,2007,2507,1074,1364,2193,165,1433,1529,2961,129410,19.596731012,8.3952489457,10.662122497,-1,1.2897728827,11.201482066,11.95189538
48,135,2008,2540,1076,901,2193,166,1464,1067,2531,131941,19.437461498,8.2341372331,6.8949420511,0,1.2703222869,11.203324265,8.165264338
48,137,2001,20,19,-91,28,1,1,-90,-91,2050,9.5442615128,9.0670484371,-43.42638988,-2,0.4772130756,0.4772130756,-42.94917681
48,137,2002,25,16,-40,28,1,9,-39,-33,2017,12.294074256,7.868207524,-19.67051881,-3,0.4917629702,4.4258667322,-19.17875584
48,137,2003,20,17,-34,28,1,3,-33,-34,1983,10,8.5,-17,-4,0.5,1.5,-16.5
48,137,2004,29,28,-31,28,0,1,-31,-31,1952,14.739517154,14.231257942,-15.75603558,-1,0,0.5082592122,-15.75603558
48,137,2005,25,11,-48,28,1,14,-47,-33,1919,12.916559029,5.6832859726,-24.79979334,0,0.5166623611,7.2332730561,-24.28313097
48,137,2006,30,20,-37,28,0,10,-37,-28,1891,15.748031496,10.498687664,-19.42257218,-1,0,5.249343832,-19.42257218
48,137,2007,21,10,38,28,1,11,39,44,1935,10.977522216,5.2273915316,19.86408782,-6,0.5227391532,5.7501306848,20.386826973
48,137,2008,29,1,4,28,0,28,4,17,1952,14.921533316,0.5145356316,2.0581425264,-15,0,14.406997685,2.0581425264
48,139,2001,1805,922,2109,1951,400,883,2509,3322,115704,15.827363363,8.0846698175,18.493024561,-70,3.5074489447,7.7426935454,22.000473506
48,139,2002,1872,913,2519,1954,371,959,2890,3796,119500,15.918096631,7.7634734103,21.419703747,-53,3.1547082533,8.1546232207,24.574412
48,139,2003,1950,816,2729,1974,330,1134,3059,4204,123704,16.035920462,6.7104159471,22.442065098,11,2.7137711551,9.3255045147,25.155836253
48,139,2004,1961,971,2373,1933,299,990,2672,3512,127216,15.630479834,7.7395185717,18.914395026,-150,2.3832297147,7.8909612626,21.297624741
48,139,2005,2028,930,3306,1926,310,1098,3616,4618,131834,15.657209033,7.1800810654,25.52403011,-96,2.3933603551,8.4771279676,27.917390465
48,139,2006,2091,877,4201,1889,309,1214,4510,5642,137476,15.52857302,6.5129404775,31.198247373,-82,2.2947532583,9.0156325424,33.493000631
48,139,2007,2287,916,3875,1992,285,1371,4160,5522,142998,16.30810699,6.531799739,27.631794747,-9,2.0322739363,9.7763072513,29.664068684
48,139,2008,2422,975,3498,1992,287,1447,3785,5188,148186,16.635529425,6.6967965273,24.026045387,-44,1.9712621573,9.9387328974,25.997307544
48,141,2001,14220,4094,-10405,12926,4703,10126,-5702,4009,685035,20.818982461,5.9938758225,-15.23358035,-415,6.8854904722,14.825106639,-8.348089873
48,141,2002,14004,4179,-9250,13117,4005,9825,-5245,4178,689213,20.380600881,6.0818716855,-13.46190789,-402,5.8286422829,14.298729196,-7.633265611
48,141,2003,14119,4160,-5590,13124,2513,9959,-3077,6163,695376,20.39449974,6.0090033938,-8.07459831,-719,3.6299580598,14.385496346,-4.444640251
48,141,2004,14606,4345,-5799,13262,4227,10261,-1572,8061,703437,20.883420443,6.2124100934,-8.291315565,-628,6.0436956191,14.671010349,-2.247619946
48,141,2005,14401,4216,-6741,13177,3724,10185,-3017,6555,709992,20.377394266,5.96563393,-9.538505295,-613,5.2694546383,14.411760336,-4.269050656
48,141,2006,14383,4528,-1091,13300,4080,9855,2989,12466,722458,20.081678244,6.3220356731,-1.523264337,-378,5.6965339104,13.75964257,4.1732695731
48,141,2007,14568,4378,-5906,13159,3323,10190,-2583,7511,729969,20.060216451,6.0285301774,-8.132594616,-96,4.5757893512,14.031686274,-3.556805265
48,141,2008,15224,4598,-1940,13159,3512,10626,1572,12093,742062,20.684347001,6.2471510451,-2.635814056,-105,4.7716386408,14.437195956,2.1358245852
48,143,2001,463,333,-381,1817,97,130,-284,-179,32871,14.047117004,10.103002078,-11.55929067,-25,2.9429165213,3.9441149254,-8.616374145
48,143,2002,437,327,262,2058,93,110,355,432,33303,13.207604195,9.8830356333,7.9185178469,-33,2.8107716021,3.3245685617,10.729289449
48,143,2003,425,287,142,1990,82,138,224,319,33622,12.70078446,8.5767650355,4.2435562196,-43,2.4505042959,4.1240194247,6.6940605155
48,143,2004,447,341,439,2154,68,106,507,579,34201,13.181369152,10.055585863,12.945460979,-34,2.0052194683,3.1257832889,14.950680448
48,143,2005,470,375,123,2172,76,95,199,260,34461,13.690250794,10.923072442,3.5827677609,-34,2.2137426815,2.7671783519,5.7965104425
48,143,2006,507,322,588,2242,75,185,663,830,35291,14.537217571,9.2327101732,16.859731621,-18,2.150475972,5.3045073976,19.010207593
48,143,2007,531,309,10,2237,68,222,78,296,35587,14.983492762,8.7192076526,0.2821750049,-4,1.9187900336,6.2642851096,2.2009650385
48,143,2008,532,309,-4,2237,67,223,63,283,35870,14.890073751,8.648557874,-0.111955442,-3,1.875253649,6.2415158767,1.7632982073
48,145,2001,191,238,-331,2006,26,-47,-305,-364,18154,10.416666667,12.979930192,-18.05191972,-12,1.4179755672,-2.563263525,-16.63394415
48,145,2002,203,234,-301,1912,24,-31,-277,-314,17840,11.279657721,13.002167028,-16.72500972,-6,1.3335555926,-1.722509307,-15.39145413
48,145,2003,198,217,-65,1990,21,-19,-44,-90,17750,11.126720989,12.19443664,-3.652711436,-27,1.1801067716,-1.06771565,-2.472604664
48,145,2004,215,240,-117,2018,20,-25,-97,-135,17615,12.158914181,13.572741411,-6.616711438,-13,1.1310617842,-1.41382723,-5.485649654
48,145,2005,201,199,-174,2038,22,2,-152,-164,17451,11.464096276,11.350025666,-9.924143045,-14,1.2547767068,0.1140706097,-8.669366338
48,145,2006,221,233,-92,2021,22,-12,-70,-91,17360,12.697135963,13.38657321,-5.285685559,-9,1.2639682859,-0.689437247,-4.021717273
48,145,2007,199,195,-446,1874,18,4,-428,-414,16946,11.601469131,11.368273771,-26.00128257,10,1.0493791174,0.2331953594,-24.95190346
48,145,2008,214,179,-104,1874,18,35,-86,-46,16900,12.645512025,10.577320806,-6.145482479,5,1.0636411984,2.0681912191,-5.081841281
48,147,2001,354,410,17,3369,31,-56,48,-39,31301,11.302501556,13.090467904,0.5427754985,-31,0.9897670855,-1.787966348,1.5325425839
48,147,2002,344,418,361,3484,29,-74,390,279,31580,10.941301824,13.294953961,11.482005693,-37,0.9223771887,-2.353652137,12.404382882
48,147,2003,358,420,525,3559,24,-62,549,473,32053,11.252023321,13.200697751,16.500872189,-14,0.7543255858,-1.94867443,17.255197775
48,147,2004,373,421,233,3504,24,-48,257,184,32237,11.603670866,13.096904651,7.2484056618,-25,0.7466168922,-1.493233784,7.9950225541
48,147,2005,418,428,422,3497,24,-10,446,410,32647,12.884532396,13.192774798,13.007829357,-26,0.7397817644,-0.308242402,13.747611121
48,147,2006,411,421,170,3522,24,-10,194,167,32814,12.557095064,12.862620492,5.193932265,-17,0.7332610256,-0.305525427,5.9271932907
48,147,2007,415,435,122,3477,18,-20,140,116,32930,12.624726211,13.233146751,3.7113652957,-4,0.5475784862,-0.60842054,4.2589437819
48,147,2008,418,398,262,3477,19,20,281,299,33229,12.636224852,12.031620792,7.9203131849,-2,0.5743738569,0.6046040599,8.4946870418
48,149,2001,279,303,341,596,51,-24,392,350,22176,12.681241762,13.772101268,15.499295487,-18,2.3180764511,-1.090859506,17.817371938
48,149,2002,258,344,125,560,51,-86,176,72,22248,11.615343058,15.487124077,5.6275886908,-18,2.2960561858,-3.871781019,7.9236448766
48,149,2003,259,328,90,548,41,-69,131,32,22280,11.633129716,14.73230327,4.0424002875,-30,1.8415379087,-3.099173554,5.8839381962
48,149,2004,251,333,70,556,39,-82,109,12,22292,11.26267612,14.942116127,3.140985372,-15,1.7499775644,-3.679440007,4.8909629364
48,149,2005,247,338,99,539,42,-91,141,30,22322,11.07275743,15.152194378,4.4380687677,-20,1.8828170529,-4.079436948,6.3208858206
48,149,2006,242,311,89,571,41,-69,130,49,22371,10.829436377,13.917168237,3.9827266015,-12,1.8347392209,-3.08773186,5.8174658224
48,149,2007,267,321,93,516,35,-54,128,86,22457,11.912197734,14.321406264,4.149192469,12,1.5615240475,-2.40920853,5.7107165165
48,149,2008,264,311,257,516,35,-47,292,241,22698,11.693057247,13.774775772,11.383014063,-4,1.5502159229,-2.081718525,12.933229986
48,151,2001,29,54,-77,74,5,-25,-72,-100,4235,6.7677946324,12.60210035,-17.96966161,-3,1.1668611435,-5.834305718,-16.80280047
48,151,2002,39,58,-12,72,4,-19,-8,-31,4204,9.2428012798,13.745704467,-2.843938855,-4,0.9479796184,-4.502903188,-1.895959237
48,151,2003,26,61,-37,70,3,-35,-34,-72,4132,6.2380038388,14.635316699,-8.877159309,-3,0.7197696737,-8.39731286,-8.157389635
48,151,2004,30,63,-48,74,4,-33,-44,-81,4051,7.3322742271,15.397775877,-11.73163876,-4,0.9776365636,-8.06550165,-10.7540022
48,151,2005,43,51,0,69,4,-8,4,-6,4045,10.622529644,12.598814229,0,-2,0.9881422925,-1.976284585,0.9881422925
48,151,2006,44,58,-37,78,4,-14,-33,-48,3997,10.942551604,14.424272569,-9.201691122,-1,0.9947774186,-3.481720965,-8.206913703
48,151,2007,32,41,-36,64,2,-9,-34,-56,3941,8.062484253,10.330057949,-9.070294785,-13,0.5039052658,-2.267573696,-8.566389519
48,151,2008,38,38,-22,64,2,0,-20,-29,3912,9.6778301286,9.6778301286,-5.602954285,-9,0.5093594805,0,-5.093594805
48,153,2001,110,101,-297,130,7,9,-290,-282,7455,14.481305951,13.296471827,-39.09952607,-1,0.9215376514,1.1848341232,-38.17798841
48,153,2002,115,95,-185,135,7,20,-178,-160,7295,15.593220339,12.881355932,-25.08474576,-2,0.9491525424,2.7118644068,-24.13559322
48,153,2003,119,61,18,144,4,58,22,71,7366,16.233544779,8.3213969033,2.4554941682,-9,0.5456653707,7.9121478753,3.0011595389
48,153,2004,94,69,-248,152,3,25,-245,-229,7137,12.962835275,9.5152727022,-34.19982073,-9,0.4137075088,3.4475625733,-33.78611322
48,153,2005,115,79,-199,139,4,36,-195,-163,6974,16.29934094,11.196938559,-28.2049465,-4,0.5669335979,5.1024023811,-27.6380129
48,153,2006,111,76,-172,141,3,35,-169,-137,6837,16.074143798,11.005720078,-24.90768228,-3,0.4344363189,5.0684237202,-24.47324596
48,153,2007,90,58,-250,134,4,32,-246,-219,6618,13.377926421,8.6213303605,-37.16090673,-5,0.5945745076,4.7565960609,-36.56633222
48,153,2008,96,54,-200,134,3,42,-197,-163,6455,14.686758969,8.26130192,-30.59741452,-8,0.4589612178,6.4254570489,-30.1384533
48,155,2001,13,20,21,37,1,-7,22,14,1623,8.0445544554,12.376237624,12.995049505,-1,0.6188118812,-4.331683168,13.613861386
48,155,2002,15,11,-77,29,1,4,-76,-72,1551,9.4517958412,6.9313169502,-48.51921865,0,0.6301197227,2.520478891,-47.88909893
48,155,2003,15,16,-22,32,1,-1,-21,-23,1528,9.7434231893,10.392984735,-14.29035401,-1,0.649561546,-0.649561546,-13.64079247
48,155,2004,13,27,-5,29,0,-14,-5,-21,1507,8.5667215815,17.792421746,-3.294892916,-2,0,-9.225700165,-3.294892916
48,155,2005,11,10,-52,31,1,1,-51,-50,1457,7.4224021592,6.7476383266,-35.0877193,0,0.6747638327,0.6747638327,-34.41295547
48,155,2006,14,16,-4,34,0,-2,-4,-6,1451,9.628610729,11.004126547,-2.751031637,0,0,-1.375515818,-2.751031637
48,155,2007,12,15,-48,27,1,-3,-47,-53,1398,8.424008424,10.53001053,-33.6960337,-3,0.702000702,-2.106002106,-32.99403299
48,155,2008,13,9,-36,27,0,4,-36,-37,1361,9.4237042407,6.5241029358,-26.09641174,-5,0,2.8996013048,-26.09641174
48,157,2001,5290,1464,10272,6208,1998,3826,12270,16453,375211,14.414777736,3.9892693016,27.990282968,357,5.4443716288,10.425508434,33.434654597
48,157,2002,5366,1597,15304,6445,1872,3769,17176,21486,396697,13.903211264,4.137798805,39.652393809,541,4.8503189499,9.7654124585,44.502712759
48,157,2003,5900,1598,12833,6468,1648,4302,14481,19710,416407,14.512288711,3.9306165017,31.565457801,927,4.0536019993,10.581672209,35.6190598
48,157,2004,6020,1689,15751,6413,1499,4331,17250,21477,437884,14.093558284,3.9541561365,36.87502268,-104,3.5093428352,10.139402148,40.384365515
48,157,2005,6377,1716,14092,6437,1581,4661,15673,20632,458516,14.228023204,3.828647925,31.441320839,298,3.5274431058,10.399375279,34.968763945
48,157,2006,6852,1880,19068,6491,1581,4972,20649,25644,484160,14.537338386,3.9886450912,40.455045,23,3.3542807921,10.548693294,43.809325792
48,157,2007,7249,2038,16439,6415,1451,5211,17890,23416,507576,14.618809845,4.1099647487,33.151967862,315,2.9261819678,10.508845096,36.07814983
48,157,2008,7660,2067,17258,6415,1455,5593,18713,24565,532141,14.734778791,3.9760819531,33.197495088,259,2.7988385301,10.758696838,35.996333618
48,159,2001,116,104,101,180,24,12,125,127,9592,12.174004303,10.914624547,10.599779609,-10,2.5187595109,1.2593797555,13.118539119
48,159,2002,103,111,24,169,23,-8,47,31,9623,10.720791049,11.553473849,2.4980483997,-8,2.3939630497,-0.8326828,4.8920114494
48,159,2003,100,106,70,157,18,-6,88,73,9696,10.352502718,10.973652881,7.2467519023,-9,1.8634504892,-0.621150163,9.1102023914
48,159,2004,120,125,159,167,19,-5,178,162,9858,12.27370359,12.785107906,16.262657257,-11,1.9433364018,-0.511404316,18.205993659
48,159,2005,131,93,998,178,19,38,1017,1046,10904,12.619208169,8.9586745015,96.137173683,-9,1.8302668336,3.6605336673,97.967440516
48,159,2006,124,105,28,177,19,19,47,61,10965,11.340253327,9.6026338653,2.5607023641,-5,1.7376194613,1.7376194613,4.2983218254
48,159,2007,155,120,94,177,15,35,109,139,11104,14.046853052,10.874983008,8.5187366895,-5,1.359372876,3.171870044,9.8781095655
48,159,2008,145,120,-148,177,15,25,-133,-103,11001,13.1192038,10.85727211,-13.3906356,5,1.3571590138,2.2619316897,-12.03347659
48,161,2001,220,225,173,1582,31,-5,204,186,18104,12.214757648,12.492365776,9.6052412415,-13,1.7211703959,-0.277608128,11.326411637
48,161,2002,213,216,207,1574,30,-3,237,224,18328,11.693017128,11.85770751,11.363636364,-10,1.6469038208,-0.164690382,13.010540184
48,161,2003,212,244,50,1511,19,-32,69,15,18343,11.562269914,13.307518202,2.7269504513,-22,1.0362411715,-1.745248289,3.7631916228
48,161,2004,211,220,153,1529,19,-9,172,146,18489,11.457428323,11.946133797,8.3079930495,-17,1.0317115552,-0.488705474,9.3397046047
48,161,2005,223,225,93,1528,18,-2,111,94,18583,12.030643073,12.138541217,5.0172637031,-15,0.9710832974,-0.107898144,5.9883470004
48,161,2006,247,189,101,1531,18,58,119,167,18750,13.232261002,10.125090403,5.4107625961,-10,0.9642943241,3.1071705997,6.3750569202
48,161,2007,237,199,-73,1506,16,38,-57,-31,18719,12.650457712,10.622114281,-3.896554485,-12,0.8540393392,2.0283434306,-3.042515146
48,161,2008,242,206,144,1506,17,36,161,204,18923,12.857977791,10.945220764,7.6510281069,7,0.9032463737,1.9127570267,8.5542744806
48,163,2001,280,128,-140,2092,13,152,-127,12,16203,17.287151942,7.9026980305,-8.643575971,-13,0.8026177687,9.3844539112,-7.840958202
48,163,2002,276,115,-86,2128,13,161,-73,75,16278,16.99455066,7.0810627752,-5.295403467,-13,0.8004679659,9.9134878852,-4.494935501
48,163,2003,237,120,-209,2116,7,117,-202,-96,16182,14.6025878,7.393715342,-12.87738755,-11,0.4313000616,7.2088724584,-12.44608749
48,163,2004,228,111,-162,2122,11,117,-151,-48,16134,14.11065726,6.8696620869,-10.02599332,-14,0.6807773239,7.2409951727,-9.345215992
48,163,2005,258,129,-149,2122,9,129,-140,-22,16112,16.001984742,8.0009923711,-9.241456305,-11,0.5582087701,8.0009923711,-8.683247535
48,163,2006,254,129,-137,2109,10,125,-127,-11,16101,15.770030733,8.0091888368,-8.505882718,-9,0.6208673517,7.7608418961,-7.885015366
48,163,2007,257,106,-174,2117,9,151,-165,-23,16078,15.973150191,6.5881475496,-10.81450636,-9,0.5593710184,9.3850026415,-10.25513534
48,163,2008,256,112,-58,2117,11,144,-47,85,16163,15.880400732,6.9476753202,-3.597903291,-12,0.682360969,8.9327254117,-2.915542322
48,165,2001,284,89,-467,95,77,195,-390,-198,14240,19.806123161,6.2068484553,-32.56851942,-3,5.3699700119,13.599274705,-27.19854941
48,165,2002,245,94,-401,96,75,151,-326,-179,14061,17.313875835,6.6428748101,-28.33822126,-4,5.3001660719,10.671001025,-23.03805519
48,165,2003,277,98,-128,103,56,179,-72,93,14154,19.634945951,6.9466595782,-9.073188021,-14,3.969519759,12.688286372,-5.103668262
48,165,2004,293,97,-194,113,54,196,-140,43,14197,20.669464922,6.8427921414,-13.68558428,-13,3.8093894395,13.826672781,-9.876194843
48,165,2005,286,104,-87,107,55,182,-32,140,14337,20.046260601,7.2895493096,-6.097988365,-10,3.8550501157,12.756711292,-2.242938249
48,165,2006,314,117,-24,106,54,197,30,218,14555,21.736120725,8.0991277862,-1.661359546,-9,3.7380589783,13.636992939,2.0766994324
48,165,2007,302,86,-3,108,53,216,50,252,14807,20.570805803,5.8579115864,-0.204345753,-14,3.6101083032,14.712894217,3.4057625502
48,165,2008,330,89,-4,108,52,241,48,274,15081,22.082441113,5.9555674518,-0.267665953,-15,3.4796573876,16.126873662,3.2119914347
48,167,2001,3800,2169,1587,4078,862,1631,2449,3855,254563,15.041433211,8.585491746,6.2817775016,-225,3.4120303758,6.4559414651,9.6938078774
48,167,2002,3780,2273,3426,4167,790,1507,4216,5577,260140,14.688082253,8.8322780322,13.312531693,-146,3.0697314762,5.8558042211,16.382263169
48,167,2003,3994,2302,2902,4266,659,1692,3561,5068,265208,15.205159247,8.7637147186,11.047914906,-185,2.5088132057,6.4414445282,13.556728112
48,167,2004,3933,2230,2311,4378,686,1703,2997,4462,269670,14.706157292,8.3383500537,8.6412228583,-238,2.5650709134,6.3678072383,11.206293772
48,167,2005,3952,2373,2919,4420,687,1579,3606,4948,274618,14.521723793,8.7196484214,10.725939209,-237,2.5243988477,5.8020753719,13.250338056
48,167,2006,3977,2357,1956,4458,708,1620,2664,4145,278763,14.373460599,8.5185432821,7.0692705387,-139,2.5588157165,5.8549173174,9.6280862552
48,167,2007,4247,2365,1935,4610,639,1882,2574,4319,283082,15.118048572,8.418691988,6.8880207175,-137,2.274648702,6.6993565841,9.1626694195
48,167,2008,4309,2391,2769,4610,649,1918,3418,5157,288239,15.084339627,8.3700756667,9.6933247684,-179,2.2719276904,6.7142639602,11.965252459
48,169,2001,81,69,157,502,2,12,159,171,5030,16.381838406,13.954899383,31.75245222,0,0.4044898372,2.4269390232,32.156942057
48,169,2002,70,57,-62,496,2,13,-60,-51,4979,13.98741133,11.389749226,-12.38885003,-4,0.3996403237,2.5976621041,-11.98920971
48,169,2003,69,54,-54,504,2,15,-52,-41,4938,13.915498639,10.890390239,-10.89039024,-4,0.4033477866,3.0251083997,-10.48704245
48,169,2004,56,50,60,532,1,6,61,62,5000,11.269873214,10.062386798,12.074864158,-5,0.201247736,1.2074864158,12.276111894
48,169,2005,59,45,-233,432,2,14,-231,-218,4782,12.062972807,9.2005724801,-47.63851973,-1,0.4089143324,2.8624003271,-47.2296054
48,169,2006,63,46,31,503,1,17,32,46,4828,13.111342352,9.5733610822,6.4516129032,-3,0.2081165453,3.5379812695,6.6597294485
48,169,2007,70,35,-166,499,2,35,-164,-131,4697,14.69816273,7.3490813648,-34.85564304,-2,0.4199475066,7.3490813648,-34.43569554
48,169,2008,52,32,-82,499,1,20,-81,-69,4628,11.152815013,6.8632707775,-17.58713137,-8,0.2144772118,4.2895442359,-17.37265416
48,171,2001,233,295,225,564,42,-62,267,186,21099,11.092068933,14.043606589,10.711225364,-19,1.9994287346,-2.951537656,12.710654099
48,171,2002,204,274,508,603,42,-70,550,468,21567,9.5626494164,12.843950687,23.812872076,-12,1.9687807622,-3.28130127,25.781652838
48,171,2003,220,288,517,584,31,-68,548,486,22053,10.087116002,13.204951857,23.704722604,6,1.4213663457,-3.117835855,25.12608895
48,171,2004,247,268,290,587,28,-21,318,274,22327,11.131140153,12.077512393,13.068949977,-23,1.261829653,-0.94637224,14.33077963
48,171,2005,242,320,409,565,30,-78,439,341,22668,10.75675075,14.223802645,18.179797755,-20,1.3334814979,-3.467051895,19.513279253
48,171,2006,254,306,513,571,29,-52,542,476,23144,11.088797695,13.358945255,22.395878809,-14,1.2660438313,-2.27014756,23.66192264
48,171,2007,258,281,215,529,28,-23,243,237,23381,11.090811392,12.079527136,9.2423428264,17,1.2036539495,-0.988715744,10.445996776
48,171,2008,278,313,405,529,27,-35,432,401,23782,11.788902317,13.273116638,17.174479995,4,1.144965333,-1.484214321,18.319445328
48,173,2001,22,5,-79,0,9,17,-70,-54,1347,16.011644833,3.6390101892,-57.49636099,-1,6.5502183406,12.372634643,-50.94614265
48,173,2002,12,4,-26,0,9,8,-17,-11,1336,8.9452105852,2.9817368617,-19.3812896,-2,6.7089079389,5.9634737234,-12.67238166
48,173,2003,15,5,-23,0,7,10,-16,-7,1329,11.257035647,3.7523452158,-17.26078799,-1,5.2532833021,7.5046904315,-12.00750469
48,173,2004,11,7,-47,0,6,4,-41,-38,1291,8.3969465649,5.3435114504,-35.8778626,-1,4.5801526718,3.0534351145,-31.29770992
48,173,2005,7,5,-24,0,7,2,-17,-17,1274,5.4580896686,3.8986354776,-18.71345029,-2,5.4580896686,1.559454191,-13.25536062
48,173,2006,7,6,-71,0,6,1,-65,-64,1210,5.6360708535,4.8309178744,-57.16586151,0,4.8309178744,0.8051529791,-52.33494364
48,173,2007,13,2,-51,0,3,11,-48,-43,1167,10.938157341,1.6827934371,-42.91123265,-6,2.5241901557,9.2553639041,-40.38704249
48,173,2008,12,1,40,0,2,11,42,45,1212,10.088272383,0.8406893653,33.627574611,-8,1.6813787306,9.2475830181,35.308953342
48,175,2001,81,59,5,121,4,22,9,23,6997,11.595447713,8.4460668528,0.7157683774,-8,0.5726147019,3.1493808604,1.2883830792
48,175,2002,93,86,9,115,4,7,13,13,7010,13.279074748,12.279574498,1.2850717498,-7,0.5711429999,0.9995002499,1.8562147498
48,175,2003,70,69,62,114,3,1,65,59,7069,9.9438880602,9.8018325165,8.8074437105,-7,0.4261666312,0.1420555437,9.2336103416
48,175,2004,75,75,-73,108,2,0,-71,-77,6992,10.667804566,10.667804566,-10.38332978,-6,0.2844747884,0,-10.09885499
48,175,2005,67,77,-3,104,3,-10,0,-16,6976,9.5933562428,11.025200458,-0.429553265,-6,0.4295532646,-1.431844215,0
48,175,2006,71,75,90,117,2,-4,92,84,7060,10.116842405,10.686805358,12.824166429,-4,0.2849814762,-0.569962952,13.109147905
48,175,2007,75,60,21,104,2,15,23,39,7099,10.593968501,8.4751748005,2.9663111802,1,0.2825058267,2.1187937001,3.2488170069
48,175,2008,80,68,42,104,1,12,43,53,7152,11.227282296,9.5431899516,5.8943232054,-2,0.1403410287,1.6840923444,6.0346642341
48,177,2001,312,235,-160,303,73,77,-87,-29,18626,16.737748451,12.606957968,-8.583460744,-19,3.9162039645,4.1307904831,-4.66725678
48,177,2002,288,232,16,298,70,56,86,123,18749,15.411371237,12.414715719,0.856187291,-19,3.745819398,2.9966555184,4.602006689
48,177,2003,384,189,-7,327,55,195,48,216,18965,20.363790635,10.022803203,-0.371214933,-27,2.9166887628,10.340987432,2.5454738293
48,177,2004,327,188,-49,344,55,139,6,131,19096,17.18294317,9.8788786422,-2.574814114,-14,2.8900974751,7.304064528,0.3152833609
48,177,2005,356,204,18,347,57,152,75,210,19306,18.540701005,10.624446643,0.9374511744,-17,2.9685953857,7.9162543618,3.9060465601
48,177,2006,380,202,-327,338,57,178,-270,-100,19206,19.734108849,10.490236809,-16.98171998,-8,2.9601163274,9.2438720399,-14.02160366
48,177,2007,337,194,-329,266,44,143,-285,-164,19042,17.621836436,10.144321272,-17.20351391,-22,2.3007738967,7.4775151642,-14.90274001
48,177,2008,363,188,-100,266,45,175,-55,113,19155,19.006728277,9.843705003,-5.236013299,-7,2.3562059848,9.1630232741,-2.879807315
48,179,2001,238,293,-472,1712,52,-55,-420,-487,22090,10.656636891,13.11930508,-21.13417064,-12,2.3283408333,-2.462668189,-18.80582981
48,179,2002,272,278,-357,1605,51,-6,-306,-332,21758,12.406495165,12.680167853,-16.2835249,-20,2.3262178435,-0.273672687,-13.95730706
48,179,2003,251,264,-263,1713,45,-13,-218,-248,21510,11.602107793,12.203013775,-12.15679024,-17,2.0800591661,-0.600905981,-10.07673107
48,179,2004,285,260,-332,1704,38,25,-294,-292,21218,13.340198465,12.170005617,-15.54016102,-23,1.7786931286,1.1701928478,-13.76146789
48,179,2005,312,286,91,1703,44,26,135,140,21358,14.656144307,13.434798948,4.2747087561,-21,2.0668921458,1.2213453589,6.3416009019
48,179,2006,347,297,266,1698,41,50,307,347,21705,16.115923182,13.793744049,12.353992987,-10,1.904186889,2.3221791329,14.258179876
48,179,2007,321,256,189,1694,37,65,226,291,21996,14.690739342,11.715979039,8.6496876502,0,1.6933250955,2.974760303,10.343012746
48,179,2008,356,247,110,1694,36,109,146,252,22248,16.092577525,11.165355754,4.9724256396,-3,1.6273393002,4.9272217702,6.5997649399
48,181,2001,1490,1298,1051,2948,242,192,1293,1395,112381,13.341272435,11.622128604,9.4105216975,-90,2.1668375364,1.7191438306,11.577359234
48,181,2002,1636,1263,397,2901,226,373,623,892,113273,14.500075337,11.194129065,3.5186613133,-104,2.0030666418,3.3059462717,5.5217279552
48,181,2003,1560,1206,694,2912,185,354,879,1111,114384,13.704827877,10.594886166,6.0968913761,-122,1.6252520239,3.1099417106,7.7221433999
48,181,2004,1619,1224,50,2875,179,395,229,548,114932,14.120253275,10.675225453,0.4360794711,-76,1.5611645066,3.4450278219,1.9972439777
48,181,2005,1583,1233,212,2880,188,350,400,645,115577,13.734821634,10.69806385,1.8394075719,-105,1.6311727525,3.0367577839,3.4705803244
48,181,2006,1600,1241,763,2916,190,359,953,1252,116829,13.769007685,10.679586586,6.5660955397,-60,1.6350696626,3.0894210993,8.2011652023
48,181,2007,1613,1266,697,2744,165,347,862,1237,118066,13.733795951,10.779284361,5.9345665084,28,1.4048830328,2.9545115903,7.3394495413
48,181,2008,1729,1206,11,2744,168,523,179,738,118804,14.598725039,10.182800692,0.0928779499,36,1.4184995989,4.4159243467,1.5113775489
48,183,2001,1770,1258,-339,3042,280,512,-59,351,111624,15.88177499,11.287724824,-3.041763685,-102,2.5123711849,4.5940501667,-0.5293925
48,183,2002,1853,1200,-48,3189,269,653,221,766,112390,16.543608882,10.713616113,-0.428544645,-108,2.4016356121,5.8299927683,1.9730909675
48,183,2003,1852,1127,-39,3109,242,725,203,760,113150,16.422807484,9.9937926754,-0.345836659,-168,2.1459608052,6.4290148089,1.8001241465
48,183,2004,1906,1193,-254,3193,214,713,-40,590,113740,16.801093041,10.516109128,-2.238970426,-83,1.8863766583,6.2849839129,-0.352593768
48,183,2005,1862,1231,-109,3327,224,631,115,640,114380,16.324741364,10.792565317,-0.955637384,-106,1.9638786604,5.5321760477,1.0082412765
48,183,2006,1973,1233,520,3294,221,740,741,1423,115803,17.142881968,10.713215138,4.5181442591,-58,1.9202113101,6.4296668303,6.4383555693
48,183,2007,1978,1133,19,3302,207,845,226,1069,116872,17.002256366,9.7389061996,0.1633179327,-2,1.7793058988,7.2633501665,1.9426238315
48,183,2008,1937,1167,-363,3302,206,770,-157,656,117528,16.527303754,9.957337884,-3.097269625,43,1.7576791809,6.5699658703,-1.339590444
48,185,2001,338,261,463,2664,29,77,492,554,24162,14.151140883,10.927360268,19.384550973,-15,1.2141511409,3.2237806154,20.598702114
48,185,2002,335,272,378,2643,29,63,407,457,24619,13.734855784,11.151882905,15.497837273,-13,1.1889875156,2.5829728788,16.686824788
48,185,2003,327,237,128,2644,23,90,151,216,24835,13.224410563,9.5846645367,5.1765276823,-25,0.9301573179,3.6397460266,6.1066850002
48,185,2004,331,243,41,2624,24,88,65,133,24968,13.292371945,9.7584482862,1.6464871594,-20,0.9637973616,3.5339236592,2.610284521
48,185,2005,328,225,-27,2640,24,103,-3,78,25046,13.116327428,8.9974807054,-1.079697685,-22,0.9597312752,4.1188467229,-0.119966409
48,185,2006,333,219,53,2599,24,114,77,179,25225,13.248194784,8.71277675,2.1085715422,-12,0.9548248493,4.5354180343,3.0633963916
48,185,2007,362,214,235,2694,22,148,257,413,25638,14.234315711,8.4147612213,9.2405088178,8,0.8650689106,5.8195544895,10.105577728
48,185,2008,361,231,105,2694,24,130,129,257,25895,14.010439912,8.9651291406,4.0750587003,-2,0.9314419886,5.0453107717,5.0065006889
48,187,2001,1217,598,1439,1646,185,619,1624,2173,92045,13.379728118,6.574426799,15.820401612,-70,2.0338945783,6.8053013187,17.85429619
48,187,2002,1171,654,1458,1784,127,517,1585,2046,94091,12.582197963,7.0271199553,15.665964671,-56,1.3645936305,5.5550780075,17.030558301
48,187,2003,1159,672,1819,1842,0,487,1819,2309,96400,12.168553895,7.0554514387,19.098015129,3,0,5.1131024563,19.098015129
48,187,2004,1280,690,1893,1792,220,590,2113,2583,98983,13.102470532,7.0630505213,19.377325561,-120,2.2519871227,6.039420011,21.629312683
48,187,2005,1391,700,2516,1729,153,691,2669,3276,102259,13.824152016,6.9567982827,25.004720685,-84,1.5205573389,6.8673537333,26.525278023
48,187,2006,1451,709,4306,1768,194,742,4500,5177,107436,13.839147333,6.7622022461,41.069171893,-65,1.8503063974,7.0769450869,42.91947829
48,187,2007,1561,793,4000,1745,131,768,4131,4929,112365,14.203757035,7.2156177633,36.396558705,30,1.1919872976,6.9881392714,37.588546003
48,187,2008,1687,798,3751,1745,154,889,3905,4807,117172,14.699155256,6.9531273825,32.683183975,13,1.3418316001,7.7460278735,34.025015575
48,189,2001,650,317,-1199,2320,92,333,-1107,-785,35794,17.962499827,8.7601729927,-33.13390353,-11,2.5423845909,9.2023268346,-30.59151894
48,189,2002,610,293,-730,2360,87,317,-643,-342,35452,17.123768352,8.2250231592,-20.49237852,-16,2.4422423715,8.8987451927,-18.05013615
48,189,2003,642,287,-533,2121,75,355,-458,-116,35336,18.138667571,8.1087189919,-15.05904956,-13,2.1190032209,10.029948579,-12.94004634
48,189,2004,668,292,215,2425,71,376,286,630,35966,18.737202323,8.1905135901,6.0306863763,-32,1.9915289894,10.546688732,8.0222153656
48,189,2005,605,320,-597,2411,72,285,-525,-269,35697,16.884584793,8.9306894771,-16.66131756,-29,2.0094051324,7.9538953156,-14.65191242
48,189,2006,603,325,-309,2406,72,278,-237,25,35722,16.886262759,9.1012195634,-8.653159523,-16,2.0162701802,7.7850431958,-6.636889343
48,189,2007,647,272,-585,2420,66,375,-519,-149,35573,18.149940389,7.6302686023,-16.41068799,-5,1.8514622344,10.519671786,-14.55922575
48,189,2008,652,282,-779,2420,68,370,-711,-339,35234,18.41625828,7.9653141639,-22.00347423,2,1.9207140537,10.450944116,-20.08276018
48,191,2001,59,66,-7,37,14,-7,7,-5,3758,15.689403005,17.550857599,-1.861454594,-5,3.7229091876,-1.861454594,1.8614545938
48,191,2002,58,58,-55,38,14,0,-41,-41,3717,15.518394649,15.518394649,-14.71571906,0,3.745819398,0,-10.96989967
48,191,2003,51,55,-18,35,12,-4,-6,-16,3701,13.750337018,14.828794823,-4.853060124,-6,3.235373416,-1.078457805,-1.617686708
48,191,2004,45,57,-25,45,11,-12,-14,-30,3671,12.208355941,15.463917526,-6.782419967,-4,2.9842647857,-3.255561584,-3.798155182
48,191,2005,48,62,-47,47,12,-14,-35,-51,3620,13.166918118,17.007269236,-12.89260732,-2,3.2917295296,-3.840351118,-9.600877795
48,191,2006,49,54,-18,49,11,-5,-7,-14,3606,13.562136728,14.946028231,-4.98200941,-2,3.0445613064,-1.383891503,-1.937448104
48,191,2007,34,38,-154,45,7,-4,-147,-155,3451,9.6358225875,10.769448774,-43.64460819,-4,1.9838458268,-1.133626187,-41.66076236
48,191,2008,41,44,-46,45,6,-3,-40,-51,3400,11.969055612,12.844840169,-13.42869654,-8,1.751569114,-0.875784557,-11.67712743
48,193,2001,94,148,-65,232,8,-54,-57,-119,8114,11.500581146,18.107297975,-7.952529516,-8,0.9787728635,-6.606716829,-6.973756653
48,193,2002,83,126,-103,221,7,-43,-96,-149,7965,10.324025126,15.672616456,-12.81174202,-10,0.8707009142,-5.34859133,-11.94104111
48,193,2003,91,116,123,220,2,-25,125,100,8065,11.35371179,14.472863381,15.346225827,0,0.2495321273,-3.119151591,15.595757954
48,193,2004,91,150,-31,223,3,-59,-28,-93,7972,11.348756002,18.706740662,-3.866059737,-6,0.3741348132,-7.35798466,-3.491924924
48,193,2005,80,145,95,215,3,-65,98,27,7999,10.018157911,18.157911214,11.89656252,-6,0.3756809217,-8.139753303,12.272243441
48,193,2006,97,132,112,229,3,-35,115,73,8072,12.071433016,16.427104723,13.938149462,-7,0.3733432892,-4.355671707,14.311492751
48,193,2007,103,122,7,179,1,-19,8,-10,8062,12.768067435,15.123342011,0.8677327383,1,0.1239618198,-2.355274575,0.9916945581
48,193,2008,98,126,61,179,2,-28,63,30,8092,12.133217779,15.59985143,7.5523090256,-5,0.2476166894,-3.466633651,7.799925715
48,195,2001,85,64,-140,86,50,21,-90,-71,5275,16.006025798,12.051595895,-26.36286602,-2,9.4153092929,3.954429903,-16.94755673
48,195,2002,74,57,-140,88,49,17,-91,-75,5200,14.128878282,10.883054893,-26.73031026,-1,9.3556085919,3.245823389,-17.37470167
48,195,2003,90,62,-124,86,34,28,-90,-61,5139,17.409807525,11.993422962,-23.98684592,1,6.5770383983,5.4163845633,-17.40980752
48,195,2004,116,67,-107,86,29,49,-78,-35,5104,22.649614371,13.082104852,-20.8923167,-6,5.6624035927,9.5675095187,-15.22991311
48,195,2005,105,54,-63,86,33,51,-30,19,5123,20.533880903,10.560281608,-12.32032854,-2,6.4535054268,9.973599296,-5.866823115
48,195,2006,95,38,-103,86,32,57,-71,-17,5106,18.574640727,7.4298562909,-20.138821,-3,6.2567210871,11.144784436,-13.88209991
48,195,2007,99,43,-19,86,21,56,2,49,5155,19.296364877,8.3812493909,-3.703342754,-9,4.0931683072,10.915115486,0.3898255531
48,195,2008,121,41,38,86,20,80,58,125,5280,23.191183517,7.8581696215,7.2831816004,-13,3.8332534739,15.333013896,11.116435074
48,197,2001,53,69,-115,65,8,-16,-107,-127,4588,11.394173922,14.83392454,-24.72320757,-4,1.719875309,-3.439750618,-23.00333226
48,197,2002,43,67,-61,66,8,-24,-53,-80,4508,9.454705365,14.73175022,-13.41248901,-3,1.7590149516,-5.277044855,-11.65347405
48,197,2003,52,63,-21,70,1,-11,-20,-38,4470,11.583871686,14.034306082,-4.678102027,-7,0.2227667632,-2.450434395,-4.455335264
48,197,2004,57,66,-74,65,0,-9,-74,-88,4382,12.878445549,14.91188432,-16.71938545,-5,0,-2.033438771,-16.71938545
48,197,2005,62,45,-98,68,1,17,-97,-80,4302,14.27913404,10.363887609,-22.57024413,0,0.2303086135,3.9152464302,-22.33993551
48,197,2006,49,44,-69,59,0,5,-69,-66,4236,11.478097915,10.306863434,-16.16303584,-2,0,1.1712344811,-16.16303584
48,197,2007,50,40,-139,67,1,10,-138,-137,4099,11.99760048,9.5980803839,-33.35332933,-9,0.2399520096,2.399520096,-33.11337732
48,197,2008,57,43,-111,67,0,14,-111,-115,3984,14.103674378,10.639614005,-27.46505011,-18,0,3.4640603736,-27.46505011
48,199,2001,649,493,105,436,11,156,116,223,48378,13.446179027,10.214123668,2.1754218765,-49,0.2279013394,3.2320553593,2.4033232159
48,199,2002,676,470,320,435,9,206,329,491,48869,13.902742501,9.6661079519,6.5811798822,-44,0.1850956842,4.2366345491,6.7662755663
48,199,2003,579,441,216,465,8,138,224,298,49167,11.811987433,8.9966950916,4.4065445347,-64,0.1632053531,2.8152923416,4.5697498878
48,199,2004,686,480,493,448,8,206,501,659,49826,13.859565828,9.6976553898,9.9603002232,-48,0.1616275898,4.1619104381,10.121927813
48,199,2005,699,523,662,422,9,176,671,800,50626,13.917094732,10.41293354,13.180424481,-47,0.1791900609,3.5041611914,13.359614542
48,199,2006,620,498,-13,456,9,122,-4,95,50721,12.235191964,9.8276219326,-0.256544348,-23,0.1776076253,2.4075700317,-0.078936722
48,199,2007,701,479,582,458,8,222,590,809,51530,13.711357346,9.3691015247,11.383751748,-3,0.1564776873,4.3422558215,11.540229435
48,199,2008,709,483,388,458,9,226,397,613,52143,13.677620981,9.3177587221,7.4850732592,-10,0.1736228333,4.3598622592,7.6586960925
48,201,2001,63300,20594,-21296,42403,35512,42706,14216,69869,3483800,18.353861581,5.971238948,-6.174784143,12947,10.296719312,12.382622633,4.1219351697
48,201,2002,64202,20962,-11865,43840,33550,43240,21685,75178,3558978,18.232010153,5.9527646619,-3.36940906,10253,9.5274904306,12.279245491,6.1580813707
48,201,2003,66282,20657,-27555,44970,29396,45625,1841,57872,3616850,18.473686939,5.7573843743,-7.679949965,10406,8.1930614836,12.716302565,0.5131115183
48,201,2004,67071,20410,-29329,45426,26695,46661,-2634,55841,3672691,18.401981689,5.5998038834,-8.046871538,11814,7.3241922914,12.802177805,-0.722679247
48,201,2005,67523,20289,-24674,46733,28108,47234,3434,62384,3735075,18.23032747,5.4777648214,-6.661657509,11716,7.5887926265,12.752562648,0.9271351174
48,201,2006,68555,20455,47129,46881,28025,48100,75154,123357,3858432,18.056215659,5.3874975028,12.412973347,103,7.3813061606,12.668718156,19.794279507
48,201,2007,69876,21440,-19797,47628,25523,48436,5726,53764,3912196,17.984646801,5.5182155162,-5.095341072,-398,6.5690958311,12.466431285,1.4737547596
48,201,2008,70702,22055,-1835,47628,25557,48647,23722,72153,3984349,17.907072017,5.5859872894,-0.464760221,-216,6.472957477,12.321084728,6.0081972559
48,203,2001,781,659,66,2200,96,122,162,220,62274,12.5635416,10.600990927,1.0617077408,-64,1.5443021685,1.9625506724,2.6060099093
48,203,2002,820,627,-536,1900,92,193,-444,-301,61973,13.199513872,10.092799021,-8.627974921,-50,1.4809210685,3.1067148503,-7.147053852
48,203,2003,817,575,-425,1674,73,242,-352,-181,61792,13.202440108,9.2918030138,-6.867854401,-71,1.1796549913,3.9106370945,-5.68819941
48,203,2004,864,607,234,1854,78,257,312,522,62314,13.923581455,9.7819605821,3.7709699773,-47,1.2569899924,4.1416208725,5.0279599697
48,203,2005,803,625,-114,1718,79,178,-35,87,62401,12.877360382,10.022852103,-1.828168224,-56,1.2668885058,2.8545082789,-0.561279718
48,203,2006,849,601,507,1820,80,248,587,803,63204,13.518570121,9.5696827356,8.0729270332,-32,1.2738346403,3.9488873851,9.3467616735
48,203,2007,845,577,-295,1774,71,268,-224,7,63211,13.368666693,9.1286635289,-4.667167662,-37,1.1232844204,4.2400031642,-3.543883242
48,203,2008,904,604,28,1774,74,300,102,383,63594,14.25811285,9.5264382319,0.4416229644,-19,1.1671464059,4.7316746185,1.6087693703
48,205,2001,64,27,-105,1431,5,37,-100,-68,5470,11.627906977,4.9055232558,-19.07703488,-5,0.9084302326,6.7223837209,-18.16860465
48,205,2002,72,39,-420,1107,5,33,-415,-374,5096,13.628620102,7.382169222,-79.50028393,8,0.9464319515,6.2464508802,-78.55385198
48,205,2003,98,35,224,1410,5,63,229,304,5400,18.673780488,6.6692073171,42.682926829,12,0.9527439024,12.004573171,43.635670732
48,205,2004,77,49,-128,1397,4,28,-124,-104,5296,14.397905759,9.1623036649,-23.934181,-8,0.7479431563,5.2356020942,-23.18623785
48,205,2005,70,50,-127,1428,5,20,-122,-101,5195,13.344771709,9.5319797922,-24.21122867,1,0.9531979792,3.8127919169,-23.25803069
48,205,2006,65,46,-40,1422,4,19,-36,-21,5174,12.53737101,8.8726010223,-7.715305237,-4,0.7715305237,3.6647699875,-6.943774713
48,205,2007,75,39,-42,1424,5,36,-37,-17,5157,14.519407608,7.5500919562,-8.130868261,-16,0.9679605072,6.9693156519,-7.162907753
48,205,2008,76,25,-17,1424,4,51,-13,5,5162,14.730109507,4.8454307588,-3.294892916,-33,0.7752689214,9.8846787479,-2.519623995
48,207,2001,62,101,-79,115,7,-39,-72,-116,5927,10.359231412,16.875522139,-13.19966583,-5,1.1695906433,-6.516290727,-12.03007519
48,207,2002,70,89,-195,108,7,-19,-188,-211,5716,12.024392339,15.288155974,-33.49652152,-4,1.2024392339,-3.263763635,-32.29408228
48,207,2003,56,94,-89,106,5,-38,-84,-126,5590,9.906244472,16.628338935,-15.74385282,-4,0.8844861136,-6.722094463,-14.85936671
48,207,2004,63,100,-81,107,4,-37,-77,-119,5471,11.391375102,18.08154778,-14.6460537,-5,0.7232619112,-6.690172679,-13.92279179
48,207,2005,59,78,-20,112,5,-19,-15,-39,5432,10.822709346,14.307988627,-3.668715033,-5,0.9171787581,-3.485279281,-2.751536274
48,207,2006,67,79,-119,121,4,-12,-115,-130,5302,12.483696665,14.719582635,-22.17253587,-3,0.7452953233,-2.23588597,-21.42724054
48,207,2007,53,78,-54,120,4,-25,-50,-75,5227,10.067432805,14.816221863,-10.25738437,0,0.7598062494,-4.748789059,-9.497578118
48,207,2008,58,76,4,120,3,-18,7,-11,5216,11.10791918,14.555204443,0.7660633917,0,0.5745475438,-3.447285263,1.3406109356
48,209,2001,1482,524,4651,7486,187,958,4838,5801,104854,14.536038488,5.139597954,45.618836038,5,1.8341694988,9.3964405342,47.453005537
48,209,2002,1606,582,5740,9084,178,1024,5918,7008,111862,14.821240702,5.3710847376,52.972553942,66,1.6427028923,9.4501559645,54.615256834
48,209,2003,1625,521,3111,9205,144,1104,3255,4421,116283,14.245326437,4.5672708146,27.272129567,62,1.2623550812,9.6780556225,28.534484648
48,209,2004,1697,623,2901,9396,147,1074,3048,3961,120244,14.349313186,5.2678975339,24.529969094,-161,1.2429870586,9.0814156523,25.772956153
48,209,2005,1670,561,4924,9974,148,1109,5072,6080,126324,13.545958924,4.5504688362,39.940300445,-101,1.2004801921,8.9954900879,41.140780637
48,209,2006,1773,652,5374,9936,150,1121,5524,6563,132887,13.679975001,5.0306507054,41.46428971,-82,1.1573582911,8.6493242957,42.621648001
48,209,2007,1987,656,7523,10731,131,1331,7654,9063,141950,14.459479619,4.773738616,54.745176232,78,0.9532923151,9.6857410028,55.698468547
48,209,2008,2194,697,5906,10731,134,1497,6040,7526,149476,15.056995601,4.7833755396,40.531730182,-11,0.9196159574,10.273620061,41.451346139
48,211,2001,47,33,-39,143,5,14,-34,-23,3302,14.184397163,9.9592575826,-11.77003169,-3,1.5089784216,4.2251395805,-10.26105327
48,211,2002,47,42,-4,144,5,5,1,3,3305,14.227334645,12.713788406,-1.210836991,-3,1.5135462388,1.5135462388,0.3027092478
48,211,2003,46,26,-49,144,1,20,-48,-31,3274,13.983888129,7.9039367685,-14.89588083,-3,0.303997568,6.0799513604,-14.59188326
48,211,2004,52,34,-2,136,0,18,-2,12,3286,15.853658537,10.365853659,-0.609756098,-4,0,5.487804878,-0.609756098
48,211,2005,54,32,13,140,1,22,14,35,3321,16.346299379,9.6866959286,3.935220221,-1,0.3027092478,6.6596034509,4.2379294687
48,211,2006,54,37,14,139,0,17,14,29,3350,16.18947684,11.092789687,4.1972717733,-2,0,5.0966871534,4.1972717733
48,211,2007,57,21,-30,146,1,36,-29,6,3356,16.99970176,6.2630480167,-8.947211452,-1,0.2982403817,10.736653743,-8.648971071
48,211,2008,52,17,78,146,0,35,78,116,3472,15.231400117,4.9794961921,22.847100176,3,0,10.251903925,22.847100176
48,213,2001,914,932,482,1131,103,-18,585,500,74042,12.386166522,12.630095403,6.5318733738,-67,1.3958152645,-0.243928881,7.9276886383
48,213,2002,980,890,876,1198,99,90,975,1022,75064,13.145010932,11.93781605,11.75003018,-43,1.3279143696,1.2071948815,13.07794455
48,213,2003,967,891,1488,1197,83,76,1571,1667,76731,12.740867618,11.739517112,19.605388847,20,1.0935801574,1.0013505056,20.698969004
48,213,2004,925,907,1534,1258,79,18,1613,1528,78259,11.936253952,11.703980902,19.794825473,-103,1.0194206078,0.2322730499,20.81424608
48,213,2005,985,886,127,1258,83,99,210,242,78501,12.566981373,11.303904057,1.6203113039,-67,1.0589436081,1.2630773156,2.679254912
48,213,2006,977,828,116,1258,85,149,201,311,78812,12.421096794,10.526784182,1.4747668661,-39,1.0806481346,1.8943126124,2.5554150007
48,213,2007,1019,867,-291,1239,74,152,-217,-99,78713,12.937628948,11.007776543,-3.694651643,-34,0.9395334074,1.9298524044,-2.755118235
48,213,2008,970,873,-35,1239,76,97,41,101,78814,12.315349115,11.083814203,-0.444368267,-37,0.9649139513,1.2315349115,0.5205456842
48,215,2001,15276,2849,-1672,5640,5128,12427,3456,15338,588836,26.285043714,4.9022053902,-2.876969959,-545,8.8236255672,21.382838324,5.9466556085
48,215,2002,15201,3073,2728,6028,4847,12128,7575,19170,608006,25.4018492,5.1351807507,4.5586635496,-533,8.0996489094,20.266668449,12.658312459
48,215,2003,16042,2978,3426,6293,4253,13064,7679,20037,628043,25.956899767,4.8185791987,5.543469555,-706,6.8816042082,21.138320568,12.425073763
48,215,2004,16425,3144,3145,6314,3836,13281,6981,19728,647771,25.748267381,4.9286181215,4.9301857481,-534,6.0134157487,20.819649259,10.943601497
48,215,2005,16653,3193,2522,6213,4055,13460,6577,19383,667154,25.329201285,4.8565507538,3.8359602259,-654,6.1676521475,20.472650531,10.003612373
48,215,2006,17157,3225,1311,6318,4025,13932,5336,18880,686034,25.357895577,4.766521725,1.9376465059,-388,5.948914711,20.591373852,7.8865612169
48,215,2007,17379,3469,1956,6384,3671,13910,5627,19444,705478,24.978584446,4.985943348,2.8113304089,-93,5.276275016,19.992641098,8.0876054249
48,215,2008,18125,3557,2727,6384,3675,14568,6402,21126,726604,25.312796334,4.9675926379,3.8084411368,156,5.1323876705,20.345203696,8.9408288073
48,217,2001,527,369,71,871,128,158,199,320,32906,16.09356868,11.268551884,2.1682037501,-37,3.9088743663,4.8250167959,6.0770781164
48,217,2002,468,456,322,796,124,12,446,429,33335,14.130221464,13.767908093,9.7220754518,-29,3.7439048324,0.3623133709,13.465980284
48,217,2003,490,413,543,834,103,77,646,702,34037,14.546102238,12.260286172,16.119456154,-21,3.0576500623,2.285816066,19.177106216
48,217,2004,440,434,312,858,95,6,407,383,34420,12.854784755,12.679492236,9.1152110084,-30,2.7754648904,0.1752925194,11.890675899
48,217,2005,469,415,83,849,99,54,182,203,34623,13.585736425,12.021493852,2.4042987703,-33,2.8677780514,1.5642425735,5.2720768217
48,217,2006,483,407,119,853,98,76,217,276,34899,13.894882196,11.70852392,3.4233767728,-17,2.81925146,2.1863582751,6.2426282328
48,217,2007,478,405,101,840,87,73,188,264,35163,13.645057235,11.561188661,2.8831606292,3,2.4835146014,2.0838685735,5.3666752305
48,217,2008,493,393,277,840,89,100,366,474,35637,13.926553672,11.101694915,7.8248587571,8,2.5141242938,2.8248587571,10.338983051
48,219,2001,341,179,-255,665,29,162,-226,-88,22567,15.08115519,7.9165008182,-11.2776967,-24,1.2825615851,7.1646543718,-9.995135111
48,219,2002,349,216,-141,626,29,133,-112,0,22567,15.4650596,9.5714982053,-6.248061328,-21,1.2850622591,5.893561395,-4.962999069
48,219,2003,336,221,-10,639,21,115,11,93,22660,14.858381056,9.7729232538,-0.442213722,-33,0.928648816,5.0854578018,0.4864350941
48,219,2004,380,218,-276,648,19,162,-257,-116,22544,16.812671445,9.6451641448,-12.21130873,-21,0.8406335723,7.1675073002,-11.37067516
48,219,2005,353,201,-93,651,21,152,-72,64,22608,15.636073707,8.9032600992,-4.119418852,-16,0.9301913536,6.7328136074,-3.189227498
48,219,2006,348,218,-409,592,20,130,-389,-268,22340,15.484559936,9.7000978909,-18.19880751,-9,0.8899172377,5.784462045,-17.30889027
48,219,2007,361,176,-336,617,18,185,-318,-154,22186,16.215245025,7.9054934196,-15.09230562,-21,0.8085163725,8.3097516058,-14.28378925
48,219,2008,367,192,-140,617,17,175,-123,19,22205,16.534883197,8.6504021085,-6.307584871,-33,0.76592102,7.8844810885,-5.541663851
48,221,2001,447,489,1171,644,61,-42,1232,1181,42644,10.629317417,11.628045228,27.84548254,-9,1.4505332493,-0.998727811,29.296015789
48,221,2002,466,485,942,649,59,-19,1001,967,43611,10.805170715,11.245724886,21.842212046,-15,1.3680366356,-0.440554171,23.210248681
48,221,2003,499,467,1031,711,43,32,1074,1110,44721,11.298283748,10.573744509,23.343748585,4,0.9735996015,0.7245392383,24.317348186
48,221,2004,515,469,964,729,46,46,1010,999,45720,11.388640108,10.371402351,21.317765173,-57,1.0172377572,1.0172377572,22.33500293
48,221,2005,546,561,1094,731,44,-15,1138,1082,46802,11.802598301,12.126845507,23.648429563,-41,0.9511251378,-0.324247206,24.599554701
48,221,2006,589,511,1114,755,46,78,1160,1213,48015,12.423932417,10.778657836,23.497895947,-25,0.9702901378,1.6452745816,24.468186085
48,221,2007,565,543,928,760,42,22,970,1024,49039,11.643002864,11.189647001,19.123374616,32,0.8654975581,0.4533558637,19.988872174
48,221,2008,602,535,1395,760,44,67,1439,1534,50573,12.086897161,10.74167771,28.008673654,28,0.8834276995,1.3452194515,28.892101353
48,223,2001,482,360,-4,469,77,122,73,161,32173,15.019085456,11.2175742,-0.124639713,-34,2.3993144816,3.8015112565,2.2746747682
48,223,2002,452,373,-33,469,73,79,40,87,32260,14.030077755,11.577918148,-1.024319836,-32,2.2659196375,2.4521596077,1.2415998013
48,223,2003,455,381,123,470,56,74,179,215,32475,14.057310574,11.771066656,3.8001081332,-38,1.7301305322,2.2862439175,5.5302386653
48,223,2004,441,398,316,455,54,43,370,384,32859,13.499862246,12.183549147,9.6733706799,-29,1.6530443567,1.3163130988,11.326415037
48,223,2005,471,378,98,476,56,93,154,216,33075,14.287014287,11.466011466,2.9726696393,-31,1.6986683653,2.821002821,4.6713380047
48,223,2006,475,307,15,466,55,168,70,220,33295,14.313695947,9.2511676962,0.452011451,-18,1.6573753202,5.0625282507,2.1093867711
48,223,2007,496,336,218,438,48,160,266,404,33699,14.807296176,10.030749022,6.5080454966,-22,1.432964146,4.7765471535,7.9410096427
48,223,2008,489,342,-71,438,49,147,-22,105,33804,14.488244967,10.132882983,-2.10361021,-20,1.451787328,4.3553619839,-0.651822882
48,225,2001,241,315,-87,3014,50,-74,-37,-133,23026,10.436288838,13.640792465,-3.767456967,-22,2.1652051532,-3.204503627,-1.602251813
48,225,2002,250,333,21,2950,49,-83,70,-35,22991,10.865549688,14.472912185,0.9127061738,-22,2.1296477389,-3.607362496,3.0423539127
48,225,2003,236,287,-18,2977,37,-51,19,-65,22926,10.279417209,12.500816691,-0.784023346,-33,1.6116035455,-2.221399482,0.8275801991
48,225,2004,268,314,137,3024,35,-46,172,106,23032,11.662822577,13.664650333,5.9619652726,-20,1.5231298142,-2.001827756,7.4850950868
48,225,2005,248,301,-189,2988,37,-53,-152,-225,22807,10.820480377,13.132921748,-8.246253191,-20,1.6143458627,-2.312441371,-6.631907328
48,225,2006,268,303,-52,2992,37,-35,-15,-60,22747,11.766255433,13.30289327,-2.283004786,-10,1.6244457128,-1.536637836,-0.658559073
48,225,2007,268,281,-84,2945,31,-13,-53,-62,22685,11.797851734,12.370135587,-3.697834126,4,1.3646768797,-0.572283853,-2.333157246
48,225,2008,267,304,5,2945,31,-37,36,13,22698,11.766520503,13.397087015,0.2203468259,14,1.3661503206,-1.630566512,1.5864971465
48,227,2001,425,370,-483,4787,28,55,-455,-422,33027,12.786569589,11.131837054,-14.53156026,-22,0.8424092906,1.6547325351,-13.68915097
48,227,2002,443,391,-106,4825,25,52,-81,-58,32969,13.425056064,11.849202982,-3.212315898,-29,0.757621674,1.575853082,-2.454694224
48,227,2003,463,336,-502,4782,20,127,-482,-367,32602,14.122096659,10.248432996,-15.31164692,-12,0.6100257736,3.8736636623,-14.70162114
48,227,2004,462,394,-271,4807,18,68,-253,-211,32391,14.216915668,12.124382626,-8.339359623,-26,0.5539058052,2.092533042,-7.785453818
48,227,2005,449,387,-402,4830,20,62,-382,-347,32044,13.93652518,12.012105222,-12.4776907,-27,0.6207806316,1.9244199581,-11.85691006
48,227,2006,475,383,-229,4825,19,92,-210,-133,31911,14.854194355,11.977171449,-7.161285279,-15,0.5941677742,2.8770229067,-6.567117504
48,227,2007,473,337,189,4822,17,136,206,334,32245,14.745308311,10.505642496,5.8918885217,-8,0.5299582268,4.2396658146,6.4218467486
48,227,2008,484,356,154,4822,16,128,170,292,32537,14.942422278,10.990707295,4.7544070884,-6,0.4939643728,3.9517149826,5.2483714612
48,229,2001,35,12,-40,32,34,23,-6,15,3358,10.446202059,3.5815549918,-11.93851664,-2,10.147739143,6.8646470676,-1.790777496
48,229,2002,51,16,-109,32,34,35,-75,-42,3316,15.283188493,4.7947258016,-32.66406952,-2,10.188792328,10.488462691,-22.4752772
48,229,2003,67,21,-166,32,17,46,-149,-95,3221,20.498699709,6.4249655805,-50.78782316,8,5.2011626128,14.073734129,-45.58666055
48,229,2004,57,17,-89,32,16,40,-73,-37,3184,17.798594848,5.3083528493,-27.79078845,-4,4.9960967994,12.490241998,-22.79469165
48,229,2005,35,18,-8,32,17,17,9,24,3208,10.951188986,5.6320400501,-2.503128911,-2,5.3191489362,5.3191489362,2.816020025
48,229,2006,39,17,-24,32,16,22,-8,12,3220,12.134411948,5.2893590541,-7.467330429,-2,4.9782202862,6.8450528936,-2.489110143
48,229,2007,45,10,-27,32,12,35,-15,22,3242,13.927576602,3.0950170226,-8.356545961,2,3.7140204271,10.832559579,-4.642525534
48,229,2008,48,5,-162,32,11,43,-151,-105,3137,15.049380781,1.5676438313,-50.79166013,3,3.4488164289,13.481736949,-47.34284371
48,231,2001,1088,703,749,2306,214,385,963,1286,78216,14.025498563,9.0624315161,9.6554213451,-62,2.7586918129,4.9630670465,12.414113158
48,231,2002,1084,764,1089,2794,203,320,1292,1569,79785,13.721432143,9.6708248682,13.784722882,-43,2.5696039898,4.0506072746,16.354326871
48,231,2003,1140,757,-29,2508,169,383,140,405,80190,14.25222691,9.4639787467,-0.362556649,-118,2.1128301297,4.7882481638,1.7502734802
48,231,2004,1095,769,419,2494,169,326,588,848,81038,13.583248567,9.5392859801,5.1976083559,-66,2.0964100528,4.0439625871,7.2940184087
48,231,2005,1138,753,-43,2418,172,385,129,434,81472,14.005291982,9.2671220233,-0.529198203,-80,2.1167928127,4.7381699588,1.5875946096
48,231,2006,1156,802,253,2398,176,354,429,743,82215,14.124518135,9.7991899173,3.0912656472,-40,2.1504456676,4.3253282179,5.2417113149
48,231,2007,1176,744,-100,2415,155,432,55,490,82705,14.261460102,9.022556391,-1.212709192,3,1.8796992481,5.2389037109,0.6669900558
48,231,2008,1165,777,-467,2415,158,388,-309,100,82805,14.077699233,9.3891607758,-5.643163555,21,1.9092501964,4.6885384569,-3.733913359
48,233,2001,323,290,-664,262,46,33,-618,-596,23167,13.765182186,12.358832303,-28.29746431,-11,1.9603665033,1.4063498828,-26.33709781
48,233,2002,335,256,-253,346,46,79,-207,-144,23023,14.505304178,11.084650357,-10.95475211,-16,1.9917731111,3.4206538212,-8.962979
48,233,2003,323,248,-535,329,39,75,-496,-421,22602,14.15890411,10.871232877,-23.45205479,0,1.7095890411,3.2876712329,-21.74246575
48,233,2004,313,236,-448,320,38,77,-410,-360,22242,13.959504059,10.525376862,-19.98037642,-27,1.694764071,3.4341271965,-18.28561235
48,233,2005,293,250,-412,313,39,43,-373,-342,21900,13.27533868,11.327080785,-18.66702913,-12,1.7670246024,1.948257895,-16.90000453
48,233,2006,283,242,-71,360,39,41,-32,-4,21896,12.923554663,11.051237556,-3.242305233,-13,1.7809845648,1.8723171066,-1.461320669
48,233,2007,303,251,-230,327,38,52,-192,-160,21736,13.888888889,11.505317198,-10.54272094,-20,1.7418408508,2.3835716905,-8.800880088
48,233,2008,310,221,-318,327,37,89,-281,-224,21512,14.335923048,10.220125786,-14.70588235,-32,1.7110617832,4.1157972623,-12.99482057
48,235,2001,7,14,-63,0,2,-7,-61,-69,1700,4.0357451715,8.071490343,-36.32170654,-1,1.153070049,-4.035745172,-35.16863649
48,235,2002,15,10,34,0,2,5,36,40,1740,8.7209302326,5.8139534884,19.76744186,-1,1.1627906977,2.9069767442,20.930232558
48,235,2003,11,10,-10,0,1,1,-9,-11,1729,6.3418852695,5.765350245,-5.765350245,-3,0.5765350245,0.5765350245,-5.188815221
48,235,2004,12,11,-26,0,0,1,-26,-28,1701,6.9970845481,6.4139941691,-15.16034985,-3,0,0.583090379,-15.16034985
48,235,2005,6,14,6,0,1,-8,7,-2,1699,3.5294117647,8.2352941176,3.5294117647,-1,0.5882352941,-4.705882353,4.1176470588
48,235,2006,11,8,42,0,0,3,42,44,1743,6.3916327716,4.6484601976,24.404416037,-1,0,1.7431725741,24.404416037
48,235,2007,7,9,-18,0,1,-2,-17,-21,1722,4.0404040404,5.1948051948,-10.38961039,-2,0.5772005772,-1.154401154,-9.812409812
48,235,2008,12,1,-27,0,0,11,-27,-23,1699,7.015492546,0.5846243788,-15.78485823,-7,0,6.4308681672,-15.78485823
48,237,2001,103,98,-120,1052,14,5,-106,-108,8650,11.833639706,11.259191176,-13.78676471,-7,1.6084558824,0.5744485294,-12.17830882
48,237,2002,94,84,166,1097,14,10,180,187,8837,10.750843484,9.6071367301,18.98553211,-3,1.601189455,1.1437067536,20.586721565
48,237,2003,89,94,-17,1081,10,-5,-7,-25,8812,10.085557255,10.652161596,-1.926454757,-13,1.1332086804,-0.56660434,-0.793246076
48,237,2004,103,85,-2,1094,8,18,6,18,8830,11.676680648,9.6360956808,-0.226731663,-6,0.9069266523,2.0405849677,0.6801949892
48,237,2005,82,92,18,1098,10,-10,28,9,8839,9.2817929707,10.413718943,2.0374667497,-9,1.131925972,-1.131925972,3.1693927217
48,237,2006,94,97,62,1104,9,-3,71,65,8904,10.595727893,10.933889421,6.9886715888,-3,1.0144845855,-0.338161528,8.0031561743
48,237,2007,92,88,-106,1107,8,4,-98,-90,8814,10.384919291,9.9334010611,-11.9652331,4,0.9030364601,0.45151823,-11.06219664
48,237,2008,90,96,-28,1107,7,-6,-21,-21,8793,10.223206679,10.904753791,-3.180553189,6,0.7951382973,-0.681547112,-2.385414892
48,239,2001,201,174,-247,240,32,27,-215,-200,14211,14.045140102,12.158479491,-17.25945077,-12,2.2360422053,1.8866606107,-15.02340857
48,239,2002,199,144,-61,254,31,55,-30,11,14222,13.997819435,10.12907537,-4.290788872,-14,2.1805648366,3.868744065,-2.110224035
48,239,2003,231,170,-179,248,23,61,-156,-104,14118,16.302046577,11.997177135,-12.63232181,-9,1.6231474947,4.3048694425,-11.00917431
48,239,2004,196,152,-71,253,24,44,-47,-13,14105,13.889381001,10.771356695,-5.031357404,-10,1.7007405308,3.1180243064,-3.330616873
48,239,2005,198,142,-54,261,24,56,-30,12,14117,14.031606548,10.063071363,-3.826801786,-14,1.7008007937,3.9685351853,-2.126000992
48,239,2006,194,146,-123,262,24,48,-99,-58,14059,13.770584895,10.363429869,-8.730834753,-7,1.7035775128,3.4071550256,-7.02725724
48,239,2007,211,143,-110,250,22,68,-88,-19,14040,15.018328054,10.17829816,-7.829460123,1,1.5658920246,4.8400298943,-6.263568099
48,239,2008,215,145,8,250,23,70,31,106,14146,15.255800752,10.288795856,0.5676577024,5,1.6320158944,4.967004896,2.1996735968
48,241,2001,512,384,-95,898,40,128,-55,37,35627,14.378589382,10.783942036,-2.667902327,-36,1.1233272954,3.5946473454,-1.544575031
48,241,2002,480,406,-227,880,38,74,-189,-152,35475,13.501729909,11.420213215,-6.385193103,-37,1.0688869511,2.0815166943,-5.316306152
48,241,2003,485,429,-272,901,32,56,-240,-222,35253,13.714511933,12.130980658,-7.69143762,-38,0.9048750141,1.5835312747,-6.786562606
48,241,2004,475,409,-277,885,33,66,-244,-210,35043,13.514282463,11.636508478,-7.88096051,-32,0.9388869921,1.8777739843,-6.942073518
48,241,2005,497,389,-148,911,33,108,-115,-38,35005,14.190269529,11.106669712,-4.225673824,-31,0.9422110553,3.0835998173,-3.283462768
48,241,2006,427,379,-714,893,33,48,-681,-647,34358,12.31203956,10.928016378,-20.58734484,-14,0.9515159379,1.3840231824,-19.6358289
48,241,2007,479,373,-5,882,23,106,18,98,34456,13.921585724,10.840817276,-0.145319266,-26,0.6684686256,3.0807684483,0.5231493591
48,241,2008,469,395,-155,882,25,74,-130,-82,34374,13.627778585,11.477553392,-4.503850065,-26,0.7264274299,2.1502251925,-3.777422635
48,243,2001,19,30,-3,68,16,-11,13,0,2229,8.5240017945,13.458950202,-1.34589502,-2,7.1781067743,-4.934948407,5.8322117541
48,243,2002,19,20,-48,68,16,-1,-32,-35,2194,8.5914537644,9.0436355415,-21.7047253,-2,7.2349084332,-0.452181777,-14.46981687
48,243,2003,12,19,27,68,7,-7,34,25,2219,5.4384772264,8.6109222751,12.236573759,-2,3.1724450487,-3.172445049,15.409018808
48,243,2004,12,9,-8,68,6,3,-2,-1,2218,5.4090601758,4.0567951318,-3.606040117,-2,2.7045300879,1.3522650439,-0.901510029
48,243,2005,28,29,-4,68,7,-1,3,0,2218,12.623985573,13.0748422,-1.80342651,-2,3.1559963931,-0.450856628,1.3525698828
48,243,2006,15,17,9,68,6,-2,15,12,2230,6.7446043165,7.6438848921,4.0467625899,-1,2.6978417266,-0.899280576,6.7446043165
48,243,2007,22,9,3,68,4,13,7,18,2248,9.825815096,4.0196516302,1.3398838767,-2,1.7865118356,5.8061634658,3.1263957124
48,243,2008,16,9,21,68,3,7,24,27,2275,7.0749502543,3.979659518,9.2858722087,-4,1.3265531727,3.0952907362,10.612425381
48,245,2001,3437,2636,-3597,14995,540,801,-3057,-2432,249171,13.726750989,10.527703116,-14.3657618,-176,2.156661488,3.1990478739,-12.20910031
48,245,2002,3396,2595,-2069,15560,507,801,-1562,-950,248221,13.655225657,10.434425966,-8.319393959,-189,2.0386335124,3.2207996912,-6.280760446
48,245,2003,3423,2510,-2072,15679,431,913,-1641,-984,247237,13.817518337,10.132039446,-8.36397838,-256,1.739804383,3.6854788902,-6.624173997
48,245,2004,3381,2564,-1400,16213,420,817,-980,-355,246882,13.684962529,10.378066822,-5.666651151,-192,1.6999953453,3.3068957073,-3.966655806
48,245,2005,3472,2549,-1880,16600,434,923,-1446,-739,246143,14.084478475,10.340246438,-7.626388114,-216,1.7605598093,3.7442320369,-5.865828305
48,245,2006,3208,2604,-6139,16359,441,604,-5698,-5179,240964,13.171644013,10.691696075,-25.20596091,-85,1.8106904643,2.4799479375,-23.39527044
48,245,2007,3595,2465,-69,17043,386,1130,317,1408,242372,14.875779996,10.199943724,-0.285515666,-39,1.597232567,4.6758362712,1.3117169009
48,245,2008,3384,2451,-586,17043,391,933,-195,718,243090,13.941358953,10.097597752,-2.414195138,-20,1.6108366875,3.8437612007,-0.80335845
48,247,2001,67,54,-128,47,4,13,-124,-114,5154,12.857417002,10.362694301,-24.56342353,-3,0.7676069852,2.494722702,-23.79581654
48,247,2002,88,57,-34,49,4,31,-30,-5,5149,17.082403184,11.064738426,-6.600019412,-6,0.776472872,6.0176647578,-5.82354654
48,247,2003,76,41,-143,53,3,35,-140,-102,5047,14.907806983,8.0423695567,-28.05021577,3,0.5884660651,6.8654374264,-27.46174971
48,247,2004,74,40,-39,55,2,34,-37,-6,5041,14.670896114,7.9302141158,-7.731958763,-3,0.3965107058,6.7406819984,-7.335448057
48,247,2005,89,56,-43,57,3,33,-40,-11,5030,17.674510972,11.121040612,-8.53937047,-4,0.5957700328,6.5534703604,-7.943600437
48,247,2006,99,45,-94,56,2,54,-92,-41,4989,19.762451342,8.9829324284,-18.76434774,-3,0.3992414413,10.779518914,-18.3651063
48,247,2007,92,37,-90,52,3,55,-87,-37,4952,18.509204305,7.4439191228,-18.1068303,-5,0.60356101,11.065285183,-17.50326929
48,247,2008,96,48,15,52,2,48,17,64,5016,19.261637239,9.6308186196,3.0096308186,-1,0.4012841091,9.6308186196,3.4109149278
48,249,2001,673,329,55,495,17,344,72,377,39749,17.011918454,8.3163761833,1.3902756537,-39,0.4297215657,8.6955422707,1.8199972194
48,249,2002,627,391,-52,492,17,236,-35,162,39911,15.741903088,9.8167210645,-1.305548581,-39,0.4268139593,5.9251820236,-0.878734622
48,249,2003,598,342,-15,481,13,256,-2,197,40108,14.946450218,8.5479698572,-0.374910959,-57,0.3249228308,6.3984803609,-0.049988128
48,249,2004,619,348,99,482,11,271,110,350,40458,15.366283544,8.6388799245,2.4576123923,-31,0.2730680436,6.7274036194,2.7306804359
48,249,2005,663,345,-126,471,13,318,-113,169,40627,16.353209595,8.5095887032,-3.107849787,-36,0.3206511685,7.8436208917,-2.787198619
48,249,2006,693,333,-281,496,13,360,-268,74,40701,17.042101121,8.1890615778,-6.910289199,-18,0.3196930946,8.8530395436,-6.590596105
48,249,2007,732,376,49,491,12,356,61,414,41115,17.893810502,9.1913562139,1.1978097194,-3,0.2933411558,8.7024542877,1.4911508751
48,249,2008,696,391,-373,491,11,305,-362,-46,41069,16.937603426,9.5152341088,-9.077192641,11,0.2676920082,7.4223693176,-8.809500633
48,251,2001,1927,1061,2652,2685,268,866,2920,3708,131675,14.843515302,8.1727917671,20.428127961,-78,2.0643809553,6.6707235347,22.492508916
48,251,2002,1927,1084,2146,2513,255,843,2401,3178,134853,14.46001921,8.1342297995,16.103373754,-66,1.9134950174,6.3257894105,18.016868772
48,251,2003,1996,1048,2249,2621,213,948,2462,3365,138218,14.618908635,7.6756594439,16.471906574,-45,1.5600338374,6.9432491916,18.031940411
48,251,2004,1989,1074,2211,2630,210,915,2421,3180,141398,14.226653696,7.6819638361,15.814545663,-156,1.502059968,6.5446898604,17.316605631
48,251,2005,2061,1097,1389,2685,214,964,1603,2445,143843,14.450937979,7.6917413696,9.7391328736,-122,1.5004855543,6.7591966092,11.239618428
48,251,2006,2055,1058,928,2694,220,997,1148,2071,145914,14.184299258,7.3026708587,6.405367256,-74,1.5185137891,6.881628399,7.9238810452
48,251,2007,2091,1129,2277,2664,197,962,2474,3450,149364,14.162924431,7.6470309336,15.42275415,14,1.3343357785,6.515893497,16.757089929
48,251,2008,2189,1141,2974,2664,200,1048,3174,4266,153630,14.449131006,7.531502274,19.630751764,44,1.3201581549,6.9176287319,20.950909919
48,253,2001,200,218,-568,4787,6,-18,-562,-598,20125,9.7924010967,10.673717195,-27.81041911,-18,0.2937720329,-0.881316099,-27.51664708
48,253,2002,189,242,-70,4856,4,-53,-66,-143,19982,9.4247886903,12.067718852,-3.490662478,-24,0.1994664273,-2.642930162,-3.291196051
48,253,2003,173,199,-18,5057,-2,-26,-20,-71,19911,8.6732008122,9.9766876394,-0.902413957,-25,-0.100268217,-1.303486827,-1.002682175
48,253,2004,170,175,-173,5053,7,-5,-166,-185,19726,8.5778439337,8.8301334612,-8.72921765,-14,0.3532053384,-0.252289527,-8.376012312
48,253,2005,211,201,-186,5073,4,10,-182,-182,19544,10.746116628,10.236822002,-9.472880061,-10,0.2037178508,0.5092946269,-9.26916221
48,253,2006,197,203,-36,5151,6,-6,-30,-47,19497,10.091954612,10.399323788,-1.844215056,-11,0.307369176,-0.307369176,-1.53684588
48,253,2007,177,174,-218,5154,2,3,-216,-240,19257,9.1345409506,8.9797182226,-11.25045157,-27,0.103215152,0.154822728,-11.14723641
48,253,2008,185,170,-33,5154,4,15,-29,-60,19197,9.6218858896,8.8417329797,-1.716336402,-46,0.208040776,0.78015291,-1.508295626
48,255,2001,180,179,-33,3615,6,1,-27,-40,15391,11.679968853,11.615080138,-2.141327623,-14,0.3893322951,0.0648887159,-1.751995328
48,255,2002,174,160,-164,3606,6,14,-158,-154,15237,11.362152279,10.447956119,-10.70915502,-10,0.3917983544,0.9141961604,-10.31735667
48,255,2003,176,150,-57,3606,4,26,-53,-44,15193,11.567532041,9.8586920802,-3.74630299,-17,0.2628984555,1.7088399606,-3.483404535
48,255,2004,179,131,-44,3597,4,48,-40,-3,15190,11.782904914,8.623243261,-2.896356515,-11,0.2633051377,3.1596616529,-2.633051377
48,255,2005,176,163,-135,3586,4,13,-131,-129,15061,11.635978976,10.776503256,-8.925324783,-11,0.2644540676,0.8594757198,-8.660870715
48,255,2006,196,124,-72,3599,4,72,-68,-4,15057,13.015472475,8.2342785045,-4.78119397,-8,0.2656218872,4.7811939704,-4.515572083
48,255,2007,184,140,-55,3593,3,44,-52,-21,15036,12.228757518,9.3044894161,-3.655335128,-13,0.1993819161,2.9242681022,-3.455953212
48,255,2008,189,147,-16,3593,3,42,-13,15,15051,12.56356566,9.7716621797,-1.063582278,-14,0.1994216771,2.7919034799,-0.864160601
48,257,2001,1164,678,2354,1489,208,486,2562,3087,75169,15.809739832,9.2087659846,31.972618183,39,2.8251081487,6.6009738474,34.797726331
48,257,2002,1165,734,1912,1413,197,431,2109,2575,77744,15.237422587,9.6002301963,25.007684108,35,2.5766285404,5.6371923904,27.584312648
48,257,2003,1210,745,2940,1414,166,465,3106,3746,81490,15.197759273,9.3572980645,36.926786993,175,2.0849818506,5.840461208,39.011768843
48,257,2004,1253,723,2426,1488,159,530,2585,3076,84566,15.091294503,8.7079057667,29.219058631,-39,1.9150166209,6.3833887363,31.134075252
48,257,2005,1276,753,2613,1480,158,523,2771,3302,87868,14.799865456,8.7337764014,30.307247991,8,1.832585221,6.0660890544,32.139833212
48,257,2006,1418,709,3111,1495,160,709,3271,3986,91854,15.779926776,7.8899633879,34.620135543,6,1.7805277039,7.8899633879,36.400663247
48,257,2007,1591,772,3554,1442,147,819,3701,4604,96458,16.897489273,8.1991588428,37.745868559,84,1.5612387952,8.6983304303,39.307107354
48,257,2008,1638,774,3000,1442,149,864,3149,4069,100527,16.630707922,7.8584663807,30.459172018,56,1.5128055436,8.7722415412,31.971977562
48,259,2001,305,240,453,438,41,65,494,542,24511,12.582508251,9.900990099,18.688118812,-17,1.6914191419,2.6815181518,20.379537954
48,259,2002,291,238,563,465,37,53,600,647,25158,11.717570315,9.5834423886,22.670075902,-6,1.4898628923,2.1341279269,24.159938795
48,259,2003,340,262,909,499,26,78,935,1032,26190,13.242969541,10.204876529,35.405468567,19,1.0126976708,3.0380930124,36.418166238
48,259,2004,316,243,807,490,34,73,841,877,27067,11.866984622,9.1255609591,30.305875284,-37,1.2768274593,2.7414236626,31.582702743
48,259,2005,361,268,1205,516,32,93,1237,1324,28391,13.01886112,9.6649716903,43.456309279,-6,1.1540264705,3.3538894298,44.61033575
48,259,2006,310,270,1307,508,33,40,1340,1358,29749,10.663914689,9.2879256966,44.960440316,-22,1.1351909185,1.3759889921,46.095631235
48,259,2007,369,292,1367,523,28,77,1395,1422,31171,12.114248194,9.5863427446,44.878529219,-50,0.9192383454,2.5279054498,45.797767564
48,259,2008,445,296,1615,523,30,149,1645,1715,32886,13.893875767,9.2417690494,50.423841266,-79,0.936665782,4.6521067175,51.360507048
48,261,2001,7,3,-9,4,2,4,-7,-3,416,16.766467066,7.1856287425,-21.55688623,0,4.7904191617,9.5808383234,-16.76646707
48,261,2002,5,4,2,4,2,1,4,4,420,11.961722488,9.5693779904,4.7846889952,-1,4.7846889952,2.3923444976,9.5693779904
48,261,2003,6,4,-9,4,1,2,-8,-6,414,14.388489209,9.5923261391,-21.58273381,0,2.3980815348,4.7961630695,-19.18465228
48,261,2004,7,1,4,4,0,6,4,9,423,16.726403823,2.3894862605,9.5579450418,-1,0,14.336917563,9.5579450418
48,261,2005,5,4,9,4,1,1,10,10,433,11.682242991,9.3457943925,21.028037383,-1,2.3364485981,2.3364485981,23.364485981
48,261,2006,2,8,-22,4,0,-6,-22,-28,405,4.7732696897,19.093078759,-52.50596659,0,0,-14.31980907,-52.50596659
48,261,2007,6,0,-18,4,1,6,-17,-11,394,15.018773467,0,-45.0563204,0,2.5031289111,15.018773467,-42.55319149
48,261,2008,4,1,-7,4,0,3,-7,-6,388,10.230179028,2.557544757,-17.9028133,-2,0,7.6726342711,-17.9028133
48,263,2001,8,15,-29,38,1,-7,-28,-36,808,9.6852300242,18.159806295,-35.10895884,-1,1.210653753,-8.474576271,-33.89830508
48,263,2002,7,22,9,35,1,-15,10,-6,802,8.6956521739,27.329192547,11.180124224,-1,1.2422360248,-18.63354037,12.422360248
48,263,2003,5,14,-24,38,1,-9,-23,-31,771,6.3572790846,17.800381437,-30.51493961,1,1.2714558169,-11.44310235,-29.24348379
48,263,2004,8,7,-13,48,0,1,-13,-12,759,10.45751634,9.1503267974,-16.99346405,0,0,1.3071895425,-16.99346405
48,263,2005,4,22,-2,45,1,-18,-1,-20,739,5.3404539386,29.372496662,-2.670226969,-1,1.3351134846,-24.03204272,-1.335113485
48,263,2006,4,20,-7,39,0,-16,-7,-23,716,5.4982817869,27.491408935,-9.621993127,0,0,-21.99312715,-9.621993127
48,263,2007,6,14,19,39,1,-8,20,10,726,8.3217753121,19.417475728,26.352288488,-2,1.386962552,-11.09570042,27.73925104
48,263,2008,8,7,-16,39,0,1,-16,-18,708,11.157601116,9.7629009763,-22.31520223,-3,0,1.3947001395,-22.31520223
48,265,2001,494,604,431,1796,94,-110,525,374,44205,11.22268163,13.721659321,9.7914489527,-41,2.1354900268,-2.498977691,11.92693898
48,265,2002,517,664,537,1814,89,-147,626,443,44648,11.637198519,14.946034461,12.08738028,-36,2.0033088359,-3.308835943,14.090689116
48,265,2003,501,619,314,1760,74,-118,388,234,44882,11.191779292,13.827767229,7.0144085781,-36,1.6530771808,-2.635987937,8.667485759
48,265,2004,547,684,792,1959,63,-137,855,666,45548,12.09775517,15.127723101,17.516310959,-52,1.3933429172,-3.029967931,18.909653876
48,265,2005,523,649,681,1908,72,-126,753,595,46143,11.407880817,14.156242161,14.854238693,-32,1.5704921966,-2.748361344,16.42473089
48,265,2006,607,608,862,2049,71,-1,933,903,47046,13.027288628,13.048750389,18.500037558,-29,1.5237849961,-0.021461761,20.023822554
48,265,2007,589,677,669,1997,62,-88,731,619,47665,12.43783721,14.296121887,14.127186916,-24,1.3092460221,-1.858284677,15.436432938
48,265,2008,612,671,654,1997,61,-59,715,604,48269,12.758771656,13.988783956,13.634373632,-52,1.2717076323,-1.2300123,14.906081264
48,267,2001,51,70,1,49,19,-19,20,-3,4488,11.359839626,15.591936741,0.2227419534,-4,4.2320971155,-4.232097115,4.4548390689
48,267,2002,50,60,9,46,17,-10,26,11,4499,11.12718371,13.352620452,2.0028930678,-5,3.7832424613,-2.225436742,5.7861355291
48,267,2003,47,65,-16,45,13,-18,-3,-27,4472,10.478207558,14.491138112,-3.567049381,-6,2.8982276223,-4.012930554,-0.668821759
48,267,2004,51,54,33,40,11,-3,44,37,4509,11.357309876,12.025386928,7.3488475671,-4,2.4496158557,-0.668077052,9.7984634228
48,267,2005,40,55,36,35,13,-15,49,29,4538,8.8427102907,12.15872665,7.9584392616,-5,2.8738808445,-3.316016359,10.832320106
48,267,2006,60,76,-41,31,12,-16,-29,-48,4490,13.291980505,16.83650864,-9.082853345,-3,2.658396101,-3.544528135,-6.424457244
48,267,2007,56,45,-75,31,10,11,-65,-50,4440,12.541993281,10.078387458,-16.79731243,4,2.2396416573,2.4636058231,-14.55767077
48,267,2008,48,56,-8,31,9,-8,1,-8,4432,10.820559062,12.623985573,-1.80342651,-1,2.0288548242,-1.80342651,0.2254283138
48,269,2001,1,4,-43,57,1,-3,-42,-44,314,2.9761904762,11.904761905,-127.9761905,1,2.9761904762,-8.928571429,-125
48,269,2002,5,1,-9,57,1,4,-8,-5,309,16.051364366,3.2102728732,-28.89245586,-1,3.2102728732,12.841091493,-25.68218299
48,269,2003,0,2,4,57,1,-2,5,3,312,0,6.4412238325,12.882447665,0,3.2206119163,-6.441223833,16.103059581
48,269,2004,4,2,3,57,0,2,3,5,317,12.718600954,6.3593004769,9.5389507154,0,0,6.3593004769,9.5389507154
48,269,2005,0,2,-21,57,1,-2,-20,-22,295,0,6.5359477124,-68.62745098,0,3.2679738562,-6.535947712,-65.35947712
48,269,2006,2,0,-7,57,0,2,-7,-6,289,6.8493150685,0,-23.97260274,-1,0,6.8493150685,-23.97260274
48,269,2007,2,1,3,57,1,1,4,4,293,6.8728522337,3.4364261168,10.309278351,-1,3.4364261168,3.4364261168,13.745704467
48,269,2008,2,0,-13,57,0,2,-13,-12,281,6.968641115,0,-45.29616725,-1,0,6.968641115,-45.29616725
48,271,2001,35,34,-4,23,7,1,3,0,3383,10.345846881,10.050251256,-1.182382501,-4,2.0691693763,0.2955956252,0.8867868756
48,271,2002,36,43,15,23,6,-7,21,12,3395,10.622602538,12.688108587,4.4260843907,-2,1.7704337563,-2.065506049,6.1965181469
48,271,2003,36,34,-114,23,0,2,-114,-108,3287,10.775217001,10.176593834,-34.1215205,4,0,0.5986231667,-34.1215205
48,271,2004,32,30,-38,23,3,2,-35,-36,3251,9.7889262771,9.1771183848,-11.62434995,-3,0.9177118385,0.6118078923,-10.70663812
48,271,2005,36,39,22,23,2,-3,24,17,3268,11.044638748,11.965025311,6.7495014573,-4,0.6135910416,-0.920386562,7.3630924988
48,271,2006,35,29,-6,23,2,6,-4,0,3268,10.709914321,8.8739290086,-1.835985312,-2,0.611995104,1.8359853121,-1.223990208
48,271,2007,34,24,20,23,1,10,21,28,3296,10.359536868,7.3126142596,6.0938452163,-3,0.3046922608,3.0469226082,6.3985374771
48,271,2008,40,17,-80,23,2,23,-78,-63,3233,12.253024966,5.2075356104,-24.50604993,-8,0.6126512483,7.0454893552,-23.89339868
48,273,2001,509,258,-671,1400,61,251,-610,-376,31129,16.253153239,8.2383370055,-21.42606252,-17,1.9478238656,8.014816234,-19.47823866
48,273,2002,519,262,-202,1514,32,257,-170,62,31191,16.655969191,8.4082156611,-6.48267009,-25,1.026957638,8.2477535302,-5.455712452
48,273,2003,493,197,-314,1563,-38,296,-352,-85,31106,15.827407419,6.3245421128,-10.08074225,-29,-1.219962438,9.5028653065,-11.30070469
48,273,2004,498,229,-533,1145,87,269,-446,-212,30894,16.064516129,7.3870967742,-17.19354839,-35,2.8064516129,8.6774193548,-14.38709677
48,273,2005,485,255,-463,1178,47,230,-416,-208,30686,15.751867489,8.2819097109,-15.03734979,-22,1.526469633,7.4699577785,-13.51088016
48,273,2006,518,220,-541,1217,69,298,-472,-188,30498,16.932531381,7.1914225941,-17.68436192,-14,2.2554916318,9.7411087866,-15.42887029
48,273,2007,506,223,-163,1515,37,283,-126,136,30634,16.554341425,7.2956880194,-5.332722633,-21,1.2104953216,9.2586534057,-4.122227311
48,273,2008,521,218,-219,1515,49,303,-170,105,30739,16.978150001,7.104101152,-7.136688772,-28,1.5967933782,9.8740488488,-5.539895394
48,275,2001,50,78,-207,123,14,-28,-193,-219,4025,12.093360745,18.865642762,-50.06651348,2,3.3861410086,-6.772282017,-46.68037248
48,275,2002,47,75,-44,118,14,-28,-30,-61,3964,11.766178495,18.775816748,-11.01514583,-3,3.5048191263,-7.009638253,-7.510326699
48,275,2003,51,60,-57,113,5,-9,-52,-64,3900,12.970498474,15.259409969,-14.49643947,-3,1.2716174975,-2.288911495,-13.22482197
48,275,2004,47,59,-99,100,4,-12,-95,-112,3788,12.226847034,15.348595213,-25.75442248,-5,1.0405827263,-3.121748179,-24.71383975
48,275,2005,41,61,-132,99,5,-20,-127,-149,3639,11.040797092,16.426551771,-35.54598088,-2,1.3464386697,-5.385754679,-34.19954221
48,275,2006,41,58,-39,95,4,-17,-35,-54,3585,11.351052049,16.057585825,-10.79734219,-2,1.1074197121,-4.706533776,-9.689922481
48,275,2007,46,38,-96,102,2,8,-94,-88,3497,12.990680599,10.731431799,-27.1109856,-2,0.5648121999,2.2592487998,-26.5461734
48,275,2008,46,47,-101,102,1,-1,-100,-104,3393,13.352685051,13.642960813,-29.31785196,-3,0.290275762,-0.290275762,-29.0275762
48,277,2001,647,566,-143,1207,74,81,-69,-33,48571,13.316182146,11.649086699,-2.943143813,-45,1.5230254695,1.6670954464,-1.420118343
48,277,2002,681,580,133,1250,69,101,202,254,48825,13.984147193,11.910140047,2.7311183211,-49,1.4168959711,2.0740071461,4.1480142922
48,277,2003,623,555,194,1257,47,68,241,247,49072,12.727662748,11.338447552,3.9633492344,-62,0.9601928558,1.3892151956,4.9235420902
48,277,2004,657,592,-92,1239,61,65,-31,-1,49071,13.3886268,12.064029019,-1.874815321,-35,1.2430840712,1.3245977808,-0.631731249
48,277,2005,673,599,-66,1222,56,74,-10,23,49094,13.711608007,12.203942342,-1.344674782,-41,1.1409361789,1.507665665,-0.203738603
48,277,2006,648,574,-153,1201,61,74,-92,-40,49054,13.204548233,11.696621429,-3.117740555,-22,1.2430207442,1.5079268044,-1.874719811
48,277,2007,638,564,-98,1147,49,74,-49,36,49090,13.001304206,11.493315944,-1.997065536,11,0.9985327682,1.5079882621,-0.998532768
48,277,2008,660,570,51,1147,52,90,103,196,49286,13.417906807,11.588192242,1.0368382532,3,1.0571684151,1.8297145645,2.0940066683
48,279,2001,217,194,-184,294,21,23,-163,-150,14502,14.886464979,13.308636894,-12.62262468,-10,1.4406256431,1.5778280853,-11.18199904
48,279,2002,240,183,-32,307,21,57,-11,31,14533,16.531771999,12.605476149,-2.204236267,-15,1.4465300499,3.9262958498,-0.757706217
48,279,2003,248,199,-100,304,9,49,-91,-60,14473,17.099910363,13.721299042,-6.895125147,-18,0.6205612632,3.3786113218,-6.274563883
48,279,2004,245,176,-221,315,11,69,-210,-157,14316,17.020389732,12.226892216,-15.35308625,-16,0.7641807635,4.7934975164,-14.58890548
48,279,2005,229,153,-153,331,10,76,-143,-76,14240,16.038660877,10.715786525,-10.71578652,-9,0.7003782042,5.3228743522,-10.01540832
48,279,2006,250,161,-386,320,10,89,-376,-292,13948,17.738044558,11.423300695,-27.3875408,-5,0.7095217823,6.3147438626,-26.67801902
48,279,2007,226,161,-184,302,6,65,-178,-129,13819,16.278315987,11.596499442,-13.25314222,-16,0.4321676811,4.6818165448,-12.82097454
48,279,2008,238,171,-298,302,8,67,-290,-234,13585,17.369727047,12.479929937,-21.74864983,-11,0.5838563713,4.8897971099,-21.16479346
48,281,2001,221,192,201,350,30,29,231,247,18124,12.277436738,10.666370379,11.16635649,-13,1.6666203717,1.6110663593,12.832976862
48,281,2002,254,208,499,360,11,46,510,551,18675,13.804722954,11.304655018,27.120302182,-5,0.5978423327,2.5000679366,27.718144515
48,281,2003,248,191,312,353,-40,57,272,329,19004,13.163831312,10.138273309,16.56094907,0,-2.123198599,3.0255580031,14.437750471
48,281,2004,215,182,1164,344,51,33,1215,1197,20201,10.967988777,9.2845300344,59.380181099,-51,2.6017089657,1.6834587425,61.981890065
48,281,2005,246,187,-730,343,21,59,-709,-654,19547,12.377981282,9.4092784543,-36.73140787,-4,1.0566569387,2.9687028278,-35.67475093
48,281,2006,271,187,702,346,36,84,738,808,20355,13.583279034,9.3729637612,35.186206205,-14,1.804420831,4.2103152724,36.990627036
48,281,2007,267,215,482,352,13,52,495,519,20874,12.952048316,10.429552014,23.38160033,-28,0.6306240753,2.5224963011,24.012224405
48,281,2008,254,198,277,352,22,56,299,323,21197,12.07482589,9.4126595517,13.168215635,-32,1.0458510613,2.6621663379,14.214066697
48,283,2001,92,51,-128,583,1,41,-127,-90,5787,15.775034294,8.7448559671,-21.9478738,-4,0.1714677641,7.0301783265,-21.77640604
48,283,2002,100,52,-4,569,0,48,-4,39,5826,17.222078705,8.9554809265,-0.688883148,-5,0,8.2665977784,-0.688883148
48,283,2003,93,47,-10,634,0,46,-10,28,5854,15.924657534,8.0479452055,-1.712328767,-8,0,7.8767123288,-1.712328767
48,283,2004,93,35,-7,638,1,58,-6,47,5901,15.82305402,5.9549128031,-1.190982561,-5,0.1701403658,9.8681412165,-1.020842195
48,283,2005,96,49,56,626,1,47,57,99,6000,16.133098059,8.2346021343,9.4109738677,-5,0.1680531048,7.8984959247,9.5790269725
48,283,2006,81,50,-89,634,1,31,-88,-60,5940,13.567839196,8.3752093802,-14.9078727,-3,0.1675041876,5.1926298157,-14.74036851
48,283,2007,99,40,-27,625,0,59,-27,31,5971,16.623289396,6.7164805642,-4.533624381,-1,0,9.9068088322,-4.533624381
48,283,2008,103,36,-175,625,0,67,-175,-110,5861,17.410412441,6.0851926978,-29.58079784,-2,0,11.325219743,-29.58079784
48,285,2001,238,305,-242,453,16,-67,-226,-307,18863,12.515447112,16.038703231,-12.72579076,-14,0.8413745957,-3.52325612,-11.88441616
48,285,2002,259,270,75,450,15,-11,90,64,18927,13.707329981,14.289494575,3.9693040487,-15,0.7938608097,-0.582164594,4.7631648584
48,285,2003,232,274,11,435,13,-42,24,-42,18885,12.271236644,14.492753623,0.5818258754,-24,0.6876123982,-2.221516979,1.2694382736
48,285,2004,234,278,-56,448,11,-44,-45,-103,18782,12.424668808,14.760931319,-2.973425014,-14,0.5840656277,-2.336262511,-2.389359386
48,285,2005,236,231,-26,456,13,5,-13,-28,18754,12.574595055,12.308184143,-1.385336743,-20,0.6926683717,0.2664109122,-0.692668372
48,285,2006,247,269,-20,427,12,-22,-8,-39,18715,13.184232299,14.35853639,-1.067549174,-9,0.6405295044,-1.174304091,-0.42701967
48,285,2007,254,260,-4,430,11,-6,7,8,18723,13.569100914,13.889630856,-0.213686629,7,0.5876382285,-0.320529943,0.3739516
48,285,2008,256,239,-103,430,10,17,-93,-71,18652,13.698996656,12.789297659,-5.511705686,5,0.5351170569,0.9096989967,-4.976588629
48,287,2001,209,138,212,615,31,71,243,305,16022,13.169917137,8.6959261476,13.358959009,-9,1.9534326853,4.473990989,15.312391695
48,287,2002,220,139,26,626,30,81,56,119,16141,13.680315891,8.6434723129,1.6167646053,-18,1.8654976215,5.036843578,3.4822622268
48,287,2003,211,146,20,654,20,65,40,82,16223,13.039179335,9.0223705352,1.2359411692,-23,1.2359411692,4.0168087999,2.4718823384
48,287,2004,219,131,-148,660,22,88,-126,-53,16170,13.521439817,8.0881671966,-9.13777668,-15,1.3583181552,5.4332726206,-7.779458525
48,287,2005,207,162,-16,656,22,45,6,41,16211,12.785275316,10.005867638,-0.988233841,-10,1.3588215311,2.7794076773,0.3705876903
48,287,2006,211,138,-70,681,24,73,-46,20,16231,13.007829357,8.5074902904,-4.315393626,-7,1.4795635288,4.5003390666,-2.835830097
48,287,2007,205,144,-16,641,19,61,3,54,16285,12.609177021,8.8571780047,-0.984130889,-10,1.1686554312,3.7519990159,0.1845245418
48,287,2008,203,138,36,641,21,65,57,115,16400,12.421600122,8.4442404773,2.2028453419,-7,1.2849931161,3.9773596451,3.487838458
48,289,2001,201,210,61,115,26,-9,87,63,15490,13.002555229,13.584759194,3.9460490992,-15,1.6819225669,-0.582203965,5.6279716661
48,289,2002,178,165,240,119,26,13,266,272,15762,11.391270959,10.559324203,15.359017023,-7,1.6638935108,0.8319467554,17.022910534
48,289,2003,183,235,106,106,16,-52,122,56,15818,11.58961368,14.882837239,6.713109563,-14,1.0132995567,-3.293223559,7.7264091197
48,289,2004,188,188,35,96,15,0,50,37,15855,11.871309949,11.871309949,2.2100842989,-13,0.9471789853,0,3.1572632842
48,289,2005,206,204,254,96,16,2,270,255,16110,12.88909745,12.763960582,15.892382293,-17,1.0010949476,0.1251368684,16.893477241
48,289,2006,213,216,221,101,15,-3,236,225,16335,13.129912159,13.314840499,13.6230544,-8,0.9246417013,-0.18492834,14.547696101
48,289,2007,199,173,38,97,13,26,51,73,16408,12.155269829,10.567144122,2.3211068015,-4,0.7940628531,1.5881257063,3.1151696546
48,289,2008,219,198,416,97,12,21,428,451,16859,13.166200739,11.90368834,25.009769441,2,0.721435657,1.2625123997,25.731205098
48,291,2001,1026,678,674,4771,114,348,788,1081,71641,14.430278268,9.5357979198,9.479539525,-55,1.603364252,4.8944803482,11.082903777
48,291,2002,1037,728,1262,4907,106,309,1368,1640,73281,14.311146686,10.046783787,17.416265301,-37,1.4628558811,4.2643628987,18.879121182
48,291,2003,1102,693,73,4846,95,409,168,463,73744,14.990647849,9.4269682027,0.9930283965,-114,1.2922972284,5.5636796463,2.2853256249
48,291,2004,1118,690,173,5025,88,428,261,639,74383,15.095154833,9.3163299061,2.3358334402,-50,1.1881696112,5.7788249273,3.5240030514
48,291,2005,1027,671,-315,5168,95,356,-220,72,74455,13.800239186,9.0165145998,-4.232790013,-64,1.2765557183,4.7837245865,-2.956234295
48,291,2006,1036,665,-417,5091,94,371,-323,15,74470,13.913043478,8.9306698002,-5.600134296,-33,1.2623803928,4.982373678,-4.337753903
48,291,2007,1118,673,-73,4899,78,445,5,460,74930,14.966532798,9.0093708166,-0.977242303,10,1.0441767068,5.9571619813,0.0669344043
48,291,2008,1114,697,-123,4899,80,417,-43,403,75333,14.827336071,9.2770675416,-1.637129566,29,1.0647997178,5.5502685292,-0.572329848
48,293,2001,275,300,-29,1829,73,-25,44,-2,22045,12.473918171,13.607910732,-1.315431371,-21,3.3112582781,-1.133992561,1.9958269074
48,293,2002,308,267,130,1829,73,41,203,226,22271,13.900171496,12.049823991,5.8669555014,-18,3.2945211662,1.8503475043,9.1614766676
48,293,2003,302,295,72,1817,56,7,128,110,22381,13.526829705,13.213293917,3.2249395324,-25,2.508286303,0.3135357879,5.7332258353
48,293,2004,299,299,81,1814,47,0,128,110,22491,13.32679622,13.32679622,3.6102692102,-18,2.0948475664,0,5.7051167766
48,293,2005,299,288,-167,1825,52,11,-115,-124,22367,13.330955459,12.840518971,-7.445717598,-20,2.3184270364,0.4904364885,-5.127290561
48,293,2006,268,278,38,1841,51,-10,89,69,22436,11.963484588,12.409883267,1.6963149789,-10,2.2766332612,-0.446398679,3.9729482401
48,293,2007,305,264,-207,1829,47,41,-160,-124,22312,13.631894163,11.799410029,-9.251810137,-5,2.1006525431,1.8324841334,-7.151157594
48,293,2008,297,247,-212,1829,46,50,-166,-120,22192,13.347114866,11.100125831,-9.527233507,-4,2.0672299119,2.2469890347,-7.460003595
48,295,2001,34,36,-103,50,16,-2,-87,-90,2941,11.386470194,12.056262559,-34.49430676,-1,5.3583389149,-0.669792364,-29.13596785
48,295,2002,36,37,44,54,16,-1,60,57,2998,12.123253073,12.460010103,14.817309311,-2,5.3881124768,-0.33675703,20.205421788
48,295,2003,40,30,10,57,9,10,19,27,3025,13.2824174,9.96181305,3.32060435,-2,2.988543915,3.32060435,6.309148265
48,295,2004,44,37,-103,55,8,7,-95,-94,2931,14.77501679,12.424445937,-34.58697112,-6,2.6863666891,2.3505708529,-31.90060443
48,295,2005,43,37,-16,51,9,6,-7,-4,2927,14.680778423,12.632297713,-5.462615227,-3,3.0727210652,2.0484807101,-2.389894162
48,295,2006,41,31,15,53,8,10,23,32,2959,13.931362555,10.533469249,5.0968399592,-1,2.7183146449,3.3978933062,7.8151546041
48,295,2007,38,24,17,47,4,14,21,30,2989,12.777404169,8.0699394755,5.7162071284,-5,1.3449899126,4.707464694,7.061197041
48,295,2008,49,22,-34,47,3,27,-31,-8,2981,16.415410385,7.3701842546,-11.39028476,-4,1.0050251256,9.0452261307,-10.38525963
48,297,2001,115,104,-202,1600,3,11,-199,-196,12084,9.4401576096,8.5371860121,-16.58184206,-8,0.2462649811,0.9029715974,-16.33557708
48,297,2002,130,108,-178,1598,3,22,-175,-162,11922,10.830625677,8.9977505624,-14.82962593,-9,0.2499375156,1.8328751146,-14.57968841
48,297,2003,102,94,-233,1600,3,8,-230,-230,11692,8.6389429999,7.9613788431,-19.73405607,-8,0.2540865588,0.6775641569,-19.47996951
48,297,2004,111,82,-103,1635,1,29,-102,-82,11610,9.5270792207,7.0380224873,-8.84044288,-9,0.0858295425,2.4890567333,-8.754613338
48,297,2005,115,76,-136,1638,2,39,-134,-100,11510,9.9480968858,6.5743944637,-11.76470588,-5,0.1730103806,3.3737024221,-11.5916955
48,297,2006,100,91,-138,1638,1,9,-137,-134,11376,8.7389670541,7.9524600192,-12.05977453,-6,0.0873896705,0.7865070349,-11.97238486
48,297,2007,102,76,-101,1638,2,26,-99,-94,11282,9.0034424927,6.7084473475,-8.915173449,-21,0.1765380881,2.2949951452,-8.738635361
48,297,2008,118,77,-50,1638,1,41,-49,-35,11247,10.475387279,6.8356340716,-4.438723423,-27,0.0887744685,3.639753207,-4.349948955
48,299,2001,147,230,414,229,8,-83,422,333,17443,8.5086678436,13.31288166,23.963186988,-6,0.4630567534,-4.804213816,24.426243741
48,299,2002,152,287,407,191,8,-135,415,277,17720,8.6454511845,16.323976908,23.149333106,-3,0.4550237466,-7.678525723,23.604356852
48,299,2003,153,268,284,168,8,-115,292,176,17896,8.5916442049,15.049415993,15.947888589,-1,0.4492362983,-6.457771788,16.397124888
48,299,2004,139,278,128,216,6,-139,134,-22,17874,7.7718758736,15.543751747,7.1568353369,-17,0.3354766564,-7.771875874,7.4923119933
48,299,2005,158,254,199,212,8,-96,207,104,17978,8.8140131652,14.169362937,11.101193797,-7,0.4462791476,-5.355349771,11.547472944
48,299,2006,156,286,136,218,7,-130,143,2,17980,8.6767895879,15.907447578,7.5643806663,-11,0.3893431225,-7.23065799,7.9537237889
48,299,2007,169,278,480,219,7,-109,487,362,18342,9.3056549749,15.307527119,26.430262651,-16,0.3854413303,-6.001872144,26.815703981
48,299,2008,173,268,183,219,6,-95,189,58,18400,9.4170159491,14.588209678,9.9613521311,-36,0.3266017092,-5.171193729,10.28795384
48,301,2001,0,0,-3,0,1,0,-2,-2,62,0,0,-47.61904762,0,15.873015873,0,-31.74603175
48,301,2002,2,0,1,0,1,2,2,4,66,31.25,0,15.625,0,15.625,31.25,31.25
48,301,2003,0,0,-7,0,1,0,-6,-6,60,0,0,-111.1111111,0,15.873015873,0,-95.23809524
48,301,2004,0,1,-13,0,0,-1,-13,-15,45,0,19.047619048,-247.6190476,-1,0,-19.04761905,-247.6190476
48,301,2005,1,1,7,0,1,0,8,9,54,20.202020202,20.202020202,141.41414141,1,20.202020202,0,161.61616162
48,301,2006,0,0,3,0,0,0,3,3,57,0,0,54.054054054,0,0,0,54.054054054
48,301,2007,0,0,-3,0,1,0,-2,-3,54,0,0,-54.05405405,-1,18.018018018,0,-36.03603604
48,301,2008,0,0,-11,0,0,0,-11,-12,42,0,0,-229.1666667,-1,0,0,-229.1666667
48,303,2001,3804,1913,1176,10227,288,1891,1464,3335,246400,15.543501578,7.8166978231,4.8052465447,-20,1.1767950722,7.7268037551,5.9820416169
48,303,2002,3970,2052,309,10188,268,1918,577,2417,248817,16.033375268,8.287276083,1.2479377727,-78,1.0823537964,7.7460991848,2.3302915692
48,303,2003,4048,1952,1263,10307,233,2096,1496,3512,252329,16.154972802,7.7901449877,5.0404472948,-80,0.9298687408,8.3648278146,5.9703160356
48,303,2004,4049,1990,-363,10338,232,2059,-131,2000,254329,15.983168133,7.8553975265,-1.432919247,72,0.9158051388,8.1277706066,-0.517114109
48,303,2005,4019,2026,-469,10027,236,1993,-233,1740,256069,15.748494312,7.9389025819,-1.837781496,-20,0.924768514,7.8095917304,-0.913012982
48,303,2006,3966,2035,1162,10096,240,1931,1402,3335,259404,15.387808867,7.8956608785,4.5084805606,2,0.9311835925,7.4921479884,5.4396641531
48,303,2007,4260,2050,-10,10110,213,2210,203,2423,261827,16.345919563,7.8659941561,-0.038370703,10,0.8172959782,8.4799254074,0.778925275
48,303,2008,4329,2080,22,10110,216,2249,238,2591,264418,16.45241285,7.905063231,0.0836112457,104,0.8209104125,8.5473496185,0.9045216582
48,305,2001,97,60,-111,38,4,37,-107,-75,6411,15.042257889,9.3044894161,-17.21330542,-5,0.6202992944,5.7377684733,-16.59300613
48,305,2002,89,73,-52,47,4,16,-48,-36,6375,13.921476615,11.418739246,-8.133896449,-4,0.6256843422,2.502737369,-7.508212107
48,305,2003,88,62,-257,41,-1,26,-258,-224,6151,14.050774389,9.8994092288,-41.03464793,8,-0.159667891,4.1513651605,-41.19431582
48,305,2004,90,64,-107,36,0,26,-107,-90,6061,14.739600393,10.481493613,-17.52374713,-9,0,4.2581067802,-17.52374713
48,305,2005,97,66,-42,41,0,31,-42,-15,6046,16.023787891,10.902783514,-6.938134963,-4,0,5.1210043776,-6.938134963
48,305,2006,85,60,-12,40,0,25,-12,10,6056,14.047264915,9.9157164105,-1.983143282,-3,0,4.1315485044,-1.983143282
48,305,2007,84,40,-266,40,0,44,-266,-221,5835,14.128332352,6.7277773106,-44.73971912,1,0,7.4005550416,-44.73971912
48,305,2008,88,50,-90,40,0,38,-90,-52,5783,15.148906869,8.6073334481,-15.49320021,0,0,6.5415734206,-15.49320021
48,307,2001,88,133,-141,114,6,-45,-135,-184,7987,10.892437183,16.462433469,-17.45265503,-4,0.7426661716,-5.569996287,-16.70998886
48,307,2002,101,123,-125,105,6,-22,-119,-145,7842,12.761387327,15.541095458,-15.7937962,-4,0.7581022174,-2.779708131,-15.03569398
48,307,2003,107,102,58,105,4,5,62,60,7902,13.592479675,12.957317073,7.3678861789,-7,0.5081300813,0.6351626016,7.8760162602
48,307,2004,96,131,133,101,3,-35,136,91,7993,12.079270211,16.483170808,16.734822271,-10,0.3774771941,-4.403900598,17.112299465
48,307,2005,108,107,-65,132,4,1,-61,-66,7927,13.567839196,13.442211055,-8.165829146,-6,0.5025125628,0.1256281407,-7.663316583
48,307,2006,99,105,37,118,3,-6,40,31,7958,12.464589235,13.220018886,4.6584828455,-3,0.3777148253,-0.755429651,5.0361976708
48,307,2007,107,102,-124,108,3,5,-121,-115,7843,13.543446617,12.91057528,-15.69520916,1,0.3797228024,0.6328713373,-15.31548636
48,307,2008,102,95,89,108,2,7,91,100,7943,12.922843025,12.035981249,11.275814012,2,0.2533890789,0.8868617763,11.529203091
48,309,2001,3291,1972,-267,9436,635,1319,368,1484,215569,15.31930344,9.1794793019,-1.242860534,-203,2.9558668138,6.1398241376,1.7130062795
48,309,2002,3221,1967,86,9530,593,1254,679,1723,217292,14.882375636,9.0883678594,0.3973561952,-210,2.7399095784,5.7940077762,3.1372657735
48,309,2003,3372,1893,614,9388,505,1479,1119,2299,219591,15.436627198,8.6659357311,2.8108212038,-299,2.3118317719,6.7706914666,5.1226529757
48,309,2004,3323,2074,1336,10050,485,1249,1821,2883,222474,15.033988214,9.383235497,6.0443599923,-187,2.1942474523,5.6507527174,8.2386074446
48,309,2005,3310,1960,-98,9709,505,1350,407,1537,224011,14.826925877,8.7796902472,-0.438984512,-220,2.2621140688,6.0472356294,1.8231295564
48,309,2006,3471,2015,-157,9383,514,1456,357,1704,225715,15.436065515,8.9610118161,-0.698202906,-109,2.2858362647,6.4750536994,1.587633359
48,309,2007,3473,2029,171,9764,457,1444,628,2091,227806,15.315718567,8.9477664761,0.7540995897,19,2.0153421782,6.3679520904,2.7694417679
48,309,2008,3594,1955,219,9764,462,1639,681,2407,230213,15.693672097,8.5367637587,0.9562922062,87,2.0173835583,7.1569083379,2.9736757645
48,311,2001,6,6,-11,0,2,0,-9,-11,840,7.0963926671,7.0963926671,-13.01005322,-2,2.3654642224,0,-10.644589
48,311,2002,7,10,-10,0,2,-3,-8,-11,829,8.388256441,11.983223487,-11.98322349,0,2.3966446974,-3.594967046,-9.58657879
48,311,2003,2,7,21,0,1,-5,22,17,846,2.3880597015,8.3582089552,25.074626866,0,1.1940298507,-5.970149254,26.268656716
48,311,2004,1,2,-52,0,0,-1,-52,-55,791,1.2217470984,2.4434941967,-63.53084911,-2,0,-1.221747098,-63.53084911
48,311,2005,11,6,65,0,1,5,66,71,862,13.309134906,7.2595281307,78.644888082,0,1.2099213551,6.0496067756,79.854809437
48,311,2006,11,6,-20,0,0,5,-20,-15,847,12.873025161,7.0216500878,-23.40550029,0,0,5.8513750731,-23.40550029
48,311,2007,9,5,21,0,1,4,22,25,872,10.471204188,5.8173356603,24.432809773,-1,1.1634671321,4.6538685282,25.596276905
48,311,2008,6,3,-38,0,0,3,-38,-35,837,7.0216500878,3.5108250439,-44.47045056,0,0,3.5108250439,-44.47045056
48,313,2001,167,163,664,3684,34,4,698,705,13676,12.534244005,12.234022592,49.836754607,3,2.551882013,0.3002214133,52.38863662
48,313,2002,141,131,-1000,2634,34,10,-966,-935,12741,10.674944165,9.9178559261,-75.70882386,21,2.5741000114,0.7570882386,-73.13472385
48,313,2003,153,114,138,2858,27,39,165,195,12936,11.917280056,8.8795420026,10.748919266,-9,2.1030494217,3.0377380535,12.851968688
48,313,2004,143,151,134,2865,24,-8,158,139,13075,10.995348122,11.610472492,10.303333205,-11,1.8453731114,-0.61512437,12.148706317
48,313,2005,152,107,-93,2842,26,45,-67,-32,13043,11.639482349,8.1935829696,-7.121525385,-10,1.9909640861,3.4458993797,-5.130561299
48,313,2006,159,139,101,2813,25,20,126,139,13182,12.125834128,10.600571973,7.7025738799,-7,1.906577693,1.5252621544,9.6091515729
48,313,2007,173,135,93,2787,22,38,115,148,13330,13.050694025,10.184067592,7.0156910078,-5,1.6596258298,2.8666264333,8.6753168377
48,313,2008,163,116,-8,2787,21,47,13,52,13382,12.20425277,8.6852351003,-0.598981731,-8,1.572327044,3.51901767,0.973345313
48,315,2001,98,154,142,120,5,-56,147,84,11029,8.9196322927,14.016565031,12.924365159,-7,0.4550832802,-5.096932739,13.379448439
48,315,2002,137,144,-77,126,4,-7,-73,-97,10932,12.476663176,13.114156915,-7.012431128,-17,0.3642821365,-0.637493739,-6.648148991
48,315,2003,114,146,76,133,4,-32,80,41,10973,10.408582515,13.330289888,6.9390550103,-7,0.3652134216,-2.921707373,7.3042684319
48,315,2004,112,135,-131,124,3,-23,-128,-158,10815,10.280888563,12.392142464,-12.02496787,-7,0.2753809436,-2.111253901,-11.74958693
48,315,2005,107,140,-32,131,4,-33,-28,-66,10749,9.9239473196,12.98460397,-2.967909479,-5,0.3709886848,-3.06065665,-2.596920794
48,315,2006,84,175,75,131,3,-91,78,-19,10730,7.821593184,16.2949858,6.9835653429,-6,0.2793426137,-8.473392616,7.2629079566
48,315,2007,99,133,12,129,4,-34,16,-39,10691,9.243265954,12.417720928,1.1203958732,-21,0.3734652911,-3.174454974,1.4938611643
48,315,2008,105,138,-83,129,3,-33,-80,-147,10544,9.8893336473,12.997409936,-7.817282788,-34,0.2825523899,-3.108076289,-7.534730398
48,317,2001,77,61,-63,94,19,16,-44,-33,4687,16.370787711,12.969065589,-13.39428085,-5,4.0395450197,3.4017221218,-9.354735835
48,317,2002,59,39,-88,100,19,20,-69,-49,4638,12.654155496,8.3646112601,-18.87399464,0,4.0750670241,4.2895442359,-14.79892761
48,317,2003,63,44,-149,96,13,19,-136,-115,4523,13.753956992,9.6059382164,-32.52919987,2,2.8381181094,4.1480187752,-29.69108176
48,317,2004,61,60,-175,84,11,1,-164,-171,4352,13.746478873,13.521126761,-39.43661972,-8,2.4788732394,0.2253521127,-36.95774648
48,317,2005,80,49,-3,86,13,31,10,38,4390,18.302447952,11.210249371,-0.686341798,-3,2.9741477923,7.0921985816,2.2878059941
48,317,2006,69,53,-23,86,11,16,-12,3,4393,15.71217124,12.068769213,-5.237390413,-1,2.5048388933,3.6434020266,-2.73255152
48,317,2007,73,33,2,87,7,40,9,46,4439,16.530797101,7.472826087,0.4528985507,-3,1.5851449275,9.0579710145,2.0380434783
48,317,2008,80,35,23,87,6,45,29,74,4513,17.873100983,7.8194816801,5.1385165326,0,1.3404825737,10.053619303,6.4789991063
48,319,2001,27,47,37,37,3,-20,40,15,3756,7.2028811525,12.538348673,9.8706149126,-5,0.8003201281,-5.33546752,10.670935041
48,319,2002,30,63,23,41,3,-33,26,-12,3744,8,16.8,6.1333333333,-5,0.8,-8.8,6.9333333333
48,319,2003,35,46,48,41,2,-11,50,36,3780,9.3035619351,12.227538543,12.759170654,-3,0.5316321106,-2.923976608,13.290802764
48,319,2004,33,58,80,41,1,-25,81,51,3831,8.6716594403,15.24109841,21.022204704,-5,0.2627775588,-6.56943897,21.284982263
48,319,2005,36,46,5,35,2,-10,7,-6,3825,9.4043887147,12.016718913,1.3061650993,-3,0.5224660397,-2.612330199,1.828631139
48,319,2006,41,48,40,31,1,-7,41,32,3857,10.674303567,12.496745639,10.413954699,-2,0.2603488675,-1.822442072,10.674303567
48,319,2007,41,33,17,29,2,8,19,26,3883,10.594315245,8.5271317829,4.3927648579,-1,0.5167958656,2.0671834625,4.9095607235
48,319,2008,38,43,0,29,1,-5,1,-1,3882,9.7875080489,11.075338055,0,3,0.2575660013,-1.287830006,0.2575660013
48,321,2001,554,399,-341,463,167,155,-174,-52,37894,14.609704641,10.522151899,-8.992616034,-33,4.4040084388,4.0875527426,-4.588607595
48,321,2002,564,373,-450,451,157,191,-293,-124,37770,14.908014379,9.8593783041,-11.89469232,-22,4.1499259886,5.0486360753,-7.744766335
48,321,2003,550,367,-257,450,139,183,-118,25,37795,14.557003904,9.7134916959,-6.802090915,-40,3.6789518957,4.843512208,-3.123139019
48,321,2004,558,368,-528,502,124,190,-404,-255,37540,14.813831552,9.7696953607,-14.017389,-41,3.2919625672,5.0441361917,-10.72542643
48,321,2005,559,325,-580,493,132,234,-448,-244,37296,14.93933401,8.6856593084,-15.50056123,-30,3.5277139345,6.253674702,-11.97284729
48,321,2006,538,314,-642,511,131,224,-511,-303,36993,14.483974747,8.4534722503,-17.28385091,-16,3.5267670853,6.030502497,-13.75708382
48,321,2007,553,344,-476,506,121,209,-355,-133,36860,14.975694962,9.3158030141,-12.89047161,13,3.2767795486,5.6598919475,-9.613692064
48,321,2008,546,365,83,506,122,181,205,405,37265,14.731871838,9.8482293423,2.239460371,19,3.2917369309,4.8836424958,5.5311973019
48,323,2001,1001,270,-783,114,316,731,-467,236,47579,21.091001032,5.6888813974,-16.49775605,-28,6.658098228,15.402119635,-9.839657824
48,323,2002,1170,276,-358,124,296,894,-62,794,48373,24.387193597,5.7528764382,-7.462064366,-38,6.1697515424,18.634317159,-1.292312823
48,323,2003,919,243,-173,119,257,676,84,691,49064,18.863470755,4.9878382955,-3.551012449,-69,5.2752034648,13.87563246,1.7241910157
48,323,2004,1053,264,-474,124,237,789,-237,505,49569,21.351880202,5.3531779425,-9.611387669,-47,4.8056938347,15.99870226,-4.805693835
48,323,2005,1067,265,-505,129,252,802,-253,506,50075,21.416241821,5.3189354101,-10.13608446,-43,5.0580065032,16.097306411,-5.078077958
48,323,2006,1102,317,-225,123,255,785,30,788,50863,21.835185956,6.2810834374,-4.45818225,-27,5.0526065506,15.554102518,0.5944243001
48,323,2007,1056,292,-527,112,228,764,-299,479,51342,20.664351059,5.7140061641,-10.31260702,14,4.4616212514,14.950344895,-5.850985764
48,323,2008,1109,305,-114,112,230,804,116,937,52279,21.404927573,5.8868376101,-2.200326189,17,4.4392545913,15.518089962,2.2389284025
48,325,2001,518,339,302,1781,18,179,320,465,39927,13.04966683,8.5402259759,7.6081069166,-34,0.4534633262,4.5094408545,8.0615702427
48,325,2002,558,308,318,1797,13,250,331,551,40478,13.879733847,7.6612150986,7.9099558485,-30,0.3233629749,6.2185187488,8.2333188235
48,325,2003,566,315,476,1878,0,251,476,702,41180,13.862695633,7.7151044601,11.658380073,-25,0,6.1475911729,11.658380073
48,325,2004,554,327,472,1899,22,227,494,681,41861,13.342806565,7.875627702,11.367878518,-40,0.5298587445,5.4671788635,11.897737262
48,325,2005,581,339,270,1885,15,242,285,488,42349,13.798836243,8.0513003206,6.4125400784,-39,0.3562522266,5.7475359221,6.768792305
48,325,2006,594,351,569,1877,19,243,588,809,43158,13.893599354,8.209854164,13.308851907,-22,0.4444080602,5.6837451905,13.753259967
48,325,2007,609,338,304,1890,12,271,316,595,43753,14.014336505,7.7780718206,6.9956622292,8,0.2761445617,6.2362646846,7.2718067909
48,325,2008,640,357,216,1890,15,283,231,522,44275,14.540827918,8.1110555732,4.9075294225,8,0.3408006543,6.4297723452,5.2483300768
48,327,2001,26,34,-25,37,1,-8,-24,-35,2321,11.118238187,14.539234552,-10.69061364,-3,0.4276245456,-3.420996365,-10.2629891
48,327,2002,21,29,16,40,1,-8,17,7,2328,9.0342009034,12.475801248,6.8832006883,-2,0.430200043,-3.441600344,7.3134007313
48,327,2003,22,35,-29,38,1,-13,-28,-43,2285,9.5382614351,15.174506829,-12.5731628,-2,0.433557338,-5.636245393,-12.13960546
48,327,2004,16,42,-27,39,0,-26,-27,-55,2230,7.0874861573,18.604651163,-11.96013289,-2,0,-11.51716501,-11.96013289
48,327,2005,24,25,-63,41,1,-1,-62,-65,2165,10.921501706,11.376564278,-28.66894198,-2,0.4550625711,-0.455062571,-28.21387941
48,327,2006,21,32,-9,42,0,-11,-9,-20,2145,9.7447795824,14.849187935,-4.176334107,0,0,-5.104408353,-4.176334107
48,327,2007,22,26,-28,39,1,-4,-27,-32,2113,10.333489901,12.212306247,-13.15171442,-1,0.4697040864,-1.878816346,-12.68201033
48,327,2008,21,27,29,39,0,-6,29,25,2138,9.8800282287,12.702893437,13.643848506,2,0,-2.822865208,13.643848506
48,329,2001,1811,883,-730,1613,185,928,-545,288,115763,15.663515512,7.6371530631,-6.313841151,-95,1.6000830313,8.0263624491,-4.713758119
48,329,2002,1830,947,223,1627,176,883,399,1173,116936,15.728473264,8.1392700441,1.9166390917,-109,1.5126837674,7.5892032196,3.4293228591
48,329,2003,1856,880,45,1693,155,976,200,1005,117941,15.80401657,7.4932837187,0.3831792811,-171,1.3198397459,8.3107328517,1.703019027
48,329,2004,1892,1000,241,1661,157,892,398,1204,119145,15.960453169,8.4357574888,2.0330175548,-86,1.3244139257,7.52469568,3.3574314806
48,329,2005,1957,869,221,1731,160,1088,381,1356,120501,16.332423658,7.2523639034,1.8443871377,-113,1.3353029051,9.0800597548,3.1796900428
48,329,2006,1997,896,1735,1753,162,1101,1897,2932,123433,16.373281297,7.3462493953,14.225159264,-66,1.3282281273,9.0270319021,15.553387392
48,329,2007,2145,933,1455,1763,149,1212,1604,2826,126259,17.181167198,7.473206991,11.654358169,10,1.1934703555,9.707960207,12.847828525
48,329,2008,2214,962,1834,1763,151,1252,1985,3235,129494,17.313579899,7.522883407,14.341962753,-2,1.1808268134,9.7906964923,15.522789566
48,331,2001,370,297,58,406,32,73,90,137,24376,15.221639412,12.218451095,2.3860948267,-26,1.3164661113,3.0031883164,3.702560938
48,331,2002,355,285,419,452,30,70,449,510,24886,14.412731923,11.570784783,17.011083594,-9,1.2179773456,2.8419471398,18.229060939
48,331,2003,368,294,-172,434,24,74,-148,-104,24782,14.818394137,11.83860836,-6.925988564,-30,0.9664170089,2.9797857776,-5.959571555
48,331,2004,371,272,84,437,23,99,107,188,24970,14.913973308,10.9342338,3.3767486734,-18,0.9245859463,3.979739508,4.3013346197
48,331,2005,374,317,-207,441,24,57,-183,-148,24822,15.022493573,12.732969152,-8.314588689,-22,0.9640102828,2.2895244216,-7.350578406
48,331,2006,314,303,3,453,24,11,27,27,24849,12.643192205,12.200277828,0.12079483,-11,0.9663586399,0.4429143766,1.0871534698
48,331,2007,358,299,-172,462,22,59,-150,-90,24759,14.433155943,12.054507338,-6.934365425,1,0.8869537171,2.3786486051,-6.047411708
48,331,2008,364,249,13,462,23,115,36,133,24892,14.662343155,10.030009466,0.5236551127,-18,0.9264667378,4.6323336892,1.4501218505
48,333,2001,47,75,-59,290,6,-28,-53,-86,5041,9.2446892211,14.752163651,-11.60503541,-5,1.1801730921,-5.50747443,-10.42486231
48,333,2002,33,91,72,284,6,-58,78,18,5059,6.5346534653,18.01980198,14.257425743,-2,1.1881188119,-11.48514851,15.445544554
48,333,2003,36,60,-48,290,4,-24,-44,-72,4987,7.1670316544,11.945052757,-9.556042206,-4,0.7963368505,-4.778021103,-8.759705355
48,333,2004,57,81,34,291,3,-24,37,10,4997,11.418269231,16.225961538,6.8108974359,-3,0.6009615385,-4.807692308,7.4118589744
48,333,2005,48,51,91,300,4,-3,95,87,5084,9.5228647952,10.118043845,18.053764507,-5,0.7935720663,-0.59517905,18.847336574
48,333,2006,46,77,-63,292,3,-31,-60,-93,4991,9.1315136476,15.285359801,-12.50620347,-2,0.5955334988,-6.153846154,-11.91066998
48,333,2007,53,69,30,281,3,-16,33,17,5008,10.601060106,13.801380138,6.00060006,0,0.600060006,-3.200320032,6.600660066
48,333,2008,55,67,-3,281,2,-12,-1,-10,4998,10.993403958,13.391964821,-0.599640216,3,0.3997601439,-2.398560863,-0.199880072
48,335,2001,101,104,-53,2662,4,-3,-49,-60,9579,10.51097929,10.823186596,-5.5156624,-8,0.4162764075,-0.312207306,-5.099385992
48,335,2002,75,119,-111,2683,4,-44,-107,-160,9419,7.8955679545,12.527634488,-11.68544057,-9,0.4210969576,-4.632066533,-11.26434362
48,335,2003,97,141,-20,2801,2,-44,-18,-76,9343,10.340049035,15.030380556,-2.131968873,-14,0.2131968873,-4.690331521,-1.918771986
48,335,2004,107,120,-83,2761,1,-13,-82,-102,9241,11.515281963,12.914334912,-8.932414981,-7,0.1076194576,-1.399052949,-8.824795523
48,335,2005,85,100,54,2753,2,-15,56,33,9274,9.1817445315,10.80205239,5.8331082906,-8,0.2160410478,-1.620307858,6.0491493384
48,335,2006,103,86,-70,2743,1,17,-69,-56,9218,11.139952412,9.3013194895,-7.570841445,-4,0.1081548778,1.8386329223,-7.462686567
48,335,2007,107,90,50,2738,2,17,52,62,9280,11.568818251,9.7307817061,5.4059898367,-7,0.2162395935,1.8380365445,5.6222294302
48,335,2008,102,102,-49,2738,1,0,-48,-50,9230,11.021069692,11.021069692,-5.29443544,-2,0.1080497029,0,-5.186385737
48,337,2001,236,274,91,445,16,-38,107,48,19181,12.319256669,14.302865793,4.750221851,-21,0.8352038419,-1.983609125,5.585425693
48,337,2002,237,301,8,398,16,-64,24,-59,19122,12.37500979,15.716784586,0.4177218495,-19,0.8354436989,-3.341774796,1.2531655484
48,337,2003,241,290,219,384,11,-49,230,171,19293,12.54718209,15.098268905,11.401796173,-10,0.5726929585,-2.551086815,11.974489132
48,337,2004,274,275,37,393,9,-1,46,29,19322,14.191376408,14.243169753,1.9163537485,-16,0.466140101,-0.051793345,2.3824938495
48,337,2005,249,299,127,385,11,-50,138,70,19392,12.863563569,15.446608462,6.560934029,-18,0.5682698765,-2.583044893,7.1292039056
48,337,2006,239,286,253,406,11,-47,264,208,19600,12.258924908,14.669675831,12.977020927,-9,0.5642183012,-2.410750923,13.541239229
48,337,2007,254,260,5,403,10,-6,15,2,19602,12.958522524,13.264629356,0.2550890261,-7,0.5101780521,-0.306106831,0.7652670782
48,337,2008,275,283,109,403,9,-8,118,114,19716,13.988503993,14.395442291,5.54453431,4,0.4578055852,-0.406938298,6.0023398952
48,339,2001,4703,2088,10320,1751,1262,2615,11582,14348,311689,15.44423099,6.8568050835,33.88995616,151,4.1442950265,8.5874259068,38.034251186
48,339,2002,4840,2158,11133,2007,1191,2682,12324,15211,326900,15.158419578,6.7586507127,34.867496935,205,3.730098702,8.3997688654,38.597595637
48,339,2003,5127,2193,10526,2012,1043,2934,11569,15074,341974,15.33024157,6.5572888167,31.47379028,571,3.1186740702,8.7729527534,34.592464351
48,339,2004,5161,2187,12696,1960,961,2974,13657,16386,358360,14.738681829,6.2455913893,36.256985952,-245,2.7444048126,8.4930904397,39.001390765
48,339,2005,5380,2287,10956,2027,1006,3093,11962,15151,373511,14.702044486,6.2497352676,29.939702489,96,2.7491183556,8.4523092184,32.688820844
48,339,2006,5795,2497,14503,2059,1011,3298,15514,18812,392323,15.133827957,6.5209954115,37.87504864,0,2.6402588551,8.612832546,40.515307495
48,339,2007,6164,2626,14422,2137,915,3538,15337,18931,411254,15.341404744,6.5357769075,35.894506687,56,2.2773175439,8.8056278365,38.171824231
48,339,2008,6560,2688,13958,2137,919,3872,14877,18699,429953,15.596636737,6.3908170046,33.185648717,-50,2.1849556649,9.2058197328,35.370604382
48,341,2001,409,129,-338,216,160,280,-178,88,20180,20.311879221,6.4064362336,-16.78585618,-14,7.9459674215,13.905442988,-8.839888756
48,341,2002,385,147,-597,206,153,238,-444,-210,19970,19.178082192,7.3225404732,-29.7384807,-4,7.6214196762,11.855541719,-22.11706102
48,341,2003,436,124,-474,193,126,312,-348,-40,19930,21.854636591,6.2155388471,-23.7593985,-4,6.3157894737,15.639097744,-17.44360902
48,341,2004,418,119,-320,190,114,299,-206,71,20001,20.936114798,5.9602814856,-16.02764769,-22,5.7098494904,14.975833312,-10.3177982
48,341,2005,442,154,-570,186,120,288,-450,-174,19827,22.195440394,7.7332529878,-28.62307924,-12,6.0259114191,14.462187406,-22.59716782
48,341,2006,396,132,-225,180,119,264,-106,148,19975,19.898497563,6.632832521,-11.30596452,-10,5.9795990151,13.265665042,-5.326365509
48,341,2007,428,140,-463,175,108,288,-355,-65,19910,21.461702394,7.0201830262,-23.21674815,2,5.4155697631,14.441519368,-17.80117839
48,341,2008,428,115,-4,175,107,313,103,398,20308,21.284002188,5.7188323636,-0.198915908,-18,5.321000547,15.565169824,5.1220846387
48,343,2001,158,197,158,155,9,-39,167,119,13149,12.070743726,15.050231101,12.070743726,-9,0.6875740097,-2.979487375,12.758317736
48,343,2002,141,181,3,156,9,-40,12,-40,13109,10.739584127,13.786274659,0.2285017899,-12,0.6855053698,-3.046690532,0.9140071597
48,343,2003,147,157,-39,160,6,-10,-33,-63,13046,11.240680558,12.005352705,-2.982221373,-20,0.4588032881,-0.764672147,-2.523418084
48,343,2004,151,194,-132,170,7,-43,-125,-179,12867,11.65438197,14.973179485,-10.18793656,-11,0.5402693629,-3.318797515,-9.647667194
48,343,2005,163,188,12,152,7,-25,19,-14,12853,12.67496112,14.618973561,0.933125972,-8,0.5443234837,-1.944012442,1.4774494557
48,343,2006,179,170,106,162,7,9,113,116,12969,13.864146852,13.167066842,8.2100534428,-6,0.5421733406,0.6970800093,8.7522267834
48,343,2007,182,172,88,182,4,10,92,101,13070,13.979031453,13.210952802,6.759092131,-1,0.3072314605,0.7680786513,7.0663235915
48,343,2008,181,186,-145,182,4,-5,-141,-155,12915,13.931114104,14.31595151,-11.16028478,-9,0.307869925,-0.384837406,-10.85241485
48,345,2001,11,22,-77,0,1,-11,-76,-88,1354,7.8683834049,15.73676681,-55.07868383,-1,0.7153075823,-7.868383405,-54.36337625
48,345,2002,14,18,-18,0,1,-4,-17,-23,1331,10.4283054,13.407821229,-13.40782123,-2,0.7448789572,-2.979515829,-12.66294227
48,345,2003,20,15,10,0,1,5,11,13,1344,14.953271028,11.214953271,7.476635514,-3,0.7476635514,3.738317757,8.2242990654
48,345,2004,16,18,-38,0,0,-2,-38,-42,1302,12.093726379,13.605442177,-28.72260015,-2,0,-1.511715797,-28.72260015
48,345,2005,12,17,-2,0,1,-5,-1,-7,1295,9.241432422,13.092029265,-1.540238737,-1,0.7701193685,-3.850596843,-0.770119369
48,345,2006,13,23,1,0,0,-10,1,-10,1285,10.07751938,17.829457364,0.7751937984,-1,0,-7.751937984,0.7751937984
48,345,2007,18,14,-5,0,1,4,-4,0,1285,14.007782101,10.894941634,-3.891050584,0,0.7782101167,3.1128404669,-3.112840467
48,345,2008,18,5,-37,0,0,13,-37,-25,1260,14.145383104,3.9292730845,-29.07662083,-1,0,10.21611002,-29.07662083
48,347,2001,874,547,-79,4745,206,327,127,395,59641,14.703037338,9.2020153591,-1.328993077,-59,3.4654756197,5.5010219789,2.1364825422
48,347,2002,805,495,-568,4515,193,310,-375,-105,59536,13.509318073,8.3069719828,-9.532040578,-40,3.2388799852,5.2023460903,-6.293160593
48,347,2003,926,503,-103,4392,172,423,69,409,59945,15.500372444,8.4197487467,-1.724123501,-83,2.8791188557,7.0806236975,1.1549953549
48,347,2004,946,607,182,4384,162,339,344,636,60581,15.697857724,10.072515474,3.0200952492,-47,2.6882166503,5.6253422498,5.7083118995
48,347,2005,1000,571,26,4407,167,429,193,566,61147,16.430073607,9.3815720294,0.4271819138,-56,2.7438222923,7.0485015773,3.1710042061
48,347,2006,935,553,-43,4422,168,382,125,477,61624,15.231610071,9.008642106,-0.700491158,-30,2.7368026651,6.2229679647,2.0363115068
48,347,2007,1022,536,-45,4423,153,486,108,597,62221,16.504501595,8.6559812669,-0.726714845,3,2.4708304736,7.8485203278,1.7441156284
48,347,2008,1051,538,-153,4423,155,513,2,547,62768,16.817479938,8.6087575707,-2.448215443,32,2.4802182592,8.2087223676,0.0320028162
48,349,2001,730,566,286,1496,260,164,546,673,45978,15.99421579,12.400994709,6.2662270083,-37,5.6965700076,3.5932210817,11.962797016
48,349,2002,668,517,317,1611,247,151,564,670,46648,14.423595967,11.163172327,6.8447304213,-45,5.3332757541,3.2604236392,12.178006175
48,349,2003,736,486,7,1710,215,250,222,402,47050,15.710047173,10.373753976,0.1494162095,-70,4.5892121497,5.3362931973,4.7386283592
48,349,2004,636,522,392,1716,195,114,587,660,47710,13.423385395,11.017306881,8.2735331363,-41,4.1156606163,2.4060785141,12.389193753
48,349,2005,671,474,106,1757,205,197,311,471,48181,13.995056888,9.8862249846,2.210843562,-37,4.2756880208,4.1088319029,6.4865315827
48,349,2006,700,522,381,1830,204,178,585,733,48914,14.418868119,10.75235594,7.8479839333,-30,4.2020701375,3.6665121788,12.050054071
48,349,2007,752,500,-280,1721,185,252,-95,145,49059,15.351168179,10.206893736,-5.715860492,-12,3.7765506823,5.144274443,-1.93930981
48,349,2008,711,490,14,1721,187,221,201,397,49456,14.434350099,9.9477236969,0.2842206771,-25,3.7963761864,4.4866264021,4.0805968634
48,351,2001,141,136,-91,606,7,5,-84,-96,14943,9.405643386,9.0721099326,-6.070308852,-17,0.4669468348,0.3335334534,-5.603362017
48,351,2002,167,164,-164,603,6,3,-158,-166,14777,11.238223419,11.036339166,-11.03633917,-11,0.4037685061,0.201884253,-10.63257066
48,351,2003,137,150,-80,595,5,-13,-75,-110,14667,9.3058008423,10.188833039,-5.434044287,-22,0.339627768,-0.883032197,-5.094416519
48,351,2004,132,160,-412,600,6,-28,-406,-454,14213,9.1412742382,11.08033241,-28.53185596,-20,0.4155124654,-1.939058172,-28.11634349
48,351,2005,148,150,-24,597,6,-2,-18,-30,14183,10.424003381,10.564868291,-1.690378927,-10,0.4225947317,-0.140864911,-1.267784195
48,351,2006,113,170,-248,584,6,-57,-242,-304,13879,8.0535956097,12.116028793,-17.67514789,-5,0.4276245456,-4.062433184,-17.24752334
48,351,2007,134,154,-74,587,5,-20,-69,-97,13782,9.6887314269,11.134810744,-5.350493475,-8,0.3615198294,-1.446079317,-4.988973645
48,351,2008,136,145,-11,587,6,-9,-5,-30,13752,9.8786954311,10.532432629,-0.79901213,-16,0.4358247984,-0.653737198,-0.363187332
48,353,2001,247,189,-484,506,16,58,-468,-413,15337,15.890886866,12.159423553,-31.13841799,-3,1.0293691897,3.7314633126,-30.1090488
48,353,2002,224,184,-343,500,16,40,-327,-291,15046,14.745087714,12.112036336,-22.57841556,-4,1.053220551,2.6330513774,-21.52519501
48,353,2003,211,172,-70,513,8,39,-62,-43,15003,14.043728577,11.447968318,-4.659056874,-20,0.5324636427,2.5957602582,-4.126593231
48,353,2004,223,207,-156,492,7,16,-149,-145,14858,14.935869529,13.864237634,-10.44841097,-12,0.4688389538,1.0716318944,-9.979572017
48,353,2005,251,221,-305,471,8,30,-297,-277,14581,17.052209654,15.014096946,-20.72081253,-10,0.543496722,2.0381127076,-20.17731581
48,353,2006,240,172,-99,481,7,68,-92,-32,14549,16.477857878,11.80913148,-6.797116375,-8,0.4806041881,4.6687263989,-6.316512187
48,353,2007,219,174,-41,471,8,45,-33,1,14550,15.052063645,11.959173855,-2.817966253,-11,0.5498470738,3.09288979,-2.268119179
48,353,2008,235,161,260,471,7,74,267,329,14879,15.970641204,10.941588229,17.669645588,-12,0.4757212274,5.029052975,18.145366815
48,355,2001,5201,2531,-4416,5834,480,2670,-3936,-1478,311920,16.634736246,8.0950812227,-14.1240137,-212,1.5352188806,8.5396550235,-12.58879482
48,355,2002,5183,2479,-1583,5825,311,2704,-1272,1152,313072,16.585812298,7.9329015411,-5.065664841,-280,0.9952127387,8.6529107573,-4.070452102
48,355,2003,4915,2497,-1918,5937,-44,2418,-1962,110,313182,15.696506529,7.9744001635,-6.125310178,-346,-0.140518065,7.7221063658,-6.265828242
48,355,2004,4964,2499,-388,6205,586,2465,198,2458,315640,15.788251683,7.9481951967,-1.234053516,-205,1.8638024751,7.8400564866,0.6297489592
48,355,2005,5110,2459,-759,6200,375,2651,-384,1974,317614,16.13886371,7.7662359811,-2.397142379,-293,1.1843588828,8.3726277292,-1.212783496
48,355,2006,5007,2361,-838,6229,490,2646,-348,2144,319758,15.711389895,7.4085463434,-2.62954758,-154,1.5375636206,8.3028435513,-1.091983959
48,355,2007,5069,2505,-2542,6041,333,2564,-2209,362,320120,15.843645195,7.8296175208,-7.945264566,7,1.040823407,8.014027674,-6.904441159
48,355,2008,5200,2517,-1159,6041,393,2683,-766,1957,322077,16.194407635,7.8387161572,-3.609484317,40,1.2239235001,8.3556914778,-2.385560817
48,357,2001,155,70,-64,74,84,85,20,97,9082,17.158355012,7.7489345215,-7.084740134,-8,9.2987214258,9.4094204904,2.2139812919
48,357,2002,159,83,-233,70,81,76,-152,-79,9003,17.583632845,9.1788775228,-25.7672104,-3,8.9576997512,8.4047553221,-16.80951064
48,357,2003,167,85,-339,61,71,82,-268,-176,8827,18.73247336,9.5344924285,-38.02579921,10,7.9641054403,9.197980931,-30.06169377
48,357,2004,172,67,-43,61,62,105,19,118,8945,19.356290795,7.5399504839,-4.839072699,-6,6.977267612,11.816340311,2.1381949133
48,357,2005,181,63,-2,61,69,118,67,178,9123,20.03542174,6.9736550808,-0.221385876,-7,7.6378127075,13.061766659,7.416426832
48,357,2006,162,79,-5,72,66,83,61,139,9262,17.623062279,8.5939624694,-0.543921675,-5,7.1797661137,9.0290998096,6.6358444384
48,357,2007,180,64,46,70,63,116,109,220,9482,19.206145967,6.8288518993,4.9082373026,-5,6.7221510883,12.377294067,11.630388391
48,357,2008,206,79,-57,70,62,127,5,131,9613,21.576328882,8.2744173868,-5.970149254,-1,6.4938465567,13.301911495,0.523697303
48,359,2001,21,16,-29,270,4,5,-25,-22,2170,9.628610729,7.336084365,-13.29665291,-2,1.8340210912,2.2925263641,-11.46263182
48,359,2002,21,16,-50,270,4,5,-46,-42,2128,9.7719869707,7.4453234062,-23.26663564,-1,1.8613308516,2.3266635644,-21.40530479
48,359,2003,28,17,3,270,3,11,6,15,2143,13.111683446,7.9606649497,1.4048232264,-2,1.4048232264,5.1510184968,2.8096464528
48,359,2004,25,18,-34,270,2,7,-32,-26,2117,11.737089202,8.4507042254,-15.96244131,-1,0.9389671362,3.2863849765,-15.02347418
48,359,2005,27,11,-46,270,3,16,-43,-28,2089,12.838801712,5.2306229196,-21.87351403,-1,1.4265335235,7.6081787922,-20.4469805
48,359,2006,18,18,-2,270,2,0,0,-1,2088,8.618625808,8.618625808,-0.95762509,-1,0.9576250898,0,0
48,359,2007,21,9,-37,270,1,12,-36,-27,2061,10.122921186,4.3383947939,-17.83562304,-3,0.482043866,5.7845263919,-17.35357918
48,359,2008,24,3,-11,270,0,21,-11,1,2062,11.642008246,1.4552510308,-5.335920446,-9,0,10.186757216,-5.335920446
48,361,2001,1109,880,-1002,977,52,229,-950,-778,84129,13.12146525,10.411983246,-11.85546274,-57,0.6152535555,2.7094820038,-11.24020919
48,361,2002,1078,892,-437,976,50,186,-387,-271,83858,12.834326466,10.619869395,-5.202783549,-70,0.5952841589,2.2144570711,-4.60749939
48,361,2003,1137,894,-465,1001,39,243,-426,-275,83583,13.580903124,10.678388208,-5.554195209,-92,0.4658357272,2.9025149157,-5.088359482
48,361,2004,1080,879,-139,984,44,201,-95,51,83634,12.91734692,10.513285132,-1.662510391,-55,0.5262622819,2.404061788,-1.136248109
48,361,2005,1048,908,-196,975,42,140,-154,-84,83550,12.537084889,10.862283472,-2.344721983,-70,0.5024404249,1.6748014164,-1.842281558
48,361,2006,1066,893,-1574,957,43,173,-1531,-1388,82162,12.865694699,10.777734865,-18.99681375,-30,0.5189726755,2.0879598339,-18.47784107
48,361,2007,1067,849,200,933,39,218,239,384,82546,12.956261991,10.309153168,2.4285402045,-73,0.4735653399,2.6471088229,2.9021055444
48,361,2008,1067,899,341,933,41,168,382,476,83022,12.888964051,10.859586394,4.1191534596,-74,0.4952647855,2.0293776575,4.6144182451
48,363,2001,384,389,-13,297,47,-5,34,-1,27082,14.178897812,14.363518878,-0.48001477,-30,1.7354380135,-0.184621065,1.2554232438
48,363,2002,353,358,-49,295,44,-5,-5,-36,27046,13.043156961,13.227904227,-1.810523204,-26,1.6257759385,-0.184747266,-0.184747266
48,363,2003,358,322,47,295,37,36,84,85,27131,13.215940344,11.886963102,1.7350536205,-35,1.3658932757,1.3289772413,3.1009468963
48,363,2004,346,338,-89,314,39,8,-50,-60,27071,12.767056566,12.471864507,-3.28401166,-18,1.4390612893,0.2951920593,-1.844950371
48,363,2005,409,338,76,303,39,71,115,165,27236,15.062514961,12.44775075,2.7989025356,-21,1.4362789327,2.6147642109,4.2351814683
48,363,2006,428,316,138,314,38,112,176,274,27510,15.635845541,11.544222409,5.0414642166,-14,1.388229277,4.0916231323,6.4296934936
48,363,2007,427,314,-368,288,34,113,-334,-242,27268,15.590200445,11.464456534,-13.43605097,-21,1.2413742743,4.1257439118,-12.1946767
48,363,2008,391,305,124,288,35,86,159,218,27486,14.282061585,11.140738576,4.5293494539,-27,1.2784454104,3.1413230084,5.8077948643
48,365,2001,277,236,-92,438,29,41,-63,-42,22713,12.18439342,10.380927246,-4.046802147,-20,1.2756224158,1.803466174,-2.771179731
48,365,2002,298,257,79,429,27,41,106,126,22839,13.083948015,11.283807517,3.4685634001,-21,1.1854583772,1.8001404988,4.6540217773
48,365,2003,285,246,-15,643,24,39,9,15,22854,12.474558466,10.767513624,-0.656555709,-33,1.050489134,1.7070448428,0.3939334253
48,365,2004,309,262,-237,449,23,47,-214,-187,22667,13.576151666,11.511170668,-10.41277652,-20,1.0105226159,2.0649809978,-9.402253905
48,365,2005,301,274,153,455,24,27,177,186,22853,13.224956063,12.038664323,6.7223198594,-18,1.0544815466,1.1862917399,7.776801406
48,365,2006,299,263,173,479,23,36,196,220,23073,13.02094674,11.453207334,7.5338588164,-12,1.0016112877,1.5677394069,8.5354701041
48,365,2007,282,247,-182,481,21,35,-161,-135,22938,12.257938319,10.736562996,-7.911151681,-9,0.912825194,1.5213753233,-6.998326487
48,365,2008,320,233,60,481,20,87,80,146,23084,13.906392595,10.125592108,2.6074486115,-21,0.8691495372,3.7808004867,3.4765981487
48,367,2001,1097,720,1978,2919,98,377,2076,2403,91640,12.129789857,7.9612112098,21.871216351,-50,1.0836093036,4.1685786474,22.954825655
48,367,2002,1128,773,1882,2922,92,355,1974,2301,93941,12.156416875,8.330594188,20.282248722,-28,0.9914808089,3.8258226866,21.273729531
48,367,2003,1234,739,2198,2949,59,495,2257,2772,96713,12.944915921,7.7522632622,23.057475846,20,0.6189222361,5.1926526587,23.676398082
48,367,2004,1124,752,1837,2987,76,372,1913,2164,98877,11.493430134,7.6895546807,18.784191421,-121,0.7771358454,3.8038754538,19.561327266
48,367,2005,1212,789,2006,2986,71,423,2077,2415,101292,12.109767247,7.8833385789,20.043063611,-85,0.7094005565,4.2264286678,20.752464168
48,367,2006,1187,760,2807,2997,74,427,2881,3251,104543,11.53350985,7.3845555906,27.274273083,-57,0.719022518,4.1489542595,27.993295601
48,367,2007,1365,829,3236,2954,61,536,3297,3890,108433,12.818345729,7.7849147322,30.388400571,57,0.5728344978,5.0334309969,30.961235069
48,367,2008,1410,828,2639,2954,64,582,2703,3343,111776,12.806016103,7.5201286051,23.968139359,58,0.5812659791,5.2858874978,24.549405338
48,369,2001,162,79,-401,156,79,83,-322,-240,9735,16.438356164,8.0162354135,-40.69000507,-1,8.0162354135,8.4221207509,-32.67376966
48,369,2002,155,85,-46,153,77,70,31,90,9825,15.848670757,8.691206544,-4.703476483,-11,7.8732106339,7.1574642127,3.1697341513
48,369,2003,183,76,-152,154,56,107,-96,3,9828,18.623110975,7.7341881647,-15.46837633,-8,5.6988754897,10.888922811,-9.76950084
48,369,2004,171,78,-231,155,53,93,-178,-98,9730,17.486450557,7.9762756928,-23.62204724,-13,5.4197770733,9.5101748645,-18.20227017
48,369,2005,177,85,-334,142,54,92,-280,-191,9539,18.371477503,8.8224609476,-34.66708184,-3,5.6048575432,9.5490165551,-29.0622243
48,369,2006,143,72,-308,143,53,71,-255,-188,9351,15.140285866,7.6230809952,-32.60984648,-4,5.6114346215,7.5172048703,-26.99841186
48,369,2007,143,56,-157,142,45,87,-112,-39,9312,15.324438729,6.001178803,-16.82473343,-14,4.8223758238,9.3232599261,-12.00235761
48,369,2008,172,55,-227,142,44,117,-183,-88,9224,18.558480794,5.9343979284,-24.49287872,-22,4.7475183427,12.624082866,-19.74536038
48,371,2001,222,105,-443,2093,37,117,-406,-297,16411,13.406201878,6.3407711585,-26.75201546,-8,2.2343669797,7.0654307195,-24.51764848
48,371,2002,214,145,-222,2081,35,69,-187,-128,16283,13.09108705,8.8701290757,-13.58047348,-10,2.141065639,4.2209579739,-11.43940784
48,371,2003,202,129,-461,2112,28,73,-433,-355,15928,12.542299215,8.0096861321,-28.62376207,5,1.7385365248,4.5326130825,-26.88522554
48,371,2004,243,136,-204,2124,23,107,-181,-90,15838,15.299376692,8.5626141157,-12.84392117,-16,1.4480891519,6.7367625763,-11.39583202
48,371,2005,245,115,-259,2129,26,130,-233,-115,15723,15.52549032,7.2874750483,-16.4126612,-12,1.6476030544,8.238015272,-14.76505814
48,371,2006,215,122,-6,2115,25,93,19,104,15827,13.629160063,7.7337559429,-0.380348653,-8,1.5847860539,5.8954041204,1.204437401
48,371,2007,243,112,-94,2124,23,131,-71,63,15890,15.323012895,7.0624586184,-5.927420626,3,1.4503263234,8.2605542769,-4.477094303
48,371,2008,255,132,269,2124,22,123,291,417,16307,15.839985092,8.1995216946,16.709631332,3,1.3665869491,7.6404633972,18.076218281
48,373,2001,527,540,1511,3354,47,-13,1558,1510,43082,12.450681598,12.757814161,35.69825407,-35,1.1104023437,-0.307132563,36.808656413
48,373,2002,491,588,1124,3127,46,-97,1170,1047,44129,11.260047471,13.484537501,25.776564883,-26,1.0549127977,-2.22449003,26.831477681
48,373,2003,503,575,974,3307,37,-72,1011,935,45064,11.278912022,12.893388495,21.840278946,-4,0.8296615205,-1.614476472,22.669940466
48,373,2004,509,595,748,3331,35,-86,783,644,45708,11.214912087,13.109769532,16.480853127,-53,0.7711629137,-1.894857445,17.25201604
48,373,2005,510,568,300,3298,38,-58,338,236,45944,11.129053376,12.394710426,6.5465019858,-44,0.8292235849,-1.265657051,7.3757255706
48,373,2006,527,586,391,3370,38,-59,429,347,46291,11.427332358,12.706673172,8.4783433621,-23,0.8239822193,-1.279340814,9.3023255814
48,373,2007,525,605,105,3315,32,-80,137,-85,46206,11.351719515,13.081505346,2.270343903,-142,0.6919143324,-1.729785831,2.9622582354
48,373,2008,520,584,189,3315,33,-64,222,-62,46144,11.261505143,12.647536546,4.0931239848,-220,0.7146724418,-1.386031402,4.8077964266
48,375,2001,2253,1148,-610,7706,411,1105,-199,801,114523,19.741943964,10.059366032,-5.345133519,-105,3.6013932397,9.6825779316,-1.743740279
48,375,2002,2102,1264,108,7665,392,838,500,1213,115736,18.25770111,10.978941105,0.9380740818,-125,3.4048614821,7.278760005,4.3429355639
48,375,2003,2160,1230,592,8083,349,930,941,1722,117458,18.525347994,10.549156496,5.0773175982,-149,2.993215949,7.9761914972,8.0705335472
48,375,2004,2394,1165,-691,7972,327,1229,-364,759,118217,20.316113292,9.8864962342,-5.864007638,-106,2.7750079559,10.429617057,-3.088999682
48,375,2005,2304,1208,-116,8019,338,1096,222,1217,119434,19.389777447,10.166168036,-0.976221434,-101,2.8445072817,9.2236094104,1.8682858477
48,375,2006,2271,1132,-481,7897,342,1139,-139,941,120375,18.940073142,9.4408466738,-4.011525839,-59,2.8522699315,9.4992264677,-1.159255908
48,375,2007,2310,1197,-1419,7959,313,1113,-1106,15,120390,19.188835587,9.943305713,-11.78742757,8,2.6000456877,9.2455298735,-9.187381887
48,375,2008,2312,1207,-906,7959,315,1105,-591,528,120918,19.1622325,10.003812555,-7.509075538,14,2.6107712964,9.1584199446,-4.898304242
48,377,2001,158,39,-204,96,107,119,-97,19,7359,21.498061093,5.3064834342,-27.75699027,-3,14.558813525,16.191577658,-13.19817675
48,377,2002,144,30,-122,96,105,114,-17,90,7449,19.448946515,4.0518638574,-16.47757969,-7,14.181523501,15.397082658,-2.296056186
48,377,2003,157,48,-189,96,89,109,-100,13,7462,21.058279123,6.4381999866,-25.35041245,4,11.937495808,14.620079136,-13.41291664
48,377,2004,150,38,-235,96,83,112,-152,-52,7410,20.172135557,5.110274341,-31.60301237,-12,11.161915008,15.061861216,-20.44109736
48,377,2005,183,35,-107,96,88,148,-19,122,7532,24.49471289,4.6847811538,-14.32204524,-7,11.77887833,19.809931736,-2.543166912
48,377,2006,155,45,-255,96,87,110,-168,-61,7471,20.66253416,5.99880024,-33.99320136,-3,11.597680464,14.66373392,-22.3955209
48,377,2007,151,30,-143,96,70,121,-73,46,7517,20.149452896,4.003202562,-19.08193221,-2,9.3408059781,16.146250334,-9.741126234
48,377,2008,153,36,-234,96,70,117,-164,-50,7467,20.421783235,4.8051254672,-31.23331554,-3,9.3432995195,15.616657768,-21.89001602
48,379,2001,103,108,488,70,21,-5,509,499,9716,10.880473248,11.408651561,51.550203349,-5,2.2183489146,-0.528178313,53.768552263
48,379,2002,105,128,360,66,20,-23,380,354,10070,10.613565147,12.938441322,36.389366219,-3,2.0216314566,-2.324876175,38.410997675
48,379,2003,104,83,288,65,11,21,299,325,10395,10.163694112,8.1114097239,28.145614464,5,1.075006108,2.052284388,29.220620572
48,379,2004,107,118,195,65,11,-11,206,183,10578,10.203595098,11.252562819,18.595336862,-12,1.0489677204,-1.04896772,19.644304582
48,379,2005,110,113,171,66,12,-3,183,169,10747,10.316529894,10.597889801,16.037514654,-11,1.1254396249,-0.281359906,17.162954279
48,379,2006,120,103,195,60,12,17,207,218,10965,11.053795136,9.4878408254,17.962417097,-6,1.1053795136,1.565954311,19.06779661
48,379,2007,114,123,193,60,9,-9,202,200,11165,10.302756439,11.116131948,17.442385901,7,0.8133755084,-0.813375508,18.25576141
48,379,2008,112,116,38,60,9,-4,47,39,11204,10.013858465,10.371496267,3.397559122,-4,0.8046850552,-0.357637802,4.2022441772
48,381,2001,1222,714,3,1693,129,508,132,528,105233,11.641532262,6.8020082119,0.0285798664,-112,1.2289342568,4.83952405,1.2575141232
48,381,2002,1304,720,28,1667,119,584,147,621,105854,12.355095292,6.8218317566,0.2652934572,-110,1.1274971931,5.5332635359,1.3927906503
48,381,2003,1440,785,344,1624,93,655,437,975,106829,13.541279745,7.3818781943,3.2348612724,-117,0.8745409835,6.1594015507,4.1094022559
48,381,2004,1379,799,970,1670,101,580,1071,1534,108363,12.816461578,7.4259266144,9.0152050262,-117,0.9386966058,5.3905349641,9.953901632
48,381,2005,1393,772,683,1646,97,621,780,1334,109697,12.776300101,7.0806200128,6.2643309181,-67,0.8896633954,5.695680088,7.1539943135
48,381,2006,1444,784,593,1593,100,660,693,1291,110988,13.086526044,7.1051498743,5.3741758615,-62,0.9062691166,5.9813761697,6.2804449781
48,381,2007,1545,758,1570,2090,89,787,1659,2353,113341,13.77441169,6.7579314311,13.997298611,-93,0.7934774372,7.0164802589,14.790776048
48,381,2008,1569,734,460,2090,92,835,552,1205,114546,13.769982491,6.4417891323,4.037088557,-182,0.8074177114,7.328193359,4.8445062685
48,383,2001,43,26,-119,50,5,17,-114,-98,3198,13.242993532,8.0073914383,-36.64921466,-1,1.5398829689,5.2356020942,-35.10933169
48,383,2002,41,28,-99,46,5,13,-94,-81,3117,12.984956453,8.8677751386,-31.35391924,0,1.5835312747,4.1171813143,-29.77038797
48,383,2003,59,28,-134,50,5,31,-129,-94,3023,19.218241042,9.1205211726,-43.64820847,4,1.6286644951,10.09771987,-42.01954397
48,383,2004,53,24,-40,42,4,29,-36,-8,3015,17.555481948,7.9496522027,-13.24942034,-1,1.3249420338,9.6058297449,-11.9244783
48,383,2005,41,24,-76,38,5,17,-71,-56,2959,13.726146635,8.0348175427,-25.44358889,-2,1.6739203214,5.6913290927,-23.76966856
48,383,2006,38,24,-32,45,4,14,-28,-14,2945,12.872628726,8.1300813008,-10.8401084,0,1.3550135501,4.7425474255,-9.485094851
48,383,2007,55,16,37,42,4,39,41,74,3019,18.443997317,5.3655264923,12.407780013,-6,1.3413816231,13.078470825,13.749161636
48,383,2008,65,14,20,42,3,51,23,67,3086,21.294021294,4.5864045864,6.552006552,-7,0.9828009828,16.707616708,7.5348075348
48,385,2001,27,33,-79,7,1,-6,-78,-91,2967,8.9626556017,10.954356846,-26.22406639,-7,0.3319502075,-1.991701245,-25.89211618
48,385,2002,23,29,-26,7,0,-6,-26,-35,2932,7.7979318529,9.8321749449,-8.815053399,-3,0,-2.034243092,-8.815053399
48,385,2003,29,39,13,7,-1,-10,12,0,2932,9.8908594816,13.301500682,4.4338335607,-2,-0.34106412,-3.410641201,4.0927694407
48,385,2004,34,49,-4,12,0,-15,-4,-21,2911,11.637857265,16.772206059,-1.369159678,-2,0,-5.134348793,-1.369159678
48,385,2005,33,44,-4,16,0,-11,-4,-18,2893,11.371467953,15.161957271,-1.378359752,-3,0,-3.790489318,-1.378359752
48,385,2006,34,43,47,28,0,-9,47,38,2931,11.675824176,14.766483516,16.14010989,0,0,-3.090659341,16.14010989
48,385,2007,35,26,21,29,0,9,21,20,2951,11.900714043,8.8405304318,7.1404284257,-10,0,3.060183611,7.1404284257
48,385,2008,33,23,-72,29,1,10,-71,-76,2875,11.328527291,7.8956402334,-24.71678682,-15,0.3432887058,3.432887058,-24.37349811
48,387,2001,158,228,-38,297,11,-70,-27,-111,14176,11.102132593,16.020798932,-2.670133155,-14,0.7729332818,-4.918666339,-1.897199874
48,387,2002,169,249,-171,289,10,-80,-161,-249,13927,12.02718571,17.720528058,-12.16951927,-8,0.7116677935,-5.693342348,-11.45785147
48,387,2003,157,215,-174,261,5,-58,-169,-238,13689,11.370220162,15.570683662,-12.6013905,-11,0.3621089224,-4.200463499,-12.23928158
48,387,2004,144,213,-41,270,6,-69,-35,-115,13574,10.563767744,15.625573121,-3.007739427,-11,0.4401569893,-5.061805377,-2.567582438
48,387,2005,138,231,-28,292,6,-93,-22,-127,13447,10.214277784,17.097812812,-2.072462159,-12,0.4440990341,-6.883535028,-1.628363125
48,387,2006,148,197,-153,290,6,-49,-147,-202,13245,11.089465008,14.760977072,-11.4641091,-6,0.4495729057,-3.671512064,-11.01453619
48,387,2007,151,189,-121,282,5,-38,-116,-159,13086,11.469370704,14.355702404,-9.190687782,-5,0.3797804869,-2.8863317,-8.810907296
48,387,2008,143,189,-88,282,6,-46,-82,-131,12955,10.982681157,14.515571599,-6.758573019,-3,0.4608117968,-3.532890442,-6.297761223
48,389,2001,205,106,-491,1153,26,99,-465,-370,12678,15.937184172,8.2406903522,-38.17149965,-4,2.0213014071,7.6964938195,-36.15019824
48,389,2002,216,115,-399,1163,26,101,-373,-274,12404,17.223506897,9.1699226537,-31.81564469,-2,2.0731999043,8.0535842437,-29.74244478
48,389,2003,221,110,-535,1160,22,111,-513,-388,12016,18.0999181,9.009009009,-43.81654382,14,1.8018018018,9.0909090909,-42.01474201
48,389,2004,171,114,-517,1150,21,57,-496,-460,11556,14.508739182,9.6724927881,-43.86560326,-21,1.7817749873,4.836246394,-42.08382827
48,389,2005,145,116,-357,1150,22,29,-335,-312,11244,12.719298246,10.175438596,-31.31578947,-6,1.9298245614,2.5438596491,-29.38596491
48,389,2006,168,109,-199,1155,21,59,-178,-124,11120,15.024145949,9.7478089787,-17.79645859,-5,1.8780182436,5.2763369701,-15.91844035
48,389,2007,185,85,-55,1158,20,100,-35,49,11169,16.600116649,7.6270806227,-4.935169815,-16,1.7946072053,8.9730360267,-3.140562609
48,389,2008,172,106,-178,1158,19,66,-159,-107,11062,15.473887814,9.5362331879,-16.0136746,-14,1.7093248167,5.9376546264,-14.30434978
48,391,2001,117,92,-92,120,3,25,-89,-71,7754,15.020219526,11.81077091,-11.81077091,-7,0.385133834,3.2094486167,-11.42563708
48,391,2002,93,95,-113,113,2,-2,-111,-117,7637,12.084984731,12.344876876,-14.68390618,-4,0.2598921448,-0.259892145,-14.42401403
48,391,2003,85,90,-111,122,1,-5,-110,-120,7517,11.218160222,11.878051999,-14.64959747,-5,0.1319783555,-0.659891778,-14.51761911
48,391,2004,102,100,58,120,2,2,60,57,7574,13.517990855,13.252932211,7.6867006825,-5,0.2650586442,0.2650586442,7.9517593268
48,391,2005,70,78,-33,127,2,-8,-31,-46,7528,9.2702953251,10.329757648,-4.370282082,-7,0.2648655807,-1.059462323,-4.105416501
48,391,2006,90,81,-73,131,2,9,-71,-66,7462,12.008005337,10.807204803,-9.739826551,-4,0.266844563,1.2008005337,-9.472981988
48,391,2007,90,77,-136,128,1,13,-135,-119,7343,12.158054711,10.401891253,-18.37217156,3,0.1350894968,1.7561634583,-18.23708207
48,391,2008,90,75,-8,128,2,15,-6,7,7350,12.250731641,10.208943034,-1.088953924,-2,0.2722384809,2.0417886068,-0.816715443
48,393,2001,6,8,-10,0,1,-2,-9,-11,872,6.8376068376,9.1168091168,-11.3960114,0,1.1396011396,-2.279202279,-10.25641026
48,393,2002,8,11,-22,0,1,-3,-21,-25,847,9.3077370564,12.798138453,-25.59627691,-1,1.1634671321,-3.490401396,-24.43280977
48,393,2003,2,10,-39,0,1,-8,-38,-43,804,2.4227740763,12.113870382,-47.24409449,3,1.2113870382,-9.691096305,-46.03270745
48,393,2004,4,16,25,0,0,-12,25,12,816,4.9382716049,19.75308642,30.864197531,-1,0,-14.81481481,30.864197531
48,393,2005,14,12,4,0,1,2,5,6,822,17.094017094,14.652014652,4.884004884,-1,1.221001221,2.442002442,6.105006105
48,393,2006,14,10,-20,0,0,4,-20,-17,805,17.209588199,12.292562999,-24.585126,-1,0,4.9170251998,-24.585126
48,393,2007,15,5,20,0,1,10,21,30,835,18.292682927,6.0975609756,24.390243902,-1,1.2195121951,12.195121951,25.609756098
48,393,2008,13,5,-7,0,0,8,-7,-2,833,15.587529976,5.9952038369,-8.393285372,-3,0,9.5923261391,-8.393285372
48,395,2001,249,205,-74,265,27,44,-47,-20,15995,15.557638238,12.808497345,-4.623555139,-17,1.686972821,2.7491408935,-2.936582318
48,395,2002,232,242,-200,252,27,-10,-173,-191,15804,14.591653826,15.220604422,-12.57901192,-8,1.698166609,-0.628950596,-10.88084531
48,395,2003,216,179,-117,292,18,37,-99,-74,15730,13.699498954,11.352825522,-7.420561933,-12,1.1416249128,2.3466734319,-6.27893702
48,395,2004,222,188,31,287,17,34,48,70,15800,14.081826832,11.92515065,1.9663812242,-12,1.0783380907,2.1566761814,3.0447193149
48,395,2005,220,204,90,266,18,16,108,109,15909,13.876186572,12.867009366,5.6766217793,-15,1.1353243559,1.0091772052,6.8119461352
48,395,2006,229,194,-92,260,17,35,-75,-47,15862,14.415662082,12.212394951,-5.791445028,-7,1.0701583205,2.2032671304,-4.721286708
48,395,2007,230,187,-174,268,15,43,-159,-109,15753,14.550055353,11.829827613,-11.00743318,7,0.9489166535,2.72022774,-10.05851653
48,395,2008,231,172,-141,268,14,59,-127,-60,15693,14.6918527,10.939388157,-8.967754245,8,0.8904153151,3.7524645424,-8.07733893
48,397,2001,727,318,2667,668,104,409,2771,3223,47103,15.981007441,6.9903168724,58.626336788,43,2.2861413671,8.9906905686,60.912478155
48,397,2002,698,319,3127,654,104,379,3231,3692,50795,14.259739729,6.5169870682,63.882816809,82,2.1246603608,7.7427526609,66.00747717
48,397,2003,822,326,2874,641,88,496,2962,3639,54434,15.623069686,6.1960106054,54.623725399,181,1.6725427401,9.4270590807,56.296268139
48,397,2004,841,327,2953,636,79,514,3032,3482,57916,14.971072541,5.8210947931,52.567868269,-64,1.4063195372,9.1499777481,53.974187806
48,397,2005,934,352,3618,664,86,582,3704,4319,62235,15.547103228,5.8592937221,60.224217859,33,1.4315319889,9.6878095064,61.655749848
48,397,2006,1009,357,5336,664,88,652,5424,6082,68317,15.457442245,5.4690851155,81.745204976,6,1.3481218212,9.9883571297,83.093326797
48,397,2007,1104,403,4549,617,75,701,4624,5376,73693,15.548200831,5.6756566439,64.065910851,51,1.0562636434,9.872544187,65.122174495
48,397,2008,1317,402,2991,617,77,915,3068,3940,77633,17.406129812,5.3130327901,39.530549939,-43,1.0176704598,12.093097022,40.548220398
48,399,2001,160,138,-397,289,31,22,-366,-344,11131,14.155533929,12.209148014,-35.12341856,0,2.7426346988,1.9463859152,-32.38078386
48,399,2002,133,164,-170,270,31,-31,-139,-180,10951,12.046010325,14.853727017,-15.39715605,-10,2.8077166923,-2.807716692,-12.58943936
48,399,2003,146,142,-246,274,23,4,-223,-218,10733,13.466150157,13.097214536,-22.68954068,1,2.1213798192,0.3689356207,-20.56816086
48,399,2004,146,160,-64,277,21,-14,-43,-66,10667,13.644859813,14.953271028,-5.981308411,-9,1.9626168224,-1.308411215,-4.018691589
48,399,2005,156,162,24,266,22,-6,46,30,10697,14.60400674,15.165699307,2.2467702677,-10,2.0595394121,-0.561692567,4.3063096798
48,399,2006,131,149,-292,263,21,-18,-271,-292,10405,12.41588475,14.121884182,-27.67510189,-3,1.9903326699,-1.705999431,-25.68476922
48,399,2007,148,123,-154,262,19,25,-135,-111,10294,14.30020774,11.884632108,-14.87994589,-1,1.8358374801,2.4155756317,-13.04410841
48,399,2008,141,140,-43,262,18,1,-25,-21,10273,13.711285068,13.614041912,-4.18145573,3,1.7503768172,0.0972431565,-2.431078913
48,401,2001,604,516,-135,3010,115,88,-20,12,47359,12.755263658,10.896880873,-2.850928135,-56,2.4285684117,1.8583827846,-0.422359724
48,401,2002,574,574,-42,2998,113,0,71,19,47378,12.117757582,12.117757582,-0.886665189,-52,2.3855515796,0,1.4988863907
48,401,2003,599,521,-230,2961,88,78,-142,-119,47259,12.658896626,11.010492725,-4.86067817,-55,1.8597377347,1.6484039012,-3.000940436
48,401,2004,587,534,127,2971,82,53,209,226,47485,12.391285992,11.272481635,2.6809085536,-36,1.7309803259,1.118804357,4.4118888795
48,401,2005,647,509,-62,2997,86,138,24,119,47604,13.6083038,10.705759867,-1.304041477,-43,1.8088317261,2.9025439325,0.5047902491
48,401,2006,653,533,180,3007,84,120,264,360,47964,13.665662146,11.154361292,3.7669512808,-24,1.7579105977,2.5113008538,5.5248618785
48,401,2007,706,489,200,2963,77,217,277,488,48452,14.64487222,10.14354464,4.1486890143,-6,1.5972452705,4.5013275805,5.7459342848
48,401,2008,684,518,188,2963,76,166,264,435,48887,14.05397631,10.643215977,3.8627888102,5,1.5615529233,3.4107603324,5.4243417335
48,403,2001,112,181,54,100,3,-69,57,-21,10423,10.734652801,17.347965687,5.1756361719,-9,0.2875353429,-6.613312886,5.4631715148
48,403,2002,104,184,70,95,2,-80,72,-16,10407,9.9855976956,17.666826692,6.7210753721,-8,0.1920307249,-7.681228997,6.913106097
48,403,2003,87,142,4,94,0,-55,4,-64,10343,8.3855421687,13.686746988,0.3855421687,-13,0,-5.301204819,0.3855421687
48,403,2004,114,162,7,94,3,-48,10,-47,10296,11.047046853,15.698435002,0.6783274383,-9,0.2907117593,-4.651388149,0.9690391976
48,403,2005,96,159,-50,94,2,-63,-48,-116,10180,9.3768314124,15.530377027,-4.883766361,-5,0.1953506544,-6.153545614,-4.688415706
48,403,2006,101,142,54,94,2,-41,56,9,10189,9.9170307821,13.942756149,5.3021748736,-6,0.1963768472,-4.025725367,5.4985517208
48,403,2007,102,168,-22,94,2,-66,-20,-97,10092,10.058675608,16.567230413,-2.169518268,-11,0.1972289335,-6.508554805,-1.972289335
48,403,2008,104,143,26,94,3,-39,29,-30,10062,10.320531904,14.190731368,2.5801329761,-20,0.2977076511,-3.870199464,2.8778406272
48,405,2001,112,117,-151,270,6,-5,-145,-157,8796,12.62042932,13.183841343,-17.0150431,-7,0.6760944279,-0.563412023,-16.33894867
48,405,2002,115,131,81,336,5,-16,86,61,8857,13.028946921,14.841669971,9.1769104402,-9,0.5664759531,-1.81272305,9.7433863932
48,405,2003,103,117,-2,345,5,-14,3,-22,8835,11.64368076,13.226316979,-0.226090889,-11,0.5652272213,-1.58263622,0.3391363328
48,405,2004,91,144,54,348,6,-53,60,-1,8834,10.300526346,16.299733997,6.112400249,-8,0.6791555832,-5.999207652,6.7915558322
48,405,2005,114,132,-65,328,6,-18,-59,-80,8754,12.963384126,15.010234251,-7.391403229,-3,0.682283375,-2.046850125,-6.709119854
48,405,2006,107,142,4,329,6,-35,10,-31,8723,12.244664416,16.249928477,0.4577444642,-6,0.6866166962,-4.005264061,1.1443611604
48,405,2007,117,104,-112,325,6,13,-106,-102,8621,13.491697417,11.992619926,-12.91512915,-9,0.6918819188,1.4990774908,-12.22324723
48,405,2008,102,109,-33,325,7,-7,-26,-45,8576,11.862534163,12.676629645,-3.8378787,-12,0.8140954818,-0.814095482,-3.023783218
48,407,2001,283,217,238,147,25,66,263,309,22761,12.518523434,9.5990091345,10.527945502,-20,1.1058766284,2.919514299,11.633822131
48,407,2002,273,223,329,142,24,50,353,389,23150,11.892574764,9.714447518,14.33207728,-14,1.0455010782,2.1781272462,15.377578358
48,407,2003,261,222,491,146,18,39,509,550,23700,11.141942369,9.477054429,20.960512273,2,0.7684098186,1.6648879402,21.728922092
48,407,2004,229,235,536,136,21,-6,557,517,24217,9.5581943778,9.8086274182,22.372018282,-34,0.8765156416,-0.25043304,23.248533923
48,407,2005,243,208,80,123,20,35,100,115,24332,10.010504851,8.5686625883,3.295639457,-20,0.8239098643,1.4418422625,4.1195493213
48,407,2006,293,241,-43,130,21,52,-22,20,24352,12.036808808,9.9005833539,-1.766494125,-10,0.8627064333,2.1362254539,-0.903787692
48,407,2007,257,257,386,120,18,0,404,412,24764,10.465021582,10.465021582,15.717892337,8,0.73295871,0,16.450851047
48,407,2008,272,218,51,120,20,54,71,118,24882,10.957579664,8.782177819,2.054546187,-7,0.8057043871,2.1754018451,2.8602505741
48,409,2001,1228,532,-1046,1538,14,696,-1032,-377,66874,18.311276794,7.9328984157,-15.59739049,-41,0.2087604846,10.378378378,-15.38863001
48,409,2002,1106,515,-433,944,-125,591,-558,-20,66854,16.541038526,7.7022014836,-6.475831539,-53,-1.86946638,8.8388370424,-8.345297918
48,409,2003,1066,549,173,862,-432,517,-259,172,67026,15.924708694,8.2013743651,2.5844039438,-86,-6.453540484,7.7233343293,-3.86913654
48,409,2004,1174,527,-193,850,220,647,27,625,67651,17.434305783,7.8261321532,-2.866116709,-49,3.2670760412,9.6081736302,0.4009593323
48,409,2005,1215,523,232,1177,1,692,233,864,68515,17.845864606,7.6818001557,3.4076054228,-61,0.0146879544,10.164064451,3.4222933772
48,409,2006,1101,512,-677,1019,111,589,-566,-8,68507,16.070412051,7.4732524704,-9.881624849,-31,1.6201777817,8.5971595802,-8.261447067
48,409,2007,1142,543,-718,750,-19,599,-737,-122,68385,16.684685738,7.933261257,-10.49002133,16,-0.277591094,8.7514244806,-10.76761242
48,409,2008,1180,576,-649,750,40,604,-609,14,68399,17.253479939,8.4220376652,-9.489413967,19,0.5848637268,8.831442274,-8.90455024
48,411,2001,63,87,-15,570,15,-24,0,-29,6172,10.183463994,14.062878849,-2.424634284,-5,2.4246342843,-3.879414855,0
48,411,2002,70,99,-95,565,15,-29,-80,-114,6058,11.447260834,16.189697465,-15.53556827,-5,2.4529844644,-4.742436631,-13.08258381
48,411,2003,54,94,-18,556,9,-40,-9,-59,5999,8.9574521025,15.592601808,-2.985817368,-10,1.4929086838,-6.635149706,-1.492908684
48,411,2004,73,77,71,558,8,-4,79,67,6066,12.101118939,12.764193949,11.769581434,-8,1.3261500207,-0.66307501,13.095731455
48,411,2005,63,72,-86,546,9,-9,-77,-91,5975,10.464247156,11.959139606,-14.28452786,-5,1.4948924508,-1.494892451,-12.78963541
48,411,2006,66,76,-30,549,8,-10,-22,-33,5942,11.076613242,12.754887975,-5.034824201,-1,1.3426197869,-1.678274734,-3.692204414
48,411,2007,70,67,-32,541,5,3,-27,-22,5920,11.8023942,11.296577306,-5.395380206,2,0.8430281571,0.5058168943,-4.552352049
48,411,2008,76,70,-50,541,4,6,-46,-39,5881,12.880264384,11.863401407,-8.473858148,1,0.6779086518,1.0168629777,-7.795949496
48,413,2001,42,30,11,50,10,12,21,31,2948,14.322250639,10.230179028,3.7510656436,-2,3.410059676,4.0920716113,7.1611253197
48,413,2002,41,29,-59,49,10,12,-49,-42,2906,14.007516228,9.9077553809,-20.1571575,-5,3.4164673727,4.0997608473,-16.74069013
48,413,2003,31,40,-136,49,6,-9,-130,-135,2771,10.92126123,14.091949974,-47.91262991,4,2.113792496,-3.170688744,-45.79883741
48,413,2004,37,46,-28,42,4,-9,-24,-35,2736,13.437443254,16.706010532,-10.16887598,-2,1.452696568,-3.268567278,-8.716179408
48,413,2005,48,26,-10,43,5,22,-5,15,2751,17.495899399,9.4769455076,-3.644979041,-2,1.8224895207,8.018953891,-1.822489521
48,413,2006,38,32,-14,46,4,6,-10,-6,2745,13.828238719,11.644832606,-5.094614265,-2,1.4556040757,2.1834061135,-3.639010189
48,413,2007,51,25,29,44,4,26,33,60,2805,18.378378378,9.009009009,10.45045045,1,1.4414414414,9.3693693694,11.891891892
48,413,2008,45,21,-11,44,3,24,-8,14,2819,16.00284495,7.4679943101,-3.911806543,-2,1.06685633,8.5348506401,-2.844950213
48,415,2001,207,176,-538,1555,14,31,-524,-500,15740,12.945590994,11.0068793,-33.64602877,-7,0.875547217,1.9387116948,-32.77048155
48,415,2002,227,166,54,1685,14,61,68,115,15855,14.369362241,10.507991771,3.4182623833,-14,0.8862161734,3.86137047,4.3044785567
48,415,2003,214,174,-176,1654,12,40,-164,-138,15717,13.556315723,11.022424933,-11.14911947,-14,0.7601672368,2.5338907893,-10.38895224
48,415,2004,242,178,78,1679,10,64,88,139,15856,15.329553733,11.275456878,4.9409305419,-13,0.6334526336,4.0540968549,5.5743831755
48,415,2005,227,168,-145,1716,11,59,-134,-87,15769,14.355731225,10.624505929,-9.169960474,-12,0.6956521739,3.7312252964,-8.4743083
48,415,2006,241,151,15,1814,10,90,25,106,15875,15.231955505,9.5436733662,0.9480470231,-9,0.6320313488,5.6882821388,1.5800783719
48,415,2007,248,147,7,1793,11,101,18,109,15984,15.56859914,9.228161587,0.439436266,-10,0.6905427038,6.340437553,1.1299789698
48,415,2008,254,143,-114,1793,10,111,-104,-11,15973,15.896360735,8.9495259255,-7.134587101,-18,0.6258409738,6.9468348093,-6.508746128
48,417,2001,35,43,18,55,-1,-8,17,5,3304,10.60124186,13.024382856,5.4520672422,-4,-0.302892625,-2.423140997,5.1491746176
48,417,2002,39,36,19,59,-1,3,18,19,3323,11.770031689,10.864644636,5.7341180021,-2,-0.301795684,0.905387053,5.4323223178
48,417,2003,28,48,-54,55,-2,-20,-56,-76,3247,8.5235920852,14.611872146,-16.43835616,0,-0.608828006,-6.088280061,-17.04718417
48,417,2004,37,52,-75,54,1,-15,-74,-93,3154,11.560693642,16.247461334,-23.43383846,-4,0.3124511795,-4.686767693,-23.12138728
48,417,2005,27,38,-20,57,-1,-11,-21,-35,3119,8.6083213773,12.115415272,-6.376534354,-3,-0.318826718,-3.507093894,-6.695361071
48,417,2006,40,45,9,55,0,-5,9,2,3121,12.820512821,14.423076923,2.8846153846,-2,0,-1.602564103,2.8846153846
48,417,2007,41,31,28,49,-1,10,27,37,3158,13.059404364,9.8741837872,8.9186176143,0,-0.318522058,3.1852205765,8.6000955566
48,417,2008,35,44,-44,49,1,-9,-43,-53,3105,11.176752355,14.050774389,-14.05077439,-1,0.3193357816,-2.874022034,-13.73143861
48,419,2001,411,317,-120,359,130,94,10,80,25343,16.243133225,12.528158716,-4.74252065,-24,5.1377307039,3.714974509,0.3952100541
48,419,2002,391,295,-75,360,123,96,48,116,25459,15.39309476,11.613715995,-2.95263966,-28,4.8423290422,3.7793787646,1.8896893823
48,419,2003,415,312,184,345,98,103,282,362,25821,16.185647426,12.168486739,7.1762870515,-23,3.8221528861,4.0171606864,10.998439938
48,419,2004,377,327,-187,341,92,50,-95,-65,25756,14.618919286,12.680070574,-7.251294182,-20,3.5674816294,1.9388487116,-3.683812552
48,419,2005,395,306,51,334,95,89,146,212,25968,15.273374062,11.832031552,1.9720052587,-23,3.6733431289,3.4413425102,5.6453483876
48,419,2006,379,300,-54,327,94,79,40,106,26074,14.56515891,11.529149533,-2.075246916,-13,3.6124668537,3.036009377,1.5372199377
48,419,2007,394,274,71,308,85,120,156,265,26339,15.034438021,10.455421365,2.7092515216,-11,3.2434701315,4.5790166562,5.952721653
48,419,2008,424,292,-28,308,85,132,57,190,26529,16.039948551,11.046379663,-1.059241885,1,3.2155557237,4.9935688886,2.1563138382
48,421,2001,34,35,-67,81,14,-1,-53,-56,3126,10.779961953,11.097019658,-21.2428662,-2,4.438807863,-0.317057705,-16.80405834
48,421,2002,40,24,-1,81,14,16,13,25,3151,12.744941851,7.6469651107,-0.318623546,-4,4.4607296479,5.0979767405,4.1421061016
48,421,2003,48,36,-84,80,7,12,-77,-64,3087,15.389547932,11.542160949,-26.93170888,1,2.2443090734,3.847386983,-24.68739981
48,421,2004,41,29,-90,82,6,12,-84,-77,3010,13.44923733,9.5128751845,-29.52271609,-5,1.9681810727,3.9363621453,-27.55453502
48,421,2005,46,33,-111,72,7,13,-104,-92,2918,15.519568151,11.133603239,-37.44939271,-1,2.3616734143,4.3859649123,-35.0877193
48,421,2006,30,19,-56,76,6,11,-50,-40,2878,10.351966874,6.5562456867,-19.3236715,-1,2.0703933747,3.795721187,-17.25327812
48,421,2007,38,23,-15,81,5,15,-10,5,2883,13.19215414,7.9847248742,-5.207429266,0,1.7358097553,5.2074292658,-3.471619511
48,421,2008,41,15,22,81,4,26,26,47,2930,14.106313435,5.1608463788,7.5692413556,-5,1.376225701,8.9454670566,8.9454670566
48,423,2001,2658,1824,744,4791,592,834,1336,1993,177488,15.060215364,10.334775329,4.2155004632,-177,3.3542691858,4.7254400354,7.569769649
48,423,2002,2713,1739,1618,4856,557,974,2175,3014,180502,15.156847957,9.7153551775,9.0393586413,-135,3.1118187659,5.4414927791,12.151177407
48,423,2003,2807,1702,1365,4819,501,1105,1866,2797,183299,15.431513382,9.3567637252,7.5041025176,-174,2.7542530119,6.0747496571,10.25835553
48,423,2004,2899,1674,1311,5134,454,1225,1765,2835,186134,15.694320756,9.0625363733,7.0973627153,-155,2.4578204979,6.6317843831,9.5551832132
48,423,2005,2892,1642,2231,5301,483,1250,2714,3795,189929,15.380401688,8.7325793816,11.865033252,-169,2.5687185392,6.6478223064,14.433751792
48,423,2006,2938,1487,2549,5550,478,1451,3027,4373,194302,15.292883708,7.7401354914,13.268060099,-105,2.4880865937,7.5527482166,15.756146693
48,423,2007,3133,1721,1793,5422,430,1412,2223,3650,197952,15.974343155,8.7749264507,9.1420355178,15,2.1924569284,7.1994167045,11.334492446
48,423,2008,3243,1770,1381,5422,432,1473,1813,3325,201277,16.246314772,8.8670913185,6.9183350909,39,2.1641714405,7.3792234532,9.0825065313
48,425,2001,89,78,55,161,14,11,69,71,6901,12.963367562,11.361153594,8.011069842,-9,2.0391814143,1.6022139684,10.050251256
48,425,2002,93,88,180,158,14,5,194,194,7095,13.289511289,12.575021435,25.721634753,-5,2.0005715919,0.7144898542,27.722206345
48,425,2003,102,84,117,158,10,18,127,139,7234,14.236862307,11.724474841,16.330518529,-6,1.3957708144,2.512387466,17.726289343
48,425,2004,87,64,51,163,9,23,60,78,7312,11.962051423,8.7996700124,7.0122370411,-5,1.2374535955,3.1623814107,8.2496906366
48,425,2005,87,64,77,183,10,23,87,106,7418,11.812627291,8.6897488119,10.454854039,-4,1.3577732519,3.1228784793,11.812627291
48,425,2006,93,81,174,180,9,12,183,190,7608,12.378543857,10.781312392,23.159856249,-5,1.1979235991,1.5972314655,24.357779848
48,425,2007,102,70,99,182,6,32,105,130,7738,13.29336635,9.1228984752,12.902384986,-7,0.7819627264,4.1704678744,13.684347713
48,425,2008,101,90,197,182,5,11,202,204,7942,12.882653061,11.479591837,25.12755102,-9,0.637755102,1.4030612245,25.765306122
48,427,2001,1427,267,-874,400,511,1160,-363,766,54570,26.334729732,4.9273811062,-16.12932991,-31,9.430306162,21.407348626,-6.699023751
48,427,2002,1488,280,-319,397,487,1208,168,1327,55897,26.940172178,5.0693872378,-5.77548046,-49,8.8171128029,21.87078494,3.0416323427
48,427,2003,1469,279,-48,405,427,1190,379,1497,57394,25.933216231,4.925369182,-0.847375343,-72,7.5381098234,21.007847049,6.6907344802
48,427,2004,1486,298,-110,401,382,1188,272,1408,58802,25.577472546,5.1292643464,-1.893352611,-52,6.5750972495,20.4482082,4.6817446384
48,427,2005,1510,308,-904,392,407,1202,-497,656,59458,25.536952478,5.2088618299,-15.28834771,-49,6.8831388466,20.328090648,-8.405208862
48,427,2006,1557,276,-672,395,402,1281,-270,979,60437,25.972726135,4.604028525,-11.20980858,-32,6.7058676342,21.36869761,-4.503940948
48,427,2007,1464,331,-587,395,369,1133,-218,898,61335,24.044936439,5.4363893177,-9.640968367,-17,6.0605065204,18.608547121,-3.580461847
48,427,2008,1604,336,-694,395,369,1268,-325,914,62249,25.958052822,5.4375970999,-11.23122734,-29,5.9716468151,20.520455722,-5.259580528
48,429,2001,140,112,-227,641,14,28,-213,-191,9447,14.671207755,11.736966204,-23.78831543,-6,1.4671207755,2.934241551,-22.32119466
48,429,2002,144,118,-126,636,14,26,-112,-91,9356,15.316704781,12.55118864,-13.40211668,-5,1.4891240759,2.765516141,-11.91299261
48,429,2003,107,116,25,745,12,-9,37,15,9371,11.427350884,12.38852993,2.6699417953,-13,1.2815720617,-0.961179046,3.951513857
48,429,2004,130,108,-108,746,11,22,-97,-84,9287,13.935041269,11.576803516,-11.57680352,-9,1.1791188766,2.3582377532,-10.39768464
48,429,2005,133,126,67,748,12,7,79,77,9364,14.261969868,13.511339875,7.1846013619,-9,1.2867942738,0.750629993,8.4713956356
48,429,2006,139,112,16,744,11,27,27,49,9413,14.805346967,11.929488204,1.7042126005,-5,1.1716461629,2.8758587634,2.8758587634
48,429,2007,136,99,30,739,11,37,41,79,9492,14.387728114,10.47341973,3.1737635546,1,1.1637133034,3.914308384,4.337476858
48,429,2008,156,109,33,739,10,47,43,93,9585,16.354772763,11.427373277,3.4596634691,3,1.0483828694,4.9273994863,4.5080463385
48,431,2001,15,6,-20,26,4,9,-16,-8,1365,10.956902849,4.3827611395,-14.6092038,-1,2.9218407597,6.5741417093,-11.68736304
48,431,2002,13,16,-2,23,4,-3,2,-3,1362,9.534286762,11.734506784,-1.466813348,-2,2.933626696,-2.200220022,1.466813348
48,431,2003,15,18,-28,21,3,-3,-25,-28,1334,11.127596439,13.353115727,-20.77151335,0,2.2255192878,-2.225519288,-18.54599407
48,431,2004,6,10,-14,26,2,-4,-12,-18,1316,4.5283018868,7.5471698113,-10.56603774,-2,1.5094339623,-3.018867925,-9.056603774
48,431,2005,10,11,-56,26,3,-1,-53,-54,1262,7.7579519007,8.5337470908,-43.44453064,0,2.3273855702,-0.77579519,-41.11714507
48,431,2006,7,15,-46,22,2,-8,-44,-52,1210,5.6634304207,12.13592233,-37.21682848,0,1.6181229773,-6.472491909,-35.5987055
48,431,2007,11,5,21,27,2,6,23,28,1238,8.9869281046,4.0849673203,17.156862745,-1,1.6339869281,4.9019607843,18.790849673
48,431,2008,12,7,14,27,1,5,15,19,1257,9.619238477,5.6112224449,11.22244489,-1,0.8016032064,4.0080160321,12.024048096
48,433,2001,17,25,-101,41,1,-8,-100,-109,1568,10.477657935,15.408320493,-62.24961479,-1,0.6163328197,-4.930662558,-61.63328197
48,433,2002,24,16,-103,33,1,8,-102,-95,1473,15.784281486,10.522854324,-67.74087471,-1,0.6576783953,5.2614271621,-67.08319632
48,433,2003,13,27,-32,41,1,-14,-31,-43,1430,8.9562521529,18.601446779,-22.04615915,2,0.6889424733,-9.645194626,-21.35721667
48,433,2004,23,18,-36,42,0,5,-36,-34,1396,16.277423921,12.738853503,-25.47770701,-3,0,3.5385704176,-25.47770701
48,433,2005,12,23,-33,45,1,-11,-32,-43,1353,8.7304474354,16.733357585,-24.00873045,0,0.7275372863,-8.002910149,-23.28119316
48,433,2006,16,24,39,40,0,-8,39,29,1382,11.700182815,17.550274223,28.519195612,-2,0,-5.850091408,28.519195612
48,433,2007,32,17,14,40,1,15,15,29,1411,22.914428929,12.173290369,10.025062657,-1,0.716075904,10.741138561,10.741138561
48,433,2008,33,15,14,40,0,18,14,29,1440,23.14977201,10.522623641,9.8211153981,-3,0,12.627148369,9.8211153981
48,435,2001,60,26,-35,31,11,34,-24,6,4036,14.877262584,6.4468137863,-8.678403174,-4,2.7274981403,8.4304487974,-5.950905033
48,435,2002,64,34,0,31,11,30,11,38,4074,15.78298397,8.3847102343,0,-3,2.7127003699,7.3982737361,2.7127003699
48,435,2003,55,37,-76,31,8,18,-68,-54,4020,13.590313813,9.1425747467,-18.77934272,-4,1.9767729182,4.447739066,-16.8025698
48,435,2004,71,37,55,31,7,34,62,92,4112,17.461878997,9.0998524348,13.526807673,-4,1.7215937039,8.3620265617,15.248401377
48,435,2005,68,40,41,31,8,28,49,74,4186,16.389491444,9.6408773198,9.8818992528,-3,1.928175464,6.7486141239,11.810074717
48,435,2006,55,24,35,31,7,31,42,71,4257,13.028544356,5.6851829918,8.2908918631,-2,1.6581783726,7.3433613644,9.9490702357
48,435,2007,65,19,-31,31,7,46,-24,14,4271,15.243902439,4.4559099437,-7.270168856,-8,1.6416510319,10.787992495,-5.628517824
48,435,2008,72,13,-57,31,6,59,-51,-1,4270,16.859852476,3.0441400304,-13.34738321,-9,1.4049877064,13.815712446,-11.9423955
48,437,2001,151,89,-196,644,11,62,-185,-128,8232,18.201542912,10.728061716,-23.62584378,-5,1.3259402122,7.4734811958,-22.29990357
48,437,2002,111,86,-241,645,10,25,-231,-211,8021,13.659016797,10.582661662,-29.6560635,-5,1.2305420538,3.0763551344,-28.42552144
48,437,2003,132,91,-101,665,9,41,-92,-58,7963,16.516516517,11.386386386,-12.63763764,-7,1.1261261261,5.1301301301,-11.51151151
48,437,2004,134,74,-158,683,8,60,-150,-99,7864,16.933089025,9.3511088646,-19.96588109,-9,1.0109306881,7.5819801605,-18.9549504
48,437,2005,139,76,-180,658,9,63,-171,-113,7751,17.803394172,9.7342299071,-23.05475504,-5,1.1527377522,8.0691642651,-21.90201729
48,437,2006,109,78,-77,667,8,31,-69,-41,7710,14.099993532,10.089903628,-9.96054589,-3,1.0348619106,4.0100899036,-8.925683979
48,437,2007,151,74,-107,684,9,77,-98,-21,7689,19.611663095,9.6110137022,-13.8970063,0,1.1689070719,10.000649393,-12.72809923
48,437,2008,133,63,-105,684,8,70,-97,-35,7654,17.336896305,8.212214039,-13.6870234,-8,1.0428208303,9.1246822655,-12.64420257
48,439,2001,25811,9634,9668,23672,9613,16177,19281,34106,1488537,17.540795551,6.5471320109,6.5702379367,-1352,6.5328607039,10.99366354,13.103098641
48,439,2002,26677,10065,10628,24284,8952,16612,19580,34908,1523445,17.713917281,6.6833068724,7.0571470879,-1284,5.944258631,11.030610409,13.001405719
48,439,2003,27277,9399,5566,25143,7604,17878,13170,29036,1552481,17.735797285,6.1113303766,3.6190727605,-2012,4.9442021687,11.624466909,8.5632749292
48,439,2004,27694,9687,4037,24852,7382,18007,11419,28323,1580804,17.677293958,6.1832868699,2.5768482599,-1103,4.7119875785,11.494007088,7.2888358384
48,439,2005,27709,9954,8195,25300,7607,17755,15802,32065,1612869,17.352434016,6.2335749465,5.1320219697,-1492,4.7637939138,11.118859069,9.8958158835
48,439,2006,28402,9736,23847,25281,7755,18666,31602,49346,1662215,17.344287963,5.9454963598,14.562679919,-922,4.7357563959,11.398791604,19.298436315
48,439,2007,29476,10301,20571,25528,6937,19175,27508,47034,1709249,17.485578965,6.1106984977,12.203007358,351,4.1151262478,11.374880467,16.318133606
48,439,2008,30483,10437,13302,25528,6994,20046,20296,40842,1750091,17.62359294,6.03409899,7.690484312,500,4.0435458787,11.58949395,11.734030191
48,441,2001,2031,1170,-1915,6644,105,861,-1810,-1025,125442,16.124870489,9.2890686716,-15.203903,-76,0.833634368,6.8358018173,-14.37026863
48,441,2002,2018,1199,-722,6535,-118,819,-840,-127,125315,16.095263542,9.5630431055,-5.758563071,-106,-0.941150197,6.5322204365,-6.699713268
48,441,2003,1955,1130,-118,6231,-613,825,-731,-86,125229,15.606041254,9.0203716712,-0.941950316,-180,-4.893352066,6.585669583,-5.835302382
48,441,2004,2064,1244,-664,6285,428,820,-236,485,125714,16.449950786,9.9146021208,-5.292038431,-99,3.4111332055,6.5353486648,-1.880905225
48,441,2005,2117,1209,-660,6425,79,908,-581,212,125926,16.825623907,9.6089651884,-5.245588937,-115,0.6278811,7.2166587188,-4.617707837
48,441,2006,2098,1165,-1107,6371,252,933,-855,23,125949,16.659057072,9.2506203474,-8.790074442,-55,2.0009925558,7.4084367246,-6.789081886
48,441,2007,2096,1174,-483,6354,40,922,-443,504,126453,16.608426241,9.302620423,-3.827227993,25,0.3169546992,7.3058058177,-3.510273294
48,441,2008,2127,1192,-791,6354,133,935,-658,338,126791,16.798028779,9.4138459351,-6.24693971,61,1.0503703938,7.3841828434,-5.196569317
48,443,2001,5,4,-43,0,7,1,-36,-36,1025,4.7938638543,3.8350910834,-41.22722915,-1,6.711409396,0.9587727709,-34.51581975
48,443,2002,5,8,-3,0,7,-3,4,0,1025,4.8780487805,7.8048780488,-2.926829268,-1,6.8292682927,-2.926829268,3.9024390244
48,443,2003,7,17,-4,0,3,-10,-1,-13,1012,6.8728522337,16.691212568,-3.927344134,-2,2.9455081001,-9.818360334,-0.981836033
48,443,2004,7,11,-49,0,2,-4,-47,-53,959,7.1029934044,11.161846778,-49.72095383,-2,2.029426687,-4.058853374,-47.69152714
48,443,2005,10,10,4,0,3,0,7,6,965,10.395010395,10.395010395,4.158004158,-1,3.1185031185,0,7.2765072765
48,443,2006,8,9,-8,0,2,-1,-6,-7,958,8.3203328133,9.360374415,-8.320332813,0,2.0800832033,-1.040041602,-6.24024961
48,443,2007,12,4,-34,0,2,8,-32,-26,932,12.698412698,4.2328042328,-35.97883598,-2,2.1164021164,8.4656084656,-33.86243386
48,443,2008,9,2,-10,0,1,7,-9,-8,924,9.6982758621,2.1551724138,-10.77586207,-6,1.0775862069,7.5431034483,-9.698275862
48,445,2001,178,122,-380,965,51,56,-329,-277,12434,14.157884271,9.7037184331,-30.22469676,-4,4.0564724597,4.4541658381,-26.1682243
48,445,2002,197,118,-70,963,50,79,-20,47,12481,15.813766807,9.4722054987,-5.619104957,-12,4.0136463978,6.3415613084,-1.605458559
48,445,2003,200,111,-192,982,36,89,-156,-70,12411,16.069419894,8.9185280411,-15.4266431,-3,2.8924955809,7.1508918528,-12.53414752
48,445,2004,197,127,-142,1007,33,70,-109,-51,12360,15.905696177,10.253925962,-11.46501958,-12,2.6644059586,5.6517702152,-8.800613621
48,445,2005,182,114,-256,994,36,68,-220,-160,12200,14.820846906,9.2833876221,-20.84690554,-8,2.9315960912,5.5374592834,-17.91530945
48,445,2006,205,121,-105,1000,35,84,-70,8,12208,16.797771223,9.9147820387,-8.60373648,-6,2.8679121599,6.8829891839,-5.73582432
48,445,2007,208,92,-209,1010,34,116,-175,-59,12149,17.079279057,7.5542965061,-17.16139098,0,2.7918052305,9.5249825512,-14.36958575
48,445,2008,196,99,-142,1010,33,97,-109,-14,12135,16.142315928,8.1535167188,-11.69494317,-2,2.7178389063,7.9887992094,-8.977104266
48,447,2001,16,13,-46,26,3,3,-43,-40,1794,8.8202866593,7.1664829107,-25.35832415,0,1.6538037486,1.6538037486,-23.7045204
48,447,2002,18,26,-48,29,3,-8,-45,-53,1741,10.18387553,14.710042433,-27.15700141,0,1.6973125884,-4.526166902,-25.45968883
48,447,2003,8,30,-24,26,3,-22,-21,-45,1696,4.6552225778,17.457084667,-13.96566773,-2,1.7457084667,-12.80186209,-12.21995927
48,447,2004,5,27,-34,22,2,-22,-32,-56,1640,2.9976019185,16.18705036,-20.38369305,-2,1.1990407674,-13.18944844,-19.18465228
48,447,2005,15,23,45,23,3,-8,48,39,1679,9.0388671287,13.859596264,27.116601386,-1,1.8077734257,-4.820729135,28.924374812
48,447,2006,12,20,36,22,2,-8,38,29,1708,7.0859167405,11.809861234,21.257750221,-1,1.1809861234,-4.723944494,22.438736345
48,447,2007,16,12,-49,22,3,4,-46,-41,1667,9.4814814815,7.1111111111,-29.03703704,1,1.7777777778,2.3703703704,-27.25925926
48,447,2008,11,13,-1,22,2,-2,1,0,1667,6.5986802639,7.7984403119,-0.599880024,1,1.199760048,-1.199760048,0.599880024
48,449,2001,542,286,-653,621,245,256,-408,-170,27932,19.345397437,10.208087947,-23.30727772,-18,8.7446907235,9.1373094907,-14.562587
48,449,2002,505,270,-293,651,230,235,-63,151,28083,18.030884584,9.6402749264,-10.46148353,-21,8.2120860484,8.3906096581,-2.249397483
48,449,2003,510,239,-35,657,202,271,167,397,28480,18.032989764,8.4507540265,-1.237558121,-41,7.1424782985,9.5822357371,5.9049201775
48,449,2004,567,266,-97,650,176,301,79,358,28838,19.784360934,9.281552043,-3.384626121,-22,6.1411772916,10.502808891,2.7565511707
48,449,2005,570,236,-1316,629,188,334,-1128,-811,28027,20.047480876,8.3003605029,-46.28506111,-17,6.6121515871,11.747120373,-39.67290952
48,449,2006,584,252,96,641,187,332,283,598,28625,20.617100897,8.8964202499,3.3891124762,-17,6.6017086775,11.720680647,9.9908211537
48,449,2007,615,224,22,638,172,391,194,586,29211,21.267030915,7.7460405284,0.7607718376,1,5.9478525486,13.520990387,6.7086243862
48,449,2008,564,227,59,638,173,337,232,582,29793,19.117347976,7.6943936004,1.999864416,13,5.8640092197,11.422954376,7.8638736357
48,451,2001,1606,1030,-779,4076,89,576,-690,-201,103840,15.451147532,9.9095155401,-7.494672433,-87,0.8562591098,5.5416319914,-6.638413323
48,451,2002,1512,1017,-167,4339,-52,495,-219,180,104020,14.548253632,9.7854325026,-1.606850765,-96,-0.500336765,4.7628211296,-2.10718753
48,451,2003,1648,964,428,4329,-361,684,67,623,104643,15.795804719,9.2397789738,4.102308507,-128,-3.460124699,6.5560257449,0.6421838083
48,451,2004,1572,1016,-606,4435,281,556,-325,148,104791,15.011889187,9.7023405942,-5.787025984,-83,2.6834229399,5.3095485929,-3.103603044
48,451,2005,1603,990,-422,4636,66,613,-356,155,104946,15.285810324,9.4403943987,-4.024087309,-102,0.6293596266,5.8454159257,-3.394727683
48,451,2006,1594,965,73,4736,175,629,248,826,105772,15.129224841,9.1591605843,0.6928691426,-51,1.6609876707,5.9700642565,2.3538568134
48,451,2007,1712,963,59,5100,39,749,98,857,106629,16.12045141,9.0677539183,0.55555294,10,0.3672299095,7.052697492,0.9227828494
48,451,2008,1720,982,364,5100,98,738,462,1235,107864,16.037819416,9.1564759689,3.3940501555,35,0.9137827342,6.8813434471,4.3078328897
48,453,2001,14472,4130,9412,19874,7903,10342,17315,27044,847960,17.343409576,4.9494390236,11.279447964,-613,9.4710451825,12.393970553,20.750493146
48,453,2002,14552,4025,-12388,20504,7440,10527,-4948,5110,853070,17.109633575,4.7324268237,-14.56529279,-469,8.7476411351,12.377206751,-5.817651658
48,453,2003,14406,3977,-6476,21231,6499,10429,23,9571,862641,16.793037988,4.6359789032,-7.549056922,-881,7.5758679638,12.157059085,0.0268110422
48,453,2004,14993,4109,336,21876,5935,10884,6271,16606,879247,17.214654444,4.7178693464,0.3857882941,-549,6.814445016,12.496785098,7.2002333101
48,453,2005,14989,4042,6122,22123,6249,10947,12371,22454,901701,16.832608251,4.5391555509,6.8749901738,-864,7.0176108455,12.2934527,13.892601019
48,453,2006,15607,4226,18734,22443,6260,11381,24994,35840,937541,16.971121799,4.5953713541,20.371435624,-535,6.8071520768,12.375750445,27.178587701
48,453,2007,16265,4322,14577,22793,5685,11943,20262,32351,969892,17.054334281,4.5317450207,15.284416281,146,5.9608908937,12.52258926,21.245307175
48,453,2008,16571,4471,10825,22793,5697,12100,16522,28651,998543,16.836725622,4.5426950852,10.99858517,29,5.7883547082,12.294030537,16.786939879
48,455,2001,169,195,38,181,18,-26,56,17,13837,12.221137506,14.101312507,2.7479480782,-13,1.301659616,-1.880175001,4.0496076943
48,455,2002,166,192,146,187,18,-26,164,131,13968,11.940298507,13.810465744,10.501708326,-7,1.2947311635,-1.870167236,11.796439489
48,455,2003,160,189,87,185,16,-29,103,58,14026,11.431020933,13.502893477,6.2156176323,-16,1.1431020933,-2.071872544,7.3587197257
48,455,2004,148,226,116,195,14,-78,130,38,14064,10.53755785,16.091135635,8.2591669633,-14,0.9967960128,-5.553577786,9.2559629761
48,455,2005,172,213,109,178,16,-41,125,71,14135,12.199014149,15.106918685,7.7307705947,-13,1.1347920139,-2.907904536,8.8655626086
48,455,2006,185,211,-2,196,16,-26,14,-19,14116,13.096881526,14.937524335,-0.141587908,-7,1.1327032671,-1.840642809,0.9911153587
48,455,2007,158,207,58,189,12,-49,70,26,14142,11.182673933,14.650718381,4.1050322033,5,0.8493170076,-3.468044448,4.9543492108
48,455,2008,169,186,9,189,11,-17,20,5,14147,11.948107038,13.149987628,0.6362897239,2,0.7776874403,-1.20188059,1.4139771643
48,457,2001,237,246,-314,1573,16,-9,-298,-327,20543,11.445681308,11.880327433,-15.16432038,-20,0.7727042233,-0.434646126,-14.39161616
48,457,2002,204,234,55,1585,16,-30,71,22,20565,9.9250754111,11.384645325,2.6758781746,-19,0.7784372871,-1.459569913,3.4543154617
48,457,2003,205,242,-102,1553,10,-37,-92,-160,20405,10.007322431,11.813522089,-4.979253112,-31,0.4881620698,-1.806199658,-4.491091042
48,457,2004,257,281,113,1587,11,-24,124,79,20484,12.570618015,13.744527868,5.5271588936,-21,0.5380420162,-1.173909854,6.0652009098
48,457,2005,234,269,-221,1575,11,-35,-210,-258,20226,11.495946942,13.215426185,-10.85728322,-13,0.5404077622,-1.719479243,-10.31687546
48,457,2006,247,238,-75,1583,11,9,-64,-65,20161,12.231658702,11.785970733,-3.714066408,-10,0.5447297398,0.4456879689,-3.169336668
48,457,2007,243,233,173,1561,8,10,181,173,20334,12.001481664,11.50759353,8.544264724,-18,0.3951105075,0.4938881343,8.9393752315
48,457,2008,246,232,143,1561,10,14,153,136,20470,12.057641408,11.371434173,7.0091167533,-31,0.4901480247,0.6862072346,7.499264778
48,459,2001,454,446,279,479,26,8,305,277,35639,12.788552274,12.563203335,7.8590442388,-36,0.7323840509,0.2253489387,8.5914282897
48,459,2002,513,397,776,479,25,116,801,903,36542,14.214266912,11.000124687,21.501503166,-14,0.6927030659,3.2141422258,22.194206232
48,459,2003,442,435,380,501,12,7,392,361,36903,12.036217578,11.845598747,10.347879366,-38,0.3267751379,0.1906188304,10.674654503
48,459,2004,473,405,133,491,16,68,149,188,37091,12.784820391,10.946833527,3.5948860718,-29,0.4324674974,1.8379868638,4.0273535692
48,459,2005,489,431,264,491,14,58,278,302,37393,13.130336717,11.572955266,7.0887707427,-34,0.3759196606,1.557381451,7.4646904033
48,459,2006,502,398,72,498,15,104,87,172,37565,13.3941674,10.61928013,1.9210758024,-19,0.4002241255,2.7748872702,2.321299928
48,459,2007,500,401,209,493,12,99,221,316,37881,13.254513162,10.630119556,5.5403865016,-4,0.3181083159,2.624393606,5.8584948175
48,459,2008,507,432,361,493,14,75,375,450,38331,13.30499134,11.336797355,9.4735737154,0,0.3673962106,1.9681939852,9.840969926
48,461,2001,47,42,-174,33,3,5,-171,-166,3212,14.264036419,12.746585736,-52.80728376,0,0.9104704097,1.5174506829,-51.89681335
48,461,2002,53,42,10,33,3,11,13,22,3234,16.444306547,13.031337263,3.1026993484,-2,0.9308098045,3.4129692833,4.033509153
48,461,2003,48,24,-125,33,3,24,-122,-94,3140,15.061186068,7.5305930342,-39.22183872,4,0.9413241293,7.5305930342,-38.28051459
48,461,2004,47,22,-76,33,2,25,-74,-52,3088,15.09312781,7.0648683365,-24.4059088,-3,0.6422607579,8.0282594733,-23.76364804
48,461,2005,51,22,-99,33,3,29,-96,-69,3019,16.702145079,7.204846897,-32.42181104,-2,0.9824791223,9.4972981824,-31.43933191
48,461,2006,39,29,49,33,2,10,51,60,3079,12.791079042,9.5113151853,16.070842899,-1,0.6559527714,3.279763857,16.726795671
48,461,2007,45,22,-72,33,1,23,-71,-48,3031,14.7299509,7.201309329,-23.56792144,0,0.3273322422,7.5286415712,-23.2405892
48,461,2008,52,6,78,33,0,46,78,118,3149,16.828478964,1.9417475728,25.242718447,-6,0,14.886731392,25.242718447
48,463,2001,486,247,-197,617,49,239,-148,71,25989,18.725798062,9.5170208257,-7.590498391,-20,1.8879919857,9.2087772362,-5.702506406
48,463,2002,459,225,161,635,48,234,209,415,26404,17.521424618,8.5889336362,6.1458591797,-28,1.8323058424,8.9324909816,7.978165022
48,463,2003,463,269,-247,610,43,194,-204,-36,26368,17.547184113,10.194800273,-9.361024786,-26,1.6296520882,7.3523838399,-7.731372698
48,463,2004,450,243,-233,619,41,207,-192,-8,26360,17.068730086,9.2171142467,-8.837809134,-23,1.5551509634,7.8516158398,-7.28265817
48,463,2005,468,208,-87,608,42,260,-45,192,26552,17.689749017,7.8621106743,-3.288478984,-23,1.5875415785,9.8276383429,-1.700937406
48,463,2006,448,236,-275,600,43,212,-232,-32,26520,16.882725354,8.8935785348,-10.36328007,-12,1.6204401568,7.9891468194,-8.742839916
48,463,2007,461,207,-336,606,36,254,-300,-46,26474,17.398196022,7.8122051553,-12.68068083,0,1.3586443748,9.5859908669,-11.32203646
48,463,2008,484,234,-308,606,38,250,-270,-13,26461,18.286577879,8.8410314537,-11.6369132,7,1.4357230566,9.4455464249,-10.20119014
48,465,2001,855,319,-638,823,226,536,-412,90,45098,18.977648547,7.0805495749,-14.16109915,-34,5.0163141189,11.897098972,-9.144785031
48,465,2002,879,340,-281,816,153,539,-128,373,45471,19.410615111,7.5080877563,-6.205213704,-38,3.3786394903,11.902527355,-2.826574214
48,465,2003,948,279,226,807,-10,669,216,821,46292,20.661922561,6.0808822728,4.9257325937,-64,-0.21795277,14.581040289,4.7077798241
48,465,2004,960,279,-263,825,257,681,-6,634,46926,20.596880431,5.9859683752,-5.642687035,-41,5.513956532,14.610912056,-0.128730503
48,465,2005,977,305,-691,809,172,672,-519,115,47041,20.794534251,6.4916406824,-14.70729086,-38,3.6608596635,14.302893569,-11.04643119
48,465,2006,945,320,-653,768,219,625,-434,169,47210,20.052837636,6.7903788819,-13.85661691,-22,4.6471655473,13.262458754,-9.209451359
48,465,2007,955,329,-260,752,148,626,-112,527,47737,20.11648604,6.9301821016,-5.476739655,13,3.1175287266,13.186303938,-2.359210928
48,465,2008,978,363,-509,752,175,615,-334,316,48053,20.419668024,7.5790792358,-10.62741414,35,3.6538260779,12.840588788,-6.973588057
48,467,2001,642,560,441,930,106,82,547,591,48931,13.200234397,11.51422315,9.0674507304,-38,2.1794779533,1.6860112469,11.246928684
48,467,2002,610,602,904,947,104,8,1008,998,49929,12.340683795,12.178838762,18.288488772,-18,2.1039854339,0.1618450334,20.392474206
48,467,2003,604,568,206,935,80,36,286,264,50193,12.065280358,11.346157688,4.1149797247,-58,1.5980503785,0.7191226703,5.7130301033
48,467,2004,599,553,971,952,75,46,1046,1028,51221,11.812964679,10.9057921,19.149229889,-64,1.4790857278,0.9071725797,20.628315617
48,467,2005,603,626,128,930,80,-23,208,135,51356,11.757021555,12.205465163,2.4956861675,-50,1.5598038547,-0.448443608,4.0554900221
48,467,2006,601,515,313,971,79,86,392,452,51808,11.651351247,9.9841029817,6.0680082199,-26,1.5315420108,1.6672482649,7.5995502307
48,467,2007,628,624,-58,833,61,4,3,-23,51785,12.124371338,12.047146043,-1.11976678,-30,1.177685751,0.0772252951,0.0579189714
48,467,2008,640,571,274,833,63,69,337,412,52197,12.309822854,10.982670078,5.2701429093,6,1.2117481872,1.3271527764,6.4818910965
48,469,2001,1373,682,-61,1582,116,691,55,658,84665,16.280117625,8.0867008158,-0.723297287,-88,1.3754505786,8.193416809,0.6521532916
48,469,2002,1365,689,-552,1601,114,676,-438,173,84838,16.10590963,8.1296496227,-6.513159059,-65,1.3451089361,7.9762600072,-5.168050123
48,469,2003,1351,689,-523,1620,99,662,-424,151,84989,15.910308726,8.1141396833,-6.159209077,-87,1.1658923493,7.7961690426,-4.993316728
48,469,2004,1352,720,-469,1606,96,632,-373,189,85178,15.890272497,8.4622752943,-5.512232101,-70,1.1283033726,7.4279972027,-4.383928729
48,469,2005,1325,716,-821,1623,98,609,-723,-187,84991,15.572754144,8.415163749,-9.649231059,-73,1.1517961556,7.1575903954,-8.497434903
48,469,2006,1390,769,-517,1605,98,621,-419,163,85154,16.339004966,9.0393487907,-6.077169473,-39,1.1519586235,7.2996561756,-4.92521085
48,469,2007,1411,726,224,1569,86,685,310,1012,86166,16.472098996,8.4753677329,2.6149894933,17,1.0039691805,7.9967312631,3.6189586738
48,469,2008,1416,750,-214,1569,87,666,-127,589,86755,16.377420903,8.6744814106,-2.475118696,50,1.0062398436,7.7029394926,-1.468878852
48,471,2001,626,431,230,17500,108,195,338,476,62220,10.099706366,6.9536316995,3.7107547352,-57,1.7424413539,3.1460746668,5.4531960892
48,471,2002,587,431,-782,16755,102,156,-680,-564,61656,9.4772191546,6.9585714747,-12.62552875,-40,1.6468080984,2.5186476799,-10.97872066
48,471,2003,629,414,834,17480,82,215,916,1104,62760,10.111239712,6.6550925926,13.406635802,-27,1.3181584362,3.4561471193,14.724794239
48,471,2004,612,445,486,18097,88,167,574,687,63447,9.6983527063,7.0519067881,7.7016330314,-54,1.3945343761,2.6464459182,9.0961674075
48,471,2005,627,390,623,18957,87,237,710,888,64335,9.8135887684,6.1041461239,9.7509821415,-59,1.3616941353,3.7094426445,11.112676277
48,471,2006,608,421,-661,18397,89,187,-572,-412,63923,9.4808900809,6.5648926383,-10.30734925,-27,1.3878276599,2.9159974427,-8.919521589
48,471,2007,661,413,-324,18512,80,248,-244,7,63930,10.339999844,6.4605445316,-5.068320649,3,1.2514371974,3.879455312,-3.816883452
48,471,2008,654,429,-42,18512,82,225,40,282,64212,10.207426137,6.6956969612,-0.655522779,17,1.2798301884,3.5117291754,0.624307409
48,473,2001,507,241,24,3086,116,266,140,371,33209,15.352703378,7.2978333611,0.7267551895,-35,3.5126500825,8.0548700168,4.239405272
48,473,2002,494,233,408,3115,111,261,519,759,33968,14.70741474,6.9368980455,12.147014603,-21,3.3047025023,7.7705166947,15.451717106
48,473,2003,540,251,423,3362,91,289,514,786,34754,15.7154914,7.3047932249,12.310468263,-17,2.6483513285,8.4106981753,14.958819592
48,473,2004,493,263,-291,3283,83,230,-208,-8,34746,14.18705036,7.5683453237,-8.374100719,-30,2.3884892086,6.618705036,-5.985611511
48,473,2005,547,274,-543,3070,88,273,-455,-211,34535,15.790765145,7.9098165442,-15.67529337,-29,2.5403790361,7.8809486006,-13.13491433
48,473,2006,575,279,78,3117,85,296,163,442,34977,16.543906088,8.0273909541,2.2442168259,-17,2.4456209,8.5165151341,4.6898377259
48,473,2007,600,260,418,3117,76,340,494,838,35815,16.951067917,7.3454627642,11.809243982,4,2.1471352695,9.6056051531,13.956379252
48,473,2008,599,272,-232,3117,78,327,-154,180,35995,16.682913243,7.5755465813,-6.461495613,7,2.1723993873,9.107366662,-4.289096226
48,475,2001,156,105,-411,378,5,51,-406,-355,10464,14.659587464,9.867030024,-38.62237467,0,0.4698585726,4.7925574402,-38.15251609
48,475,2002,142,101,-152,380,5,41,-147,-115,10349,13.64531783,9.7054725412,-14.60625571,-9,0.4804689377,3.939845289,-14.12578677
48,475,2003,157,100,-200,388,3,57,-197,-144,10205,15.27683176,9.7304660893,-19.46093218,-4,0.2919139827,5.5463656709,-19.1690182
48,475,2004,145,111,-92,398,2,34,-90,-64,10141,14.253415905,10.911235624,-9.043546643,-8,0.1965988401,3.3421802811,-8.846947803
48,475,2005,152,88,-52,392,3,64,-49,9,10150,14.982011729,8.6737962644,-5.125425065,-6,0.2956975999,6.308215465,-4.829727465
48,475,2006,159,122,22,383,2,37,24,56,10206,15.621929652,11.986637846,2.1615248575,-5,0.1965022598,3.6352918059,2.3580271173
48,475,2007,161,95,-83,365,3,66,-80,-22,10184,15.792054929,9.318293281,-8.141245709,-8,0.2942618931,6.4737616479,-7.846983816
48,475,2008,179,93,284,365,2,86,286,365,10549,17.267158636,8.9712053248,27.395938841,-7,0.1929291468,8.2959533111,27.588867988
48,477,2001,416,336,-86,1730,71,80,-15,38,30447,13.671618246,11.042460891,-2.826344157,-27,2.3333771526,2.6291573551,-0.492967004
48,477,2002,375,349,178,1879,68,26,246,249,30696,12.266326481,11.415861178,5.8224163028,-23,2.2242938685,0.8504653027,8.0467101712
48,477,2003,401,337,81,1859,57,64,138,163,30859,13.028998457,10.949557306,2.6317927057,-39,1.8520022744,2.0794411502,4.4837949801
48,477,2004,408,357,187,1789,58,51,245,272,31131,13.163413454,11.517986772,6.0332311663,-24,1.8712695596,1.6454266817,7.9045007259
48,477,2005,430,360,191,1764,58,70,249,296,31427,13.747242559,11.509319352,6.1063333227,-23,1.8542792289,2.2379232073,7.9606125516
48,477,2006,418,345,228,1730,60,73,288,344,31771,13.228266717,10.918067027,7.2154182094,-17,1.8987942656,2.3101996899,9.1142124751
48,477,2007,438,350,41,1724,52,88,93,165,31936,13.750451285,10.987803538,1.2871427002,-16,1.6324736685,2.7626477467,2.9196163687
48,477,2008,450,356,183,1724,54,94,237,308,32244,14.023060143,11.093798691,5.702711125,-23,1.6827672172,2.9292614522,7.3854783422
48,479,2001,5823,996,-1030,3093,1772,4827,742,5391,199947,29.520688056,5.0493912594,-5.221760037,-178,8.9834551322,24.471296796,3.7616950948
48,479,2002,5911,998,-1228,3140,1672,4913,444,5188,205135,29.184214554,4.9273974158,-6.062969967,-169,8.2551187167,24.256817138,2.1921487501
48,479,2003,5994,1037,-1005,3177,1484,4957,479,5177,210312,28.855666306,4.9922132065,-4.838162269,-259,7.1441122454,23.8634531,2.3059499768
48,479,2004,6033,1006,-611,3221,1339,5027,728,5597,215909,28.309257404,4.720555768,-2.867057231,-158,6.2831254208,23.588701636,3.41606819
48,479,2005,6000,948,-1000,3319,1417,5052,417,5256,221165,27.455305051,4.3379381981,-4.575884175,-213,6.4840278763,23.117366853,1.9081437011
48,479,2006,5919,1068,-864,3492,1407,4851,543,5270,226435,26.44772118,4.7721179625,-3.860589812,-124,6.2868632708,21.675603217,2.4262734584
48,479,2007,6051,1129,-1156,3478,1278,4922,122,5042,231477,26.428658782,4.9310784605,-5.049005049,-2,5.581858523,21.497580321,0.532853474
48,479,2008,6332,1183,-1037,3478,1280,5149,243,5464,236941,27.035681806,5.0510441529,-4.427669304,72,5.4652041553,21.984637653,1.0375348514
48,481,2001,614,399,-551,762,129,215,-422,-233,40982,14.939717995,9.7083835176,-13.40681533,-26,3.1388006862,5.2313344769,-10.26801465
48,481,2002,626,463,-334,793,125,163,-209,-81,40901,15.290109058,11.30881868,-8.15798151,-35,3.0531367927,3.9812903777,-5.104844717
48,481,2003,674,410,-275,777,111,264,-164,59,40960,16.466937858,10.016980003,-6.718706099,-41,2.7119140983,6.4499578554,-4.006792001
48,481,2004,647,454,-315,750,97,193,-218,-59,40901,15.807283077,11.091972979,-7.695972441,-34,2.3698708787,4.7153100988,-5.326101562
48,481,2005,697,418,-382,753,104,279,-278,-31,40870,17.047608565,10.223673429,-9.34316567,-32,2.5436890829,6.8239351359,-6.799476587
48,481,2006,634,402,-301,798,101,232,-200,11,40881,15.510513633,9.8347420827,-7.363824296,-21,2.4709177869,5.6757715502,-4.892906509
48,481,2007,681,380,-543,770,96,301,-447,-150,40731,16.688722247,9.3123560261,-13.30686664,-4,2.3525952066,7.3763662207,-10.95427143
48,481,2008,682,419,-291,770,95,263,-196,60,40791,16.731679792,10.279433772,-7.139177155,-7,2.3306592086,6.4522460195,-4.808517946
48,483,2001,45,88,-94,132,10,-43,-84,-131,5106,8.7015372716,17.016339553,-18.17654452,-4,1.9336749492,-8.314802282,-16.24286957
48,483,2002,58,75,-118,115,10,-17,-108,-129,4977,11.504512546,14.876524844,-23.40573242,-4,1.9835366458,-3.372012298,-21.42219578
48,483,2003,59,87,-202,90,2,-28,-200,-225,4752,12.128687429,17.884674684,-41.52533662,3,0.4111419468,-5.755987255,-41.11419468
48,483,2004,62,81,9,114,3,-19,12,-10,4742,13.060880556,17.063408469,1.8959342743,-3,0.6319780914,-4.002527912,2.5279123657
48,483,2005,65,75,-36,104,3,-10,-33,-45,4697,13.772645407,15.891513932,-7.627926687,-2,0.6356605573,-2.118868524,-6.99226613
48,483,2006,66,86,62,99,3,-20,65,42,4739,13.988978381,18.228062738,13.141161509,-3,0.6358626537,-4.239084358,13.777024163
48,483,2007,75,67,14,89,2,8,16,14,4753,15.80278129,14.117151285,2.9498525074,-10,0.4214075011,1.6856300042,3.3712600084
48,483,2008,72,74,25,89,2,-2,27,19,4772,15.118110236,15.538057743,5.249343832,-6,0.4199475066,-0.419947507,5.6692913386
48,485,2001,1870,1335,-2014,11192,135,535,-1879,-1426,130165,14.28811565,10.200339247,-15.38837696,-82,1.0314949801,4.0877764025,-14.35688198
48,485,2002,1918,1303,-303,11068,-279,615,-582,-91,130074,14.74029642,10.013871864,-2.328628684,-124,-2.144182847,4.7264245559,-4.472811531
48,485,2003,1883,1277,1079,11089,-1173,606,-94,411,130485,14.453540273,9.8020026174,8.2821932844,-101,-9.003718927,4.6515376556,-0.721525643
48,485,2004,1935,1262,-1113,11253,749,673,-364,194,130679,14.818275107,9.6644254185,-8.523379945,-115,5.73585946,5.1538496883,-2.787520485
48,485,2005,1855,1356,-1776,11499,106,499,-1670,-1274,129405,14.264622199,10.427400378,-13.65712616,-103,0.8151212685,3.8372218206,-12.84200489
48,485,2006,1967,1277,-1345,11368,427,690,-918,-288,129117,15.217273578,9.8792365833,-10.405304,-60,3.3033939084,5.3380369949,-7.101910089
48,485,2007,1897,1231,-1929,11305,22,666,-1907,-1262,127855,14.764254471,9.5808103607,-15.01330884,-21,0.1712248805,5.1834441106,-14.84208396
48,485,2008,1976,1254,-1397,11305,194,722,-1203,-534,127321,15.487349908,9.8285105182,-10.94930558,-53,1.5205191711,5.6588393893,-9.428786406
48,487,2001,194,199,-272,915,15,-5,-257,-276,14364,13.377465177,13.722245208,-18.75603365,-14,1.034340091,-0.34478003,-17.72169356
48,487,2002,222,181,-131,869,15,41,-116,-87,14277,15.502252016,12.639223491,-9.147725289,-12,1.0474494606,2.8630285255,-8.100275828
48,487,2003,198,194,-193,900,14,4,-179,-186,14091,13.959390863,13.677382967,-13.60688099,-11,0.9870276368,0.2820078962,-12.61985336
48,487,2004,229,201,-219,683,12,28,-207,-195,13896,16.364740773,14.36381177,-15.65012327,-16,0.8575410012,2.0009290028,-14.79258227
48,487,2005,217,168,-19,835,13,49,-6,33,13929,15.597484277,12.075471698,-1.365678347,-10,0.9344115004,3.5220125786,-0.431266846
48,487,2006,222,174,-30,789,12,48,-18,22,13951,15.925394548,12.482065997,-2.152080344,-8,0.8608321377,3.4433285509,-1.291248207
48,487,2007,209,179,-134,659,13,30,-121,-93,13858,15.031105038,12.873530152,-9.637167823,-2,0.9349491172,2.1575748858,-8.702218706
48,487,2008,231,155,-170,659,12,76,-158,-76,13782,16.714905933,11.215629522,-12.30101302,6,0.8683068017,5.499276411,-11.43270622
48,489,2001,413,103,-590,1072,55,310,-535,-233,19815,20.72096932,5.1676993703,-29.60138474,-8,2.7594511201,15.55326995,-26.84193362
48,489,2002,386,115,-307,1072,55,271,-252,3,19818,19.478717231,5.8032447708,-15.49214039,-16,2.7754648904,13.67547246,-12.7166755
48,489,2003,379,97,-285,1072,42,282,-243,27,19845,19.111010261,4.891208431,-14.37107632,-12,2.1178428258,14.21980183,-12.25323349
48,489,2004,398,111,-147,1072,41,287,-106,164,20009,19.972901089,5.5703317107,-7.376925779,-17,2.0575099112,14.402569378,-5.319415868
48,489,2005,412,133,-26,1072,43,279,17,279,20288,20.448172321,6.6009876666,-1.290418642,-17,2.1341539072,13.847184654,0.8437352657
48,489,2006,353,127,-128,1072,43,226,-85,130,20418,17.343880509,6.2398663588,-6.288999165,-11,2.1127106569,11.10401415,-4.176288508
48,489,2007,402,123,-298,1072,34,279,-264,19,20437,19.679353812,6.0212948232,-14.5881777,4,1.6644229592,13.658058989,-12.92375474
48,489,2008,405,123,-153,1072,36,282,-117,163,20600,19.738284962,5.9945902478,-7.45668543,-2,1.7545142189,13.743694715,-5.702171211
48,491,2001,4706,1198,17255,5079,761,3508,18016,21628,276567,17.708172626,4.5079453477,64.928711999,104,2.8635612768,13.200227279,67.792273276
48,491,2002,4919,1222,8832,4983,702,3697,9534,13180,289747,17.371987978,4.3156270196,31.191176626,-51,2.47918999,13.056360959,33.670366616
48,491,2003,5062,1352,8241,5024,566,3710,8807,12645,302392,17.097336943,4.5664953668,27.834680708,128,1.911713297,12.530841576,29.746394005
48,491,2004,5203,1431,9789,5147,605,3772,10394,13674,316066,16.825718157,4.6276384168,31.656151267,-492,1.9564788555,12.19807974,33.612630122
48,491,2005,5549,1397,10979,5158,604,4152,11583,15554,331620,17.134846206,4.3138187332,33.902230402,-181,1.8651012991,12.821027473,35.767331701
48,491,2006,5621,1526,14025,5214,619,4095,14644,18493,350113,16.490326858,4.4768259715,41.1451404,-246,1.8159602073,12.013500887,42.961100607
48,491,2007,6027,1667,17087,5037,557,4360,17644,21908,372021,16.692192862,4.6168716609,47.323626917,-96,1.5426499791,12.075321201,48.866276896
48,491,2008,6459,1833,17486,5037,566,4626,18052,22172,394193,16.859519664,4.7845641035,45.642601153,-506,1.477394044,12.074955561,47.119995197
48,493,2001,423,247,396,511,7,176,403,556,33262,12.824399709,7.4884792627,12.005821004,-23,0.2122241087,5.3359204463,12.218045113
48,493,2002,432,263,559,526,1,169,560,715,33977,12.84968545,7.8228409108,16.627255016,-14,0.0297446422,5.0268445396,16.656999658
48,493,2003,452,264,861,641,-15,188,846,1026,35003,13.105247898,7.6543925776,24.963757611,-8,-0.434908669,5.4508553204,24.528848942
48,493,2004,436,320,1033,634,15,116,1048,1107,36110,12.262174286,8.9997609438,29.052353297,-57,0.4218637942,3.2624133421,29.474217091
48,493,2005,462,293,660,633,4,169,664,805,36915,12.653200959,8.0246490928,18.076001369,-28,0.1095515235,4.6285518658,18.185552893
48,493,2006,462,315,870,664,9,147,879,1004,37919,12.347328754,8.4186332416,23.251463239,-22,0.2405323783,3.9286955127,23.491995617
48,493,2007,503,299,1021,650,3,204,1024,1227,39146,13.053915526,7.7596833842,26.497112827,-1,0.077856355,5.2942321417,26.574969182
48,493,2008,551,334,1048,650,7,217,1055,1252,40398,13.853967615,8.3978678467,26.350196118,-20,0.1760032183,5.4560997687,26.526199336
48,495,2001,113,66,-120,134,15,47,-105,-62,7014,16.0397445,9.3683463449,-17.03335699,-4,2.1291696238,6.6713981547,-14.90418737
48,495,2002,90,83,-139,144,15,7,-124,-121,6893,12.943122169,11.936434889,-19.98993313,-4,2.1571870281,1.0066872798,-17.8327461
48,495,2003,105,74,-319,140,14,31,-305,-263,6630,15.529098573,10.944317089,-47.17888043,11,2.0705464764,4.5847814834,-45.10833395
48,495,2004,114,72,-82,143,13,42,-69,-33,6597,17.237468814,10.886822409,-12.39888108,-6,1.9656762682,6.3506464051,-10.43320481
48,495,2005,97,87,-210,145,14,10,-196,-187,6410,14.915045745,13.377412163,-32.29030522,-1,2.1526870147,1.5376335819,-30.13761821
48,495,2006,104,76,-21,134,13,28,-8,15,6425,16.205687573,11.842617842,-3.272302298,-5,2.0257109466,4.3630697312,-1.246591352
48,495,2007,114,54,23,127,14,60,37,80,6505,17.633410673,8.3526682135,3.5576179428,-17,2.1655065739,9.2807424594,5.7231245166
48,495,2008,116,48,114,127,13,68,127,170,6675,17.602427921,7.2837632777,17.298937785,-25,1.9726858877,10.318664643,19.271623672
48,497,2001,706,407,1195,1166,109,299,1304,1581,50981,14.066406989,8.1091043126,23.809286618,-22,2.171725725,5.9573026768,25.981012343
48,497,2002,663,405,1130,1182,102,258,1232,1468,52449,12.820264913,7.8313835444,21.850526926,-22,1.9723484482,4.988881369,23.822875375
48,497,2003,686,443,982,1170,87,243,1069,1304,53753,12.918777424,8.3425924182,18.493060394,-8,1.6383872243,4.5761850059,20.131447619
48,497,2004,666,429,563,1179,92,237,655,839,54592,12.29406064,7.9191471688,10.392726937,-53,1.6982786469,4.3749134709,12.091005584
48,497,2005,679,407,812,1174,90,272,902,1128,55720,12.310537385,7.3790702734,14.721879759,-46,1.6317354413,4.9314671115,16.353615201
48,497,2006,743,445,600,1194,91,298,691,958,56678,13.220875816,7.918290361,10.676346554,-31,1.6192458941,5.3025854553,12.295592448
48,497,2007,756,457,397,1175,88,299,485,783,57461,13.247005844,8.0077799876,6.9564303174,-1,1.5419795162,5.2392258562,8.4984098336
48,497,2008,746,458,651,1175,90,288,741,1045,58506,12.865729044,7.8987987962,11.227331913,16,1.5521657023,4.9669302474,12.779497616
48,499,2001,417,489,628,1574,60,-72,688,590,37463,11.219328455,13.156478691,16.896254843,-26,1.614291864,-1.937150237,18.510546707
48,499,2002,438,543,557,1448,58,-105,615,489,37952,11.615726314,14.400318239,14.771597162,-21,1.5381555393,-2.784591925,16.309752702
48,499,2003,438,543,1401,1659,46,-105,1447,1396,39348,11.332470893,14.04915912,36.248382924,54,1.1901681759,-2.716688228,37.4385511
48,499,2004,459,535,891,1613,43,-76,934,804,40152,11.547169811,13.459119497,22.41509434,-54,1.0817610063,-1.911949686,23.496855346
48,499,2005,445,513,466,1641,46,-68,512,410,40562,11.026587705,12.711549421,11.546943529,-34,1.1398270436,-1.684961717,12.686770573
48,499,2006,459,504,925,1718,46,-45,971,902,41464,11.191573404,12.288786482,22.553824397,-24,1.1215955916,-1.097213079,23.675419989
48,499,2007,446,530,397,1680,35,-84,432,353,41817,10.710726336,12.72799318,9.5339873441,5,0.8405278515,-2.017266844,10.374515196
48,499,2008,502,565,671,1680,37,-63,708,644,42461,11.912954745,13.408006835,15.923491303,-1,0.8780464653,-1.49505209,16.801537768
48,501,2001,132,51,-100,58,31,81,-69,5,7283,18.130622897,7.0050133919,-13.73532038,-7,4.2579493167,11.125609505,-9.47737106
48,501,2002,113,58,-186,47,31,55,-155,-102,7181,15.625,8.0199115044,-25.71902655,-2,4.2865044248,7.6050884956,-21.43252212
48,501,2003,125,62,-91,43,19,63,-72,-15,7166,17.425245696,8.6429218652,-12.68557887,-6,2.6486373458,8.7823238308,-10.03694152
48,501,2004,128,53,9,48,18,75,27,96,7262,17.743276961,7.3468256169,1.2475741614,-6,2.4951483227,10.396451345,3.7427224841
48,501,2005,136,51,-87,45,19,85,-68,11,7273,18.713450292,7.0175438596,-11.97110423,-6,2.614379085,11.695906433,-9.356725146
48,501,2006,130,66,-96,51,18,64,-78,-18,7255,17.896475771,9.0859030837,-13.21585903,-4,2.4779735683,8.8105726872,-10.73788546
48,501,2007,130,44,58,56,16,86,74,159,7414,17.724452928,5.9990456064,7.9078328448,-1,2.1814711296,11.725407322,10.089303974
48,501,2008,139,56,58,56,15,83,73,157,7571,18.551885219,7.4741408075,7.7410744077,1,2.002002002,11.077744411,9.7430764097
48,503,2001,225,259,-241,387,23,-34,-218,-263,17647,12.655735861,14.568158169,-13.5556993,-11,1.2936974435,-1.912422308,-12.26200186
48,503,2002,238,276,-17,416,22,-38,5,-50,17597,13.505844967,15.662240381,-0.964703212,-17,1.2484394507,-2.156395415,0.2837362388
48,503,2003,222,242,162,426,17,-20,179,146,17743,12.563667233,13.695529145,9.1680814941,-13,0.9620826259,-1.131861913,10.13016412
48,503,2004,235,243,-39,436,17,-8,-22,-44,17699,13.261102647,13.712544439,-2.200778737,-14,0.9593138085,-0.451441792,-1.241464929
48,503,2005,213,262,-157,368,19,-49,-138,-195,17504,12.101241371,14.88509502,-8.919694344,-8,1.0794534557,-2.783853649,-7.840240889
48,503,2006,248,243,279,373,19,5,298,293,17797,14.050593468,13.767315374,15.806917651,-10,1.0764567576,0.2832780941,16.883374409
48,503,2007,248,256,-134,350,15,-8,-119,-144,17653,13.991537377,14.442877292,-7.559943583,-17,0.8462623413,-0.451339915,-6.713681241
48,503,2008,238,222,-84,350,17,16,-67,-74,17579,13.51044505,12.602179837,-4.768392371,-23,0.9650317893,0.9082652134,-3.803360581
48,505,2001,244,92,-37,23,68,152,31,165,12363,19.868897846,7.4915516469,-3.012906641,-18,5.537233826,12.377346199,2.5243271854
48,505,2002,291,83,-16,32,64,208,48,243,12606,23.30890304,6.6482438223,-1.281589171,-13,5.1263566823,16.660659217,3.8447675117
48,505,2003,235,77,-140,39,56,158,-84,63,12669,18.595450049,6.0929772502,-11.07814045,-11,4.431256182,12.502472799,-6.646884273
48,505,2004,309,76,-132,32,51,233,-81,143,12812,24.253365253,5.9652289942,-10.36066088,-9,4.0029826145,18.288136258,-6.35767827
48,505,2005,310,83,50,27,54,227,104,319,13131,23.898546814,6.3986431793,3.8546043249,-12,4.1629726709,17.499903635,8.0175769957
48,505,2006,300,86,-188,32,53,214,-135,73,13204,22.783368141,6.5312322005,-14.27757737,-6,4.025061705,16.252135941,-10.25251566
48,505,2007,303,61,56,24,52,242,108,343,13547,22.653358753,4.5605771747,4.1867593735,-7,3.8877051325,18.092781578,8.074464506
48,505,2008,315,96,28,24,51,219,79,300,13847,22.997736731,7.0088340513,2.0442432649,2,3.7234430897,15.988902679,5.7676863547
48,507,2001,215,86,-184,363,15,129,-169,-46,11552,18.574514039,7.4298056156,-15.89632829,-6,1.2958963283,11.144708423,-14.60043197
48,507,2002,201,96,-94,363,14,105,-80,16,11568,17.387543253,8.3044982699,-8.131487889,-9,1.2110726644,9.0830449827,-6.920415225
48,507,2003,196,80,-240,363,12,116,-228,-114,11454,17.027191382,6.9498740335,-20.8496221,-2,1.042481105,10.077317349,-19.807141
48,507,2004,201,86,-120,363,9,115,-111,-6,11448,17.553052135,7.5102611126,-10.47943411,-10,0.7859575583,10.042791023,-9.693476552
48,507,2005,251,93,-115,363,11,158,-104,45,11493,21.882219607,8.107754675,-10.02571815,-9,0.9589817358,13.774464932,-9.066736411
48,507,2006,224,109,-8,363,10,115,2,112,11605,19.395618668,9.4380465841,-0.692700667,-5,0.8658758334,9.9575720842,0.1731751667
48,507,2007,237,77,-144,363,9,160,-135,23,11628,20.402014376,6.628502561,-12.39616063,-2,0.7747600396,13.773511815,-11.62140059
48,507,2008,235,88,-103,363,10,147,-93,50,11678,20.166480735,7.551703424,-8.838925599,-4,0.8581481164,12.614777311,-7.980777482
49,0,2001,47707,12524,-6435,40639,9529,35183,3094,46856,2291066,21.038190399,5.5229273808,-2.837754527,8579,4.2021698349,15.515263018,1.3644153079
49,0,2002,48209,13003,-4321,42283,8701,35206,4380,43396,2334462,20.844755453,5.6222770676,-1.868327248,3810,3.7621650977,15.222478385,1.8938378494
49,0,2003,49735,13100,-8162,42769,7040,36635,-1122,46000,2380462,21.096840585,5.5568233974,-3.462197906,10487,2.9862623448,15.540017188,-0.475935561
49,0,2004,50741,13537,-2438,43104,7522,37204,5084,59390,2439852,21.052985345,5.6166465504,-1.011552359,17102,3.1209585102,15.436338795,2.1094061507
49,0,2005,50676,13194,9373,44030,7433,37482,16806,61410,2501262,20.511973616,5.3404960906,3.7938812988,7122,3.0086332758,15.171477525,6.8025145746
49,0,2006,52669,13490,18428,43777,7662,39179,26090,83893,2585155,20.709666549,5.3043232594,7.245965087,18624,3.012729786,15.40534329,10.258694873
49,0,2007,54979,13175,23846,44393,6755,41804,30601,83770,2668925,20.928116816,5.0151501309,9.0771362446,11365,2.5713350387,15.912966685,11.648471283
49,0,2008,56991,13779,17605,44369,6823,43212,24428,67499,2736424,21.086890042,5.0982832006,6.5139179727,-141,2.5245363435,15.988606841,9.0384543163
49,1,2001,115,47,-86,202,11,68,-75,-10,6006,19.131592081,7.8189985027,-14.30710364,-3,1.829978373,11.312593578,-12.47712527
49,1,2002,120,52,-33,202,11,68,-22,41,6047,19.91205509,8.6285572057,-5.47581515,-5,1.8252717166,11.283497884,-3.650543433
49,1,2003,120,59,-111,202,1,61,-110,-50,5997,19.926934573,9.7974094985,-18.43241448,-1,0.1660577881,10.129525075,-18.26635669
49,1,2004,133,68,-60,202,4,65,-56,3,6000,22.172209719,11.336167375,-10.00250063,-6,0.666833375,10.836042344,-9.33566725
49,1,2005,134,64,6,202,2,70,8,72,6072,22.200132538,10.603048376,0.9940357853,-6,0.3313452618,11.597084162,1.3253810471
49,1,2006,87,64,-6,202,3,23,-3,18,6090,14.306857425,10.524584772,-0.986679822,-2,0.4933399112,3.7822726525,-0.493339911
49,1,2007,115,53,-92,202,0,62,-92,-29,6061,18.928483252,8.7235618468,-15.1427866,1,0,10.204921406,-15.1427866
49,1,2008,122,57,33,202,0,65,33,101,6162,19.962366031,9.3266792113,5.3996563855,3,0,10.63568682,5.3996563855
49,3,2001,783,277,-123,371,53,506,-70,752,43623,18.105302102,6.4050685597,-2.844127916,316,1.2255185331,11.700233542,-1.618609383
49,3,2002,801,309,91,371,50,492,141,888,44511,18.176867043,7.0120498332,2.0650373295,255,1.1346358953,11.16481721,3.1996732249
49,3,2003,800,304,-78,371,37,496,-41,702,45213,17.832464001,6.7763363203,-1.73866524,247,0.82475146,11.05612768,-0.91391378
49,3,2004,784,302,-450,371,46,482,-404,348,45561,17.273668672,6.6538876771,-9.914733294,270,1.01350607,10.619780995,-8.901227224
49,3,2005,877,296,-258,371,42,581,-216,364,45925,19.172332379,6.4709354437,-5.640207245,-1,0.9181732724,12.701396935,-4.722033972
49,3,2006,919,287,94,371,45,632,139,770,46695,19.84452602,6.1973655798,2.0297991794,-1,0.9717123731,13.647160441,3.0015115526
49,3,2007,906,285,445,371,40,621,485,1098,47793,19.177038354,6.032512065,9.419185505,-8,0.84666836,13.144526289,10.265853865
49,3,2008,954,308,549,371,40,646,589,1222,49015,19.709114949,6.3631104867,11.342037848,-13,0.8263779853,13.346004462,12.168415833
49,5,2001,2192,427,-1190,2175,397,1765,-793,1927,93778,23.616999499,4.6005742637,-12.82127254,955,4.2773489056,19.016425235,-8.543923633
49,5,2002,2255,401,441,2778,375,1854,816,3484,97262,23.607621441,4.1980737018,4.6168341709,814,3.925879397,19.409547739,8.5427135678
49,5,2003,2338,438,-612,2606,326,1900,-286,2908,100170,23.684103894,4.4369707038,-6.199602901,1294,3.3024028526,19.24713319,-2.897200049
49,5,2004,2479,440,-554,2534,305,2039,-249,2085,102255,24.493022107,4.3472891194,-5.473632209,295,3.013461776,20.145732988,-2.460170433
49,5,2005,2454,384,-761,2765,312,2070,-449,2340,104595,23.727338651,3.712835388,-7.357988881,719,3.0166787527,20.014503263,-4.341310128
49,5,2006,2417,426,-1667,2695,312,1991,-1355,1804,106399,22.910604093,4.0380295174,-15.8013972,1168,2.9574300691,18.872574576,-12.84396713
49,5,2007,2611,417,136,2797,289,2194,425,2596,108995,24.243943657,3.8719741497,1.2628021208,-23,2.6834545066,20.371969507,3.9462566274
49,5,2008,2854,442,914,2731,289,2412,1203,3621,112616,25.7568442,3.9889716666,8.2486880164,6,2.608173782,21.767872533,10.856861798
49,7,2001,290,179,-786,519,13,111,-773,-663,19691,14.483705831,8.9399425646,-39.25583718,-1,0.6492695717,5.5437632663,-38.60656761
49,7,2002,305,192,-54,468,13,113,-41,54,19745,15.468100213,9.7372958718,-2.738614464,-18,0.6592960747,5.7308043412,-2.079318389
49,7,2003,305,228,-149,522,11,77,-138,-77,19668,15.477126836,11.569786619,-7.560957045,-16,0.5581914597,3.9073402177,-7.002765585
49,7,2004,343,219,-334,496,10,124,-324,-224,19444,17.539374105,11.198609123,-17.07915729,-24,0.5113520147,6.3407649826,-16.56780528
49,7,2005,302,194,-363,526,11,108,-352,-259,19185,15.635921199,10.04426726,-18.79417018,-15,0.5695203086,5.5916539388,-18.22464987
49,7,2006,269,167,-100,428,10,102,-90,3,19188,14.020274672,8.7040366925,-5.211998019,-9,0.5211998019,5.3162379798,-4.690798217
49,7,2007,341,198,263,629,10,143,273,420,19608,17.579131869,10.20723786,13.558098773,4,0.5155170636,7.3718940097,14.073615837
49,7,2008,333,185,-218,539,9,148,-209,-59,19549,17.00845315,9.449140639,-11.13466302,2,0.459687923,7.5593125112,-10.6749751
49,9,2001,13,2,-19,78,3,11,-16,-5,923,14.046461372,2.1609940573,-20.52944354,0,3.2414910859,11.885467315,-17.28795246
49,9,2002,11,7,-37,78,3,4,-34,-31,892,12.121212121,7.7134986226,-40.77134986,-1,3.305785124,4.4077134986,-37.46556474
49,9,2003,15,8,-9,78,1,7,-8,-2,890,16.835016835,8.9786756453,-10.1010101,-1,1.1223344557,7.8563411897,-8.978675645
49,9,2004,6,1,25,78,0,5,25,29,919,6.6334991708,1.1055831951,27.639579878,-1,0,5.5279159757,27.639579878
49,9,2005,6,2,-2,78,1,4,-1,2,921,6.5217391304,2.1739130435,-2.173913043,-1,1.0869565217,4.347826087,-1.086956522
49,9,2006,12,7,10,78,0,5,10,15,936,12.924071082,7.5390414647,10.770059235,0,0,5.3850296177,10.770059235
49,9,2007,10,1,-23,78,1,9,-22,-14,922,10.764262648,1.0764262648,-24.75780409,-1,1.0764262648,9.6878363832,-23.68137783
49,9,2008,11,1,9,78,0,10,9,16,938,11.827956989,1.0752688172,9.6774193548,-3,0,10.752688172,9.6774193548
49,11,2001,4909,1090,-220,3218,273,3819,53,4249,244528,20.251357757,4.4966347433,-0.907577655,377,1.1262213623,15.754723013,0.2186437077
49,11,2002,5042,1193,1019,3346,62,3849,1081,5237,249765,20.400855363,4.8270964792,4.1230606138,307,0.2508633543,15.573758884,4.3739239682
49,11,2003,5290,1199,2204,3388,-296,4091,1908,6355,256120,20.913844055,4.7402077547,8.7134427785,356,-1.170226435,16.173636301,7.5432163436
49,11,2004,5626,1195,1208,3459,471,4431,1679,6562,262682,21.688428341,4.6067671289,4.6568825872,452,1.8157216048,17.081661212,6.472604192
49,11,2005,5545,1239,2162,3392,185,4306,2347,7057,269739,20.82938126,4.6542116107,8.1213926573,404,0.6949387796,16.17516965,8.816331437
49,11,2006,5955,1290,3543,3097,352,4665,3895,9020,278759,21.713843988,4.7037546172,12.918916751,460,1.2835051358,17.010089371,14.202421887
49,11,2007,6152,1270,3840,3110,188,4882,4028,8992,287751,21.718945826,4.4835925226,13.556689202,82,0.6637129089,17.235353304,14.220402111
49,11,2008,6506,1318,2099,3110,240,5188,2339,7581,295332,22.315862407,4.5207972107,7.1996611117,54,0.8232104177,17.795065197,8.0228715294
49,13,2001,285,105,0,210,10,180,10,174,14545,19.712270024,7.2624152718,0,-16,0.6916585973,12.449854752,0.6916585973
49,13,2002,281,118,100,210,10,163,110,262,14807,19.146906514,8.0403379667,6.8138457345,-11,0.6813845735,11.106568547,7.495230308
49,13,2003,322,124,-203,210,2,198,-201,-12,14795,21.755286805,8.37781231,-13.71528951,-9,0.135126005,13.377474495,-13.5801635
49,13,2004,269,111,-102,210,1,158,-101,45,14840,18.15420955,7.4911422305,-6.88375232,-12,0.0674877678,10.663067319,-6.816264552
49,13,2005,321,126,126,210,2,195,128,308,15148,21.408563425,8.4033613445,8.4033613445,-15,0.133386688,13.005202081,8.5367480325
49,13,2006,329,114,77,210,1,215,78,285,15433,21.516627972,7.4556096923,5.0358065465,-8,0.065400085,14.061018279,5.1012066316
49,13,2007,354,105,502,210,2,249,504,754,16187,22.390891841,6.6413662239,31.752055661,1,0.1265022138,15.749525617,31.878557875
49,13,2008,389,124,418,210,1,265,419,674,16861,23.541515372,7.5042362624,25.296538368,-10,0.0605180344,16.037279109,25.357056403
49,15,2001,166,64,-391,93,12,102,-379,-278,10667,15.361836017,5.9226355728,-36.1836017,-1,1.1104941699,9.4392004442,-35.07310753
49,15,2002,164,80,-200,93,12,84,-188,-108,10559,15.452746631,7.5379251861,-18.84481297,-4,1.1306887779,7.9148214454,-17.71412419
49,15,2003,164,74,-147,93,8,90,-139,-53,10506,15.570852124,7.0258723,-13.95680038,-4,0.7595537622,8.5449798244,-13.19724662
49,15,2004,165,87,-196,93,7,78,-189,-125,10381,15.799301001,8.3305405276,-18.76765452,-14,0.6702733758,7.468760473,-18.09738115
49,15,2005,169,76,-127,93,8,93,-119,-34,10347,16.306445388,7.3330760324,-12.253956,-8,0.7719027403,8.9733693555,-11.48205326
49,15,2006,184,77,-177,93,7,107,-170,-67,10280,17.840694236,7.4659426965,-17.16197217,-4,0.6787220633,10.374751539,-16.48325011
49,15,2007,176,76,-15,93,6,100,-9,89,10369,17.046830355,7.3611312897,-1.45285486,-2,0.5811419439,9.6856990653,-0.871712916
49,15,2008,177,86,50,93,5,91,55,141,10510,16.954835002,8.2379424302,4.7895014129,-5,0.4789501413,8.7168925715,5.2684515542
49,17,2001,65,48,-106,128,1,17,-105,-91,4657,13.822434875,10.207336523,-22.54120149,-3,0.2126528442,3.6150983519,-22.32854864
49,17,2002,71,45,-132,128,1,26,-131,-105,4552,15.419698121,9.7730481051,-28.66760778,0,0.2171788468,5.6466500163,-28.45042893
49,17,2003,67,43,-121,128,1,24,-120,-95,4457,14.874014874,9.546009546,-26.86202686,1,0.222000222,5.328005328,-26.64002664
49,17,2004,69,41,-117,128,0,28,-117,-96,4361,15.649807213,9.2991608074,-26.53662962,-7,0,6.3506464051,-26.53662962
49,17,2005,75,35,-56,128,1,40,-55,-19,4342,17.235436057,8.043203493,-12.86912559,-4,0.2298058141,9.1922325635,-12.63931977
49,17,2006,75,36,18,128,0,39,18,54,4396,17.166399634,8.2398718242,4.1199359121,-3,0,8.9265278096,4.1199359121
49,17,2007,77,28,80,128,1,49,81,132,4528,17.2568355,6.275212909,17.92917974,2,0.2241147468,10.981622591,18.153294487
49,17,2008,78,35,84,128,0,43,84,130,4658,16.982364468,7.6202917483,18.288700196,3,0,9.3620727194,18.288700196
49,19,2001,113,69,-22,106,18,44,-4,103,8504,13.368825791,8.1632653061,-2.602780243,63,2.1295474712,5.2055604851,-0.473232771
49,19,2002,123,81,75,106,18,42,93,190,8694,14.303988836,9.4196999651,8.7219444121,55,2.0932666589,4.8842888708,10.815211071
49,19,2003,109,69,-33,106,13,40,-20,67,8761,12.489258092,7.9060441134,-3.781151533,47,1.4895445431,4.5832139788,-2.291606989
49,19,2004,98,57,-59,106,11,41,-48,47,8808,11.156013433,6.4887016905,-6.716375434,54,1.2522055894,4.6673117423,-5.464169845
49,19,2005,124,64,72,106,13,60,85,203,9011,13.917728268,7.183343622,8.0812615747,58,1.4591166732,6.7343846456,9.5403782479
49,19,2006,122,71,120,106,12,51,132,246,9257,13.356689293,7.7731552441,13.137727173,63,1.3137727173,5.5835340486,14.451499891
49,19,2007,123,57,28,106,10,66,38,165,9422,13.169869907,6.1031104449,2.9980191659,61,1.0707211307,7.0667594625,4.0687402966
49,19,2008,109,68,110,106,9,41,119,167,9589,11.467045395,7.1537530903,11.572247646,7,0.946820262,4.3132923045,12.519067908
49,21,2001,774,160,89,701,69,614,158,738,34730,22.525537674,4.6564418963,2.5901458048,-34,2.0080905678,17.869095777,4.5982363726
49,21,2002,756,182,316,732,67,574,383,927,35657,21.481239433,5.1714094932,8.9789307685,-30,1.9037606376,16.30982994,10.882691406
49,21,2003,780,204,-172,694,55,576,-117,420,36077,21.747009786,5.6876794825,-4.795494466,-39,1.5334429977,16.059330304,-3.262051468
49,21,2004,811,184,329,672,56,627,385,979,37056,22.178770186,5.0319281309,8.9973062776,-33,1.5314563877,17.146842055,10.528762665
49,21,2005,872,211,1585,936,59,661,1644,2277,39333,22.830512247,5.5243556009,41.498121457,-28,1.5447250259,17.306156646,43.042846483
49,21,2006,953,240,1668,945,61,713,1729,2413,41746,23.507936704,5.9201519506,41.145056056,-29,1.5047052874,17.587784753,42.649761344
49,21,2007,982,254,954,1091,48,728,1002,1707,43453,23.051913755,5.9625112971,22.394629045,-23,1.1267737884,17.089402458,23.521402833
49,21,2008,1077,262,258,1091,48,815,306,1087,44540,24.479219938,5.9550191493,5.8641028264,-34,1.0909958747,18.524200789,6.955098701
49,23,2001,172,57,8,101,2,115,10,117,8388,20.649498769,6.843147848,0.9604418032,-8,0.2401104508,13.806350921,1.200552254
49,23,2002,187,40,-53,101,2,147,-51,88,8476,22.177419355,4.7438330171,-6.285578748,-8,0.2371916509,17.433586338,-6.048387097
49,23,2003,173,62,27,101,1,111,28,127,8603,20.258797353,7.2603782423,3.1617776216,-12,0.1171028749,12.998419111,3.2788804965
49,23,2004,176,71,82,101,0,105,82,179,8782,20.247339661,8.1679608858,9.4334196146,-8,0,12.079378775,9.4334196146
49,23,2005,165,76,29,101,1,89,30,112,8894,18.669382213,8.5992305952,3.2812853587,-7,0.113147771,10.070151618,3.3944331297
49,23,2006,192,65,97,101,0,127,97,218,9112,21.326224592,7.219815617,10.774186382,-6,0,14.106408975,10.774186382
49,23,2007,183,50,316,101,1,133,317,456,9568,19.593147752,5.3533190578,33.832976445,6,0.1070663812,14.239828694,33.940042827
49,23,2008,207,66,278,101,0,141,278,415,9983,21.175387448,6.7515728096,28.438443046,-4,0,14.423814639,28.438443046
49,25,2001,76,70,-132,67,3,6,-129,-128,5951,12.635078969,11.637572735,-21.94513716,-5,0.4987531172,0.9975062344,-21.44638404
49,25,2002,86,51,13,67,3,35,16,46,5997,14.395714764,8.5369936391,2.1760964178,-5,0.5021760964,5.8587211249,2.6782725142
49,25,2003,84,47,-18,67,3,37,-15,15,6012,13.989507869,7.8274627363,-2.997751686,-7,0.499625281,6.1620451328,-2.498126405
49,25,2004,72,59,24,67,2,13,26,34,6046,11.942278985,9.7860341682,3.9807596616,-5,0.3317299718,2.1562448167,4.3124896334
49,25,2005,106,56,84,67,3,50,87,132,6178,17.342931937,9.1623036649,13.743455497,-5,0.4908376963,8.1806282723,14.234293194
49,25,2006,90,52,182,67,2,38,184,217,6395,14.316392269,8.2716933111,28.950926589,-5,0.3181420504,6.0446989581,29.269068639
49,25,2007,104,67,69,67,3,37,72,111,6506,16.12278118,10.386791722,10.696845206,2,0.4650802263,5.7359894582,11.161925432
49,25,2008,108,62,22,67,2,46,24,71,6577,16.509974776,9.4779484828,3.36314301,1,0.3057402736,7.0320262937,3.6688832837
49,27,2001,191,106,-229,152,54,85,-175,-97,12297,15.471224333,8.5861244988,-18.54926896,-7,4.3740634239,6.8850998339,-14.17520554
49,27,2002,197,103,-218,152,51,94,-167,-78,12219,16.071137217,8.4026758036,-17.78430413,-5,4.1605482134,7.668461413,-13.62375591
49,27,2003,190,131,-167,152,38,59,-129,-77,12142,15.598702845,10.754895119,-13.71043882,-7,3.1197405689,4.8438077255,-10.59069825
49,27,2004,180,123,-250,152,41,57,-209,-167,11975,14.927229755,10.200273666,-20.73226355,-15,3.400091222,4.7269560891,-17.33217233
49,27,2005,202,96,-241,152,39,106,-202,-103,11872,16.94133434,8.051327211,-20.21218602,-7,3.2708516795,8.8900071288,-16.94133434
49,27,2006,182,103,-92,152,41,79,-51,21,11893,15.316642121,8.6682095519,-7.742478435,-7,3.4504523459,6.6484325689,-4.292026089
49,27,2007,189,95,-116,152,31,94,-85,5,11898,15.888361145,7.9862132739,-9.751586734,-4,2.6060274894,7.902147871,-7.145559245
49,27,2008,198,104,71,152,31,94,102,184,12082,16.513761468,8.6738949124,5.9216013344,-12,2.5854879066,7.8398665555,8.507089241
49,29,2001,116,28,51,0,3,88,54,135,7290,16.060920734,3.8767739702,7.0612668744,-7,0.4153686397,12.184146764,7.476635514
49,29,2002,91,31,57,0,2,60,59,113,7403,12.386850881,4.2196964541,7.7587967059,-6,0.2722384809,8.1671544273,8.0310351868
49,29,2003,109,38,-11,0,-3,71,-14,46,7449,14.678157824,5.1171559386,-1.481281982,-11,-0.403985995,9.5610018853,-1.885267977
49,29,2004,111,39,37,0,5,72,42,108,7557,14.794082367,5.1979208317,4.931360789,-6,0.6664001066,9.5961615354,5.5977608956
49,29,2005,128,40,119,0,2,88,121,205,7762,16.711273582,5.2222729943,15.536262158,-4,0.2611136497,11.489000588,15.797375808
49,29,2006,135,28,149,0,4,107,153,255,8017,17.111350529,3.5490208505,18.885860954,-5,0.5070029786,13.562329679,19.392863933
49,29,2007,150,28,203,0,2,122,205,318,8335,18.346379648,3.4246575342,24.828767123,-9,0.2446183953,14.921722114,25.073385519
49,29,2008,170,33,210,0,2,137,212,334,8669,19.995295225,3.8814396613,24.700070572,-15,0.2352387673,16.113855563,24.935309339
49,31,2001,21,15,-41,16,1,6,-40,-34,1397,14.851485149,10.608203678,-28.99575672,0,0.7072135785,4.243281471,-28.28854314
49,31,2002,18,15,-13,16,1,3,-12,-10,1387,12.931034483,10.775862069,-9.33908046,-1,0.7183908046,2.1551724138,-8.620689655
49,31,2003,17,23,-16,16,1,-6,-15,-22,1365,12.354651163,16.715116279,-11.62790698,-1,0.726744186,-4.360465116,-10.90116279
49,31,2004,19,19,10,16,0,0,10,9,1374,13.873676524,13.873676524,7.3019350128,-1,0,0,7.3019350128
49,31,2005,20,13,-20,16,1,7,-19,-12,1362,14.619883041,9.5029239766,-14.61988304,0,0.730994152,5.1169590643,-13.88888889
49,31,2006,15,20,-18,16,0,-5,-18,-24,1338,11.111111111,14.814814815,-13.33333333,-1,0,-3.703703704,-13.33333333
49,31,2007,22,7,-15,16,1,15,-14,-2,1336,16.454749439,5.2356020942,-11.21914734,-3,0.7479431563,11.219147345,-10.47120419
49,31,2008,18,6,60,16,0,12,60,68,1404,13.138686131,4.3795620438,43.795620438,-4,0,8.7591240876,43.795620438
49,33,2001,19,8,-54,18,5,11,-49,-39,1925,9.7711493957,4.1141681666,-27.77063512,-1,2.5713551041,5.6569812291,-25.19928002
49,33,2002,22,14,-1,18,5,8,4,9,1934,11.401917595,7.2557657424,-0.518268982,-3,2.591344908,4.1461518528,2.0730759264
49,33,2003,36,14,55,18,2,22,57,80,2014,18.237082067,7.0921985816,27.862208713,1,1.0131712259,11.144883485,28.875379939
49,33,2004,37,14,-18,18,1,23,-17,4,2018,18.353174603,6.9444444444,-8.928571429,-2,0.496031746,11.408730159,-8.432539683
49,33,2005,29,11,-26,18,2,18,-24,-7,2011,14.39563167,5.4604120129,-12.90642839,-1,0.9928021842,8.9352196575,-11.91362621
49,33,2006,42,19,-29,18,1,23,-28,-5,2006,20.911127707,9.4597958676,-14.4386358,0,0.497883993,11.45133184,-13.9407518
49,33,2007,33,7,58,18,1,26,59,83,2089,16.117216117,3.4188034188,28.327228327,-2,0.4884004884,12.698412698,28.815628816
49,33,2008,37,7,87,18,0,30,87,116,2205,17.233348859,3.2603632976,40.521658128,-1,0,13.972985561,40.521658128
49,35,2001,18335,5139,-9044,14055,5847,13196,-3197,13233,914237,20.20117439,5.6620580959,-9.964517108,3234,6.4421198067,14.539116294,-3.522397302
49,35,2002,18044,5261,-10651,14404,5457,12783,-5194,10278,924515,19.626355267,5.7223595134,-11.58503159,2689,5.9355475888,13.903995754,-5.649483998
49,35,2003,18562,5214,-11395,14634,4745,13348,-6650,12199,936714,19.945960438,5.6027495811,-12.24459752,5501,5.098781504,14.343210857,-7.145816017
49,35,2004,18561,5344,-7336,14599,4426,13217,-2910,12195,948909,19.686862114,5.668153178,-7.780982731,1888,4.6944696793,14.018708936,-3.086513052
49,35,2005,18305,5239,-3216,14600,4607,13066,1391,12189,961098,19.16746902,5.4858437692,-3.367526925,-2268,4.8240660898,13.681625251,1.4565391645
49,35,2006,18874,5225,1306,14903,4622,13649,5928,25937,987035,19.376500475,5.3641101506,1.3407708817,6360,4.7450559074,14.012390324,6.085826789
49,35,2007,19422,5157,-146,14885,4192,14265,4046,18210,1005245,19.497259421,5.176983155,-0.146565744,-101,4.2082438211,14.320276266,4.0616780774
49,35,2008,19540,5367,-1164,14704,4206,14173,3042,17406,1022651,19.271205229,5.2931708529,-1.147987865,191,4.1481417193,13.978034377,3.000153854
49,37,2001,245,75,-971,261,4,170,-967,-788,13585,17.526289434,5.3651906431,-69.46133486,9,0.286143501,12.161098791,-69.17519136
49,37,2002,240,90,58,251,4,150,62,197,13782,17.539372237,6.5772645887,4.2386816239,-15,0.2923228706,10.962107648,4.5310044945
49,37,2003,249,80,-213,256,2,169,-211,-49,13733,18.099218608,5.8150099945,-15.48246411,-7,0.1453752499,12.284208613,-15.33708886
49,37,2004,260,84,33,257,1,176,34,200,13933,18.79563363,6.0724354804,2.385599653,-10,0.0722908986,12.723198149,2.4578905516
49,37,2005,239,65,-209,251,2,174,-207,-42,13891,17.179413456,4.6722254169,-15.02300173,-9,0.1437607821,12.507188039,-14.87924094
49,37,2006,240,73,-53,255,1,167,-52,107,13998,17.211086808,5.2350389042,-3.80078167,-8,0.0717128617,11.976047904,-3.729068808
49,37,2007,250,44,251,249,2,206,253,459,14457,17.571604287,3.0926023546,17.641890705,0,0.1405728343,14.479001933,17.782463539
49,37,2008,276,55,387,254,1,221,388,598,15055,18.704255896,3.7272973706,26.22661968,-11,0.0677690431,14.976958525,26.294388723
49,39,2001,396,171,61,1388,72,225,133,336,23141,17.237626779,7.4435206547,2.6552909938,-22,3.1341139599,9.7941061246,5.7894049536
49,39,2002,401,178,-183,1362,68,223,-115,88,23229,17.295665301,7.6773776148,-7.893034289,-20,2.9329307742,9.618287686,-4.960103515
49,39,2003,370,166,-113,1260,53,204,-60,115,23344,15.889034419,7.1285938205,-4.852596998,-29,2.2759968222,8.7604405986,-2.576600176
49,39,2004,409,184,-81,1414,60,225,-21,186,23530,17.451038955,7.8508341511,-3.45607373,-18,2.5600546145,9.6002048044,-0.896019115
49,39,2005,412,166,-65,1534,58,246,-7,217,23747,17.4291939,7.0224422023,-2.749751465,-22,2.4536243839,10.406751697,-0.296127081
49,39,2006,425,173,-94,1577,60,252,-34,207,23954,17.819332928,7.2535166978,-3.941217165,-11,2.515670531,10.56581623,-1.425546634
49,39,2007,429,155,295,1568,47,274,342,624,24578,17.679057117,6.3875381192,12.156927388,8,1.9368663974,11.291518998,14.093793786
49,39,2008,463,164,586,1809,47,299,633,942,25520,18.483771807,6.5471675516,23.394147471,10,1.8763224081,11.936604256,25.270469879
49,41,2001,356,156,-151,439,12,200,-139,43,18911,18.846449085,8.2585563408,-7.993859022,-18,0.6352735647,10.587892745,-7.358585458
49,41,2002,329,160,-123,434,11,169,-112,37,18948,17.380279458,8.4524155419,-6.497794448,-20,0.5811035685,8.9278639161,-5.916690879
49,41,2003,327,147,-160,425,10,180,-150,12,18960,17.25229503,7.7556188667,-8.441489923,-18,0.5275931202,9.4966761633,-7.913896803
49,41,2004,361,179,-32,427,11,182,-21,147,19107,18.966558962,9.4044710642,-1.681246224,-14,0.5779283894,9.5620878977,-1.103317834
49,41,2005,329,174,-215,437,10,155,-205,-66,19041,17.248610674,9.1223655237,-11.27188843,-16,0.5242738807,8.1262451505,-10.74761455
49,41,2006,364,174,57,432,11,190,68,247,19288,18.993451434,9.0792872238,2.974249263,-11,0.5739779279,9.9141642099,3.5482271909
49,41,2007,395,197,149,426,7,198,156,355,19643,20.292312039,10.120469549,7.6545683389,1,0.3596105931,10.171842491,8.014178932
49,41,2008,390,167,153,424,6,223,159,371,20014,19.668658749,8.4222205411,7.7161661245,-11,0.30259475,11.246438208,8.0187608745
49,43,2001,484,106,416,56,165,378,581,937,30924,15.892039205,3.480487925,13.659273366,-22,5.417740638,12.41155128,19.077014004
49,43,2002,487,93,300,56,158,394,458,829,31753,15.539990746,2.9675957688,9.5728895767,-23,5.0417218437,12.572394977,14.61461142
49,43,2003,527,107,364,56,136,420,500,900,32653,16.364934944,3.3226718008,11.303294724,-20,4.2232090178,13.042263143,15.526503742
49,43,2004,538,87,496,56,120,451,616,1030,33683,16.220453449,2.6230101302,14.954172697,-37,3.6179450072,13.597443319,18.572117704
49,43,2005,553,105,434,56,126,448,560,976,34659,16.183313336,3.0727810131,12.700828188,-32,3.6873372158,13.110532323,16.388165403
49,43,2006,533,118,-318,56,126,415,-192,208,34867,15.332393637,3.3944136007,-9.147656992,-15,3.6245433363,11.937980036,-5.523113655
49,43,2007,540,103,-27,56,112,437,85,510,35377,15.374978646,2.9326348158,-0.768748932,-12,3.1888844599,12.44234383,2.4201355276
49,43,2008,552,112,184,56,111,440,295,723,36100,15.445527932,3.1338752326,5.1485093107,-12,3.1058942037,12.311652699,8.2544035144
49,45,2001,958,206,1283,1328,98,752,1381,2124,43739,22.44768845,4.8269559716,30.06303161,-9,2.2963188603,17.620732479,32.35935047
49,45,2002,1019,232,1009,1328,91,787,1100,1871,45610,22.809432674,5.1931191172,22.585591333,-16,2.0369562054,17.616313557,24.622547538
49,45,2003,1040,217,891,1328,55,823,946,1759,47369,22.370642833,4.6677206681,19.165618043,-10,1.1830628421,17.702922165,20.348680885
49,45,2004,1083,282,518,1328,72,801,590,1345,48714,22.54300969,5.8699249607,10.782344431,-46,1.4987042453,16.673084729,12.281048677
49,45,2005,1027,251,636,1328,64,776,700,1434,50148,20.77643584,5.0777851955,12.866419858,-42,1.2947340738,15.698650644,14.161153932
49,45,2006,1110,250,1308,1328,68,860,1376,2204,52352,21.658536585,4.8780487805,25.52195122,-32,1.3268292683,16.780487805,26.848780488
49,45,2007,1122,263,1474,1328,51,859,1525,2388,54740,20.95394614,4.9116647369,27.527733164,4,0.9524520973,16.042281403,28.480185261
49,45,2008,1191,262,1223,1328,52,929,1275,2201,56941,21.328605582,4.6919350651,21.901666353,-3,0.9312237534,16.636670517,22.832890107
49,47,2001,471,157,142,247,10,314,152,445,25697,18.489077313,6.1630257709,5.5742016526,-21,0.3925494122,12.326051542,5.9667510648
49,47,2002,501,187,174,254,9,314,183,477,26174,19.317152166,7.210194521,6.7089510516,-20,0.3470147096,12.106957645,7.0559657612
49,47,2003,510,182,-307,245,3,328,-304,5,26179,19.483124176,6.9528011766,-11.72807671,-19,0.1146066128,12.530323,-11.6134701
49,47,2004,515,215,-8,247,10,300,2,285,26464,19.565754231,8.1682274946,-0.303934046,-17,0.3799175579,11.397526737,0.0759835116
49,47,2005,525,176,178,251,7,349,185,511,26975,19.648571268,6.5869496061,6.6618013062,-23,0.2619809502,13.061621662,6.9237822564
49,47,2006,594,169,425,248,9,425,434,843,27818,21.681601664,6.1686711806,15.512930484,-16,0.3285091161,15.512930484,15.8414396
49,47,2007,622,197,728,264,7,425,735,1160,28978,21.902950912,6.9371082471,25.635608141,0,0.2464962321,14.965842665,25.882104374
49,47,2008,640,189,468,242,7,451,475,907,29885,21.745408831,6.4216910453,15.901330207,-19,0.2378404091,15.323717785,16.139170617
49,49,2001,10163,1610,2966,10188,1507,8553,4473,16189,387824,26.763788434,4.2398602163,7.8108232307,3163,3.9686145006,22.523928217,11.779437731
49,49,2002,10306,1616,-25,10634,1415,8690,1390,9457,397281,26.253813184,4.1166468179,-0.063685749,-623,3.6046133957,22.137166366,3.5409276466
49,49,2003,10767,1787,-575,11129,1216,8980,641,12291,409572,26.688876412,4.4295553217,-1.425290604,2670,3.0141797824,22.259321091,1.5888891781
49,49,2004,10945,1753,279,11489,1130,9192,1409,24542,434114,25.945671731,4.1555744673,0.6613835005,13941,2.6787217045,21.790097264,3.340105205
49,49,2005,11046,1686,2343,11743,1177,9360,3520,20725,454839,24.851707571,3.7932264135,5.2713698025,7845,2.6480590087,21.058481157,7.9194288112
49,49,2006,11513,1743,5392,11736,1180,9770,6572,27208,482047,24.57716307,3.7208369001,11.510471925,10866,2.5189830993,20.85632617,14.029455024
49,49,2007,12264,1803,8124,11741,1070,10461,9194,31216,513263,24.643578383,3.6229918317,16.324562197,11561,2.1500838935,21.020586551,18.47464609
49,49,2008,12864,1844,5449,11769,1073,11020,6522,17574,530837,24.641317881,3.5322287137,10.437697539,32,2.0553586821,21.109089168,12.493056221
49,51,2001,296,76,411,124,49,220,460,675,16091,18.789475355,4.8243247532,26.089440442,-5,3.1104199067,13.965150601,29.199860348
49,51,2002,369,110,349,124,48,259,397,650,16741,22.478070175,6.7007797271,21.259746589,-6,2.9239766082,15.777290448,24.183723197
49,51,2003,371,89,340,124,31,282,371,650,17391,21.739130435,5.2150474628,19.922653229,-3,1.8164772061,16.524082972,21.739130435
49,51,2004,392,105,147,124,32,287,179,452,17843,22.251234603,5.9601521258,8.3442129761,-14,1.8164273145,16.291082477,10.160640291
49,51,2005,390,90,581,124,31,300,612,904,18747,21.317299809,4.9193768789,31.757310741,-8,1.6944520361,16.39792293,33.451762777
49,51,2006,360,99,835,124,32,261,867,1114,19861,18.648984666,5.1284707833,43.255283879,-14,1.6576875259,13.520513883,44.912971405
49,51,2007,421,84,244,124,29,337,273,581,20442,20.891745031,4.1684241868,12.108279781,-29,1.4390988264,16.723320845,13.547378607
49,51,2008,443,100,290,124,29,343,319,624,21066,21.345282837,4.8183482702,13.973209984,-38,1.3973209984,16.526934567,15.370530982
49,53,2001,1741,665,2180,1437,171,1076,2351,3359,94613,18.7338258,7.155654312,23.457633684,-68,1.8400253945,11.578171488,25.297659079
49,53,2002,1949,715,3426,1521,166,1234,3592,4799,99412,20.090194563,7.3701842546,35.315036722,-27,1.7111197011,12.720010308,37.026156423
49,53,2003,2042,718,3314,1475,144,1324,3458,4833,104245,20.053324953,7.0510711638,32.544916207,51,1.4141424061,13.002253789,33.959058613
49,53,2004,2242,828,4661,1430,135,1414,4796,6008,110253,20.904623819,7.7203517049,43.459612677,-202,1.2587529954,13.184272114,44.718365672
49,53,2005,2287,791,7222,1500,141,1496,7363,8823,119076,19.945144312,6.8983861614,62.983748239,-36,1.2296743979,13.046758151,64.213422637
49,53,2006,2677,924,6206,1274,142,1753,6348,7997,127073,21.751053224,7.5076478068,50.424742737,-104,1.1537727149,14.243405417,51.578515452
49,53,2007,2813,815,4444,1460,127,1998,4571,6374,133447,21.595270996,6.2567173346,34.116382619,-195,0.9749731307,15.338553662,35.09135575
49,53,2008,2954,921,2326,1483,127,2033,2453,4142,137589,21.797842353,6.7961451615,17.163771602,-344,0.9371448811,15.001697192,18.100916483
49,55,2001,40,22,-40,7,4,18,-36,-19,2510,15.876165906,8.7318912483,-15.87616591,-1,1.5876165906,7.1442746577,-14.28854932
49,55,2002,45,16,-21,7,4,29,-17,10,2520,17.892644135,6.3618290258,-8.349900596,-2,1.5904572565,11.530815109,-6.75944334
49,55,2003,33,20,-72,7,1,13,-71,-55,2465,13.239719157,8.0240722166,-28.88665998,3,0.4012036108,5.2156469408,-28.48545637
49,55,2004,38,16,-59,7,0,22,-59,-39,2426,15.538744633,6.5426293192,-24.12594561,-2,0,8.9961153138,-24.12594561
49,55,2005,38,23,-31,7,1,15,-30,-17,2409,15.718717684,9.5139607032,-12.82316443,-2,0.4136504654,6.2047569804,-12.40951396
49,55,2006,36,20,54,7,0,16,54,68,2477,14.735980352,8.1866557511,22.103970528,-2,0,6.5493246009,22.103970528
49,55,2007,32,16,20,7,1,16,21,38,2515,12.820512821,6.4102564103,8.0128205128,1,0.4006410256,6.4102564103,8.4134615385
49,55,2008,39,9,45,7,0,30,45,74,2589,15.282131661,3.526645768,17.63322884,-1,0,11.755485893,17.63322884
49,57,2001,3922,1389,-437,2954,662,2533,225,3472,200894,19.692907139,6.9743620643,-2.194237741,714,3.3239940148,12.718545075,1.1297562739
49,57,2002,3989,1431,-5,3042,584,2558,579,3696,204590,19.675252291,7.0582316442,-0.024661886,559,2.8805082321,12.617020647,2.8558463466
49,57,2003,4018,1308,-675,3078,443,2710,-232,3008,207598,19.495958155,6.3466185333,-3.275204518,530,2.149504595,13.149339622,-1.125699923
49,57,2004,4019,1430,-631,3023,565,2589,-66,3219,210817,19.210592354,6.8353190015,-3.016144259,696,2.7006679971,12.375273353,-0.315476262
49,57,2005,3996,1445,-614,3038,525,2551,-89,3118,213935,18.815685388,6.8039703168,-2.891098806,656,2.4720307379,12.011715071,-0.419068068
49,57,2006,3965,1456,-559,3130,560,2509,1,2510,216445,18.425577397,6.766113667,-2.597704354,0,2.6023514104,11.65946373,0.0046470561
49,57,2007,4141,1343,1657,3116,476,2798,2133,4974,221419,18.91454881,6.1343248132,7.5685601009,43,2.174191073,12.780223996,9.7427511739
49,57,2008,4291,1425,2624,3156,488,2866,3112,6068,227487,19.117588092,6.3487678935,11.690643475,90,2.1741745488,12.768820198,13.864818024
50,0,2001,6537,5162,666,20815,791,1375,1457,2258,612134,10.698766786,8.4483760362,1.0900074467,-574,1.294588424,2.2503907497,2.3845958707
50,0,2002,6321,5075,1471,20849,716,1246,2187,2860,614994,10.302103774,8.2713457765,2.3974679088,-573,1.1669524288,2.0307579975,3.5644203376
50,0,2003,6514,5118,557,20865,548,1396,1105,1708,616702,10.577285304,8.3104921994,0.9044439537,-793,0.889829958,2.2667931048,1.7942739117
50,0,2004,6662,5151,67,21058,595,1511,662,1730,618432,10.787493503,8.3407954117,0.1084902529,-443,0.9634582159,2.4466980911,1.0719484687
50,0,2005,6505,5137,-556,21092,582,1368,26,850,619282,10.511313599,8.300786773,-0.898430494,-544,0.9404434304,2.2105268261,0.0420129368
50,0,2006,6198,4956,-654,21322,616,1242,-38,914,620196,10.000984285,7.9969148303,-1.05528295,-290,0.9939668151,2.004069455,-0.061316135
50,0,2007,6703,4956,-1767,21413,538,1747,-1229,552,620748,10.803066053,7.9874676053,-2.847831973,34,0.8670818345,2.8155984476,-1.980750139
50,0,2008,6617,5047,-1703,21572,528,1570,-1175,522,621270,10.655240101,8.1270963867,-2.742311303,127,0.8502292237,2.5281437145,-1.892082079
50,1,2001,375,264,-80,2605,31,111,-49,28,36049,10.406549188,7.3262106286,-2.220063827,-34,0.8602747329,3.0803385597,-1.359789094
50,1,2002,356,257,143,2605,31,99,174,241,36290,9.8425468972,7.1054341365,3.9536073211,-32,0.857075713,2.7371127608,4.810683034
50,1,2003,340,268,23,2605,24,72,47,65,36355,9.3605891665,7.3783467548,0.633216326,-54,0.6607474706,1.9822424117,1.2939637965
50,1,2004,376,286,43,2605,23,90,66,132,36487,10.323714341,7.8526125038,1.1806375443,-24,0.6315038028,2.4711018369,1.812141347
50,1,2005,373,254,-99,2605,25,119,-74,11,36498,10.221278345,6.9603343153,-2.712886209,-34,0.6850722751,3.2609440296,-2.027813934
50,1,2006,340,244,-61,2605,24,96,-37,43,36541,9.310094607,6.6813620121,-1.670340503,-16,0.6571831487,2.6287325949,-1.013157354
50,1,2007,375,264,-3,2605,22,111,19,128,36669,10.244502117,7.2121294905,-0.081956017,-2,0.6010107909,3.0323726267,0.5190547739
50,1,2008,367,257,-189,2605,21,110,-168,-52,36617,10.015555495,7.0136178806,-5.157874628,6,0.5730971809,3.0019376143,-4.584777447
50,3,2001,367,418,-15,1273,31,-51,16,-72,36907,9.9342229922,11.314728095,-0.406030912,-37,0.8391305525,-1.380505102,0.43309964
50,3,2002,372,378,56,1273,31,-6,87,46,36953,10.073111292,10.235580829,1.516382345,-35,0.839425941,-0.162469537,2.3558082859
50,3,2003,348,364,-92,1272,24,-16,-68,-132,36821,9.4342180172,9.8679751674,-2.494103614,-48,0.6506357253,-0.43375715,-1.843467888
50,3,2004,373,377,-94,1273,24,-4,-70,-102,36719,10.144139244,10.252923579,-2.556431874,-28,0.6527060103,-0.108784335,-1.903725863
50,3,2005,369,427,-130,1273,24,-58,-106,-197,36522,10.076323371,11.660135716,-3.549924223,-33,0.6553706257,-1.583812346,-2.894553597
50,3,2006,350,380,19,1273,24,-30,43,-5,36517,9.583920919,10.405399855,0.5202699927,-18,0.6571831487,-0.821478936,1.1774531415
50,3,2007,393,407,-135,1272,22,-14,-113,-109,36408,10.778196778,11.162152897,-3.702434008,18,0.603359616,-0.383956119,-3.099074391
50,3,2008,373,394,-47,1273,21,-21,-26,-26,36382,10.24866053,10.825662866,-1.291386179,21,0.5770023355,-0.577002335,-0.714383844
50,5,2001,333,310,-99,958,30,23,-69,-72,29673,11.208724629,10.434548453,-3.332323538,-26,1.0097950116,0.7741761756,-2.322528527
50,5,2002,315,287,197,958,27,28,224,230,29903,10.574728078,9.6347522492,6.6134013697,-22,0.9064052639,0.9399758292,7.5198066335
50,5,2003,314,298,17,958,20,16,37,8,29911,10.499214231,9.9642224228,0.5684287959,-45,0.6687397599,0.5349918079,1.2371685559
50,5,2004,370,268,253,958,16,102,269,341,30252,12.299918555,8.9091301963,8.4104848495,-30,0.5318883699,3.3907883583,8.9423732194
50,5,2005,362,267,32,958,20,95,52,118,30370,11.942859028,8.8086833163,1.055722345,-29,0.6598264656,3.1341757118,1.7155488107
50,5,2006,320,253,179,958,20,67,199,252,30622,10.493179433,8.2961699895,5.8696222455,-14,0.6558237146,2.1970094439,6.5254459601
50,5,2007,367,271,-182,958,16,96,-166,-61,30561,11.996796496,8.858669892,-5.94936502,9,0.5230211006,3.1381266038,-5.426343919
50,5,2008,360,279,-205,958,15,81,-190,-91,30470,11.797283348,9.1428945946,-6.717897462,18,0.4915534728,2.6543887533,-6.226343989
50,7,2001,1652,910,-145,7452,468,742,323,919,147967,11.199430537,6.1691778384,-0.983000864,-146,3.1727200312,5.030252699,2.1897191668
50,7,2002,1613,960,-76,7486,420,653,344,848,148815,10.869931465,6.4693950442,-0.512160441,-149,2.8303603318,4.4005364207,2.3181998908
50,7,2003,1645,1006,-431,7503,354,639,-77,368,149183,11.040342553,6.7517231659,-2.892636863,-194,2.3758548715,4.2886193867,-0.516781992
50,7,2004,1675,972,-259,7545,366,703,107,706,149889,11.201316071,6.5001069976,-1.732024395,-104,2.4475711534,4.7012090734,0.715546758
50,7,2005,1623,971,-501,7579,365,652,-136,388,150277,10.814016244,6.4697534031,-3.338152889,-128,2.4319876335,4.3442628412,-0.906165255
50,7,2006,1585,952,-195,7708,379,633,184,744,151021,10.521145179,6.3193250536,-1.294399565,-73,2.5157817178,4.2018201249,1.2213821532
50,7,2007,1646,891,-335,7790,341,755,6,786,151807,10.870857384,5.8845285112,-2.21247705,25,2.2521035043,4.9863288732,0.0396264546
50,7,2008,1626,946,-114,7936,342,680,228,975,152782,10.676682349,6.2116491403,-0.748549685,67,2.245649055,4.4650332087,1.49709937
50,9,2001,55,58,33,27,3,-3,36,28,6486,8.4981458591,8.9616810878,5.0988875155,-5,0.4635352287,-0.463535229,5.5624227441
50,9,2002,71,57,32,27,3,14,35,44,6530,10.909649662,8.7584511371,4.9170251998,-5,0.4609711125,2.1511985249,5.3779963122
50,9,2003,62,52,-21,27,1,10,-20,-19,6511,9.5084732766,7.9748485546,-3.220611916,-9,0.1533624722,1.533624722,-3.067249444
50,9,2004,48,79,39,27,2,-31,41,6,6517,7.3687442432,12.1277249,5.9871046976,-4,0.3070310101,-4.758980657,6.2941357077
50,9,2005,49,47,-22,27,2,2,-20,-24,6493,7.5326671791,7.2252113759,-3.382013836,-6,0.3074558032,0.3074558032,-3.074558032
50,9,2006,42,58,-80,27,2,-16,-78,-97,6396,6.5171851967,8.9999224145,-12.41368609,-3,0.3103421522,-2.482737218,-12.10334394
50,9,2007,53,64,109,27,1,-11,110,96,6492,8.2247051521,9.9317194289,16.914959652,-3,0.1551831161,-1.707014277,17.070142768
50,9,2008,56,74,30,27,0,-18,30,8,6500,8.6206896552,11.391625616,4.618226601,-4,0,-2.770935961,4.618226601
50,11,2001,586,380,238,601,26,206,264,426,46007,12.796436214,8.2980303096,5.1971874045,-44,0.5677599686,4.4984059047,5.764947373
50,11,2002,565,347,262,601,24,218,286,462,46469,12.219386652,7.5046498551,5.6663350491,-42,0.5190535923,4.7147367966,6.1853886414
50,11,2003,597,381,142,601,17,216,159,314,46783,12.804014927,8.1714065114,3.0455110882,-61,0.3646034401,4.6326084159,3.4101145284
50,11,2004,650,380,157,601,23,270,180,417,47200,13.832288818,8.0865688476,3.3410297607,-33,0.4894502197,5.7457199706,3.8304799804
50,11,2005,612,346,59,601,21,266,80,303,47503,12.92461696,7.3070546868,1.2460006547,-43,0.4434917584,5.6175622736,1.6894924131
50,11,2006,586,320,-71,601,23,266,-48,195,47698,12.310795055,6.7226184599,-1.491580971,-23,0.4831882018,5.5881765948,-1.008392769
50,11,2007,632,344,-183,601,17,288,-166,132,47830,13.231722636,7.202076878,-3.831337409,10,0.3559165899,6.0296457583,-3.475420819
50,11,2008,605,353,-170,601,17,252,-153,119,47949,12.63324946,7.3711356352,-3.549838691,20,0.3549838691,5.2621138245,-3.194854822
50,13,2001,70,47,144,0,2,23,146,165,7104,9.9693797622,6.6937264117,20.508438368,-4,0.2848394218,3.2756533504,20.79327779
50,13,2002,57,50,136,0,1,7,137,140,7244,7.9453582381,6.9696124895,18.957345972,-4,0.1393922498,0.9757457485,19.096738221
50,13,2003,80,51,115,0,-1,29,114,141,7385,10.937179575,6.9724519789,15.722195639,-2,-0.136714745,3.9647275959,15.585480894
50,13,2004,89,61,95,0,0,28,95,116,7501,11.957544001,8.1956200457,12.763670563,-7,0,3.7619239554,12.763670563
50,13,2005,73,54,55,0,-1,19,54,67,7568,9.6887650143,7.1670316544,7.2997544628,-6,-0.132722808,2.5217333599,7.1670316544
50,13,2006,59,54,-33,0,0,5,-33,-32,7536,7.8125,7.1504237288,-4.36970339,-4,0,0.6620762712,-4.36970339
50,13,2007,69,47,23,0,0,22,23,47,7583,9.1275878034,6.2173424168,3.0425292678,2,0,2.9102453866,3.0425292678
50,13,2008,74,46,120,0,-1,28,119,146,7729,9.6656217346,6.0083594566,15.673981191,-1,-0.13061651,3.657262278,15.543364681
50,15,2001,274,200,215,597,20,74,235,288,23622,11.670500043,8.5186131698,9.1575091575,-21,0.851861317,3.1518868728,10.009370474
50,15,2002,250,168,219,597,18,82,237,297,23919,10.517237753,7.0675837698,9.2131002713,-22,0.7572411182,3.4496539829,9.9703413895
50,15,2003,282,159,147,597,12,123,159,252,24171,11.728009981,6.6126013724,6.1135371179,-30,0.4990642545,5.1154086089,6.6126013724
50,15,2004,265,177,22,597,15,88,37,109,24280,10.93888671,7.3063507461,0.908133991,-16,0.6191822666,3.6325359642,1.5273162577
50,15,2005,289,166,62,597,13,123,75,177,24457,11.859572809,6.812072963,2.5442682151,-21,0.5334755935,5.0474998461,3.0777438086
50,15,2006,297,163,-20,597,15,134,-5,117,24574,12.114784524,6.6488548061,-0.815810406,-12,0.6118578042,5.4659297179,-0.203952601
50,15,2007,320,176,-76,597,13,144,-63,83,24657,12.999939063,7.1499664845,-3.087485527,2,0.5281225244,5.8499725783,-2.559363003
50,15,2008,302,168,19,597,12,134,31,176,24833,12.204485755,6.7892503536,0.7678318852,11,0.4849464538,5.4152354011,1.2527783391
50,17,2001,275,196,256,646,8,79,264,319,28625,9.6608174808,6.8855280954,8.9933428185,-24,0.2810419631,2.7752893854,9.2743847816
50,17,2002,291,242,12,646,6,49,18,39,28664,10.159018311,8.4483932343,0.4189285901,-28,0.2094642951,1.7106250764,0.6283928852
50,17,2003,271,253,174,646,-3,18,171,164,28828,9.4273985946,8.8012245182,6.0530160718,-25,-0.104362346,0.6261740764,5.9486537257
50,17,2004,304,244,75,646,2,60,77,116,28944,10.524129336,8.446998546,2.5964134875,-21,0.069237693,2.07713079,2.6656511805
50,17,2005,278,213,-29,646,0,65,-29,11,28955,9.6029292388,7.3576400283,-1.001744417,-25,0,2.2452892105,-1.001744417
50,17,2006,282,230,60,646,2,52,62,101,29056,9.7222940477,7.9295306063,2.0685732016,-13,0.0689524401,1.7927634414,2.1375256417
50,17,2007,294,232,-164,656,1,62,-163,-100,28956,10.135833965,7.99834517,-5.65400262,1,0.0344756257,2.1374887954,-5.619526994
50,17,2008,294,237,-94,656,0,57,-94,-39,28917,10.160178321,8.1903478306,-3.248492389,-2,0,1.9698304909,-3.248492389
50,19,2001,277,286,154,707,15,-9,169,133,26467,10.492225526,10.83312816,5.8332228556,-27,0.5681710574,-0.340902634,6.401393913
50,19,2002,285,286,120,707,14,-1,134,108,26575,10.746201124,10.783907092,4.5247162626,-25,0.527883564,-0.037705969,5.0525998266
50,19,2003,291,262,333,707,7,29,340,355,26930,10.877488085,9.7934772451,12.447434819,-14,0.261657789,1.0840108401,12.709092608
50,19,2004,270,243,147,707,8,27,155,159,27089,9.996482719,8.9968344471,5.4425294804,-23,0.2961920806,0.9996482719,5.7387215609
50,19,2005,297,304,178,707,7,-7,185,155,27244,10.932582408,11.190252701,6.5521874367,-23,0.2576702925,-0.257670292,6.8098577292
50,19,2006,265,276,-51,707,8,-11,-43,-65,27179,9.7385296658,10.14277052,-1.874207596,-11,0.2939933484,-0.404240854,-1.580214248
50,19,2007,300,233,5,707,7,67,12,77,27256,11.022320198,8.5606686874,0.1837053366,-2,0.2571874713,2.461651511,0.4408928079
50,19,2008,299,240,-143,707,6,59,-137,-67,27189,10.983561392,8.816236569,-5.253007622,11,0.2204059142,2.1673248232,-5.032601708
50,21,2001,693,635,-145,2012,11,58,-134,-134,63290,10.938017899,10.022570513,-2.288618464,-58,0.1736193317,0.9154473855,-2.114999132
50,21,2002,577,616,39,2012,10,-39,49,-53,63237,9.1205829586,9.7370521707,0.6164692121,-63,0.1580690287,-0.616469212,0.7745382408
50,21,2003,629,576,219,2012,2,53,221,188,63425,9.9319448611,9.0950719237,3.4580221377,-86,0.0315801108,0.8368729374,3.4896022485
50,21,2004,607,633,30,2162,8,-26,38,-28,63397,9.5724716532,9.9824951507,0.4731040356,-40,0.1261610762,-0.410023498,0.5992651117
50,21,2005,594,624,161,2162,5,-30,166,81,63478,9.363546798,9.836453202,2.5379310345,-55,0.078817734,-0.472906404,2.6167487685
50,21,2006,580,616,114,2262,7,-36,121,56,63534,9.1329953075,9.6998708783,1.7951059742,-29,0.1102258054,-0.566875571,1.9053317797
50,21,2007,601,625,-56,2262,5,-24,-51,-80,63454,9.4654613034,9.8434497748,-0.8819731,-5,0.0787475982,-0.377988471,-0.803225502
50,21,2008,627,625,-139,2272,4,2,-135,-123,63331,9.8907599479,9.8592104744,-2.19268841,10,0.063098947,0.0315494735,-2.129589462
50,23,2001,588,512,271,2117,79,76,350,375,58442,10.093640835,8.7890205907,4.652001133,-51,1.3561184115,1.3046202439,6.0081195444
50,23,2002,630,493,136,2117,68,137,204,287,58729,10.753514095,8.4150515059,2.3213935189,-54,1.1606967594,2.3384625889,3.4820902783
50,23,2003,644,477,-164,2117,49,167,-115,-32,58697,10.968610018,8.1242654949,-2.793248514,-84,0.8345681536,2.8443445234,-1.95868036
50,23,2004,616,471,-125,2117,63,145,-62,42,58739,10.490820532,8.0213903743,-2.128819101,-41,1.0729248271,2.4694301577,-1.055894274
50,23,2005,627,486,64,2117,58,141,122,207,58946,10.655563581,8.259336364,1.0876492331,-56,0.9856821175,2.3962272167,2.0733313506
50,23,2006,555,481,-128,2117,64,74,-64,-16,58930,9.4166751502,8.1611184635,-2.171773728,-26,1.0858868642,1.2555566867,-1.085886864
50,23,2007,634,468,-312,2117,53,166,-259,-78,58852,10.765651797,7.946884923,-5.297923282,15,0.899967737,2.8187668744,-4.397955545
50,23,2008,632,500,-228,2119,53,132,-175,-23,58829,10.74090125,8.4975484573,-3.874882097,20,0.9007401365,2.2433527927,-2.97414196
50,25,2001,454,439,-180,1126,29,15,-151,-175,43982,10.301909484,9.9615380252,-4.084457505,-39,0.6580514869,0.3403714587,-3.426406018
50,25,2002,421,399,7,1126,27,22,34,14,43996,9.5705744618,9.0704494305,0.1591306918,-42,0.6137898111,0.5001250313,0.7729205029
50,25,2003,443,409,93,1126,15,34,108,83,44079,10.059608288,9.2875390292,2.111836503,-59,0.3406187908,0.7720692592,2.4524552938
50,25,2004,454,386,-274,1126,15,68,-259,-225,43854,10.326043692,8.7794115975,-6.232017559,-34,0.3411688445,1.5466320949,-5.890848714
50,25,2005,423,396,-187,1126,15,27,-172,-183,43671,9.6658097686,9.0488431877,-4.273064839,-38,0.3427592117,0.616966581,-3.930305627
50,25,2006,410,373,-99,1126,16,37,-83,-67,43604,9.3955886565,8.5476940705,-2.26869092,-21,0.3666571183,0.8478945861,-1.902033801
50,25,2007,452,372,-239,1126,14,80,-225,-159,43445,10.3849556,8.5469103608,-5.491160151,-14,0.3216579168,1.8380452389,-5.169502234
50,25,2008,451,385,-326,1126,13,66,-313,-269,43176,10.413179252,8.8892993616,-7.527043096,-22,0.3001581603,1.5238798906,-7.226884936
50,27,2001,538,507,19,694,38,31,57,30,57513,9.3568471947,8.8176980069,0.3304462764,-58,0.6608925528,0.5391491878,0.9913388292
50,27,2002,518,535,188,694,36,-17,224,157,57670,8.9943828516,9.2895653004,3.2643706102,-50,0.6250922445,-0.295182449,3.8894628548
50,27,2003,568,562,2,694,27,6,29,-47,57623,9.8531567398,9.7490740982,0.0346942139,-82,0.4683718873,0.1040826416,0.5030661012
50,27,2004,565,574,-42,694,30,-9,-12,-59,57564,9.8101348242,9.9664024586,-0.72924896,-38,0.5208921146,-0.156267634,-0.208356846
50,27,2005,536,582,-199,694,28,-46,-171,-264,57300,9.3327761527,10.13372336,-3.464967266,-47,0.4875330826,-0.800947207,-2.977434183
50,27,2006,527,556,-288,695,32,-29,-256,-312,56988,9.2223155537,9.7298054039,-5.039899202,-27,0.5599888002,-0.50748985,-4.479910402
50,27,2007,567,562,-219,695,26,5,-193,-210,56778,9.967828701,9.879928977,-3.850007911,-22,0.4570785648,0.087899724,-3.392929346
50,27,2008,551,543,-217,695,25,8,-192,-212,56566,9.7226143422,9.5814511575,-3.829051383,-28,0.441134952,0.1411631846,-3.387916431
51,0,2001,99002,56498,16126,230038,25500,42504,41626,83897,7188251,13.853597717,7.905906586,2.2565515524,-233,3.5682788407,5.9476911312,5.8248303931
51,0,2002,98851,56730,29478,236771,17271,42121,46749,88534,7276785,13.667577461,7.8437412807,4.0757589542,-336,2.3879650213,5.8238361799,6.4637239755
51,0,2003,99939,56839,40783,240227,1353,43100,42136,86515,7363300,13.652789584,7.7648456276,5.5714157397,1279,0.1848349924,5.8879439566,5.7562507322
51,0,2004,103092,58135,20517,240684,28742,44957,49259,91388,7454688,13.914439666,7.8465443487,2.7692018647,-2828,3.8793390844,6.0678953175,6.648540949
51,0,2005,103664,57814,29335,242948,19030,45850,48365,92037,7546725,13.820564769,7.7078072579,3.9109649204,-2178,2.537094339,6.1127575116,6.4480592595
51,0,2006,106005,57291,10184,249269,25025,48714,35209,81622,7628347,13.970938655,7.5506725767,1.34220121,-2301,3.2981721602,6.4202660785,4.6403733702
51,0,2007,107401,58282,3796,249637,17619,49119,21415,70428,7698775,14.014503179,7.605080719,0.4953310869,-106,2.2990617547,6.4094224604,2.7943928417
51,0,2008,108095,59370,2678,249637,19565,48725,22243,70314,7769089,13.976719733,7.6765609007,0.3462662977,-654,2.5297610582,6.3001588325,2.8760273558
51,1,2001,466,442,13,893,113,24,126,112,38468,12.131625534,11.506820785,0.3384359054,-38,2.9417890243,0.6248047485,3.2802249297
51,1,2002,451,470,76,877,104,-19,180,124,38592,11.705164807,12.198287049,1.9724889696,-37,2.6991954321,-0.493122242,4.6716844018
51,1,2003,479,443,-77,877,60,36,-17,-40,38552,12.418334543,11.485015037,-1.996266722,-59,1.5555325106,0.9333195064,-0.440734211
51,1,2004,462,464,36,864,85,-2,121,91,38643,11.969687156,12.021503983,0.9327028953,-28,2.2022151694,-0.051816828,3.1349180646
51,1,2005,495,486,-28,861,75,9,47,22,38665,12.80591918,12.573084286,-0.724375226,-34,1.9402907849,0.2328348942,1.2159155585
51,1,2006,492,430,-254,861,82,62,-172,-128,38537,12.745783788,11.139607782,-6.580140411,-18,2.124297298,1.6061760058,-4.455843113
51,1,2007,481,454,-243,861,69,27,-174,-162,38375,12.507801123,11.805700021,-6.318909923,-15,1.7942583732,0.7021011026,-4.52465155
51,1,2008,489,452,-278,861,70,37,-208,-195,38180,12.775128992,11.80850369,-7.26275227,-24,1.8287505715,0.9666253021,-5.434001698
51,3,2001,1040,594,281,6506,380,446,661,1027,85628,12.218834629,6.9788343937,3.3014351256,-80,4.4645741912,5.240000235,7.7660093169
51,3,2002,985,582,20,6274,354,403,374,692,86320,11.456952102,6.76948845,0.2326284691,-85,4.1175239026,4.6874636518,4.3501523716
51,3,2003,986,574,366,6451,288,412,654,957,87277,11.359643312,6.6130175061,4.2166627303,-109,3.3180296895,4.7466258057,7.5346924198
51,3,2004,1009,621,768,6515,295,388,1063,1373,88650,11.470666811,7.0597463721,8.730894064,-78,3.3536637355,4.4109204386,12.0845578
51,3,2005,947,653,1107,6546,295,294,1402,1616,90266,10.585973306,7.2995148561,12.374522122,-80,3.2976368799,3.2864584498,15.672159002
51,3,2006,1082,662,932,6432,301,420,1233,1604,91870,11.881231607,7.2692932754,10.234110774,-49,3.3052224711,4.6119383318,13.539333245
51,3,2007,1115,623,-6,6327,275,492,269,769,92639,12.0861313,6.7530581164,-0.065037478,8,2.9808844013,5.3330731834,2.9158469235
51,3,2008,1101,636,649,6327,277,465,926,1436,94075,11.793438092,6.8125582442,6.9518086485,45,2.9671047699,4.9808798483,9.9189134184
51,5,2001,186,192,-116,455,3,-6,-113,-135,17065,10.856559171,11.206770757,-6.770757333,-16,0.1751057931,-0.350211586,-6.595651539
51,5,2002,184,246,-74,444,2,-62,-72,-149,16916,10.829581237,14.478679262,-4.355375063,-15,0.1177128395,-3.649098025,-4.237662223
51,5,2003,163,250,-184,444,2,-87,-182,-279,16637,9.7159717462,14.901797157,-10.96772271,-10,0.1192143773,-5.185825411,-10.84850833
51,5,2004,183,244,22,444,3,-61,25,-46,16591,11.014806789,14.686409053,1.3241844228,-10,0.1805706031,-3.671602263,1.5047550259
51,5,2005,187,277,24,444,3,-90,27,-79,16512,11.298069661,16.735643295,1.4500196357,-16,0.1812524545,-5.437573634,1.6312720901
51,5,2006,193,209,-87,444,3,-16,-84,-109,16403,11.72717606,12.699377184,-5.286343612,-9,0.1822877108,-0.972201124,-5.104055902
51,5,2007,179,233,-16,444,3,-54,-13,-69,16334,10.935638574,14.234658032,-0.977487247,-2,0.1832788588,-3.299019458,-0.794208388
51,5,2008,194,222,-107,444,2,-28,-105,-132,16202,11.925252029,13.646422424,-6.577329727,1,0.1229407426,-1.721170396,-6.454388985
51,7,2001,160,120,31,106,1,40,32,59,11537,13.903975668,10.427981751,2.6938952857,-13,0.0868998479,3.475993917,2.7807951336
51,7,2002,150,114,58,106,1,36,59,82,11619,12.955605459,9.8462601486,5.0095007773,-13,0.0863707031,3.1093453101,5.0958714804
51,7,2003,128,140,48,106,1,-12,49,21,11640,11.006492111,12.038350746,4.1274345415,-16,0.0859882196,-1.031858635,4.2134227611
51,7,2004,147,112,172,106,0,35,172,195,11835,12.523961661,9.5420660277,14.653887114,-12,0,2.9818956337,14.653887114
51,7,2005,127,132,270,106,1,-5,271,256,12091,10.616066204,11.034021566,22.569589568,-10,0.0835910725,-0.417955362,22.65318064
51,7,2006,161,126,269,106,0,35,269,297,12388,13.154132113,10.294538176,21.978021978,-7,0,2.8595939377,21.978021978
51,7,2007,152,123,218,106,1,29,219,251,12639,12.146881368,9.829384265,17.42118512,3,0.0799136932,2.3174971031,17.501098813
51,7,2008,163,123,123,106,0,40,123,169,12808,12.810940386,9.6671513341,9.6671513341,6,0,3.1437890518,9.6671513341
51,9,2001,345,298,58,1940,18,47,76,92,31975,10.805224091,9.3332080554,1.8165304269,-31,0.5637508221,1.4720160356,2.380281249
51,9,2002,305,327,-179,1893,17,-22,-162,-216,31759,9.5710295917,10.261398939,-5.617096055,-32,0.5334672231,-0.690369348,-5.083628832
51,9,2003,312,307,27,1858,15,5,42,3,31762,9.8235229294,9.6660946774,0.8501125612,-44,0.4722847562,0.1574282521,1.3223973174
51,9,2004,307,300,-33,1858,17,7,-16,-30,31732,9.6702050587,9.4497117838,-1.039468296,-21,0.5354836677,0.220493275,-0.503984628
51,9,2005,319,293,142,1911,17,26,159,154,31886,10.028608256,9.2112295262,4.4641453677,-31,0.5344399384,0.8173787293,4.998585306
51,9,2006,309,316,165,1921,19,-7,184,163,32049,9.6660670994,9.8850394932,5.1614921405,-14,0.5943536404,-0.218972394,5.7558457809
51,9,2007,333,313,132,1970,12,20,144,165,32214,10.363661827,9.7412196754,4.1081182018,1,0.3734652911,0.6224421518,4.4815834928
51,9,2008,327,323,304,1970,12,4,316,325,32539,10.099918151,9.9763717511,9.389526354,5,0.3706391982,0.1235463994,9.7601655522
51,11,2001,143,130,74,135,10,13,84,85,13777,10.411736867,9.4652153336,5.3878918053,-12,0.7280934872,0.9465215334,6.1159852925
51,11,2002,155,128,-135,135,10,27,-125,-110,13667,11.295729485,9.3280862848,-9.838216003,-12,0.728756741,1.9676432007,-9.109459262
51,11,2003,142,139,0,135,9,3,9,-8,13659,10.393032277,10.173461173,0,-20,0.6587133133,0.2195711044,0.6587133133
51,11,2004,152,131,107,138,7,21,114,123,13782,11.078313473,9.5477570059,7.7985496155,-12,0.5101854889,1.5305564666,8.3087351044
51,11,2005,156,153,27,136,9,3,36,27,13809,11.308035229,11.090573013,1.9571599435,-12,0.6523866478,0.2174622159,2.6095465913
51,11,2006,138,141,179,135,8,-3,187,177,13986,9.929843497,10.14570966,12.880014391,-7,0.5756431013,-0.215866163,13.455657492
51,11,2007,167,138,178,141,7,29,185,210,14196,11.851536442,9.7934852033,12.632176567,-4,0.4967709886,2.0580512384,13.128947555
51,11,2008,170,133,280,141,6,37,286,305,14501,11.847928355,9.2692615953,19.514234937,-18,0.4181621772,2.5786667596,19.932397115
51,13,2001,2835,1130,-3154,4277,3260,1705,106,3968,193550,14.79907708,5.8987503002,-16.46429951,2157,17.017633609,8.9003267803,0.553334099
51,13,2002,2831,1116,-4228,4206,2894,1715,-1334,2174,195724,14.545024841,5.7337505202,-21.72248853,1793,14.868704306,8.8112743209,-6.853784224
51,13,2003,2719,1017,-4638,4211,2207,1702,-2431,1166,196890,13.850754176,5.1806609036,-23.62625887,1895,11.242594508,8.6700932723,-12.38366436
51,13,2004,2722,1045,-5017,4050,2702,1677,-2315,1065,197955,13.78768884,5.2932163254,-25.41250364,1703,13.686383264,8.4944725145,-11.72612038
51,13,2005,2867,1030,-4290,4065,2555,1837,-1735,1806,199761,14.417322914,5.1795753754,-21.57318287,1704,12.848364159,9.2377475384,-8.724818715
51,13,2006,2729,1004,-3410,4094,2707,1725,-703,1028,200789,13.626263887,5.0131069779,-17.02658844,6,13.516414929,8.6131569092,-3.510173511
51,13,2007,2844,964,-1096,4076,2349,1880,1253,3120,203909,14.054924907,4.7640462765,-5.416384563,-13,11.608656331,9.2908786305,6.1922717681
51,13,2008,2929,1039,1750,4076,2403,1890,4153,6060,209969,14.153929419,5.0208032319,8.4565983212,17,11.612117581,9.1331261869,20.068715902
51,15,2001,654,516,184,1943,33,138,217,289,66063,9.9213422636,7.8278480245,2.7913256521,-66,0.5006181876,2.0934942391,3.2919438397
51,15,2002,687,559,312,1863,31,128,343,415,66478,10.366603542,8.4351257347,4.7079771542,-56,0.4677797814,1.9314778069,5.1757569356
51,15,2003,719,506,499,1980,22,213,521,678,67156,10.760734544,7.5729230585,7.4681593008,-56,0.3292575243,3.1878114851,7.7974168251
51,15,2004,752,633,883,1933,29,119,912,960,68116,11.118339346,9.3589212845,13.055177716,-71,0.4287657461,1.7594180614,13.483943462
51,15,2005,732,586,733,1967,26,146,759,842,68958,10.680362432,8.5501262092,10.694953091,-63,0.3793571356,2.1302362228,11.074310227
51,15,2006,762,612,968,1939,28,150,996,1111,70069,10.961899487,8.8040452574,13.925352629,-35,0.4027994562,2.1578542298,14.328152086
51,15,2007,842,612,496,1934,26,230,522,754,70823,11.952417455,8.6875053232,7.0408539875,2,0.3690770235,3.2649121313,7.409931011
51,15,2008,815,595,200,1934,26,220,226,427,71250,11.472975161,8.3759757308,2.8154540272,-19,0.3660090235,3.0969994299,3.1814630507
51,17,2001,44,66,-5,229,1,-22,-4,-31,5001,8.7710555168,13.156583275,-0.996710854,-5,0.1993421708,-4.385527758,-0.797368683
51,17,2002,36,63,26,229,1,-27,27,-4,4997,7.2014402881,12.602520504,5.201040208,-4,0.200040008,-5.401080216,5.401080216
51,17,2003,33,61,-32,229,1,-28,-31,-63,4934,6.6458564092,12.284764878,-6.444466821,-4,0.2013895882,-5.638908468,-6.243077233
51,17,2004,34,57,-42,229,0,-23,-42,-69,4865,6.9394836208,11.633840188,-8.572303296,-4,0,-4.694356567,-8.572303296
51,17,2005,23,58,-41,229,1,-35,-40,-79,4786,4.7663454564,12.019479847,-8.496528857,-4,0.2072324111,-7.25313439,-8.289296446
51,17,2006,28,55,-87,229,0,-27,-87,-116,4670,5.9221658206,11.632825719,-18.40101523,-2,0,-5.710659898,-18.40101523
51,17,2007,26,57,-12,229,1,-31,-11,-45,4625,5.5944055944,12.264658419,-2.582033351,-3,0.2151694459,-6.670252824,-2.366863905
51,17,2008,24,62,-41,229,0,-38,-41,-81,4544,5.235031083,13.523830298,-8.9431781,-2,0,-8.288799215,-8.9431781
51,19,2001,580,410,237,363,27,170,264,374,60978,9.5408859864,6.7444194042,3.8986034117,-60,0.4441446925,2.7964665822,4.3427481042
51,19,2002,576,490,317,283,26,86,343,378,61356,9.416842415,8.0108555267,5.1825330652,-51,0.4250658035,1.4059868884,5.6075988687
51,19,2003,620,487,567,283,24,133,591,684,62040,10.048948102,7.8932866543,9.1899251191,-40,0.3889915394,2.1556614477,9.5789166586
51,19,2004,630,533,938,283,23,97,961,985,63025,10.074761124,8.5235677448,15.000199896,-73,0.3678087395,1.5511933794,15.368008636
51,19,2005,620,472,980,283,24,148,1004,1098,64123,9.7524145091,7.4244187876,15.415106805,-54,0.3775128197,2.3279957215,15.792619624
51,19,2006,679,526,1209,283,23,153,1232,1351,65474,10.478637623,8.1174718551,18.657839302,-34,0.354946488,2.3611657677,19.01278579
51,19,2007,670,529,938,388,22,141,960,1104,66578,10.147517645,8.0119952746,14.206524702,3,0.3332020719,2.13552237,14.539726774
51,19,2008,724,518,47,388,21,206,68,253,66831,10.853840446,7.765593026,0.7046001394,-21,0.3148213389,3.0882474196,1.0194214783
51,21,2001,59,79,57,666,1,-20,58,32,6881,8.5943190095,11.507647487,8.3029861617,-6,0.1456664239,-2.913328478,8.4486525856
51,21,2002,54,59,-53,678,1,-5,-52,-61,6820,7.8826363039,8.6125100358,-7.736661558,-4,0.1459747464,-0.729873732,-7.590686811
51,21,2003,69,74,52,684,1,-5,53,42,6862,10.086244701,10.817131998,7.6012278907,-6,0.1461774594,-0.730887297,7.7474053501
51,21,2004,46,79,18,671,0,-33,18,-20,6842,6.7133683596,11.529480444,2.6269702277,-5,0,-4.816112084,2.6269702277
51,21,2005,64,80,-40,669,1,-16,-39,-61,6781,9.3958746238,11.74484328,-5.87242164,-6,0.146810541,-2.348968656,-5.725611099
51,21,2006,47,83,4,657,0,-36,4,-35,6746,6.9490648333,12.271752791,0.591409773,-3,0,-5.322687957,0.591409773
51,21,2007,59,88,160,677,1,-29,161,129,6875,8.6630937523,12.92122458,23.493135599,-3,0.1468320975,-4.258130827,23.639967697
51,21,2008,63,76,56,677,0,-13,56,43,6918,9.135068513,11.020082651,8.1200609005,0,0,-1.885014138,8.1200609005
51,23,2001,281,255,103,609,2,26,105,102,30666,9.1785072677,8.3292503675,3.3643638739,-29,0.0653274539,0.8492569002,3.4296913278
51,23,2002,270,242,379,617,1,28,380,390,31056,8.7489063867,7.841612391,12.280872298,-18,0.032403357,0.9072939957,12.313275655
51,23,2003,306,238,205,626,0,68,205,247,31303,9.8141407014,7.6332205456,6.5748328228,-26,0,2.1809201559,6.5748328228
51,23,2004,296,252,208,625,3,44,211,224,31527,9.4222505173,8.0216457106,6.621040904,-31,0.0954957823,1.4006048066,6.7165366863
51,23,2005,244,265,19,515,1,-21,20,-22,31505,7.7420992512,8.4084274654,0.6028683843,-21,0.031729915,-0.666328214,0.6345982993
51,23,2006,296,290,365,611,2,6,367,357,31862,9.3424021967,9.1530291792,11.520191898,-16,0.0631243392,0.1893730175,11.583316237
51,23,2007,267,268,144,649,2,-1,146,119,31981,8.3642685964,8.3955954451,4.5110662093,-26,0.0626536974,-0.031326849,4.5737199066
51,23,2008,299,246,281,649,1,53,282,280,32261,9.3085520376,7.6585411413,8.7481709785,-55,0.0311322811,1.6500108963,8.7793032595
51,25,2001,197,194,-71,2906,14,3,-57,-73,18344,10.717880362,10.55466391,-3.862789369,-19,0.761676777,0.1632164522,-3.101112592
51,25,2002,172,208,-43,3023,14,-36,-29,-87,18257,9.3986503101,11.365809677,-2.349662578,-22,0.7650064206,-1.967159367,-1.584656157
51,25,2003,176,227,-146,2947,7,-51,-139,-212,18045,9.6964354581,12.506198006,-8.04363396,-22,0.385653683,-2.809762548,-7.657980277
51,25,2004,176,216,-90,2937,10,-40,-80,-132,17913,9.7891985094,12.014016352,-5.005840147,-12,0.5562044608,-2.224817843,-4.449635686
51,25,2005,174,183,54,3137,9,-9,63,42,17955,9.7022415524,10.204081633,3.0110404818,-12,0.5018400803,-0.50184008,3.5128805621
51,25,2006,176,182,10,3123,11,-6,21,6,17961,9.8006459517,10.134758882,0.5568548836,-9,0.612540372,-0.33411293,1.1693952556
51,25,2007,172,218,-231,2999,8,-46,-223,-276,17685,9.6504516636,12.231386411,-12.96078101,-7,0.4488582169,-2.580934747,-12.5119228
51,25,2008,196,220,-69,2999,8,-24,-61,-105,17580,11.115837232,12.476960159,-3.913228413,-20,0.4537076421,-1.361122926,-3.459520771
51,27,2001,260,285,-460,1244,7,-25,-453,-495,26321,9.7860248038,10.726988727,-17.31373619,-17,0.2634698986,-0.940963923,-17.05026629
51,27,2002,242,330,-269,1309,7,-88,-262,-370,25951,9.2592592593,12.626262626,-10.29231711,-20,0.2678298133,-3.367003367,-10.0244873
51,27,2003,229,304,-457,1314,5,-75,-452,-536,25415,8.9164038469,11.836623447,-17.79387143,-9,0.1946813067,-2.920219601,-17.59919013
51,27,2004,249,319,-365,1318,4,-70,-361,-455,24960,9.8858560794,12.665012407,-14.49131514,-24,0.158808933,-2.779156328,-14.3325062
51,27,2005,220,305,-396,1248,5,-85,-391,-494,24466,8.9021972241,12.341682515,-16.023955,-18,0.2023226642,-3.439485291,-15.82163234
51,27,2006,238,285,-258,1250,4,-47,-254,-310,24156,9.7898070832,11.723088314,-10.61247995,-9,0.1645345728,-1.933281231,-10.44794537
51,27,2007,213,305,-214,1242,5,-92,-209,-304,23852,8.8735210798,12.706215631,-8.915180803,-3,0.2082986169,-3.832694551,-8.706882186
51,27,2008,234,295,-262,1242,4,-61,-258,-331,23521,9.8790450256,12.454351635,-11.06115298,-12,0.1688725645,-2.575306609,-10.89228041
51,29,2001,100,155,174,2245,6,-55,180,115,15728,6.3814173128,9.8911968348,11.103666124,-10,0.3828850388,-3.509779522,11.486551163
51,29,2002,158,164,-32,2248,5,-6,-27,-48,15680,10.061130922,10.443199185,-2.037697402,-15,0.3183902191,-0.382068263,-1.719307183
51,29,2003,139,156,67,2287,2,-17,69,35,15715,8.8549132027,9.9378881988,4.2681955725,-17,0.1274088231,-1.082974996,4.3956043956
51,29,2004,170,195,24,2287,5,-25,29,-7,15708,10.820099927,12.411291093,1.5275435191,-11,0.3182382331,-1.591191166,1.8457817522
51,29,2005,144,193,176,2286,3,-49,179,117,15825,9.1332889354,12.241144198,11.162908699,-13,0.1902768528,-3.107855263,11.353185552
51,29,2006,150,176,78,2275,4,-26,82,49,15874,9.464020947,11.104451245,4.9212908925,-7,0.2523738919,-1.640430297,5.1736647844
51,29,2007,162,157,92,2341,4,5,96,103,15977,10.172365075,9.8584031899,5.7768986845,2,0.251169508,0.313961885,6.0280681925
51,29,2008,163,171,4,2341,3,-8,7,0,15977,10.202165613,10.702885398,0.2503598923,1,0.1877699193,-0.500719785,0.4381298116
51,31,2001,679,431,-110,508,21,248,-89,104,51249,13.262495849,8.4184620193,-2.148563392,-55,0.410180284,4.8440338301,-1.738383108
51,31,2002,580,460,64,501,19,120,83,154,51403,11.30031563,8.9623192924,1.2469313798,-49,0.3701827534,2.3379963371,1.6171141332
51,31,2003,577,424,-91,503,13,153,-78,-3,51400,11.225353346,8.248786514,-1.770376351,-78,0.2529109073,2.9765668317,-1.517465444
51,31,2004,576,504,-27,510,19,72,-8,32,51432,11.202738447,9.8023961413,-0.525128365,-32,0.3695347752,1.4003423059,-0.15559359
51,31,2005,566,429,398,512,18,137,416,506,51938,10.950952888,8.3002805456,7.7004933733,-47,0.3482635194,2.6506723421,8.0487568927
51,31,2006,563,475,387,529,24,88,411,474,52412,10.790608529,9.1039770005,7.417345472,-25,0.4599904169,1.6866315285,7.8773358888
51,31,2007,555,466,103,479,21,89,124,210,52622,10.56800655,8.8733172116,1.9612696841,-3,0.3998705181,1.6946893387,2.3611402022
51,31,2008,612,473,251,479,21,139,272,408,53030,11.585204255,8.953924204,4.7514481505,-3,0.3975315186,2.6312800515,5.1489796691
51,33,2001,253,224,-17,604,10,29,-7,-2,22132,11.430895044,10.120634347,-0.768083857,-24,0.4518140333,1.3102606967,-0.316269823
51,33,2002,274,238,330,572,7,36,337,357,22489,12.281212882,10.667622868,14.791241792,-16,0.3137536138,1.6135900137,15.104995406
51,33,2003,290,220,463,599,-4,70,459,535,23024,12.743611715,9.6675675082,20.345835256,6,-0.175773955,3.0760442071,20.170061301
51,33,2004,312,229,672,574,10,83,682,727,23751,13.340459647,9.791555318,28.733297702,-38,0.4275788348,3.5489043292,29.160876537
51,33,2005,361,214,1362,571,4,147,1366,1491,25242,14.736799135,8.7359418692,55.59977956,-22,0.1632886331,6.0008572653,55.763068193
51,33,2006,376,225,1034,565,9,151,1043,1180,26422,14.555589966,8.7101269743,40.027872406,-14,0.348405079,5.8454629916,40.376277485
51,33,2007,391,248,637,574,6,143,643,801,27223,14.577313822,9.2459688694,23.748718427,15,0.2236927952,5.3313449529,23.972411222
51,33,2008,415,248,222,574,6,167,228,409,27632,15.13079938,9.0420198706,8.0940661745,14,0.2187585453,6.0887795096,8.3128247197
51,35,2001,263,316,148,509,12,-53,160,80,29364,8.9687627882,10.77615605,5.0470604283,-27,0.4092211158,-1.807393261,5.4562815441
51,35,2002,291,299,-121,509,12,-8,-109,-142,29222,9.9341139521,10.207216741,-4.130679685,-25,0.4096541836,-0.273102789,-3.721025501
51,35,2003,283,307,-18,509,11,-24,-7,-70,29152,9.6960975777,10.518381471,-0.61671292,-39,0.3768801179,-0.822283894,-0.239832802
51,35,2004,289,358,175,509,10,-69,185,91,29243,9.8981077147,12.261323743,5.9936638411,-25,0.3424950766,-2.363216029,6.3361589177
51,35,2005,294,356,-54,509,11,-62,-43,-131,29112,10.07625739,12.201182418,-1.850741153,-26,0.3770028275,-2.124925028,-1.473738326
51,35,2006,284,319,91,509,10,-35,101,52,29164,9.746722493,10.947903082,3.1230695312,-14,0.343194454,-1.201180589,3.4662639852
51,35,2007,304,349,-3,509,11,-45,8,-40,29124,10.430963492,11.975020587,-0.10293714,-3,0.377436179,-1.544057096,0.2744990393
51,35,2008,291,334,82,509,10,-43,92,34,29158,9.985930476,11.461514704,2.8139048077,-15,0.3431591229,-1.475584228,3.1570639305
51,36,2001,69,61,18,0,2,8,20,21,6947,9.9473798025,8.7940604051,2.5949686441,-7,0.2883298493,1.1533193974,2.8832984935
51,36,2002,75,63,68,0,1,12,69,76,7023,10.737294202,9.0193271296,9.735146743,-5,0.1431639227,1.7179670723,9.8783106657
51,36,2003,75,71,58,0,1,4,59,56,7079,10.636789108,10.069493689,8.2257835768,-7,0.1418238548,0.5672954191,8.3676074316
51,36,2004,55,64,-31,0,2,-9,-29,-42,7037,7.7925758005,9.0677245679,-4.392179088,-4,0.2833663927,-1.275148767,-4.108812695
51,36,2005,75,77,10,0,2,-2,12,4,7041,10.654922574,10.939053843,1.4206563432,-6,0.2841312686,-0.284131269,1.7047876119
51,36,2006,72,68,72,0,2,4,74,75,7116,10.171646535,9.6065550611,10.171646535,-3,0.2825457371,0.5650914742,10.454192272
51,36,2007,70,45,-10,0,1,25,-9,14,7130,9.8273199495,6.3175628247,-1.40390285,-2,0.140390285,3.5097571248,-1.263512565
51,36,2008,73,69,73,0,0,4,73,82,7212,10.179891229,9.6220889695,10.179891229,5,0,0.5578022591,10.179891229
51,37,2001,163,177,-21,241,5,-14,-16,-43,12422,13.099208422,14.224293808,-1.687628079,-13,0.4018162093,-1.125085386,-1.28581187
51,37,2002,144,167,74,268,5,-23,79,47,12469,11.57044715,13.41850468,5.9459242296,-9,0.4017516371,-1.848057531,6.3476758668
51,37,2003,127,141,-172,268,5,-14,-167,-192,12277,10.264285137,11.395781136,-13.90123656,-11,0.4041057141,-1.131495999,-13.49713085
51,37,2004,156,163,8,264,4,-7,12,-5,12272,12.709275327,13.279563322,0.6517577091,-10,0.3258788545,-0.570287995,0.9776365636
51,37,2005,135,151,61,267,5,-16,66,41,12313,10.982306284,12.283912955,4.9623754322,-9,0.4067520846,-1.301606671,5.3691275168
51,37,2006,136,151,75,286,4,-15,79,58,12371,11.019283747,12.234645924,6.0768108896,-6,0.3240965808,-1.215362178,6.4009074704
51,37,2007,132,166,-70,274,5,-34,-65,-97,12274,10.71211199,13.471292351,-5.680665449,2,0.4057618178,-2.759180361,-5.274903632
51,37,2008,146,157,-16,274,4,-11,-12,-26,12248,11.907674741,12.804828317,-1.304950657,-3,0.3262376641,-0.897153576,-0.978712992
51,41,2001,3303,1461,1509,4129,503,1842,2012,3608,264469,12.574952887,5.5622180344,5.7449603107,-246,1.9149867702,7.0127348524,7.6599470809
51,41,2002,3375,1505,2673,4475,442,1870,3115,4797,269266,12.646725435,5.6395027495,10.016206544,-188,1.6562526347,7.0072226854,11.672459179
51,41,2003,3438,1539,2606,4323,325,1899,2931,4643,273909,12.658903668,5.6666820086,9.5954342523,-187,1.1966677406,6.9922216597,10.792101993
51,41,2004,3579,1689,3304,3922,428,1890,3732,5334,279243,12.940385283,6.1068205484,11.946083536,-288,1.5474950827,6.8335647345,13.493578619
51,41,2005,3673,1722,4562,4738,398,1951,4960,6648,285891,12.998687037,6.0941298878,16.144843524,-263,1.4085155025,6.9045571493,17.553359026
51,41,2006,3845,1727,5079,4546,425,2118,5504,7470,293361,13.275741819,5.9628624502,17.536409024,-152,1.4674096939,7.3128793686,19.003818718
51,41,2007,3983,1679,2967,4567,367,2304,3334,5661,299022,13.447381171,5.6686299235,10.017167947,23,1.2390632412,7.7787512471,11.256231188
51,41,2008,4139,1662,1629,4567,377,2477,2006,4447,303469,13.739624326,5.5170948612,5.4075496563,-36,1.2514709763,8.2225294652,6.6590206327
51,43,2001,117,116,249,364,11,1,260,253,12954,9.1210290392,9.043071526,19.411420776,-8,0.8575326447,0.0779575132,20.26895342
51,43,2002,125,132,137,327,10,-7,147,132,13086,9.6006144393,10.138248848,10.522273425,-8,0.7680491551,-0.537634409,11.290322581
51,43,2003,112,124,203,304,8,-12,211,191,13277,8.4967568183,9.4071236202,15.400371733,-8,0.6069112013,-0.910366802,16.007282934
51,43,2004,128,145,392,333,11,-17,403,366,13643,9.5096582467,10.772659733,29.12332838,-20,0.8172362556,-1.263001486,29.940564636
51,43,2005,138,135,358,363,9,3,367,356,13999,9.9848057304,9.7677447363,25.902611967,-14,0.6511829824,0.2170609941,26.55379495
51,43,2006,134,126,227,281,10,8,237,239,14238,9.4910932464,8.9244608138,16.078195276,-6,0.7082905408,0.5666324326,16.786485816
51,43,2007,142,125,75,268,10,17,85,103,14341,9.9373665979,8.7476818643,5.2486091186,1,0.6998145491,1.1896847335,5.9484236677
51,43,2008,144,139,103,268,9,5,112,117,14458,10.000347234,9.6531129553,7.1530261467,0,0.6250217021,0.347234279,7.7780478489
51,45,2001,60,39,-48,42,1,21,-47,-31,5061,11.819166749,7.6824583867,-9.455333399,-5,0.1969861125,4.1367083621,-9.258347287
51,45,2002,49,58,2,42,1,-9,3,-10,5051,9.6914556962,11.471518987,0.3955696203,-4,0.1977848101,-1.780063291,0.5933544304
51,45,2003,54,60,25,42,1,-6,26,14,5065,10.676156584,11.862396204,4.942665085,-6,0.1977066034,-1.18623962,5.1403716884
51,45,2004,48,42,27,42,0,6,27,29,5094,9.449748991,8.2685303672,5.3154838075,-4,0,1.1812186239,5.3154838075
51,45,2005,48,53,-13,42,1,-5,-12,-21,5073,9.4423133668,10.425887676,-2.557293204,-4,0.1967148618,-0.983574309,-2.360578342
51,45,2006,40,53,31,42,0,-13,31,15,5088,7.8732408228,10.43204409,6.1017616376,-3,0,-2.558803267,6.1017616376
51,45,2007,53,44,34,42,1,9,35,44,5132,10.371819961,8.6105675147,6.6536203523,0,0.1956947162,1.7612524462,6.8493150685
51,45,2008,49,61,-35,42,0,-12,-35,-45,5087,9.58997945,11.938545846,-6.849985321,2,0,-2.348566396,-6.849985321
51,47,2001,472,327,653,1687,72,145,725,843,35317,13.526099354,9.3708357811,18.713014572,-27,2.0633032913,4.1552635727,20.776317863
51,47,2002,507,333,1086,1716,69,174,1155,1327,36644,14.09096594,9.2550131321,30.1830158,-2,1.9177054238,4.8359528078,32.100721224
51,47,2003,503,302,1188,1676,59,201,1247,1484,38128,13.454234205,8.0778901193,31.776600867,36,1.5781308511,5.376344086,33.354731718
51,47,2004,557,298,1310,1664,56,259,1366,1559,39687,14.316005911,7.6591916726,33.669600977,-66,1.4393111868,6.6568142389,35.108912163
51,47,2005,561,349,1964,1675,59,212,2023,2206,41893,13.753370924,8.556018632,48.149056141,-29,1.4464329493,5.1973522922,49.59548909
51,47,2006,627,342,1888,1743,58,285,1946,2204,44097,14.583091057,7.9544133039,43.9120828,-27,1.3489940691,6.6286777532,45.261076869
51,47,2007,696,348,1108,1733,51,348,1159,1497,45594,15.519951835,7.7599759173,24.70704976,-10,1.13723785,7.7599759173,25.84428761
51,47,2008,695,339,223,1733,50,356,273,609,46203,15.142107041,7.3858622831,4.8585465756,-20,1.0893602187,7.7562447575,5.9479067943
51,49,2001,89,78,-22,36,10,11,-12,-12,8986,9.8976868327,8.6743772242,-2.446619217,-11,1.1120996441,1.2233096085,-1.334519573
51,49,2002,110,68,19,36,10,42,29,62,9048,12.199179328,7.5413108573,2.1071309748,-9,1.1090163025,4.6578684707,3.2161472774
51,49,2003,101,93,80,36,10,8,90,90,9138,11.107445288,10.227647641,8.7979764654,-8,1.0997470582,0.8797976465,9.8977235236
51,49,2004,97,82,-39,36,9,15,-30,-20,9118,10.626643295,8.9833479404,-4.272567923,-5,0.985977213,1.643295355,-3.28659071
51,49,2005,105,84,188,36,10,21,198,212,9330,11.383347788,9.1066782307,20.381613183,-7,1.0841283608,2.2766695577,21.465741544
51,49,2006,116,90,77,36,9,26,86,107,9437,12.362125007,9.5913038845,8.2058933234,-5,0.9591303884,2.7708211222,9.1650237118
51,49,2007,117,55,87,36,8,62,95,150,9587,12.300252313,5.7821698907,9.1463414634,-7,0.8410428932,6.5180824222,9.9873843566
51,49,2008,117,74,36,36,7,43,43,83,9670,12.151425456,7.6855169549,3.7389001402,-3,0.7270083606,4.4659085008,4.4659085008
51,51,2001,147,173,-61,151,2,-26,-59,-104,16240,9.0228332924,10.618708569,-3.744168917,-19,0.1227596366,-1.595875276,-3.621409281
51,51,2002,154,218,-26,137,2,-64,-24,-103,16137,9.5129258424,13.466349569,-1.606078389,-15,0.1235444915,-3.953423727,-1.482533898
51,51,2003,181,214,2,137,2,-33,4,-53,16084,11.23490891,13.283262469,0.1241426399,-24,0.1241426399,-2.048353558,0.2482852798
51,51,2004,177,197,33,137,1,-20,34,3,16087,11.003698984,12.247054801,2.0515370986,-11,0.0621677909,-1.243355817,2.1137048895
51,51,2005,146,187,151,224,2,-41,153,100,16187,9.0475305199,11.588275392,9.3573774555,-12,0.1239387742,-2.540744872,9.4813162298
51,51,2006,185,187,-14,249,1,-2,-13,-24,16163,11.4374034,11.561051005,-0.86553323,-9,0.0618238022,-0.123647604,-0.803709428
51,51,2007,190,212,98,302,1,-22,99,65,16228,11.731653854,13.09005588,6.051063567,-12,0.0617455466,-1.358402025,6.1128091136
51,51,2008,175,225,240,302,0,-50,240,177,16405,10.72533938,13.78972206,14.709036865,-13,0,-3.06438268,14.709036865
51,53,2001,242,192,-224,890,6,50,-218,-195,24435,9.8644655049,7.8263527973,-9.13074493,-27,0.2445735249,2.0381127076,-8.886171405
51,53,2002,218,210,221,861,2,8,223,212,24647,8.8830935985,8.5571085123,9.0053380058,-19,0.0814962715,0.3259850862,9.0868342773
51,53,2003,259,234,196,836,-7,25,189,198,24845,10.466337994,9.4560737089,7.9204719955,-16,-0.282874,1.0102642851,7.6375979956
51,53,2004,258,249,175,821,10,9,185,171,25016,10.348769579,9.9877659895,7.0195142496,-23,0.4011151,0.36100359,7.4206293496
51,53,2005,272,247,146,773,4,25,150,155,25171,10.839460418,9.8431864826,5.8182397832,-20,0.1594038297,0.9962739355,5.9776436129
51,53,2006,274,239,188,755,8,35,196,219,25390,10.838393228,9.4539269397,7.4365617769,-12,0.3164494373,1.3844662882,7.7530112142
51,53,2007,284,231,265,743,3,53,268,305,25695,11.118723696,9.0437506117,10.37486542,-16,0.1174513066,2.0749730841,10.492316727
51,53,2008,300,243,355,743,4,57,359,387,26082,11.588156904,9.386407092,13.712652336,-29,0.1545087587,2.2017498117,13.867161095
51,57,2001,120,129,35,160,4,-9,39,20,10008,12.00240048,12.902580516,3.50070014,-10,0.400080016,-0.900180036,3.900780156
51,57,2002,108,123,108,160,4,-15,112,89,10097,10.74359612,12.235762248,10.74359612,-8,0.3979109674,-1.492166128,11.141507088
51,57,2003,112,144,167,160,0,-32,167,128,10225,11.022537152,14.171833481,16.435390217,-7,0,-3.149296329,16.435390217
51,57,2004,120,115,42,160,4,5,46,43,10268,11.711316059,11.223344557,4.0989606207,-8,0.390377202,0.4879715025,4.4893378227
51,57,2005,133,141,222,160,2,-8,224,210,10478,12.821748771,13.59298178,21.401715993,-6,0.1928082522,-0.771233009,21.594524246
51,57,2006,129,118,129,160,4,11,133,138,10616,12.230966152,11.188015549,12.230966152,-6,0.3792547644,1.0429506021,12.610220916
51,57,2007,122,120,212,160,2,2,214,208,10824,11.380597015,11.194029851,19.776119403,-8,0.1865671642,0.1865671642,19.962686567
51,57,2008,143,140,279,160,2,3,281,267,11091,13.050422085,12.776637007,25.46201232,-17,0.1825233858,0.2737850787,25.644535706
51,59,2001,14714,4190,-10910,6679,10925,10524,15,9749,984667,15.017465433,4.2764156696,-11.13501073,-790,11.150320093,10.741049763,0.015309364
51,59,2002,14598,4327,-14680,6912,9655,10271,-5025,4648,989315,14.790408423,4.3840318706,-14.87348922,-598,9.7822573863,10.406376553,-5.091231835
51,59,2003,14518,4225,-14360,7399,7228,10293,-7132,2548,991863,14.655926928,4.2651392252,-14.49642586,-613,7.2966689515,10.390787703,-7.199756912
51,59,2004,14942,4406,-14782,7781,9065,10536,-5717,3786,995649,15.03588406,4.4336839224,-14.87487874,-1033,9.1219575026,10.602200138,-5.75292124
51,59,2005,15183,4280,-13737,7894,8513,10903,-5224,4847,1000496,15.21232175,4.288265632,-13.7635292,-832,8.5294404966,10.924056118,-5.234088706
51,59,2006,14836,4271,-21190,7886,9033,10565,-12157,-2008,998488,14.843540519,4.2731707708,-21.20076999,-416,9.0375910963,10.570369748,-12.16317889
51,59,2007,14306,4481,-11839,8051,7776,9825,-4063,5663,1004151,14.287148108,4.475095112,-11.82339902,-99,7.7657530888,9.8120529961,-4.057645936
51,59,2008,13631,4518,-5437,8051,7969,9113,2532,11151,1015302,13.499695214,4.4744789802,-5.384626431,-494,7.8922361649,9.0252162343,2.5076097339
51,61,2001,684,415,1377,581,75,269,1452,1692,57280,12.120352979,7.353722933,24.400184286,-29,1.3289860722,4.7666300457,25.729170358
51,61,2002,723,404,1545,568,66,319,1611,1915,59195,12.414681262,6.937110968,26.529298133,-15,1.1332904057,5.4775702941,27.662588538
51,61,2003,724,438,1264,568,48,286,1312,1602,60797,12.067471165,7.3004866991,21.068071205,4,0.8000533369,4.7669844656,21.868124542
51,61,2004,740,492,1539,568,64,248,1603,1764,62561,11.99760048,7.9767830218,24.951766403,-87,1.0376303118,4.0208174581,25.989396715
51,61,2005,775,479,1369,568,58,296,1427,1664,64225,12.225324563,7.5560393103,21.595444292,-59,0.9149275157,4.6692852523,22.510371808
51,61,2006,821,452,890,585,61,369,951,1287,65512,12.656374049,6.9679428382,13.720064438,-33,0.9403639671,5.6884312108,14.660428405
51,61,2007,798,459,218,587,54,339,272,610,66122,12.124527098,6.9738821277,3.3122141696,-1,0.8204567209,5.1506449701,4.1326708905
51,61,2008,849,463,275,587,55,386,330,717,66839,12.770662074,6.9644482217,4.1365513196,1,0.8273102639,5.8062138522,4.9638615835
51,63,2001,163,135,123,55,18,28,141,159,14100,11.625833601,9.6287578902,8.7728683,-10,1.2838343854,1.9970757106,10.056702685
51,63,2002,138,150,69,55,18,-12,87,63,14163,9.7654176839,10.614584439,4.8827088419,-12,1.2737501327,-0.849166755,6.1564589746
51,63,2003,149,169,76,55,12,-20,88,55,14218,10.499982383,11.909375991,5.3556957119,-13,0.845636165,-1.409393608,6.201331877
51,63,2004,180,143,46,55,11,37,57,82,14300,12.623606143,10.02875377,3.2260326811,-12,0.7714425977,2.5948523739,3.9974752788
51,63,2005,154,163,196,55,12,-9,208,185,14485,10.70001737,11.325343061,13.618203926,-14,0.8337675873,-0.62532569,14.451971513
51,63,2006,143,129,93,55,11,14,104,111,14596,9.8345999106,8.8717719473,6.3959286132,-7,0.7565076854,0.9628279633,7.1524362986
51,63,2007,176,148,-28,55,6,28,-22,3,14599,12.056859051,10.138722384,-1.918136667,-3,0.4110292858,1.9181366672,-1.507107381
51,63,2008,162,147,201,55,5,15,206,222,14821,11.012916383,9.9932019035,13.664174031,1,0.3399048266,1.0197144799,14.004078858
51,65,2001,241,170,883,1160,6,71,889,960,21175,11.645324958,8.214544576,42.667310945,0,0.2899251027,3.4307803817,42.957236047
51,65,2002,248,145,780,1206,5,103,785,894,22069,11.469799279,6.7061326427,36.074368699,6,0.2312459532,4.7636666358,36.305614652
51,65,2003,308,166,719,1214,0,142,719,887,22956,13.681288173,7.3736812882,31.937812326,26,0,6.3076068851,31.937812326
51,65,2004,344,164,476,1192,7,180,483,632,23588,14.781711928,7.0470952217,20.45376418,-31,0.3007906497,7.7346167068,20.75455483
51,65,2005,342,141,685,1212,4,201,689,872,24460,14.235764236,5.8691308691,28.513153513,-18,0.1665001665,8.3666333666,28.67965368
51,65,2006,359,205,180,1223,6,154,186,328,24788,14.579272255,8.3252111761,7.3099415205,-12,0.2436647173,6.2540610786,7.5536062378
51,65,2007,335,160,295,1207,3,175,298,466,25254,13.388753447,6.394628512,11.790096319,-7,0.1198992846,6.9941249351,11.909995604
51,65,2008,362,181,125,1207,3,181,128,290,25544,14.252529627,7.1262648136,4.9214536005,-19,0.1181148864,7.1262648136,5.0395684869
51,67,2001,535,435,378,1051,8,100,386,449,47882,11.225935057,9.1276294392,7.9315952368,-37,0.1678644495,2.0983056182,8.0994596863
51,67,2002,551,451,317,1072,6,100,323,385,48267,11.461377653,9.3812728161,6.5939323342,-38,0.1248062902,2.0801048373,6.7187386244
51,67,2003,502,430,369,1059,2,72,371,402,48669,10.357349179,8.871832962,7.6132706115,-41,0.0412643394,1.4855162169,7.6545349509
51,67,2004,514,447,523,1010,11,67,534,551,49220,10.50169069,9.1327932658,10.685572434,-50,0.2247443533,1.3688974246,10.910316787
51,67,2005,529,515,558,1101,8,14,566,535,49755,10.689568073,10.406668351,11.27557464,-45,0.1616569841,0.2828997222,11.437231624
51,67,2006,579,489,510,1221,10,90,520,585,50340,11.569009441,9.7707178181,10.190319197,-25,0.1998101803,1.798291623,10.390129377
51,67,2007,574,493,841,1404,6,81,847,932,51272,11.297878203,9.7035783175,16.553163012,4,0.1180962878,1.5942998858,16.6712593
51,67,2008,597,473,101,1404,6,124,107,205,51477,11.620551052,9.206902257,1.965955873,-26,0.1167894578,2.4136487946,2.0827453309
51,69,2001,793,440,1137,841,46,353,1183,1502,61082,13.144154746,7.2930997331,18.846032719,-34,0.7624604266,5.8510550132,19.608493146
51,69,2002,757,422,1350,830,42,335,1392,1705,62787,12.222589994,6.8136499043,21.797221258,-22,0.6781357725,5.4089400899,22.47535703
51,69,2003,809,419,1334,877,30,390,1364,1762,64549,12.706540177,6.5810140102,20.952440787,8,0.4711943205,6.125526167,21.423635107
51,69,2004,896,473,1404,923,41,423,1445,1782,66331,13.69193154,7.22799511,21.454767726,-86,0.6265281174,6.4639364303,22.081295844
51,69,2005,895,514,1802,901,39,381,1841,2161,68492,13.276666444,7.6248117903,26.731344059,-61,0.5785363032,5.6518546539,27.309880362
51,69,2006,946,496,1743,966,45,450,1788,2201,70693,13.593418831,7.1272047994,25.045802349,-37,0.6466214032,6.4662140317,25.692423753
51,69,2007,1044,476,1367,1033,36,568,1403,1994,72687,14.562700516,6.6396987027,19.06821035,23,0.5021620868,7.9230018134,19.570372437
51,69,2008,1094,474,553,1033,36,620,589,1211,73898,14.926493161,6.467237439,7.5451103455,2,0.4911825903,8.4592557219,8.0362929358
51,71,2001,223,181,45,95,1,42,46,73,16794,13.307474265,10.801133821,2.685364762,-15,0.0596747725,2.5063404446,2.7450395345
51,71,2002,205,200,25,95,0,5,25,13,16807,12.202017797,11.904407607,1.4880509509,-17,0,0.2976101902,1.4880509509
51,71,2003,204,230,66,95,-1,-26,65,20,16827,12.130582149,13.676636737,3.924600107,-19,-0.059463638,-1.546054588,3.865136469
51,71,2004,188,230,31,95,0,-42,31,-22,16805,11.179828735,13.677450048,1.8434823977,-11,0,-2.497621313,1.8434823977
51,71,2005,177,225,244,95,0,-48,244,184,16989,10.47523229,13.31597325,14.440433213,-12,0,-2.84074096,14.440433213
51,71,2006,151,198,247,95,0,-47,247,190,17179,8.8386794662,11.589791618,14.457972372,-10,0,-2.751112152,14.457972372
51,71,2007,193,216,54,95,0,-23,54,24,17203,11.226804723,12.564714095,3.1411785236,-7,0,-1.337909371,3.1411785236
51,71,2008,183,213,82,95,-1,-30,81,46,17249,10.623476141,12.365029606,4.7602461396,-5,-0.058051782,-1.741553466,4.7021943574
51,73,2001,393,310,254,357,2,83,256,307,35170,11.223280454,8.8529693145,7.2537232448,-32,0.0571159311,2.370311139,7.3108391758
51,73,2002,438,303,403,341,-24,135,379,477,35647,12.36991118,8.5572673228,11.381447957,-37,-0.677803352,3.8126438567,10.703644605
51,73,2003,370,280,635,358,-74,90,561,638,36285,10.287493744,7.7851304009,17.655563588,-13,-2.057498749,2.5023633432,15.598064839
51,73,2004,441,306,297,343,36,135,333,437,36722,12.081033326,8.3827578177,8.1362061172,-31,0.9862068021,3.6982755078,9.1224129193
51,73,2005,390,302,472,351,-4,88,468,525,37247,10.544958023,8.1655828793,12.762103043,-31,-0.108153416,2.3793751436,12.653949628
51,73,2006,372,314,343,338,18,58,361,399,37646,9.9341727531,8.3852963561,9.1597345546,-20,0.4806857784,1.548876397,9.640420333
51,73,2007,405,325,482,342,-3,80,479,552,38198,10.679816465,8.5702230895,12.71030009,-7,-0.079109752,2.1095933759,12.631190338
51,73,2008,447,315,324,342,4,132,328,458,38656,11.632445936,8.1973612304,8.4315715513,-2,0.1040934759,3.4350847061,8.5356650272
51,75,2001,206,154,269,1420,13,52,282,320,17256,12.049602246,9.0079550772,15.734674778,-14,0.7604117922,3.0416471689,16.49508657
51,75,2002,196,145,295,1550,13,51,308,352,17608,11.243689766,8.3180357962,16.922900413,-7,0.7457549335,2.9256539697,17.668655346
51,75,2003,177,157,370,1524,13,20,383,400,18008,9.9393530997,8.816262354,20.777178796,-3,0.7300089847,1.1230907457,21.507187781
51,75,2004,188,141,456,1524,12,47,468,489,18497,10.29995891,7.7249691823,24.982879058,-26,0.6574441857,2.5749897274,25.640323243
51,75,2005,190,145,689,1612,13,45,702,730,19227,10.073162973,7.6874138479,36.52846994,-17,0.689216414,2.3857491252,37.217686354
51,75,2006,210,161,695,1619,12,49,707,745,19972,10.714559045,8.2144952677,35.460088268,-11,0.6122605168,2.5000637771,36.072348784
51,75,2007,203,160,514,1590,12,43,526,581,20553,10.018507094,7.8963602714,25.367057372,12,0.5922270204,2.1221468229,25.959284392
51,75,2008,221,167,331,1590,11,54,342,403,20956,10.648293141,8.0464477583,15.948348551,7,0.530005541,2.6018453829,16.478354092
51,77,2001,157,230,-160,127,11,-73,-149,-234,16631,9.3742536422,13.732983043,-9.553379508,-12,0.6567948412,-4.358729401,-8.896584667
51,77,2002,172,182,23,127,11,-10,34,8,16639,10.339645326,10.940787496,1.3826269913,-16,0.6612563871,-0.60114217,2.0438833784
51,77,2003,153,226,-75,127,7,-73,-68,-160,16479,9.239688387,13.64816716,-4.529259013,-19,0.4227308412,-4.408478773,-4.106528172
51,77,2004,137,211,-35,127,5,-74,-30,-115,16364,8.3427214323,12.849008921,-2.131352191,-11,0.3044788844,-4.506287489,-1.826873306
51,77,2005,139,243,-48,127,7,-104,-41,-161,16203,8.5362483496,14.923081647,-2.947769214,-16,0.4298830104,-6.386833298,-2.517886204
51,77,2006,157,221,-39,127,6,-64,-33,-104,16099,9.7207603244,13.683363259,-2.414711163,-7,0.3714940251,-3.962602935,-2.043217138
51,77,2007,157,209,32,127,6,-52,38,-14,16085,9.756400696,12.987820035,1.988565747,0,0.3728560776,-3.231419339,2.3614218245
51,77,2008,152,220,-55,127,5,-68,-50,-116,15969,9.4839957572,13.726835964,-3.431708991,2,0.3119735446,-4.242840207,-3.119735446
51,79,2001,226,123,282,147,7,103,289,380,15744,14.530024431,7.9079336505,18.130384467,-12,0.4500450045,6.6220907805,18.580429472
51,79,2002,231,92,407,147,6,139,413,545,16289,14.422626666,5.7440764212,25.411294602,-7,0.3746136796,8.6785502451,25.785908282
51,79,2003,265,114,236,147,5,151,241,384,16673,16.079121413,6.9170560039,14.319519447,-8,0.3033796493,9.1620654087,14.622899096
51,79,2004,259,118,101,147,3,141,104,232,16905,15.426767526,7.0284114599,6.0158437072,-13,0.1786884269,8.3983560665,6.1945321341
51,79,2005,260,145,164,147,6,115,170,270,17175,15.258215962,8.5093896714,9.6244131455,-15,0.3521126761,6.7488262911,9.9765258216
51,79,2006,279,127,228,147,6,152,234,376,17551,16.068651731,7.3144041928,13.131371307,-10,0.3455624028,8.7542475379,13.47693371
51,79,2007,269,128,132,147,3,141,135,281,17832,15.205041969,7.2351129073,7.4612101857,5,0.1695729588,7.969929062,7.6307831444
51,79,2008,280,118,-37,147,2,162,-35,132,17964,15.644206057,6.5929154095,-2.067270086,5,0.111744329,9.051290647,-1.955525757
51,81,2001,97,103,-28,3071,1,-6,-27,-46,11508,8.4121064955,8.9324429798,-2.428236927,-13,0.0867227474,-0.520336484,-2.341514179
51,81,2002,115,86,1,3111,0,29,1,18,11526,9.9852392116,7.4672223669,0.0868281671,-12,0,2.5180168447,0.0868281671
51,81,2003,125,97,171,3330,0,28,171,198,11724,10.752688172,8.3440860215,14.709677419,-1,0,2.4086021505,14.709677419
51,81,2004,119,80,-484,2887,1,39,-483,-466,11258,10.355930728,6.9619702376,-42.11991994,-22,0.087024628,3.3939604908,-42.03289531
51,81,2005,137,109,573,3370,1,28,574,592,11850,11.857365415,9.4339622642,49.593214471,-10,0.0865501125,2.4234031504,49.679764584
51,81,2006,146,99,-76,3327,1,47,-75,-33,11817,12.337854396,8.366079351,-6.422444754,-5,0.084505852,3.9717750454,-6.337938902
51,81,2007,159,74,19,3327,1,85,20,98,11915,13.399629193,6.2363054104,1.6012135513,-7,0.0842743974,7.1633237822,1.6854879488
51,81,2008,160,106,-18,3327,0,54,-18,40,11955,13.40594889,8.8814411395,-1.50816925,4,0,4.5245077503,-1.50816925
51,83,2001,438,444,-400,909,15,-6,-385,-423,36866,11.813094195,11.974917403,-10.78821388,-32,0.4045580204,-0.161823208,-10.38365586
51,83,2002,450,490,-149,902,12,-40,-137,-208,36658,12.24090093,13.328981013,-4.053098308,-31,0.3264240248,-1.088080083,-3.726674283
51,83,2003,412,473,-323,902,9,-61,-314,-412,36246,11.30253484,12.975968397,-8.860967848,-37,0.2469000329,-1.673433556,-8.614067815
51,83,2004,420,481,-299,891,9,-61,-290,-382,35864,11.648869782,13.340729441,-8.292885869,-31,0.2496186382,-1.691859659,-8.043267231
51,83,2005,396,447,-150,846,10,-51,-140,-222,35642,11.075993623,12.502447347,-4.19545213,-31,0.2796968087,-1.426453724,-3.915755321
51,83,2006,397,491,68,870,10,-94,78,-33,35609,11.143703246,13.782262705,1.9087451404,-17,0.2806978148,-2.638559459,2.1894429552
51,83,2007,408,465,-109,863,8,-57,-101,-158,35451,11.483253589,13.087531663,-3.067830003,0,0.2251618351,-1.604278075,-2.842668168
51,83,2008,425,473,1,863,7,-48,8,-39,35412,11.994976222,13.349702948,0.0282234735,1,0.1975643142,-1.354726726,0.2257877877
51,85,2001,1092,646,1478,2107,47,446,1525,1901,88895,12.416922036,7.3455417906,16.806053818,-70,0.5344279631,5.0713802455,17.340481781
51,85,2002,1067,612,2134,2137,44,455,2178,2590,91485,11.830579887,6.7856746868,23.661159774,-43,0.4878589644,5.0449052001,24.149018738
51,85,2003,1036,642,1657,2203,27,394,1684,2063,93548,11.198002518,6.939302719,17.9103187,-15,0.291839834,4.2586997995,18.202158534
51,85,2004,1171,707,1466,2218,42,464,1508,1866,95414,12.394026312,7.4829859972,15.516347202,-106,0.4445338216,4.911040315,15.960881024
51,85,2005,1099,685,676,2108,36,414,712,1044,96458,11.455553702,7.1401767845,7.0463642428,-82,0.3752501668,4.3153769179,7.4216144096
51,85,2006,1053,729,1222,2107,40,324,1262,1534,97992,10.830547699,7.4980714837,12.568783749,-52,0.4114168167,3.332476215,12.980200566
51,85,2007,1082,733,495,2175,36,349,531,870,98862,10.99291861,7.4471435683,5.0291078667,-10,0.3657532994,3.5457750414,5.3948611661
51,85,2008,1113,748,423,2175,36,365,459,854,99716,11.209700974,7.5335636375,4.2602906666,30,0.3625779291,3.6761373365,4.6228685957
51,87,2001,3736,2376,644,3937,952,1360,1596,2695,265957,14.118918633,8.9792694518,2.4337750534,-261,3.5977544268,5.1396491812,6.0315294802
51,87,2002,3540,2268,256,4036,883,1272,1139,2142,268099,13.257036715,8.4934913193,0.9587009602,-269,3.3067693276,4.763545396,4.2654702878
51,87,2003,3715,2299,1165,4033,761,1416,1926,3005,271104,13.779596924,8.5274006265,4.321192575,-337,2.8226845919,5.2521962971,7.1438771669
51,87,2004,3905,2388,2912,4060,728,1517,3640,4892,275996,14.275269603,8.729665509,10.645220252,-265,2.6613050631,5.5456040943,13.306525315
51,87,2005,4019,2359,2986,4169,756,1660,3742,5173,281169,14.426606122,8.4678685847,10.718548365,-229,2.7137383001,5.9587375374,13.432286666
51,87,2006,4063,2334,1670,4442,772,1729,2442,4018,285187,14.347866007,8.242165705,5.8973507829,-153,2.7262004817,6.1057003016,8.6235512646
51,87,2007,4165,2408,1906,4454,700,1757,2606,4273,289460,14.495855717,8.3807972547,6.6336376941,-90,2.4362782717,6.115058462,9.0699159658
51,87,2008,4164,2459,783,4454,703,1705,1486,3139,292599,14.307827901,8.4493152756,2.6904489064,-52,2.4155626835,5.858512625,5.1060115899
51,89,2001,611,523,-662,493,161,88,-501,-468,57451,10.592008321,9.0664817544,-11.47612031,-55,2.7910201959,1.5255265667,-8.685100113
51,89,2002,606,630,-471,493,149,-24,-322,-389,57062,10.583951167,11.00311755,-8.226140264,-43,2.6023246269,-0.419166383,-5.623815637
51,89,2003,606,578,-598,465,130,28,-468,-491,56571,10.665915711,10.173101124,-10.52511154,-51,2.2880677268,0.4928145873,-8.237043816
51,89,2004,624,656,-366,483,126,-32,-240,-317,56254,11.061378241,11.628628407,-6.487923776,-45,2.2335475294,-0.567250166,-4.254376246
51,89,2005,604,672,-551,461,129,-68,-422,-537,55717,10.788507739,12.003107948,-9.841834046,-47,2.3041680435,-1.214600209,-7.537666003
51,89,2006,666,648,-254,494,128,18,-126,-134,55583,11.967654987,11.644204852,-4.564240791,-26,2.3000898473,0.3234501348,-2.264150943
51,89,2007,663,671,-226,481,114,-8,-112,-122,55461,11.941212492,12.085299521,-4.070458557,-2,2.0532401571,-0.144087029,-2.0172184
51,89,2008,642,646,-243,481,114,-4,-129,-145,55316,11.590853697,11.663070854,-4.387192287,-12,2.0581889742,-0.072217157,-2.329003313
51,91,2001,21,25,3,0,0,-4,3,-4,2529,8.2971157645,9.8775187673,1.1853022521,-3,0,-1.580403003,1.1853022521
51,91,2002,14,39,-58,0,-1,-25,-59,-84,2445,5.6292722155,15.681544029,-23.32127061,0,-0.402090873,-10.05227181,-23.72336148
51,91,2003,18,33,50,0,-1,-15,49,34,2479,7.3111291633,13.403736799,20.30869212,0,-0.406173842,-6.092607636,19.902518278
51,91,2004,11,31,-29,0,0,-20,-29,-52,2427,4.4843049327,12.637586629,-11.82225846,-3,0,-8.153281696,-11.82225846
51,91,2005,14,27,30,0,0,-13,30,15,2442,5.7506674882,11.090573013,12.322858903,-2,0,-5.339905525,12.322858903
51,91,2006,13,28,30,0,0,-15,30,14,2456,5.3082890976,11.433238056,12.249897918,-1,0,-6.124948959,12.249897918
51,91,2007,10,21,-16,0,0,-11,-16,-28,2428,4.095004095,8.5995085995,-6.552006552,-1,0,-4.504504505,-6.552006552
51,91,2008,16,24,7,0,-1,-8,6,-2,2426,6.5925010301,9.8887515451,2.8842192007,0,-0.412031314,-3.296250515,2.4721878863
51,93,2001,324,274,301,180,7,50,308,329,30202,10.786516854,9.1219309197,10.020807324,-29,0.2330420308,1.6645859342,10.253849355
51,93,2002,371,304,395,180,-2,67,393,443,30645,12.194520683,9.9922757079,12.983384555,-17,-0.065738656,2.2022449751,12.917645899
51,93,2003,358,279,725,180,-20,79,705,791,31436,11.533319373,8.9882572768,23.356582529,7,-0.644319518,2.5450620963,22.712263011
51,93,2004,310,308,755,180,18,2,773,729,32165,9.7482743982,9.6853823053,23.741765067,-46,0.566028836,0.0628920929,24.307793903
51,93,2005,363,305,695,180,4,58,699,728,32893,11.159273264,9.3762488856,21.365550739,-29,0.1229671985,1.7830243782,21.488517938
51,93,2006,347,272,1053,180,11,75,1064,1120,34013,10.372761785,8.1308103907,31.476997579,-19,0.3288195379,2.2419513945,31.805817117
51,93,2007,409,310,810,180,3,99,813,934,34947,11.861948956,8.9907192575,23.49187935,22,0.0870069606,2.8712296984,23.578886311
51,93,2008,413,301,404,180,5,112,409,525,35472,11.729788835,8.5488291512,11.474176004,4,0.1420071288,3.1809596842,11.616183132
51,95,2001,465,349,947,1240,57,116,1004,1076,49570,9.4836025453,7.11780062,19.313917442,-44,1.1625061185,2.3658019253,20.47642356
51,95,2002,513,399,1602,1176,39,114,1641,1743,51313,10.170197159,7.910153346,31.759563058,-12,0.7731728834,2.2600438131,32.532735942
51,95,2003,517,447,1689,1212,-4,70,1685,1800,53113,9.9017486067,8.5610863195,32.348265758,45,-0.076609274,1.3406622872,32.271656484
51,95,2004,492,454,2134,1136,65,38,2199,2133,55246,9.0809254423,8.379553152,39.387591248,-104,1.1997157597,0.7013722903,40.587307007
51,95,2005,498,448,1898,1122,40,50,1938,1941,57187,8.8586091272,7.9691905401,33.762329565,-47,0.7115348697,0.8894185871,34.473864435
51,95,2006,555,463,2185,1170,55,92,2240,2297,59484,9.5139323397,7.9368480599,37.455751644,-35,0.9428221237,1.5770842797,38.398573767
51,95,2007,587,445,1407,1231,37,142,1444,1610,61094,9.7364361658,7.3811142995,23.337590605,24,0.6137106271,2.3553218663,23.951301232
51,95,2008,631,502,1136,1231,42,129,1178,1320,62414,10.21796159,8.1290280792,18.395569518,13,0.6801178871,2.0889335104,19.075687405
51,97,2001,73,76,-12,0,-1,-3,-13,-23,6598,11.044708374,11.498600499,-1.8155685,-7,-0.151297375,-0.453892125,-1.966865875
51,97,2002,61,73,-12,0,-1,-12,-13,-32,6566,9.2676997873,11.090853844,-1.823154057,-7,-0.151929505,-1.823154057,-1.975083561
51,97,2003,64,95,0,0,-2,-31,-2,-42,6524,9.7784568373,14.514896868,0,-9,-0.305576776,-4.736440031,-0.305576776
51,97,2004,80,88,187,0,1,-8,188,169,6693,12.105621548,13.316183703,28.296890368,-11,0.1513202694,-1.210562155,28.448210638
51,97,2005,77,79,49,0,-1,-2,48,39,6732,11.47113594,11.769087523,7.2998137803,-7,-0.148975791,-0.297951583,7.1508379888
51,97,2006,72,77,108,0,0,-5,108,99,6831,10.617120106,11.354420114,15.925680159,-4,0,-0.737300007,15.925680159
51,97,2007,79,66,22,0,-1,13,21,33,6864,11.53705732,9.6385542169,3.2128514056,-1,-0.1460387,1.8985031033,3.0668127054
51,97,2008,83,87,-34,0,-1,-4,-35,-34,6830,12.122097269,12.706294728,-4.965678399,5,-0.146049365,-0.584197459,-5.111727764
51,99,2001,212,119,144,355,6,93,150,227,17135,12.45483653,6.991158241,8.459888964,-16,0.3524953735,5.4636782892,8.8123843375
51,99,2002,239,130,530,355,-21,109,509,619,17754,13.70059331,7.4522055662,30.382068847,1,-1.203817822,6.248387744,29.178251025
51,99,2003,276,124,596,355,-78,152,518,687,18441,15.250725238,6.8517751071,32.932725515,17,-4.309987567,8.3989501312,28.622737947
51,99,2004,303,126,582,355,42,177,624,769,19210,16.095190035,6.6930493214,30.915513532,-32,2.2310164405,9.4021407134,33.146529973
51,99,2005,319,134,1193,355,-2,185,1191,1360,20570,16.038210156,6.7370537959,59.979889392,-16,-0.100553042,9.30115636,59.87933635
51,99,2006,332,147,813,355,23,185,836,1007,21577,15.754383467,6.9755854509,38.57925831,-14,1.0914181318,8.7787980165,39.670676442
51,99,2007,342,135,721,355,0,207,721,934,22511,15.514425694,6.1241154056,32.707312647,6,0,9.3903102885,32.707312647
51,99,2008,400,126,369,355,8,274,377,659,23170,17.512751472,5.5165167137,16.155513233,8,0.3502550294,11.996234758,16.505768263
51,101,2001,196,135,184,99,6,61,190,240,13437,14.718029586,10.137418337,13.816925734,-11,0.4505519261,4.5806112488,14.26747766
51,101,2002,181,140,197,99,6,41,203,236,13673,13.353006271,10.328292143,14.533382516,-8,0.4426410918,3.0247141276,14.976023608
51,101,2003,197,127,196,99,2,70,198,263,13936,14.270708827,9.1998985838,14.198268681,-5,0.1448802927,5.070810243,14.343148973
51,101,2004,185,118,156,99,6,67,162,216,14152,13.172885218,8.4021646255,11.107946454,-13,0.4272287098,4.7707205924,11.535175164
51,101,2005,183,122,296,99,4,61,300,350,14502,12.773085782,8.5153905214,20.660291757,-11,0.2791931318,4.2576952607,20.939484889
51,101,2006,187,115,564,99,6,72,570,632,15134,12.619786746,7.7608314212,38.061816709,-10,0.4049129437,4.8589553246,38.466729653
51,101,2007,219,121,427,99,4,98,431,529,15663,14.222164497,7.8579082378,27.729973699,0,0.2597655616,6.3642562587,27.98973926
51,101,2008,218,123,283,99,4,95,287,377,16040,13.752641706,7.7595180267,17.853200013,-5,0.2523420496,5.9931236791,18.105542062
51,103,2001,104,233,-33,422,2,-129,-31,-171,11415,9.0430850833,20.259988696,-2.869440459,-11,0.1739054824,-11.21690361,-2.695534977
51,103,2002,110,181,91,414,2,-71,93,13,11428,9.630959156,15.84730552,7.9674298472,-9,0.1751083483,-6.216346364,8.1425381955
51,103,2003,111,210,174,420,2,-99,176,74,11502,9.6816397732,18.316615787,15.176624509,-3,0.1744439599,-8.634976014,15.351068469
51,103,2004,93,198,79,409,1,-105,80,-33,11469,8.0971659919,17.239127596,6.8782377781,-8,0.087066301,-9.141961604,6.9653040791
51,103,2005,102,200,105,407,2,-98,107,-5,11464,8.8954781319,17.442113984,9.1571098417,-14,0.1744211398,-8.546635852,9.3315309816
51,103,2006,92,204,128,429,1,-112,129,12,11476,8.02092415,17.785527463,11.159546643,-5,0.0871839582,-9.764603313,11.246730602
51,103,2007,112,173,74,420,2,-61,76,20,11496,9.7510012189,15.061814383,6.4426258053,5,0.1741250218,-5.310813164,6.6167508271
51,103,2008,111,193,36,420,1,-82,37,-30,11466,9.6681473739,16.810382371,3.1356153645,15,0.0871004268,-7.142234997,3.2227157913
51,105,2001,250,296,-213,235,3,-46,-210,-274,23263,10.683760684,12.64957265,-9.102564103,-18,0.1282051282,-1.965811966,-8.974358974
51,105,2002,246,291,161,247,2,-45,163,101,23364,10.551826195,12.482038304,6.9058699895,-17,0.0857872048,-1.930212109,6.9916571943
51,105,2003,240,309,150,245,1,-69,151,60,23424,10.25904078,13.208515004,6.4119004873,-22,0.0427460032,-2.949474224,6.4546464906
51,105,2004,237,350,69,264,4,-113,73,-59,23365,10.130586249,14.96078138,2.9494111864,-19,0.1709803586,-4.830195131,3.120391545
51,105,2005,248,333,68,235,2,-85,70,-34,23331,10.621894809,14.262463594,2.9124550283,-19,0.085660442,-3.640568785,2.9981154703
51,105,2006,238,303,97,235,3,-65,100,24,23355,10.195776036,12.980336718,4.1554213255,-11,0.1285181853,-2.784560682,4.2839395108
51,105,2007,239,302,110,235,2,-63,112,50,23405,10.222412318,12.917023097,4.7048759624,1,0.0855431993,-2.694610778,4.7904191617
51,105,2008,254,304,74,235,2,-50,76,43,23448,10.842422043,12.976757091,3.1588158709,17,0.0853734019,-2.134335048,3.2441892728
51,107,2001,3766,745,11774,892,899,3021,12673,15778,189649,20.719630282,4.0988116197,64.777728873,84,4.9460827465,16.620818662,69.72381162
51,107,2002,4035,707,9118,881,835,3328,9953,13358,203007,20.55234098,3.6011164989,46.442687747,77,4.2530866713,16.951224481,50.695774418
51,107,2003,4256,712,11590,880,689,3544,12279,16416,219423,20.150084038,3.3709727055,54.87299671,593,3.2620789243,16.779111332,58.135075634
51,107,2004,4686,766,13488,906,725,3920,14213,17542,236965,20.535158681,3.3567929043,59.107601427,-591,3.1771212214,17.178365776,62.284722648
51,107,2005,4991,762,11319,893,720,4229,12039,16088,253053,20.370680261,3.1100898334,46.198302919,-180,2.9386675592,17.260590427,49.136970479
51,107,2006,5160,881,7055,911,740,4279,7795,11905,264958,19.922356861,3.4014721695,27.238803809,-169,2.8570821855,16.520884692,30.095885995
51,107,2007,5215,864,7424,895,664,4351,8088,12388,277346,19.23275506,3.1864046734,27.379477194,-51,2.448810999,16.046350386,29.828288193
51,107,2008,5450,969,7611,895,671,4481,8282,12649,289995,19.212431324,3.4159350373,26.830424736,-114,2.3654204438,15.796496287,29.19584518
51,109,2001,322,262,472,185,5,60,477,520,26286,12.372243141,10.066856221,18.135710443,-17,0.1921155767,2.3053869208,18.32782602
51,109,2002,340,267,657,185,4,73,661,722,27008,12.759410065,10.019889669,24.655683567,-12,0.1501107066,2.7395203963,24.805794273
51,109,2003,303,289,802,185,4,14,806,841,27849,11.046903768,10.536485772,29.239659478,21,0.1458337131,0.5104179959,29.385493191
51,109,2004,326,248,693,185,5,78,698,735,28584,11.553523648,8.7891836337,24.560097815,-41,0.1772012829,2.7643400138,24.737299098
51,109,2005,382,247,1146,185,5,135,1151,1264,29848,13.075027382,8.454271632,39.225082147,-22,0.1711391019,4.6207557503,39.396221249
51,109,2006,380,252,1046,185,5,128,1051,1160,31008,12.488497437,8.2818456685,34.376232418,-19,0.1643223347,4.2066517681,34.540554752
51,109,2007,381,289,783,185,4,92,787,873,31881,12.116586366,9.1907964827,24.901016076,-6,0.1272082558,2.9257898838,25.028224332
51,109,2008,418,314,742,185,3,104,745,835,32716,12.941777482,9.7218137065,22.97320309,-14,0.0928835704,3.2199637754,23.06608666
51,111,2001,100,137,-27,1192,18,-37,-9,-61,13032,7.6555023923,10.488038278,-2.066985646,-15,1.3779904306,-2.832535885,-0.688995215
51,111,2002,109,147,91,1234,17,-38,108,60,13092,8.3448170265,11.254019293,6.9667738478,-10,1.3014852243,-2.909202266,8.2682590721
51,111,2003,129,149,-32,1231,9,-20,-23,-61,13031,9.8763541707,11.407571872,-2.449948321,-18,0.6890479654,-1.531217701,-1.760900356
51,111,2004,128,168,-82,1236,10,-40,-72,-122,12909,9.8689282961,12.952968389,-6.32228219,-10,0.7710100231,-3.084040093,-5.551272167
51,111,2005,139,148,68,1234,10,-9,78,58,12967,10.743546143,11.439171433,5.2558355233,-11,0.7729169887,-0.69562529,6.028752512
51,111,2006,160,155,29,1233,10,5,39,37,13004,12.321435447,11.93639059,2.2332601748,-7,0.7700897155,0.3850448577,3.0033498903
51,111,2007,142,147,-33,1231,4,-5,-29,-35,12969,10.93443191,11.319447118,-2.541100373,-1,0.3080121665,-0.385015208,-2.233088207
51,111,2008,150,154,-26,1231,3,-4,-23,-28,12941,11.578541104,11.8873022,-2.006947125,-1,0.2315708221,-0.308761096,-1.775376303
51,113,2001,128,139,161,219,4,-11,165,142,12699,10.136205258,11.007285398,12.749445676,-12,0.3167564143,-0.871080139,13.066202091
51,113,2002,149,111,195,219,3,38,198,230,12929,11.627906977,8.6624004995,15.217730607,-6,0.2341189324,2.9655064773,15.45184954
51,113,2003,131,129,67,219,2,2,69,56,12985,10.110365054,9.9560083353,5.1709500656,-15,0.1543567184,0.1543567184,5.325306784
51,113,2004,147,132,63,219,5,15,68,74,13059,11.288588542,10.136691752,4.8379665182,-9,0.3839655967,1.15189679,5.2219321149
51,113,2005,147,107,207,219,3,40,210,238,13297,11.154955228,8.1195932615,15.707998179,-12,0.2276521475,3.0353619669,15.935650326
51,113,2006,154,122,188,219,4,32,192,218,13515,11.487393704,9.1004028047,14.023571535,-6,0.2983738624,2.3869908996,14.321945398
51,113,2007,163,141,159,219,3,22,162,184,13699,11.97912839,10.362313515,11.685162049,0,0.2204747556,1.6168148747,11.905636805
51,113,2008,163,126,-109,219,3,37,-106,-60,13639,11.924793328,9.2179384008,-7.974248299,9,0.2194747238,2.7068549272,-7.754773575
51,115,2001,74,130,138,144,1,-56,139,77,9265,8.0203760906,14.089849889,14.956917574,-6,0.1083834607,-6.069473798,15.065301035
51,115,2002,78,130,-18,92,-2,-52,-20,-80,9185,8.4552845528,14.092140921,-1.951219512,-8,-0.216802168,-5.636856369,-2.16802168
51,115,2003,68,142,36,63,-8,-74,28,-56,9129,7.4260128863,15.507262204,3.9314185869,-10,-0.873648575,-8.081249317,3.057770012
51,115,2004,69,129,-18,63,6,-60,-12,-79,9050,7.5911766324,14.192199791,-1.980306948,-7,0.6601023159,-6.601023159,-1.320204632
51,115,2005,59,139,24,63,0,-80,24,-63,8987,6.5421078893,15.412762655,2.6611964296,-7,0,-8.870654765,2.6611964296
51,115,2006,61,139,96,63,4,-78,100,18,9005,6.7807914629,15.451311694,10.671409515,-4,0.4446420631,-8.670520231,11.116051578
51,115,2007,76,130,87,63,1,-54,88,33,9038,8.4243196808,14.410020507,9.6436291082,-1,0.1108463116,-5.985700826,9.7544754198
51,115,2008,65,117,58,63,1,-52,59,0,9038,7.1918566054,12.94534189,6.417348971,-7,0.1106439478,-5.753485284,6.5279929188
51,117,2001,352,400,-32,1601,30,-48,-2,-80,32283,10.890078272,12.375088946,-0.990007116,-30,0.9281316709,-1.485010674,-0.061875445
51,117,2002,346,405,55,1619,28,-59,83,-7,32276,10.718877306,12.546662743,1.7038677799,-31,0.867423597,-1.827785437,2.5712913769
51,117,2003,350,401,-30,1615,23,-51,-7,-104,32172,10.861469712,12.444141013,-0.930983118,-46,0.7137537239,-1.582671301,-0.217229394
51,117,2004,372,432,-55,1607,24,-60,-31,-113,32059,11.583191917,13.451448677,-1.712568697,-22,0.7473027043,-1.868256761,-0.965265993
51,117,2005,312,456,34,1612,22,-144,56,-119,31940,9.7501523461,14.25022266,1.0625166018,-31,0.6875107424,-4.500070314,1.7500273442
51,117,2006,347,408,39,1611,23,-61,62,-13,31927,10.866331595,12.776551271,1.2212879891,-14,0.7202467628,-1.910219675,1.9415347519
51,117,2007,351,443,156,1598,21,-92,177,99,32026,10.976811096,13.853923975,4.8785827092,14,0.6567322878,-2.87711288,5.535314997
51,117,2008,368,443,171,1598,21,-75,192,136,32162,11.466317692,13.803203091,5.32809871,19,0.6543279118,-2.336885399,5.9824266218
51,119,2001,83,156,121,313,14,-73,135,56,10026,8.3016603321,15.603120624,12.102420484,-6,1.400280056,-7.301460292,13.50270054
51,119,2002,58,142,70,245,13,-84,83,-9,10017,5.787556753,14.169535499,6.9849822881,-8,1.2972109964,-8.381978746,8.2821932844
51,119,2003,91,142,223,241,9,-51,232,182,10199,9.0027700831,14.048278591,22.061733281,1,0.8903838544,-5.045508508,22.952117135
51,119,2004,71,125,193,252,12,-54,205,138,10337,6.9146864044,12.17374367,18.796260226,-13,1.1686793923,-5.259057265,19.964939618
51,119,2005,78,144,176,284,10,-66,186,110,10447,7.5057736721,13.856812933,16.936104696,-10,0.9622786759,-6.351039261,17.898383372
51,119,2006,74,145,177,325,12,-71,189,113,10560,7.0452706241,13.804922169,16.851525682,-5,1.1424763174,-6.759651545,17.994001999
51,119,2007,75,132,66,302,11,-57,77,17,10577,7.0965605337,12.489946539,6.2449732696,-3,1.0408288783,-5.393386006,7.2858021479
51,119,2008,86,142,60,302,11,-56,71,8,10585,8.1277762026,13.420281637,5.6705415367,-7,1.0395992817,-5.292505434,6.7101408184
51,121,2001,832,507,514,9505,392,325,906,1160,84947,9.8616757737,6.0094586746,6.0924295044,-71,4.6463664703,3.8522170991,10.738795975
51,121,2002,745,553,-375,9291,368,192,-7,111,85058,8.7644481045,6.5056910091,-4.411634952,-74,4.3292844328,2.2587570954,-0.082350519
51,121,2003,805,508,118,9477,307,297,425,596,85654,9.4310886171,5.9515441211,1.382445288,-126,3.5967008763,3.479544496,4.9791461643
51,121,2004,865,521,-303,9341,305,344,2,284,85938,10.082055107,6.0725441746,-3.531633176,-62,3.5549442864,4.0095109329,0.0233111101
51,121,2005,812,528,436,9671,315,284,751,952,86890,9.3966255468,6.1101210452,5.0454787419,-83,3.645242669,3.2865045016,8.6907214109
51,121,2006,829,510,366,9757,317,319,683,960,87850,9.4883827401,5.8372439052,4.1890809202,-42,3.6282476823,3.6511388348,7.8173286025
51,121,2007,932,514,460,9872,287,418,747,1173,89023,10.538635066,5.8120798539,5.2014722428,8,3.2452663776,4.7265552119,8.4467386204
51,121,2008,932,515,218,9872,288,417,506,944,89967,10.413989608,5.7545114252,2.4358902732,21,3.2180568747,4.6594781831,5.6539471479
51,125,2001,174,168,82,206,-1,6,81,73,14539,11.997931391,11.584209619,5.6541975521,-14,-0.068953629,0.4137217721,5.5852439235
51,125,2002,132,170,189,206,-2,-38,187,141,14680,9.035216811,11.636264075,12.936787707,-8,-0.136897224,-2.601047264,12.799890482
51,125,2003,164,172,145,206,-5,-8,140,124,14804,11.124677791,11.667345001,9.8358431692,-8,-0.339167006,-0.542667209,9.4966761633
51,125,2004,162,168,13,206,2,-6,15,-1,14803,10.94335799,11.348667545,0.8781707029,-10,0.1351031851,-0.405309555,1.0132738879
51,125,2005,150,151,161,206,-1,-1,160,146,14949,10.083355741,10.150578112,10.822801828,-13,-0.067222372,-0.067222372,10.755579457
51,125,2006,131,153,80,206,1,-22,81,51,15000,8.7482052823,10.217369528,5.3424154396,-8,0.066780193,-1.469164246,5.4091956326
51,125,2007,166,158,215,206,-1,8,214,223,15223,10.985011415,10.455613275,14.227575026,1,-0.066174768,0.5293981405,14.161400258
51,125,2008,168,187,122,206,-1,-19,121,98,15321,11.000523834,12.244630697,7.9884756417,-4,-0.065479309,-1.244106862,7.9229963332
51,127,2001,147,100,313,468,0,47,313,354,13884,10.724447363,7.2955424236,22.835047786,-6,0,3.4289049391,22.835047786
51,127,2002,147,115,287,461,-3,32,284,311,14195,10.47045835,8.1911748994,20.442323445,-5,-0.213682823,2.2792834503,20.228640621
51,127,2003,149,86,497,452,-9,63,488,569,14764,10.29041058,5.9394316102,34.324389654,18,-0.621568424,4.3509789703,33.70282123
51,127,2004,168,116,524,475,5,52,529,554,15318,11.169470115,7.7122531747,34.838109168,-27,0.3324247058,3.4572169404,35.170533874
51,127,2005,169,120,589,502,0,49,589,628,15946,10.811156602,7.6765609007,37.679119754,-10,0,3.1345957011,37.679119754
51,127,2006,167,108,644,569,3,59,647,696,16642,10.249171474,6.6282067019,39.523751074,-10,0.1841168528,3.6209647723,39.707867927
51,127,2007,189,114,519,577,0,75,519,601,17243,11.155378486,6.7286409916,30.633023462,7,0,4.4267374945,30.633023462
51,127,2008,203,115,484,577,0,88,484,582,17825,11.577506559,6.5586859815,27.603513174,10,0,5.0188205772,27.603513174
51,131,2001,165,207,-38,382,30,-42,-8,-62,12984,12.6776796,15.904725317,-2.919708029,-12,2.3050326546,-3.227045716,-0.614675375
51,131,2002,165,212,2,367,30,-47,32,-27,12957,12.721174974,16.344782391,0.1541960603,-12,2.3129409044,-3.623607417,2.4671369647
51,131,2003,144,200,118,367,19,-56,137,72,13029,11.082890787,15.392903871,9.0818132841,-9,1.4623258678,-4.310013084,10.544139152
51,131,2004,175,221,175,367,23,-46,198,139,13168,13.360308432,16.872160934,13.360308432,-13,1.7559262511,-3.511852502,15.116234683
51,131,2005,154,186,129,368,21,-32,150,104,13272,11.649016641,14.069591528,9.7579425113,-14,1.5885022693,-2.420574887,11.346444781
51,131,2006,177,188,101,383,22,-11,123,106,13378,13.283302064,14.108818011,7.5797373358,-6,1.6510318949,-0.825515947,9.2307692308
51,131,2007,160,195,11,402,16,-35,27,-8,13370,11.963511291,14.580529385,0.8224914012,0,1.1963511291,-2.617018095,2.0188425303
51,131,2008,182,199,40,402,16,-17,56,45,13415,13.589695725,14.859062908,2.9867463132,6,1.1946985253,-1.269367183,4.1814448385
51,133,2001,111,174,132,10,5,-63,137,66,12325,9.0302635861,14.155548324,10.738691832,-8,0.40676863,-5.125284738,11.145460462
51,133,2002,115,179,329,10,5,-64,334,267,12592,9.2306457439,14.367700767,26.407673476,-3,0.4013324236,-5.137055023,26.8090059
51,133,2003,100,162,203,10,4,-62,207,141,12733,7.8973346496,12.793682132,16.031589339,-4,0.315893386,-4.896347483,16.347482725
51,133,2004,105,171,74,10,3,-66,77,-1,12732,8.2466129982,13.430198311,5.8118986845,-12,0.2356175142,-5.183585313,6.0475161987
51,133,2005,117,164,114,10,4,-47,118,63,12795,9.1667646022,12.849140126,8.931719356,-8,0.3133936616,-3.682375524,9.2451130176
51,133,2006,114,183,66,10,3,-69,69,-7,12788,8.9121682367,14.306375327,5.1596763476,-7,0.2345307431,-5.394207091,5.3942070906
51,133,2007,112,169,138,10,4,-57,142,79,12867,8.7312414734,13.174819723,10.758136815,-6,0.3118300526,-4.44357825,11.069966868
51,133,2008,122,174,108,10,3,-52,111,48,12915,9.4639671088,13.497789155,8.3779380963,-11,0.2327205027,-4.033822046,8.610658599
51,135,2001,179,210,83,1679,22,-31,105,60,15811,11.342753945,13.307141499,5.2594892592,-14,1.3940814904,-1.964387555,6.6535707496
51,135,2002,172,195,-70,1577,20,-23,-50,-87,15724,10.908514349,12.367211035,-4.439511654,-14,1.2684319011,-1.458696686,-3.171079753
51,135,2003,178,221,-19,1580,13,-43,-6,-70,15654,11.345528714,14.086302505,-1.211039582,-21,0.8286060297,-2.740773791,-0.382433552
51,135,2004,179,201,-81,1582,18,-22,-63,-98,15556,11.470682474,12.880487023,-5.190644024,-13,1.1534764499,-1.40980455,-4.037167574
51,135,2005,178,174,161,1746,15,4,176,166,15722,11.381801905,11.126031076,10.294775881,-14,0.95914061,0.2557708293,11.253916491
51,135,2006,172,197,-65,1755,17,-25,-48,-82,15640,10.968688221,12.5629743,-4.145143805,-9,1.0841145335,-1.594286079,-3.061029271
51,135,2007,178,195,82,1749,13,-17,95,69,15709,11.356024116,12.440588217,5.2314268398,-9,0.8293725478,-1.084564101,6.0607993875
51,135,2008,184,195,189,1749,13,-11,202,183,15892,11.645201101,12.341381602,11.961646783,-8,0.8227587735,-0.696180501,12.784405557
51,137,2001,298,323,475,574,18,-25,493,453,26456,11.36125355,12.314378848,18.109380659,-15,0.6862502145,-0.953125298,18.795630874
51,137,2002,308,290,699,597,17,18,716,720,27176,11.485680191,10.814439141,26.066527446,-14,0.6339498807,0.6712410501,26.700477327
51,137,2003,326,314,773,625,14,12,787,811,27987,11.819516705,11.38444247,28.026031942,12,0.507586607,0.4350742345,28.533618549
51,137,2004,344,283,687,602,17,61,704,723,28710,12.134680847,9.982891511,24.23408646,-42,0.5996789954,2.1517893363,24.833765455
51,137,2005,368,279,1255,587,15,89,1270,1331,30041,12.527446341,9.4977106773,42.722677061,-28,0.5106296063,3.0297356641,43.233306667
51,137,2006,337,322,1408,638,16,15,1424,1422,31463,10.958636837,10.470863684,45.785639958,-17,0.5202913632,0.487773153,46.305931322
51,137,2007,426,304,722,607,12,122,734,875,32338,13.354022664,9.529631197,22.632874093,19,0.3761696525,3.8243914672,23.009043745
51,137,2008,432,319,664,607,11,113,675,801,33139,13.19547322,9.7438795302,20.28193106,13,0.3359958459,3.4515936894,20.617926906
51,139,2001,253,233,19,260,5,20,24,22,23229,10.896718064,10.035317426,0.8183306056,-22,0.2153501594,0.8614006374,1.0336807649
51,139,2002,288,251,66,262,4,37,70,87,23316,12.375120851,10.785261575,2.835965195,-20,0.1718766785,1.589859276,3.0078418735
51,139,2003,279,249,219,283,4,30,223,236,23552,11.90577793,10.625586754,9.3453955791,-17,0.1706921567,1.2801911752,9.5160877358
51,139,2004,275,266,-6,274,4,9,-2,-9,23543,11.678522136,11.296315957,-0.254804119,-16,0.1698694129,0.382206179,-0.084934706
51,139,2005,263,254,175,280,5,9,180,167,23710,11.131568366,10.750640171,7.4069371257,-22,0.211626775,0.380928195,7.6185639007
51,139,2006,271,242,241,289,5,29,246,263,23973,11.366734476,10.150368056,10.108424386,-12,0.2097183483,1.2163664199,10.318142734
51,139,2007,273,251,115,294,2,22,117,148,24121,11.352767497,10.437892461,4.7823013266,9,0.0831704579,0.9148750364,4.8654717844
51,139,2008,282,254,1,294,1,28,2,43,24164,11.680646163,10.520865693,0.0414207311,13,0.0414207311,1.1597804701,0.0828414622
51,141,2001,144,208,-67,233,21,-64,-46,-127,19300,7.4366720892,10.741859684,-3.460118264,-17,1.0845146797,-3.305187595,-2.375603584
51,141,2002,161,210,-170,229,21,-49,-149,-216,19084,8.3889120467,10.942059191,-8.857857441,-18,1.0942059191,-2.553147145,-7.763651521
51,141,2003,176,197,-65,229,14,-21,-51,-97,18987,9.2458826929,10.349084605,-3.414672585,-25,0.7354679415,-1.103201912,-2.679204644
51,141,2004,174,247,-59,229,13,-73,-46,-133,18854,9.196374303,13.054623292,-3.118310827,-14,0.6870854364,-3.858248989,-2.43122539
51,141,2005,183,229,6,229,14,-46,20,-45,18809,9.7177601359,12.160475799,0.3186150864,-19,0.7434352017,-2.442715663,1.0620502881
51,141,2006,174,219,-20,229,13,-45,-7,-59,18750,9.2654224021,11.661652334,-1.064991081,-7,0.6922442025,-2.396229932,-0.372746878
51,141,2007,185,239,109,229,14,-54,123,78,18828,9.8461865985,12.720208633,5.8012666986,9,0.7451168237,-2.874022034,6.5463835223
51,141,2008,183,211,31,229,13,-28,44,16,18844,9.715438522,11.201953706,1.6457846677,0,0.6901677639,-1.486515184,2.3359524315
51,143,2001,745,609,-170,408,45,136,-125,-58,61686,12.071619541,9.8679413433,-2.754597748,-69,0.7291582273,2.2036781982,-2.02543952
51,143,2002,714,651,-379,410,38,63,-341,-338,61348,11.606547784,10.582440626,-6.160898613,-60,0.6177154283,1.0241071574,-5.543183185
51,143,2003,642,593,-167,423,34,49,-133,-176,61172,10.479921645,9.6800522364,-2.726085537,-92,0.5550114267,0.7998694091,-2.17107411
51,143,2004,678,601,-177,407,36,77,-141,-105,61067,11.093022685,9.833195625,-2.895966099,-41,0.5890100541,1.2598270601,-2.306956045
51,143,2005,649,628,-113,405,39,21,-74,-106,60961,10.636903006,10.292719704,-1.852033959,-53,0.6391975612,0.3441833022,-1.212836398
51,143,2006,636,636,-119,416,41,0,-78,-105,60856,10.441892347,10.441892347,-1.953750298,-27,0.6731408588,0,-1.280609439
51,143,2007,717,624,12,672,32,93,44,124,60980,11.769920221,10.243277849,0.1969861125,-13,0.5252962999,1.5266423717,0.7222824124
51,143,2008,704,609,42,672,32,95,74,143,61123,11.531248208,9.9751848849,0.6879437852,-26,0.5241476458,1.5560633236,1.212091431
51,145,2001,279,125,336,2387,1,154,337,473,23080,12.213539957,5.4720161096,14.708779303,-18,0.0437761289,6.741523847,14.752555432
51,145,2002,257,150,901,2625,1,107,902,1017,24097,10.895139581,6.3590308837,38.196578841,8,0.0423935392,4.536108697,38.238972381
51,145,2003,280,135,580,2650,1,145,581,738,24835,11.444453527,5.5178615221,23.706368021,12,0.0408730483,5.9265920052,23.747241069
51,145,2004,264,163,589,2608,0,101,589,655,25490,10.491803279,6.477893691,23.407848982,-35,0,4.0139095877,23.407848982
51,145,2005,268,159,694,2560,1,109,695,785,26275,10.354486622,6.1431469139,26.813484014,-19,0.0386361441,4.2113397083,26.852120158
51,145,2006,263,155,925,2575,0,108,925,1017,27292,9.8194784102,5.7871450707,34.536188325,-16,0,4.0323333396,34.536188325
51,145,2007,274,151,182,2464,1,123,183,307,27599,9.9834216903,5.5018126833,6.6313238964,1,0.0364358456,4.4816090069,6.667759742
51,145,2008,302,162,254,2464,0,140,254,407,28006,10.862332524,5.8268141354,9.1358690765,13,0,5.0355183886,9.1358690765
51,147,2001,214,245,-17,3829,2,-31,-15,-67,19628,10.884215345,12.460900745,-0.864633929,-21,0.1017216387,-1.5766854,-0.762912291
51,147,2002,214,208,433,3963,2,6,435,436,20064,10.783029326,10.480701401,21.817998589,-5,0.100775975,0.302327925,21.918774564
51,147,2003,181,218,-142,3669,0,-37,-142,-197,19867,9.0656382259,10.91883499,-7.112268663,-18,0,-1.853196764,-7.112268663
51,147,2004,208,228,412,3904,4,-20,416,369,20236,10.373288781,11.370720395,20.54709124,-27,0.1994863227,-0.997431614,20.746577563
51,147,2005,200,197,563,4211,2,3,565,554,20790,9.7499146882,9.6036659679,27.446009847,-14,0.0974991469,0.1462487203,27.543508994
51,147,2006,185,215,279,4416,3,-30,282,241,21031,8.8472298606,10.281915784,13.342579087,-11,0.1434685923,-1.434685923,13.486047679
51,147,2007,200,213,499,4585,2,-13,501,481,21512,9.4022518393,10.013398209,23.458618339,-7,0.0940225184,-0.61114637,23.552640857
51,147,2008,224,241,347,4585,2,-17,349,311,21823,10.338063921,11.122649129,16.014768663,-21,0.0923041421,-0.784585208,16.107072805
51,149,2001,410,151,515,5114,-18,259,497,732,33915,12.220930579,4.5008793109,15.350681093,-24,-0.53652866,7.7200512683,14.814152434
51,149,2002,341,175,1282,6243,-225,166,1057,1230,35145,9.8754706053,5.0680567622,37.127135824,7,-6.51607298,4.807413843,30.611062844
51,149,2003,374,165,1240,6954,-618,209,622,885,36030,10.509308044,4.636459431,34.843695118,54,-17.36564805,5.8728486126,17.478047067
51,149,2004,377,169,-79,7175,272,208,193,378,36408,10.408901405,4.6660592507,-2.181175626,-23,7.50987051,5.7428421547,5.3286948839
51,149,2005,353,185,-169,7118,-54,168,-223,-81,36327,9.7064686877,5.0869595106,-4.647006256,-26,-1.484842236,4.6195091771,-6.131848491
51,149,2006,357,191,-663,7123,125,166,-538,-386,35941,9.8798915149,5.2858803343,-18.34836996,-14,3.4593457685,4.5940111806,-14.88902419
51,149,2007,346,149,-225,7161,-44,197,-269,-93,35848,9.6393597905,4.1510537826,-6.268369806,-21,-1.22581454,5.4883060079,-7.494184346
51,149,2008,372,148,36,7161,17,224,53,241,36089,10.342382918,4.1147114837,1.0008757663,-36,0.4726357785,6.2276714347,1.4735115448
51,153,2001,5181,1092,8082,2477,1231,4089,9313,13284,297080,17.838574842,3.7598385886,27.826937247,-118,4.2384261013,14.078736254,32.065363348
51,153,2002,5566,1176,7209,2321,733,4390,7942,12232,309312,18.357761976,3.8786791382,23.776698901,-100,2.4175780683,14.479082838,26.194276969
51,153,2003,5775,1222,6866,2060,-177,4553,6689,11306,320618,18.335370597,3.8797961678,21.799247535,64,-0.561967203,14.455574429,21.237280333
51,153,2004,6295,1232,5879,1798,1523,5063,7402,12071,332689,19.27118491,3.7715805892,17.997664192,-394,4.6624328225,15.499604321,22.660097014
51,153,2005,6488,1252,6019,2408,917,5236,6936,11883,344572,19.159526386,3.6972452275,17.774535962,-289,2.7079663527,15.462281159,20.482502314
51,153,2006,6871,1262,551,2279,1295,5609,1846,7263,351835,19.732713772,3.6243173891,1.5824079884,-192,3.7190895554,16.108396383,5.3014975438
51,153,2007,6899,1382,1430,2345,865,5517,2295,7753,359588,19.394931004,3.8851709883,4.0201118041,-59,2.4317459514,15.509760016,6.4518577555
51,153,2008,6697,1443,-1156,2345,990,5254,-166,5146,364734,18.491775757,3.9844157709,-3.191950541,58,2.7335908615,14.507359986,-0.45835968
51,155,2001,425,414,5,1248,5,11,10,-13,35136,12.093618838,11.780607526,0.1422778687,-34,0.1422778687,0.3130113111,0.2845557374
51,155,2002,296,408,-180,1258,5,-112,-175,-316,34820,8.462462119,11.664474813,-5.146091829,-29,0.1429469953,-3.202012694,-5.003144834
51,155,2003,344,382,14,1217,3,-38,17,-72,34748,9.8896044158,10.982060718,0.4024839006,-51,0.0862465501,-1.092456302,0.4887304508
51,155,2004,359,423,119,1294,6,-64,125,36,34784,10.326180751,12.167059771,3.4228844273,-25,0.1725824081,-1.84087902,3.5954668354
51,155,2005,336,397,-5,1306,4,-61,-1,-96,34688,9.6729617688,11.429064947,-0.143942883,-34,0.1151543068,-1.756103178,-0.028788577
51,155,2006,315,430,227,1331,5,-115,232,101,34789,9.0677490393,12.378197101,6.5345366092,-16,0.1439325244,-3.310448062,6.6784691337
51,155,2007,369,420,242,1340,4,-51,246,209,34998,10.575035465,12.036625733,6.9353891126,14,0.1146345308,-1.461590268,7.0500236434
51,155,2008,357,392,9,1340,4,-35,13,-11,34987,10.202186183,11.202400514,0.257197971,11,0.1143102093,-1.000214332,0.3715081803
51,157,2001,97,69,119,20,2,28,121,146,7227,13.558848197,9.644953872,16.634050881,-3,0.2795638803,3.9138943249,16.913614761
51,157,2002,76,76,-7,11,2,0,-5,-13,7214,10.525586871,10.525586871,-0.969461949,-8,0.2769891282,0,-0.69247282
51,157,2003,71,72,-37,9,2,-1,-35,-46,7168,9.8734529273,10.012515645,-5.14532054,-10,0.2781254346,-0.139062717,-4.867195105
51,157,2004,71,65,54,15,1,6,55,55,7223,9.86727816,9.0334236676,7.5046904315,-6,0.1389757487,0.8338544924,7.6436661803
51,157,2005,69,64,41,8,2,5,43,43,7266,9.5244668369,8.8342880806,5.6594658016,-5,0.2760715025,0.6901787563,5.9355373042
51,157,2006,75,66,-87,11,1,9,-86,-81,7185,10.379904505,9.1343159643,-12.04068923,-4,0.1383987267,1.2455885406,-11.9022905
51,157,2007,75,58,7,16,2,17,9,20,7205,10.42390549,8.0611535789,0.9728978457,-6,0.2779708131,2.362751911,1.2508686588
51,157,2008,71,73,-38,16,1,-2,-37,-47,7158,9.8865139595,10.16500731,-5.291373668,-8,0.1392466755,-0.278493351,-5.152126993
51,159,2001,71,97,108,1828,8,-26,116,82,8874,8.0380391713,10.981546473,12.226876486,-8,0.9056945545,-2.943507302,13.13257104
51,159,2002,91,111,78,1848,7,-20,85,55,8929,10.222996124,12.469808459,8.7625681065,-10,0.7863843172,-2.246812335,9.5489524237
51,159,2003,88,124,103,1930,2,-36,105,62,8991,9.8214285714,13.839285714,11.495535714,-7,0.2232142857,-4.017857143,11.71875
51,159,2004,89,111,87,1935,7,-22,94,65,9056,9.8631351471,12.301213498,9.6414916607,-7,0.7757522026,-2.438078351,10.417243863
51,159,2005,93,135,19,1961,5,-42,24,-26,9030,10.284197722,14.928674113,2.1010726529,-8,0.552913856,-4.644476391,2.6539865089
51,159,2006,98,124,94,1970,8,-26,102,71,9101,10.81021455,13.678230655,10.368981303,-5,0.8824664939,-2.868016105,11.251447797
51,159,2007,95,107,63,1983,5,-12,68,55,9156,10.406967191,11.721531467,6.9014624528,-1,0.5477351153,-1.314564277,7.4491975681
51,159,2008,105,111,-12,1983,5,-6,-7,-12,9144,11.475409836,12.131147541,-1.31147541,1,0.5464480874,-0.655737705,-0.765027322
51,161,2001,816,840,47,2266,114,-24,161,48,85800,9.5131505316,9.7929490767,0.5479388174,-89,1.329043089,-0.279798545,1.8769819064
51,161,2002,1241,869,59,2258,108,372,167,455,86255,14.425619715,10.101421057,0.6858272064,-84,1.2554125134,4.3241986574,1.9412397199
51,161,2003,827,908,631,2275,89,-81,720,568,86823,9.5563849825,10.492379159,7.2915101862,-71,1.0284380453,-0.935994176,8.3199482314
51,161,2004,1186,878,356,2288,89,308,445,683,87506,13.606456757,10.072908122,4.0842315392,-70,1.0210578848,3.5335486351,5.105289424
51,161,2005,1242,837,452,2299,91,405,543,859,88365,14.123988605,9.518340147,5.1401311188,-89,1.0348494067,4.6056484582,6.1749805255
51,161,2006,992,920,938,2261,94,72,1032,1060,89425,11.159232803,10.349288486,10.551774565,-44,1.0574273019,0.8099443163,11.609201867
51,161,2007,1145,898,405,2294,86,247,491,761,90186,12.749775905,9.9993875653,4.5097460623,23,0.9576250898,2.7503883392,5.4673711521
51,161,2008,1208,877,213,2294,86,331,299,681,90867,13.344158893,9.6877709842,2.3529021889,51,0.9499980669,3.6563879085,3.3029002557
51,163,2001,159,164,-32,181,0,-5,-32,-59,20777,7.6418426934,7.882152212,-1.537980919,-22,0,-0.240309519,-1.537980919
51,163,2002,205,193,-15,181,-1,12,-16,-23,20754,9.8721436999,9.2942621175,-0.722351978,-19,-0.048156799,0.5778815824,-0.770508777
51,163,2003,246,230,92,188,-3,16,89,82,20836,11.829766771,11.060351046,4.4241404184,-23,-0.144265448,0.7694157249,4.2798749699
51,163,2004,258,217,75,161,3,41,78,103,20939,12.351885099,10.38898863,3.5906642729,-16,0.1436265709,1.9628964692,3.7342908438
51,163,2005,257,226,198,186,0,31,198,208,21147,12.213087488,10.73991351,9.4093047569,-21,0,1.4731739771,9.4093047569
51,163,2006,253,232,83,175,4,21,87,98,21245,11.93621438,10.945461408,3.9158331761,-10,0.1887148519,0.9907529723,4.1045480279
51,163,2007,284,239,186,184,2,45,188,242,21487,13.292146401,11.185996443,8.7054198259,9,0.0936066648,2.1061499579,8.7990264907
51,163,2008,282,234,27,184,2,48,29,83,21570,13.098915391,10.869312771,1.2541514736,6,0.0929001092,2.2296026198,1.3470515828
51,165,2001,895,548,86,1487,139,347,225,711,68557,13.122878529,8.0350138927,1.2609693335,139,2.0380783414,5.0878646364,3.2990476749
51,165,2002,867,568,69,1578,132,299,201,469,69026,12.60330128,8.2568340565,1.0030308977,-31,1.9188417174,4.3464672234,2.9218726151
51,165,2003,837,601,151,1584,104,236,255,451,69477,12.0863808,8.6785123788,2.180458185,-40,1.5017725248,3.4078684216,3.6822307098
51,165,2004,868,594,273,1721,101,274,374,658,70135,12.434461221,8.5092971951,3.9108386099,10,1.4468670315,3.925164026,5.3577056413
51,165,2005,867,597,644,1672,105,270,749,1422,71557,12.237811591,8.4267283968,9.0901391751,403,1.482087909,3.8110831945,10.572227084
51,165,2006,913,606,391,1677,110,307,501,1063,72620,12.664988174,8.4063338813,5.4238886924,255,1.5259021897,4.258654293,6.949790882
51,165,2007,928,602,613,1730,95,326,708,1053,73673,12.686868134,8.2300588545,8.3804419897,19,1.2987634405,4.45680928,9.6792054302
51,165,2008,967,622,255,1730,95,345,350,721,74394,13.061654521,8.4016019775,3.4443866628,26,1.2832028744,4.6600525438,4.7275895372
51,167,2001,299,333,-160,475,4,-34,-156,-215,29062,10.250432815,11.416033871,-5.48518144,-25,0.137129536,-1.165601056,-5.348051904
51,167,2002,291,327,-176,470,4,-36,-172,-234,28828,10.053549836,11.29728796,-6.080497495,-26,0.1381931249,-1.243738124,-5.94230437
51,167,2003,319,311,62,494,2,8,64,35,28863,11.058917335,10.781577716,2.1493820527,-37,0.0693349049,0.2773396197,2.2187169576
51,167,2004,283,363,-109,472,6,-80,-103,-205,28658,9.8398845639,12.621477373,-3.789920203,-22,0.2086194607,-2.78159281,-3.581300742
51,167,2005,281,357,51,438,4,-76,55,-49,28609,9.8136797807,12.467913458,1.781130494,-28,0.1396965093,-2.654233677,1.9208270033
51,167,2006,299,316,3,437,5,-17,8,-21,28588,10.455093799,11.04953057,0.1049006067,-12,0.1748343445,-0.594436771,0.2797349511
51,167,2007,292,363,300,441,4,-71,304,245,28833,10.170495115,12.643457968,10.449138817,12,0.1393218509,-2.472962853,10.588460668
51,167,2008,304,345,29,441,4,-41,33,-2,28831,10.543840178,11.965871254,1.005826859,6,0.1387347392,-1.422031077,1.1445615982
51,169,2001,234,319,-168,346,4,-85,-164,-268,23096,10.073181231,13.732242789,-7.232027551,-19,0.1721911322,-3.659061558,-7.059836418
51,169,2002,223,288,-47,344,4,-65,-43,-131,22965,9.6828119233,12.505156206,-2.04077202,-23,0.1736827251,-2.822344283,-1.867089295
51,169,2003,222,285,-47,343,4,-63,-43,-140,22825,9.6964402708,12.44813278,-2.052849967,-34,0.1747106355,-2.751692509,-1.878139332
51,169,2004,214,312,35,345,3,-98,38,-75,22750,9.3911135491,13.69171695,1.5359297861,-15,0.1316511245,-4.300603401,1.6675809106
51,169,2005,221,329,177,514,4,-108,181,51,22801,9.7034093653,14.445346974,7.7715088582,-22,0.1756273188,-4.741937608,7.947136177
51,169,2006,241,298,167,632,3,-57,170,104,22905,10.545661401,13.039863475,7.3075744979,-9,0.1312737934,-2.494202074,7.4388482913
51,169,2007,239,284,22,724,3,-45,25,-17,22888,10.438276592,12.403642478,0.9608455441,3,0.1310243924,-1.965365886,1.0918699365
51,169,2008,225,299,29,724,2,-74,31,-38,22850,9.8386462023,13.07446762,1.2680921772,5,0.0874546329,-3.235821418,1.3555468101
51,171,2001,418,374,449,516,54,44,503,520,35757,11.775643012,10.536101642,12.64895625,-27,1.5212553174,1.2395413697,14.170211567
51,171,2002,464,393,503,516,51,71,554,598,36355,12.868870646,10.89971156,13.950521411,-27,1.4144663856,1.9691590859,15.364987797
51,171,2003,414,421,661,520,33,-7,694,671,37026,11.283574767,11.474359848,18.015562612,-16,0.89941538,-0.190785081,18.914977992
51,171,2004,461,406,801,518,42,55,843,850,37876,12.309417639,10.840832021,21.387946917,-48,1.1214653814,1.4685856185,22.509412299
51,171,2005,481,451,971,520,39,30,1010,1008,38884,12.532569046,11.750911933,25.299635227,-32,1.016154247,0.7816571131,26.315789474
51,171,2006,499,400,853,529,41,99,894,971,39855,12.674786319,10.160149354,21.666518498,-22,1.0414153088,2.5146369652,22.707933807
51,171,2007,533,457,353,513,33,76,386,459,40314,13.296910277,11.400915566,8.8063964874,-3,0.8232608614,1.8959947112,9.6296573489
51,171,2008,531,448,340,513,33,83,373,463,40777,13.096397874,11.049314967,8.3856408233,7,0.8139004328,2.0470829069,9.1995412561
51,173,2001,373,405,-140,1113,3,-32,-137,-199,32882,11.309370405,12.279611297,-4.244803905,-30,0.0909600837,-0.970240893,-4.153843822
51,173,2002,337,419,-36,1103,2,-82,-34,-149,32733,10.272041454,12.771469938,-1.097310066,-33,0.0609616703,-2.499428484,-1.036348396
51,173,2003,332,390,-100,1097,2,-58,-98,-197,32536,10.173282875,11.950543137,-3.06424183,-41,0.0612848366,-1.777260261,-3.002956993
51,173,2004,336,399,-147,1084,3,-63,-144,-231,32305,10.36381302,12.307027961,-4.534168196,-24,0.0925340448,-1.943214941,-4.441634151
51,173,2005,310,443,43,1100,3,-133,46,-117,32188,9.6134464205,13.737925046,1.3334780519,-30,0.0930333525,-4.124478626,1.4265114043
51,173,2006,352,459,219,1087,3,-107,222,101,32289,10.918622144,14.237635126,6.7931200273,-14,0.0930564387,-3.319012981,6.886176466
51,173,2007,357,431,-182,1071,3,-74,-179,-250,32039,11.099365751,13.400074618,-5.658500187,3,0.0932719811,-2.300708867,-5.565228205
51,173,2008,330,418,-37,1071,2,-88,-35,-134,31905,10.32153134,13.073939697,-1.157262605,-11,0.0625547354,-2.752408357,-1.094707869
51,175,2001,163,174,8,1703,-1,-11,7,-25,17458,9.3300134512,9.9596462608,0.4579147706,-21,-0.057239346,-0.62963281,0.4006754243
51,175,2002,181,199,-130,1660,-3,-18,-133,-168,17290,10.417865776,11.453896627,-7.482445033,-17,-0.172671808,-1.036030851,-7.655116841
51,175,2003,150,162,45,1587,-7,-12,38,8,17298,8.6735283913,9.3674106627,2.6020585174,-18,-0.404764658,-0.693882271,2.1972938591
51,175,2004,166,186,106,1508,3,-20,109,72,17370,9.5765547479,10.730356525,6.1151494173,-17,0.1730702665,-1.153801777,6.2882196839
51,175,2005,163,190,290,1656,-1,-27,289,249,17619,9.3172139815,10.860556175,16.576638372,-13,-0.057160822,-1.543342193,16.51947755
51,175,2006,177,196,191,1617,1,-19,192,163,17782,9.9997175221,11.073133527,10.790655631,-10,0.0564955792,-1.073416005,10.84715121
51,175,2007,175,172,652,2187,-1,3,651,660,18442,9.6621024735,9.4964664311,35.998233216,6,-0.055212014,0.1656360424,35.943021201
51,175,2008,189,194,66,2187,-1,-5,65,38,18480,10.237798602,10.508639835,3.5751042739,-22,-0.054168247,-0.270841233,3.5209360273
51,177,2001,1362,519,3993,554,60,843,4053,4897,96403,14.496378566,5.5239504228,42.499294871,1,0.6386069853,8.9724281434,43.137901857
51,177,2002,1562,595,4415,554,27,967,4442,5446,101849,15.757722495,6.0024615136,44.539273248,37,0.2723806065,9.755260981,44.811653855
51,177,2003,1582,615,3631,554,-40,967,3591,4687,106536,15.183434508,5.902536171,34.848957459,129,-0.383904792,9.2808983372,34.465052667
51,177,2004,1648,661,3060,554,92,987,3152,3971,110507,15.185930898,6.0909589344,28.197177518,-168,0.8477582783,9.0949719641,29.044935796
51,177,2005,1688,586,3303,554,45,1102,3348,4353,114860,14.980010383,5.2004064481,29.312188564,-97,0.399348618,9.7796039349,29.711537182
51,177,2006,1687,653,1752,554,79,1034,1831,2801,117661,14.51051733,5.6166969865,15.069606616,-64,0.6795085175,8.8938203431,15.749115134
51,177,2007,1755,645,86,554,43,1110,129,1226,118887,14.838426028,5.4534386256,0.7271251501,-13,0.363562575,9.3849874021,1.0906877251
51,177,2008,1773,696,-15,554,52,1077,37,1144,120031,14.841912288,5.8262667526,-0.125566094,30,0.4352957919,9.0156455353,0.3097296981
51,179,2001,1387,422,3587,1770,33,965,3620,4577,98101,14.476190476,4.4044357469,37.437703849,-8,0.3444227006,10.071754729,37.782126549
51,179,2002,1469,439,4615,1784,-148,1030,4467,5544,103645,14.562866178,4.3520069791,45.750597286,47,-1.467191419,10.210859199,44.283405867
51,179,2003,1552,498,4623,1664,-497,1054,4126,5390,109035,14.594696257,4.6830919692,43.4737634,210,-4.67368817,9.9116042881,38.80007523
51,179,2004,1619,491,2884,1531,279,1128,3163,4129,113164,14.572522829,4.4194618338,25.958712685,-162,2.5112624269,10.153060995,28.469975112
51,179,2005,1606,535,2403,2024,-4,1071,2399,3372,116536,13.983456683,4.6582498912,20.922942969,-98,-0.034828037,9.3252067915,20.888114933
51,179,2006,1662,523,534,1923,150,1139,684,1763,118299,14.154619201,4.4541912407,4.5478740392,-60,1.2774927076,9.7004279601,5.8253667469
51,179,2007,1729,514,1110,1975,-1,1215,1109,2322,120621,14.473463921,4.3026954629,9.2918131592,-2,-0.008371003,10.170768458,9.2834421564
51,179,2008,1737,532,-170,1975,52,1205,-118,1115,121736,14.334225956,4.3902177366,-1.402889126,28,0.4291190269,9.9440082193,-0.973770099
51,181,2001,80,61,-11,0,0,19,-11,0,6841,11.694196755,8.9168250256,-1.607952054,-8,0,2.7773717293,-1.607952054
51,181,2002,69,83,78,0,0,-14,78,59,6900,10.042937195,12.080634597,11.352885525,-5,0,-2.037697402,11.352885525
51,181,2003,70,82,35,0,-1,-12,34,15,6915,10.133912414,11.871154542,5.066956207,-7,-0.144770177,-1.737242128,4.9221860297
51,181,2004,64,63,-21,0,0,1,-21,-26,6889,9.2726745871,9.1277890467,-3.042596349,-6,0,0.1448855404,-3.042596349
51,181,2005,48,56,7,0,0,-8,7,-7,6882,6.971171302,8.1330331857,1.0166291482,-6,0,-1.161861884,1.0166291482
51,181,2006,78,58,101,0,0,20,101,118,7000,11.237573837,8.3561446477,14.551217404,-3,0,2.8814291889,14.551217404
51,181,2007,75,43,50,0,0,32,50,84,7084,10.650383414,6.1062198239,7.1002556092,2,0,4.5441635899,7.1002556092
51,181,2008,69,66,44,0,-1,3,43,44,7128,9.7101041373,9.2879256966,6.1919504644,-2,-0.140726147,0.4221784408,6.0512243175
51,183,2001,124,153,-180,2504,11,-29,-169,-208,12268,10.022631749,12.366634336,-14.54898157,-10,0.8891044294,-2.344002586,-13.65987714
51,183,2002,120,126,-221,2390,10,-6,-211,-223,12045,9.8712622877,10.364825402,-18.17957471,-6,0.8226051906,-0.493563114,-17.35696952
51,183,2003,114,153,136,2719,6,-39,142,98,12143,9.4261617331,12.650901273,11.245245576,-5,0.4961137754,-3.22473954,11.741359352
51,183,2004,116,142,-173,2637,7,-26,-166,-204,11939,9.6337513496,11.793040445,-14.36757744,-12,0.5813470642,-2.159289096,-13.78623038
51,183,2005,111,129,-79,2617,7,-18,-72,-101,11838,9.336754006,10.850822223,-6.645077175,-11,0.5888043067,-1.514068217,-6.056272869
51,183,2006,120,130,245,2680,7,-10,252,235,12073,10.037221363,10.873656476,20.492660282,-7,0.5855045795,-0.836435114,21.078164861
51,183,2007,122,127,34,2615,6,-5,40,39,12112,10.088898077,10.502377507,2.8116601199,4,0.4961753153,-0.413479429,3.3078354352
51,183,2008,137,156,43,2615,5,-19,48,36,12148,11.294311624,12.86067601,3.5449299258,7,0.4122011542,-1.566364386,3.95713108
51,185,2001,445,554,-310,863,11,-109,-299,-443,43983,10.066848398,12.532660702,-7.012860682,-35,0.2488434435,-2.465812304,-6.764017238
51,185,2002,462,561,102,890,11,-99,113,-28,43955,10.507402943,12.758989288,2.3198162342,-42,0.2501762605,-2.251586345,2.5699924947
51,185,2003,453,521,109,866,11,-68,120,-13,43942,10.307519028,11.854784577,2.4801756601,-65,0.2502929565,-1.547265549,2.7304686167
51,185,2004,477,579,155,900,9,-102,164,30,43972,10.85151398,13.17196351,3.5261733057,-32,0.2047455468,-2.32044953,3.7309188525
51,185,2005,467,590,32,851,11,-123,43,-120,43852,10.634906176,13.435962835,0.7287301876,-40,0.250501002,-2.801056659,0.9792311897
51,185,2006,508,571,105,852,10,-63,115,31,43883,11.580327121,13.016470052,2.3935715507,-21,0.2279591953,-1.43614293,2.621530746
51,185,2007,457,562,-28,830,10,-105,-18,-131,43752,10.429622868,12.825925715,-0.639014093,-8,0.2282193188,-2.396302847,-0.410794774
51,185,2008,484,536,88,830,9,-52,97,35,43787,11.057928466,12.245970367,2.0105324484,-10,0.2056226368,-1.188041901,2.2161550852
51,187,2001,418,286,386,608,7,132,393,502,32052,13.144240747,8.9934278796,12.137983082,-23,0.2201188642,4.1508128675,12.358101946
51,187,2002,439,288,606,603,7,151,613,752,32804,13.537683483,8.8812137659,18.687553966,-12,0.2158628346,4.6564697175,18.9034168
51,187,2003,474,316,542,611,5,158,547,697,33501,14.297564286,9.5317095242,16.348691652,-8,0.1508181887,4.7658547621,16.499509841
51,187,2004,455,309,462,657,8,146,470,579,34080,13.465323094,9.1445820571,13.672481911,-37,0.2367529335,4.3207410367,13.909234844
51,187,2005,465,288,757,665,6,177,763,907,34987,13.465185979,8.3397280901,21.920743626,-33,0.1737443352,5.1254578887,22.094487961
51,187,2006,524,323,590,684,7,201,597,779,35766,14.812092773,9.1303548966,16.677738046,-19,0.1978714683,5.6817378768,16.875609515
51,187,2007,521,299,252,667,6,222,258,491,36257,14.467600628,8.3029032392,6.997764603,11,0.1666134429,6.1646973883,7.1643780459
51,187,2008,528,307,162,667,6,221,168,406,36663,14.481623697,8.4201865058,4.4432254526,17,0.1645639057,6.0614371914,4.6077893582
51,191,2001,501,471,67,1360,11,30,78,56,51204,9.7897451931,9.203532906,1.309207441,-52,0.2149445052,0.586212287,1.5241519462
51,191,2002,540,548,101,1343,10,-8,111,55,51259,10.54039019,10.696544118,1.9714433503,-48,0.1951924109,-0.156153929,2.1666357612
51,191,2003,527,553,118,1276,9,-26,127,35,51294,10.277612552,10.78466744,2.3012491102,-66,0.1755189999,-0.507054889,2.4767681101
51,191,2004,513,590,390,1303,12,-77,402,278,51572,9.9741411156,11.471234421,7.5826803803,-47,0.2333132425,-1.497093306,7.8159936228
51,191,2005,513,597,491,1564,10,-84,501,366,51938,9.9120857888,11.53511738,9.4870060864,-51,0.1932180466,-1.623031591,9.6802241329
51,191,2006,516,608,241,1680,12,-92,253,138,52076,9.9217413041,11.69073394,4.6339915781,-23,0.2307381699,-1.768992636,4.8647297479
51,191,2007,535,568,681,1800,12,-33,693,670,52746,10.207780809,10.837419626,12.993455572,10,0.2289595696,-0.629638816,13.222415142
51,191,2008,561,592,310,1800,11,-31,321,292,53038,10.606518944,11.192618922,5.8609997731,2,0.2079709597,-0.586099977,6.0689707328
51,193,2001,177,220,-58,105,12,-43,-46,-107,16583,10.639257055,13.223935323,-3.486310222,-18,0.7213055631,-2.584678268,-2.765004658
51,193,2002,171,209,70,105,10,-38,80,28,16611,10.303066819,12.592637224,4.2176296921,-14,0.6025185274,-2.289570404,4.8201482196
51,193,2003,208,220,217,105,6,-12,223,204,16815,12.445401783,13.163405732,12.983904745,-7,0.3590019745,-0.718003949,13.342906719
51,193,2004,178,225,-1,105,13,-47,12,-46,16769,10.60028585,13.399237732,-0.059552168,-11,0.7741781801,-2.798951882,0.7146260124
51,193,2005,187,207,129,105,10,-20,139,106,16875,11.116395197,12.305314469,7.6685293069,-13,0.5944596362,-1.188919272,8.2629889431
51,193,2006,191,186,79,105,12,5,91,87,16962,11.28941691,10.993882436,4.6694446907,-9,0.7092827378,0.2955344741,5.3787274286
51,193,2007,188,201,270,105,10,-13,280,263,17225,10.9983327,11.758855705,15.795477813,-4,0.5850176968,-0.760523006,16.38049551
51,193,2008,206,223,248,105,10,-17,258,237,17462,11.877648687,12.857842996,14.299305215,-4,0.5765848877,-0.980194309,14.875890103
51,195,2001,499,474,-270,3159,9,25,-261,-269,41892,11.873460793,11.278598027,-6.424517864,-33,0.2141505955,0.5948627652,-6.210367268
51,195,2002,514,432,-181,3102,9,82,-172,-127,41765,12.28827235,10.327886489,-4.327193182,-37,0.2151643019,1.9603858613,-4.11202888
51,195,2003,486,469,14,3279,3,17,17,-26,41739,11.64016095,11.232994827,0.3353132784,-60,0.0718528454,0.4071661238,0.4071661238
51,195,2004,503,501,-13,3286,3,2,-10,-34,41705,12.055989646,12.008053305,-0.311586214,-26,0.0719045108,0.0479363405,-0.239681703
51,195,2005,488,515,60,3287,3,-27,63,-3,41702,11.701655736,12.34908341,1.4387281643,-39,0.0719364082,-0.647427674,1.5106645725
51,195,2006,473,427,-89,3281,3,46,-86,-60,41642,11.35054713,10.246688424,-2.135726627,-20,0.0719907852,1.1038587061,-2.063735842
51,195,2007,479,476,32,3362,3,3,35,41,41683,11.497149715,11.425142514,0.7680768077,3,0.0720072007,0.0720072007,0.8400840084
51,195,2008,494,454,-26,3362,2,40,-24,20,41703,11.848511741,10.889118077,-0.623605881,4,0.0479696832,0.9593936632,-0.575636198
51,197,2001,329,332,-50,410,7,-3,-43,-71,27553,11.925258713,12.033999674,-1.812349348,-25,0.2537289088,-0.108740961,-1.55862044
51,197,2002,330,339,107,410,6,-9,113,80,27633,11.95955496,12.28572464,3.877795093,-24,0.2174464538,-0.326169681,4.0952415468
51,197,2003,327,356,157,410,1,-29,158,94,27727,11.813583815,12.861271676,5.6719653179,-35,0.0361271676,-1.047687861,5.7080924855
51,197,2004,322,334,71,410,8,-12,79,48,27775,11.603185471,12.035602321,2.5584663616,-19,0.2882778999,-0.43241685,2.8467442615
51,197,2005,338,307,331,410,5,31,336,344,28119,12.094321394,10.985078899,11.843847282,-23,0.1789100798,1.1092424947,12.022757362
51,197,2006,331,318,186,410,7,13,193,191,28310,11.731556469,11.270800475,6.5923549948,-15,0.2480993815,0.4607559943,6.8404543763
51,197,2007,340,337,225,410,3,3,228,217,28527,11.964037511,11.858472474,7.9173777645,-14,0.1055650369,0.1055650369,8.0229428013
51,197,2008,344,365,278,410,3,-21,281,242,28769,12.007819045,12.74085451,9.703993298,-18,0.1047193521,-0.733035465,9.8087126501
51,199,2001,683,341,754,627,47,342,801,1093,57626,11.965767044,5.9741238098,13.209646195,-50,0.8234129591,5.9916432344,14.033059154
51,199,2002,622,305,1035,627,-137,317,898,1188,58814,10.683613878,5.2387495706,17.777396084,-27,-2.35314325,5.4448643078,15.424252834
51,199,2003,593,337,849,627,-494,256,355,589,59403,10.032398048,5.7013796662,14.363416429,-22,-8.357512033,4.3310183815,6.0059043962
51,199,2004,590,340,70,627,294,250,364,574,59977,9.8844027475,5.6960964986,1.1727257497,-40,4.9254481488,4.188306249,6.0981738985
51,199,2005,532,329,597,627,6,203,603,749,60726,8.8150253101,5.4513972312,9.8920490791,-57,0.0994175787,3.3636280788,9.9914666578
51,199,2006,549,374,-171,627,165,175,-6,141,60867,9.0301250894,6.1516699152,-2.812661913,-28,2.7139720214,2.8784551742,-0.098689892
51,199,2007,575,341,-17,627,10,234,-7,219,61086,9.429862324,5.5923183522,-0.27879593,-8,0.1639976056,3.8375439719,-0.114798324
51,199,2008,602,363,-360,627,64,239,-296,-59,61027,9.8597200953,5.9453129478,-5.89617813,-2,1.0482094453,3.9144071475,-4.847968685
51,510,2001,2445,864,-1444,1883,2017,1581,573,3750,133090,18.633540373,6.5846130397,-11.00483939,1596,15.371718172,12.048927333,4.3668787867
51,510,2002,2487,820,-3410,1850,1806,1667,-1604,1426,134516,18.587027197,6.1284126664,-25.48522828,1363,13.497455214,12.45861453,-11.98777307
51,510,2003,2477,765,-3955,1937,1410,1712,-2545,646,135162,18.370056141,5.6734327606,-29.33127656,1479,10.456915284,12.69662338,-18.87436128
51,510,2004,2369,785,-3621,1856,1660,1584,-1961,1473,136635,17.432127654,5.7763698643,-26.64488571,1850,12.214998694,11.65575779,-14.42988701
51,510,2005,2427,758,-3621,1902,1593,1669,-2028,967,137602,17.700018597,5.5280651407,-26.40781514,1326,11.61768835,12.171953456,-14.79012679
51,510,2006,2638,730,-3622,1955,1674,1908,-1948,635,138237,19.127099504,5.2929426223,-26.26169613,675,12.137515,13.834156881,-14.12418113
51,510,2007,2605,801,-1667,1908,1458,1804,-209,1611,139848,18.735278782,5.7608285237,-11.98914001,16,10.486002481,12.974450258,-1.50313753
51,510,2008,2529,832,830,1908,1487,1697,2317,4037,143885,17.826618687,5.864668544,5.8505707831,23,10.481685246,11.961950143,16.332256029
51,515,2001,163,165,30,609,-1,-2,29,18,6332,25.77890242,26.095207971,4.7445832674,-9,-0.158152776,-0.316305551,4.5864304919
51,515,2002,66,100,-2,609,-2,-34,-4,-45,6287,10.460416832,15.849116412,-0.316982328,-7,-0.316982328,-5.38869958,-0.633964656
51,515,2003,54,120,33,609,-4,-66,29,-46,6241,8.6206896552,19.157088123,5.2681992337,-9,-0.638569604,-10.53639847,4.6296296296
51,515,2004,52,102,44,609,2,-50,46,-8,6233,8.3373416707,16.354016354,7.0546737213,-4,0.3206669873,-8.016674683,7.3753407087
51,515,2005,57,106,68,609,-1,-49,67,14,6247,9.1346153846,16.987179487,10.897435897,-4,-0.16025641,-7.852564103,10.737179487
51,515,2006,77,103,11,609,1,-26,12,-16,6231,12.34172143,16.509055938,1.7631030614,-2,0.1602820965,-4.167334509,1.9233851579
51,515,2007,65,91,95,609,-1,-26,94,61,6292,10.380899146,14.533258804,15.172083367,-7,-0.159706141,-4.152359658,15.012377226
51,515,2008,63,95,63,609,-1,-32,62,20,6312,9.9968264043,15.074579499,9.9968264043,-10,-0.158679784,-5.077753094,9.8381466201
51,520,2001,204,258,103,632,6,-54,109,38,17355,11.767420397,14.882325796,5.9413936317,-17,0.3461005999,-3.114905399,6.2874942317
51,520,2002,178,249,-181,658,5,-71,-176,-258,17097,10.33321723,14.454893765,-10.50737258,-11,0.2902589109,-4.121676535,-10.21711367
51,520,2003,166,263,423,742,4,-97,427,332,17429,9.6159416092,15.234895441,24.503272896,2,0.2317094364,-5.618953832,24.734982332
51,520,2004,196,277,139,778,5,-81,144,49,17478,11.229839287,15.870742258,7.9640186782,-14,0.286475492,-4.640902971,8.2504941702
51,520,2005,182,266,40,737,5,-84,45,-54,17424,10.429201765,15.242679503,2.292132256,-15,0.286516532,-4.813477738,2.578648788
51,520,2006,204,248,179,737,5,-44,184,131,17555,11.664141342,14.179936533,10.234712256,-9,0.2858858172,-2.515795191,10.520598073
51,520,2007,200,239,-135,554,5,-39,-130,-164,17391,11.446231328,13.678246437,-7.726206147,5,0.2861557832,-2.232015109,-7.440050363
51,520,2008,198,259,89,554,4,-61,93,33,17424,11.374407583,14.878644263,5.112738762,1,0.2297860118,-3.50423668,5.3425247738
51,530,2001,98,80,-23,293,3,18,-20,-7,6346,15.434286164,12.599417277,-3.622332467,-5,0.4724781479,2.8348688873,-3.149854319
51,530,2002,74,76,-62,262,3,-2,-59,-64,6282,11.71998733,12.036743744,-9.819448844,-3,0.4751346215,-0.316756414,-9.344314222
51,530,2003,55,74,110,316,2,-19,112,92,6374,8.6915297092,11.694058154,17.383059418,-1,0.3160556258,-3.002528445,17.699115044
51,530,2004,40,84,225,524,1,-44,226,171,6545,6.1924297546,13.004102485,34.83241737,-11,0.1548107439,-6.81167273,34.987228114
51,530,2005,59,79,-27,521,2,-20,-25,-52,6493,9.0504678632,12.118423071,-4.141739531,-7,0.3067955208,-3.067955208,-3.83494401
51,530,2006,39,75,105,616,1,-36,106,67,6560,5.9756377844,11.491611124,16.088255573,-3,0.1532214817,-5.515973339,16.241477055
51,530,2007,50,73,-8,591,2,-23,-6,-28,6532,7.6382523679,11.151848457,-1.222120379,1,0.3055300947,-3.513596089,-0.916590284
51,530,2008,53,77,-43,591,1,-24,-42,-61,6471,8.1519649312,11.843420749,-6.61385834,5,0.1538106591,-3.691455818,-6.460047681
51,540,2001,530,329,-546,1855,187,201,-359,644,40750,13.109725933,8.1379242109,-13.50549124,802,4.6255070743,4.9718017216,-8.879984169
51,540,2002,512,347,-568,1946,173,165,-395,419,41169,12.50015259,8.4717831028,-13.86735678,649,4.2236843711,4.0283694869,-9.643672408
51,540,2003,485,323,-1436,1576,152,162,-1284,-439,40730,11.843856457,7.8877641974,-35.06758324,683,3.7118890341,3.95609226,-31.35569421
51,540,2004,517,308,-926,1869,145,209,-781,15,40745,12.691009512,7.5606014115,-22.73089905,587,3.5593740411,5.1304081006,-19.17152501
51,540,2005,472,309,-257,1932,153,163,-104,60,40805,11.575720417,7.5781729001,-6.302881668,1,3.7522992029,3.9975475169,-2.550582465
51,540,2006,535,264,-247,1901,153,271,-94,177,40982,13.082763764,6.455793708,-6.040079719,0,3.741425899,6.6269700564,-2.29865382
51,540,2007,505,303,-107,1910,135,202,28,224,41206,12.288898623,7.3733391736,-2.603786441,-6,3.285151117,4.9155594491,0.6813646761
51,540,2008,526,346,-27,1910,135,180,108,281,41487,12.721753957,8.3683020328,-0.653017789,-7,3.2650889434,4.3534519246,2.6120711548
51,550,2001,2789,1332,918,4218,66,1457,984,2236,202510,13.848613649,6.6139667911,4.5582744101,-205,0.3277190752,7.2346468579,4.8859934853
51,550,2002,2738,1455,1220,4000,-264,1283,956,2065,204575,13.451736124,7.1483842441,5.9938342115,-174,-1.29702642,6.3033518798,4.696807792
51,550,2003,2840,1437,3381,4056,-890,1403,2491,3853,208428,13.752926734,6.9587872243,16.372762425,-41,-4.309896054,6.7941395099,12.062866371
51,550,2004,2911,1381,2938,4151,503,1530,3441,4741,213169,13.809396177,6.5512800139,13.93748058,-230,2.3861649869,7.2581161631,16.323645567
51,550,2005,3002,1510,2024,4057,-5,1492,2019,3310,216479,13.974230067,7.0290097941,9.4216661081,-201,-0.023274867,6.9452202733,9.3983912412
51,550,2006,2833,1394,282,4183,276,1439,558,1891,218370,13.029810348,6.411420976,1.2970019478,-106,1.2694061617,6.6183893719,2.5664081095
51,550,2007,3009,1517,-1062,4307,7,1492,-1055,460,218830,13.764867338,6.9396157365,-4.858188472,23,0.0320219579,6.8252516011,-4.826166514
51,550,2008,3093,1517,-413,4307,102,1576,-311,1281,220111,14.093010222,6.912090691,-1.881801882,16,0.4647549443,7.1809195313,-1.417046938
51,570,2001,202,206,135,234,22,-4,157,135,17045,11.898100427,12.133706376,7.9517007804,-18,1.2958327198,-0.235605949,9.2475335002
51,570,2002,222,219,65,234,17,3,82,65,17110,12.999560826,12.823891085,3.8061777192,-20,0.995461865,0.1756697409,4.8016395842
51,570,2003,188,206,105,234,-2,-18,103,63,17173,10.96753493,12.017618061,6.1254849342,-22,-0.116675904,-1.050083132,6.0088090307
51,570,2004,220,217,263,234,18,3,281,265,17438,12.712721389,12.539366097,15.19748057,-19,1.04013175,0.1733552917,16.23761232
51,570,2005,222,229,87,234,12,-7,99,78,17516,12.70240888,13.102935286,4.9779710477,-14,0.6866166962,-0.400526406,5.6645877439
51,570,2006,233,207,234,234,17,26,251,268,17784,13.201133144,11.728045326,13.257790368,-9,0.9631728045,1.4730878187,14.220963173
51,570,2007,226,207,-53,234,10,19,-43,-28,17756,12.718064153,11.64884637,-2.982554868,-4,0.5627462015,1.0692177828,-2.419808666
51,570,2008,228,224,9,234,11,4,20,12,17768,12.836392298,12.611192433,0.506699696,-12,0.6192996284,0.2251998649,1.1259993244
51,580,2001,97,120,94,59,17,-23,111,81,6375,15.312968664,18.943878759,14.839371695,-7,2.6837161575,-3.630910096,17.523087852
51,580,2002,65,80,-8,54,17,-15,9,-11,6364,10.204882644,12.559855562,-1.255985556,-5,2.6689693069,-2.354972918,1.4129837507
51,580,2003,58,85,-18,67,13,-27,-5,-40,6324,9.1424968474,13.398486759,-2.837326608,-8,2.0491803279,-4.255989912,-0.78814628
51,580,2004,64,69,-28,75,11,-5,-17,-27,6297,10.141827114,10.934157357,-4.437049362,-5,1.7431265351,-0.792330243,-2.693922827
51,580,2005,34,106,-52,80,13,-72,-39,-114,6183,5.4487179487,16.987179487,-8.333333333,-3,2.0833333333,-11.53846154,-6.25
51,580,2006,44,84,-60,62,12,-40,-48,-91,6092,7.1690427699,13.686354379,-9.775967413,-3,1.9551934827,-6.517311609,-7.820773931
51,580,2007,45,74,92,86,11,-29,103,76,6168,7.3409461664,12.07177814,15.008156607,2,1.7944535073,-4.730831974,16.802610114
51,580,2008,51,81,-31,86,10,-30,-21,-48,6120,8.30078125,13.18359375,-5.045572917,3,1.6276041667,-4.8828125,-3.41796875
51,590,2001,577,757,-416,1664,45,-180,-371,-590,47665,12.030859049,15.783986656,-8.673894912,-39,0.9382819016,-3.753127606,-7.735613011
51,590,2002,568,781,-187,1630,44,-213,-143,-395,47270,11.966082056,16.453362827,-3.939537578,-39,0.9269500184,-4.487280771,-3.01258756
51,590,2003,597,752,-177,1720,33,-155,-144,-348,46922,12.676235774,15.967385765,-3.758280958,-49,0.7006964498,-3.291149992,-3.057584508
51,590,2004,583,699,-531,1675,40,-116,-491,-659,46263,12.512743467,15.002414552,-11.39668402,-52,0.8585072705,-2.489671084,-10.53817675
51,590,2005,577,679,-504,1624,37,-102,-467,-606,45657,12.554395126,14.773716275,-10.96605744,-37,0.8050478677,-2.219321149,-10.16100957
51,590,2006,571,746,-231,1658,39,-175,-192,-389,45268,12.559802035,16.409128403,-5.081110806,-22,0.8578498763,-3.849326368,-4.223260929
51,590,2007,621,752,-197,1645,34,-131,-163,-300,44968,13.763907975,16.66740547,-4.366328295,-6,0.7535795026,-2.903497495,-3.612748792
51,590,2008,569,748,-154,1645,34,-179,-120,-308,44660,12.696925068,16.691212568,-3.436426117,-9,0.7586914803,-3.994287499,-2.677734636
51,595,2001,96,119,-41,274,17,-23,-24,-53,5612,17.025804735,21.104903786,-7.271437439,-6,3.0149862552,-4.079099051,-4.256451184
51,595,2002,76,102,105,277,16,-26,121,91,5703,13.43349536,18.029164825,18.559434379,-4,2.8281042863,-4.595669465,21.387538665
51,595,2003,72,106,-69,263,13,-34,-56,-93,5610,12.728719173,18.739503226,-12.19835587,-3,2.2982409617,-6.010784054,-9.900114912
51,595,2004,58,105,-32,258,14,-47,-18,-70,5540,10.403587444,18.834080717,-5.739910314,-5,2.5112107623,-8.430493274,-3.228699552
51,595,2005,63,90,14,292,14,-27,28,-3,5537,11.374921007,16.249887154,2.5277602239,-4,2.5277602239,-4.874966146,5.0555204478
51,595,2006,54,88,100,333,14,-34,114,78,5615,9.6843615495,15.781922525,17.934002869,-2,2.5107604017,-6.097560976,20.444763271
51,595,2007,52,78,-7,328,13,-26,6,-23,5592,9.2799143393,13.919871509,-1.249219238,-3,2.3199785848,-4.63995717,1.0707593468
51,595,2008,59,92,84,328,12,-33,96,51,5643,10.502892746,16.377392078,14.953271028,-12,2.1361815754,-5.874499332,17.089452603
51,600,2001,297,169,-149,600,303,128,154,263,21899,13.644194326,7.7638681521,-6.845067187,-19,13.919834616,5.8803261743,7.0747674285
51,600,2002,229,198,-159,600,284,31,125,139,22038,10.424016205,9.012904841,-7.237635706,-17,12.927600883,1.411111364,5.6899651774
51,600,2003,379,213,-249,600,231,166,-18,135,22173,17.145054398,9.635611047,-11.26416503,-13,10.449888037,7.5094433512,-0.81427699
51,600,2004,267,215,-423,600,247,52,-176,-153,22020,12.083361618,9.7300477451,-19.14330324,-29,11.178240898,2.3533138732,-7.96506234
51,600,2005,184,212,-312,600,243,-28,-69,-110,21910,8.3769633508,9.6517186433,-14.20441612,-13,11.06305486,-1.274755293,-3.141361257
51,600,2006,339,161,447,600,251,178,698,862,22772,15.173895528,7.2064813571,20.008056936,-14,11.234949197,7.9674141713,31.243006132
51,600,2007,347,223,130,595,219,124,349,455,23227,15.087284506,9.6958629535,5.6522967891,-18,9.5219461293,5.3914215526,15.174242918
51,600,2008,346,222,288,595,221,124,509,617,23844,14.701196066,9.4325593253,12.236833719,-16,9.3900703193,5.2686367402,21.626904039
51,610,2001,95,77,41,71,70,18,111,116,10508,9.0909090909,7.3684210526,3.9234449761,-13,6.6985645933,1.7224880383,10.622009569
51,610,2002,184,69,-122,71,66,115,-56,51,10559,17.468078037,6.5505292638,-11.58209522,-8,6.2657236436,10.917548773,-5.316371576
51,610,2003,214,76,-200,71,58,138,-142,-4,10555,20.270910296,7.1990148716,-18.94477598,0,5.4939850336,13.071895425,-13.45079094
51,610,2004,102,84,-86,71,67,18,-19,-11,10544,9.6687046779,7.962462676,-8.152045121,-10,6.3510118963,1.706242002,-1.801033224
51,610,2005,111,90,167,71,64,21,231,246,10790,10.405924815,8.4372363364,15.655760757,-6,5.9998125059,1.9686884785,21.655573263
51,610,2006,127,73,-95,71,68,54,-27,21,10811,11.758714874,6.7589463451,-8.795889079,-6,6.2960048146,4.9997685292,-2.499884265
51,610,2007,132,71,-21,71,62,61,41,95,10906,12.15637519,6.5386563522,-1.93396878,-7,5.7098125892,5.6177188378,3.775843809
51,610,2008,139,71,144,71,62,68,206,263,11169,12.593431484,6.4326160815,13.046432616,-11,5.617214043,6.160815402,18.663646659
51,620,2001,138,162,-45,274,4,-24,-41,-73,8204,16.746556641,19.659001274,-5.460833687,-8,0.4854074389,-2.912444633,-4.975426248
51,620,2002,118,123,-78,274,4,-5,-74,-85,8119,14.45812657,15.070759052,-9.557066716,-6,0.4901059854,-0.612632482,-9.06696073
51,620,2003,130,131,103,274,1,-1,104,97,8216,15.916743189,16.039179676,12.610958066,-6,0.1224364861,-0.122436486,12.733394552
51,620,2004,163,140,75,274,4,23,79,94,8310,19.726491589,16.942998911,9.0766065594,-8,0.4840856832,2.7834926782,9.5606922425
51,620,2005,154,113,93,274,2,41,95,128,8438,18.390255553,13.494148555,11.105803678,-8,0.2388344877,4.8961069979,11.344638166
51,620,2006,143,124,226,274,3,19,229,244,8682,16.705607477,14.485981308,26.401869159,-4,0.3504672897,2.2196261682,26.752336449
51,620,2007,187,123,140,274,2,64,142,200,8882,21.293554999,14.005921202,15.94169893,-6,0.2277385561,7.2876337964,16.169437486
51,620,2008,180,133,-45,274,2,47,-43,-5,8877,20.271411679,14.978320851,-5.06785292,-9,0.2252379075,5.2930908272,-4.842615012
51,630,2001,364,229,382,2318,48,135,430,540,19904,18.539268616,11.66344097,19.456045635,-25,2.4447387185,6.8758276459,21.900784354
51,630,2002,362,220,234,2378,39,142,273,390,20294,18.010846311,10.9458182,11.642370267,-25,1.9403950445,7.0650281109,13.582765312
51,630,2003,378,211,-70,2234,23,167,-47,102,20396,18.579503564,10.37109855,-3.440648808,-18,1.1304988941,8.2084050135,-2.310149914
51,630,2004,391,209,667,2697,46,182,713,862,21258,18.773707207,10.035050655,32.025735824,-33,2.2086714361,8.7386565516,34.23440726
51,630,2005,381,189,-214,2668,38,192,-176,6,21264,17.920135459,8.8895160152,-10.06537792,-10,1.7873100983,9.0306194441,-8.278067824
51,630,2006,390,216,539,2633,43,174,582,740,22004,18.02717944,9.9842839974,24.914486457,-16,1.9876120921,8.0428954424,26.902098549
51,630,2007,433,198,148,2648,35,235,183,383,22387,19.508458922,8.9207271744,6.668018292,-35,1.5768962177,10.587731747,8.2449145097
51,630,2008,429,233,255,2648,36,196,291,431,22818,18.980201305,10.308594182,11.281937839,-56,1.5927441655,8.6716071231,12.874682004
51,640,2001,123,123,-178,139,29,0,-149,-153,6702,18.145607435,18.145607435,-26.25949694,-4,4.2782326473,0,-21.98126429
51,640,2002,112,96,-86,139,29,16,-57,-45,6657,16.767722135,14.372333258,-12.87521521,-4,4.3416423385,2.3953888764,-8.533572872
51,640,2003,84,92,-13,139,27,-8,14,-2,6655,12.620192308,13.822115385,-1.953125,-8,4.0564903846,-1.201923077,2.1033653846
51,640,2004,98,100,28,139,18,-2,46,39,6694,14.682747771,14.982395685,4.1950707918,-5,2.6968312233,-0.299647914,6.8919020151
51,640,2005,78,96,21,139,24,-18,45,21,6715,11.63397718,14.318741144,3.1322246253,-6,3.579685286,-2.684763965,6.7119099113
51,640,2006,77,86,31,139,22,-9,53,40,6755,11.43281366,12.769116555,4.6028210839,-4,3.2665181886,-1.336302895,7.8693392725
51,640,2007,86,99,17,139,19,-13,36,20,6775,12.712490761,14.634146341,2.5129342203,-3,2.8085735403,-1.92165558,5.3215077605
51,640,2008,92,95,22,139,18,-3,40,33,6808,13.546344696,13.988073327,3.2393432968,-4,2.6503717883,-0.441728631,5.889715085
51,650,2001,2009,1143,-2071,12310,82,866,-1989,-1220,145196,13.7785825,7.8391835727,-14.20380506,-97,0.5623911225,5.9393989273,-13.64141393
51,650,2002,1896,1143,-608,12567,-275,753,-883,-257,144939,13.069777862,7.8790907681,-4.191152395,-127,-1.895669257,5.1906870939,-6.086821652
51,650,2003,1825,1119,746,12620,-952,706,-206,349,145288,12.57636264,7.7112053668,5.1408035779,-151,-6.560382046,4.8651572734,-1.419578468
51,650,2004,1935,1170,-1369,11995,550,765,-819,-183,145105,13.326767519,8.0580454763,-9.428601929,-129,3.7879700957,5.2687220422,-5.640631833
51,650,2005,1982,1099,1003,12823,3,883,1006,1754,146859,13.577016344,7.52832541,6.8707100875,-135,0.0205504788,6.0486909345,6.8912605664
51,650,2006,2080,1023,-1658,12321,308,1057,-1350,-356,146503,14.180432367,6.9743184189,-11.3034408,-63,2.0997947928,7.206113948,-9.203646007
51,650,2007,2069,1123,-996,12352,9,946,-987,-37,146466,14.124361281,7.6663401247,-6.799354198,4,0.0614399476,6.4580211558,-6.73791425
51,650,2008,2046,1126,-2023,12352,113,920,-1910,-972,145494,14.015618578,7.7133853953,-13.85806275,18,0.7740786409,6.3022331826,-13.08398411
51,660,2001,488,317,436,7278,281,171,717,847,41284,11.943074608,7.7581037922,10.670451903,-41,6.8770573047,4.1849708153,17.547509208
51,660,2002,498,221,299,7431,264,277,563,806,42090,11.946170269,5.3014129105,7.1724998201,-34,6.3329095401,6.6447573584,13.50540936
51,660,2003,512,218,-570,7187,232,294,-338,-64,42026,12.173664939,5.1833182748,-13.55271292,-20,5.5161919254,6.9903466641,-8.036520995
51,660,2004,547,250,-261,6981,227,297,-34,225,42251,12.981003121,5.9328167828,-6.193860721,-38,5.3869976387,7.0481863379,-0.806863082
51,660,2005,523,276,-97,7272,231,247,134,348,42599,12.327637006,6.5055981143,-2.286387743,-33,5.4449027696,5.8220388922,3.1585150265
51,660,2006,538,285,364,7325,250,253,614,843,43442,12.505665903,6.6247486663,8.4610825072,-24,5.8111830406,5.8809172371,14.272265548
51,660,2007,580,266,-211,7199,225,314,14,314,43756,13.30305741,6.1010573637,-4.83956054,-14,5.1606688227,7.2020000459,0.3211082823
51,660,2008,630,250,-329,7199,225,380,-104,259,44015,14.355538845,5.696642399,-7.496781397,-17,5.1269781591,8.6588964464,-2.369803238
51,670,2001,367,289,-128,251,16,78,-112,-54,22249,16.475130185,12.973603879,-5.746094451,-20,0.7182618064,3.5015263063,-5.027832645
51,670,2002,367,293,158,251,11,74,169,223,22472,16.412870911,13.103463697,7.0660316183,-20,0.4919389101,3.3094072136,7.5579705284
51,670,2003,322,268,-211,251,-2,54,-213,-175,22297,14.384953874,11.972570305,-9.426165427,-16,-0.08934754,2.412383569,-9.515512967
51,670,2004,342,263,-65,251,19,79,-46,15,22312,15.333228721,11.791342554,-2.914210137,-18,0.85184604,3.5418861665,-2.062364097
51,670,2005,346,287,151,251,12,59,163,202,22514,15.437469326,12.805068487,6.7371614688,-20,0.5354035604,2.6324008388,7.2725650292
51,670,2006,354,265,117,251,18,89,135,213,22727,15.649521452,11.715037245,5.1722994629,-11,0.7957383789,3.9344842068,5.9680378418
51,670,2007,382,232,172,251,10,150,182,339,23066,16.683772629,10.13255301,7.5120651628,7,0.4367479746,6.5512196187,7.9488131374
51,670,2008,372,272,-39,251,11,100,-28,76,23142,16.101108033,11.772853186,-1.688019391,4,0.4761080332,4.3282548476,-1.211911357
51,678,2001,92,91,78,2365,5,1,83,76,6902,13.403263403,13.257575758,11.363636364,-8,0.7284382284,0.1456876457,12.092074592
51,678,2002,29,77,32,2375,4,-48,36,-21,6881,4.2080824204,11.173184358,4.6434012914,-9,0.5804251614,-6.965101937,5.2238264529
51,678,2003,32,51,-106,2235,0,-19,-106,-127,6754,4.6938027136,7.4807480748,-15.54822149,-2,0,-2.786945361,-15.54822149
51,678,2004,25,53,84,2264,7,-28,91,57,6811,3.6859565057,7.8142277921,12.384813859,-6,1.0320678216,-4.128271286,13.416881681
51,678,2005,36,62,107,2340,4,-26,111,78,6889,5.2554744526,9.0510948905,15.620437956,-7,0.5839416058,-3.795620438,16.204379562
51,678,2006,24,70,148,2469,6,-46,154,105,6994,3.4574659656,10.084275733,21.321040121,-3,0.8643664914,-6.626809767,22.185406612
51,678,2007,32,53,44,2470,4,-21,48,26,7020,4.5668617097,7.5638647067,6.2794348509,-1,0.5708577137,-2.997002997,6.8502925646
51,678,2008,33,60,10,2470,4,-27,14,-17,7003,4.7065535192,8.5573700349,1.4262283392,-4,0.5704913357,-3.850816516,1.9967196748
51,680,2001,803,828,-508,6600,128,-25,-380,-467,64812,12.345204511,12.729550853,-7.809917673,-62,1.9678532719,-0.384346342,-5.842064401
51,680,2002,864,802,29,7161,126,62,155,148,64960,13.315661314,12.360139321,0.4469377061,-69,1.9418672749,0.9555219924,2.388804981
51,680,2003,875,780,916,8054,107,95,1023,1069,66029,13.35990045,11.909396972,13.985907214,-49,1.6337249693,1.4505034774,15.619632183
51,680,2004,893,790,268,8590,103,103,371,430,66459,13.480466155,11.925608357,4.0456494173,-44,1.5548577984,1.5548577984,5.6005072157
51,680,2005,837,727,1342,9279,104,110,1446,1507,67966,12.453040729,10.816440394,19.966524084,-49,1.5473312256,1.6366003348,21.51385531
51,680,2006,966,737,1642,9733,107,229,1749,1936,69902,14.013404126,10.691385963,23.819885688,-42,1.5522093597,3.3220181623,25.372095047
51,680,2007,990,784,1583,10284,94,206,1677,1848,71750,13.977917714,11.069381301,22.350549233,-35,1.3271962274,2.9085364132,23.677745461
51,680,2008,1038,789,563,10284,94,249,657,846,72596,14.382109653,10.932066008,7.8007010932,-60,1.302426115,3.4500436451,9.1031272082
51,683,2001,719,222,-218,935,231,497,13,473,35828,20.201452594,6.2374443336,-6.125057949,-37,6.4903136985,13.96400826,0.3652557493
51,683,2002,631,163,-192,882,211,468,19,453,36281,17.50128278,4.5209335867,-5.325271464,-34,5.8522514527,12.980349194,0.5269799886
51,683,2003,753,198,-298,936,164,555,-134,389,36670,20.643993914,5.4283011885,-8.169867445,-32,4.4961686612,15.215692725,-3.673698784
51,683,2004,633,202,-291,961,180,431,-111,285,36955,17.19524618,5.4872665535,-7.904923599,-35,4.8896434635,11.707979626,-3.015280136
51,683,2005,642,195,-780,949,184,447,-596,-168,36787,17.412058257,5.2887092837,-21.15483713,-19,4.9903718369,12.123348973,-16.1644653
51,683,2006,785,211,-1506,981,191,574,-1315,-753,36034,21.559714917,5.795031653,-41.36169512,-12,5.2457395532,15.764683264,-36.11595556
51,683,2007,693,184,-1356,987,165,509,-1191,-675,35359,19.413668007,5.1545669744,-37.98691748,7,4.6223019063,14.259101032,-33.36461558
51,683,2008,616,197,-717,987,167,419,-550,-154,35205,17.459327703,5.5835836971,-20.32197721,-23,4.7332917635,11.875744005,-15.58868545
51,685,2001,218,42,70,2,73,176,143,308,10647,20.775755265,4.0026684456,6.6711140761,-11,6.957018965,16.77308682,13.628133041
51,685,2002,224,25,-58,2,70,199,12,202,10849,20.841086714,2.3260141422,-5.39635281,-9,6.5128395981,18.515072572,1.1164867882
51,685,2003,218,27,-220,2,60,191,-160,29,10878,20.067197496,2.4853868459,-20.25130023,-2,5.5230818797,17.58181065,-14.72821835
51,685,2004,256,37,151,2,63,219,214,421,11299,23.086982008,3.3367903684,13.617712044,-12,5.6815619786,19.75019164,19.299274023
51,685,2005,286,36,-37,2,62,250,25,263,11562,25.020777744,3.1494685272,-3.236953764,-12,5.4240846857,21.871309217,2.1871309217
51,685,2006,310,37,-452,2,64,273,-388,-118,11444,26.949491437,3.2165522038,-39.29409719,-3,5.5637659741,23.732939233,-33.73033122
51,685,2007,271,26,-326,2,51,245,-275,-24,11420,23.705388383,2.2743177047,-28.51644507,6,4.4611616515,21.431070679,-24.05528341
51,685,2008,234,18,-366,2,51,216,-315,-101,11319,20.581380008,1.5831830775,-32.19138924,-2,4.4856853863,18.99819693,-27.70570386
51,690,2001,208,302,-7,743,42,-94,35,-78,15277,13.580569339,19.717942021,-0.457038391,-19,2.7422303473,-6.137372682,2.2851919561
51,690,2002,192,252,-207,692,40,-60,-167,-236,15041,12.665743123,16.623787849,-13.6552543,-9,2.6386964839,-3.958044726,-11.01655782
51,690,2003,166,231,34,650,35,-65,69,-17,15024,11.042740728,15.366705471,2.2617661733,-21,2.3282887078,-4.323964743,4.5900548811
51,690,2004,149,241,-218,688,36,-92,-182,-293,14731,10.015123509,16.198958158,-14.6529995,-19,2.4197613846,-6.18383465,-12.23323811
51,690,2005,164,223,47,691,35,-59,82,12,14743,11.128452195,15.131980729,3.1892515437,-11,2.3749745538,-4.003528534,5.5642260976
51,690,2006,120,244,38,704,38,-124,76,-56,14687,8.1549439348,16.581719334,2.5823989127,-8,2.5823989127,-8.426775399,5.1647978253
51,690,2007,156,223,-98,695,31,-67,-67,-142,14545,10.673234811,15.257252326,-6.704980843,-8,2.1209633279,-4.584017515,-4.584017515
51,690,2008,148,257,91,695,31,-109,122,-2,14543,10.176017602,17.670517052,6.2568756876,-15,2.1314631463,-7.49449945,8.3883388339
51,700,2001,3191,1438,-2229,4192,214,1753,-2015,-387,180192,17.689891926,7.9718159165,-12.35686904,-125,1.1863481267,9.7180760094,-11.17052091
51,700,2002,3128,1354,-246,4177,-318,1774,-564,1038,181230,17.309405626,7.4926263481,-1.361289573,-172,-1.759715789,9.8167792774,-3.121005362
51,700,2003,3187,1421,1321,4308,-1322,1766,-1,1596,182826,17.508295427,7.806491309,7.2571252774,-169,-7.262618938,9.701804118,-0.00549366
51,700,2004,3230,1452,-1487,4597,878,1778,-609,1006,183832,17.618598258,7.9201872044,-8.111100808,-163,4.7892041085,9.6984110534,-3.321896699
51,700,2005,3227,1403,-3369,4961,75,1824,-3294,-1619,182213,17.631711948,7.6657241596,-18.40757284,-149,0.4097856821,9.9659877884,-17.99778716
51,700,2006,3233,1360,-2739,5036,541,1873,-2198,-401,181812,17.762516311,7.4720142847,-15.048417,-76,2.9723233294,10.290502026,-12.07609367
51,700,2007,3176,1396,-2980,5062,103,1780,-2877,-1002,180810,17.51686329,7.699477693,-16.4358478,95,0.5680846722,9.8173855971,-15.86776313
51,700,2008,3142,1389,-3309,5062,255,1753,-3054,-1196,179614,17.435020975,7.7075888398,-18.36170732,105,1.415000111,9.7274321355,-16.94670721
51,710,2001,4075,2057,-1899,23926,106,2018,-1793,424,234688,17.3791774,8.7727528617,-8.09890991,199,0.4520718538,8.6064245381,-7.646838056
51,710,2002,4137,2094,4556,28831,-1336,2043,3220,5532,240220,17.422321797,8.8185501192,19.186874089,269,-5.626352894,8.6037716779,13.560521196
51,710,2003,3990,2042,2267,29524,-4074,1948,-1807,350,240570,16.59768298,8.4943530439,9.4303126105,209,-16.94710788,8.1033299361,-7.516795274
51,710,2004,4087,2018,-3160,29843,2077,2069,-1083,1147,241717,16.948414533,8.368461103,-13.10423047,161,8.6131286972,8.5799534302,-4.491101771
51,710,2005,4026,1975,-6565,25725,-178,2051,-6743,-4527,237190,16.813285252,8.2479479314,-27.41659654,165,-0.743359358,8.5653373202,-28.1599559
51,710,2006,4124,1959,-1780,28228,1071,2165,-709,1642,238832,17.326930268,8.2307120259,-7.478645945,186,4.4997920264,9.096218242,-2.978853919
51,710,2007,4084,2023,-4930,26385,-110,2061,-5040,-2850,235982,17.202525621,8.5212314717,-20.76602628,129,-0.463339329,8.6812941489,-21.2293656
51,710,2008,4205,1954,-4430,26385,313,2251,-4117,-1762,234220,17.885929877,8.3113215171,-18.84296536,104,1.3313426995,9.5746083598,-17.51162266
51,720,2001,63,61,-41,49,5,2,-36,-38,3843,16.3127913,15.794924909,-10.616261,-4,1.2946659762,0.5178663905,-9.321595028
51,720,2002,23,42,31,49,5,-19,36,15,3858,5.9732502272,10.907674328,8.0509024802,-2,1.2985326581,-4.934424101,9.3494351383
51,720,2003,30,44,8,49,4,-14,12,-7,3851,7.7831106499,11.415228953,2.0754961733,-5,1.0377480867,-3.632118303,3.11324426
51,720,2004,40,63,-86,49,3,-23,-83,-112,3739,10.540184453,16.600790514,-22.66139657,-6,0.790513834,-6.060606061,-21.87088274
51,720,2005,26,57,-67,49,4,-31,-63,-97,3642,7.045115838,15.445061645,-18.15472158,-3,1.0838639751,-8.399945807,-17.07085761
51,720,2006,37,34,34,49,3,3,37,38,3680,10.106528271,9.2870800328,9.2870800328,-2,0.8194482382,0.8194482382,10.106528271
51,720,2007,43,35,18,49,4,8,22,29,3709,11.638922723,9.4735417513,4.8721071864,-1,1.0826904859,2.1653809717,5.9547976722
51,720,2008,41,45,-7,49,3,-4,-4,-7,3702,11.064633653,12.144110107,-1.889083794,1,0.8096073404,-1.079476454,-1.079476454
51,730,2001,530,494,-306,921,16,36,-290,-282,33299,15.849282297,14.772727273,-9.150717703,-28,0.4784688995,1.0765550239,-8.672248804
51,730,2002,572,495,-336,922,-2,77,-338,-283,33016,17.25099902,14.928749152,-10.13345397,-22,-0.060318178,2.3222498681,-10.19377215
51,730,2003,515,496,26,926,-39,19,-13,-42,32974,15.608425519,15.032580694,0.7879981815,-48,-1.181997272,0.575844825,-0.393999091
51,730,2004,554,464,-391,932,40,90,-351,-296,32678,16.876865899,14.135136782,-11.91128983,-35,1.2185462743,2.7417291172,-10.69274356
51,730,2005,494,496,-272,917,11,-2,-261,-291,32387,15.184815185,15.246292169,-8.360869899,-28,0.338123415,-0.061476985,-8.022746484
51,730,2006,522,436,215,906,27,86,242,311,32698,16.040562342,13.397864331,6.6067450257,-17,0.829684259,2.6426980103,7.4364292848
51,730,2007,576,456,69,901,11,120,80,209,32907,17.559637223,13.901379468,2.103498209,9,0.3353402942,3.6582577547,2.4388385032
51,730,2008,570,473,-128,901,16,97,-112,9,32916,17.319174149,14.371876092,-3.889218054,24,0.4861522568,2.9472980569,-3.403065798
51,735,2001,95,69,-116,98,3,26,-113,-95,11479,8.2418774129,5.9862056999,-10.0637661,-8,0.260269813,2.255671713,-9.803496291
51,735,2002,77,84,163,98,-6,-7,157,143,11622,6.6663780789,7.2724124497,14.111943206,-7,-0.519458032,-0.606034371,13.592485174
51,735,2003,94,94,111,98,-24,0,87,78,11700,8.0610582283,8.0610582283,9.5189091845,-9,-2.058142526,0,7.4607666581
51,735,2004,92,89,-84,98,16,3,-68,-74,11626,7.8881934322,7.6309697333,-7.202263569,-9,1.3718597273,0.2572236989,-5.830403841
51,735,2005,95,93,76,98,1,2,77,68,11694,8.1475128645,7.9759862779,6.5180102916,-11,0.0857632933,0.1715265866,6.6037735849
51,735,2006,77,76,61,98,10,1,71,66,11760,6.5660441716,6.4807708706,5.2016713567,-6,0.8527330093,0.0852733009,6.054404366
51,735,2007,99,104,73,98,2,-5,75,74,11834,8.3919640587,8.8158006273,6.1880139018,4,0.1695346274,-0.423836569,6.3575485293
51,735,2008,103,108,1,98,4,-5,5,-5,11829,8.705574103,9.1281747876,0.0845201369,-5,0.3380805477,-0.422600685,0.4226006846
51,740,2001,1568,1095,-1060,4819,-22,473,-1082,-692,99737,15.666996393,10.940919037,-10.5912093,-83,-0.219817551,4.7260773558,-10.81102685
51,740,2002,1524,1070,-266,4833,-257,454,-523,-166,99571,15.292913481,10.737150541,-2.669235555,-97,-2.578923074,4.5557629398,-5.248158629
51,740,2003,1585,1090,226,4920,-698,495,-472,-101,99470,15.926366929,10.952517321,2.2708889123,-124,-7.013630358,4.9738496089,-4.742741445
51,740,2004,1634,1109,-429,5001,311,525,-118,332,99802,16.399694889,11.130515075,-4.305672648,-75,3.1213617568,5.2691798145,-1.184310892
51,740,2005,1603,1055,615,5080,-59,548,556,1006,100808,15.981257166,10.517920343,6.1312995364,-98,-0.588205972,5.4633368227,5.5430935646
51,740,2006,1675,1036,1138,5695,144,639,1282,1869,102677,16.46312996,10.18256874,11.185099639,-52,1.4153377399,6.2805612207,12.600437379
51,740,2007,1759,1031,-1469,5664,-47,728,-1516,-746,101931,17.193853613,10.077807319,-14.35916484,42,-0.459415077,7.1160462934,-14.81857992
51,740,2008,1716,1066,-2088,5664,22,650,-2066,-1354,100577,16.947478618,10.527979142,-20.62140755,62,0.2172753669,6.4194994766,-20.40413218
51,750,2001,142,131,285,2995,18,11,303,302,16161,8.8694565896,8.1823860087,17.801374141,-12,1.1242973142,0.6870705809,18.925671455
51,750,2002,134,99,-320,2746,16,35,-304,-274,15887,8.3624563155,6.178232651,-19.97004493,-5,0.9985022466,2.1842236645,-18.97154269
51,750,2003,125,106,-331,2644,12,19,-319,-298,15589,7.9425594103,6.73529038,-21.03189732,2,0.7624857034,1.2072690304,-20.26941162
51,750,2004,118,98,17,2659,15,20,32,43,15632,7.5590147657,6.2778258224,1.0890106018,-9,0.9608917075,1.2811889433,2.0499023093
51,750,2005,128,116,204,2855,13,12,217,217,15849,8.131889076,7.3695244751,12.960198215,-12,0.8258949843,0.7623646009,13.786093199
51,750,2006,130,128,117,2738,15,2,132,125,15974,8.170191371,8.0444961192,7.3531722339,-9,0.942714389,0.1256952519,8.2958866229
51,750,2007,139,116,128,2740,13,23,141,158,16132,8.6588176665,7.2260636641,7.9735874914,-6,0.8098174796,1.4327540024,8.783404971
51,750,2008,153,116,-52,2740,13,37,-39,-7,16125,9.4863130483,7.1922373438,-3.224106396,-5,0.8060265989,2.2940757045,-2.418079797
51,760,2001,3118,2415,-477,11547,446,703,-31,471,198204,15.749980426,12.198910433,-2.409474235,-201,2.2528836658,3.5510699935,-0.156590569
51,760,2002,3113,2291,-908,11663,408,822,-500,152,198356,15.700020173,11.554367561,-4.579382691,-170,2.0576961872,4.1456526125,-2.521686504
51,760,2003,3106,2307,-1392,12495,337,799,-1055,-432,197924,15.675784799,11.643282528,-7.025335621,-176,1.7008176037,4.0325022711,-5.324518018
51,760,2004,2947,2248,-1602,13041,361,699,-1241,-730,197194,14.917062751,11.378879221,-8.108969979,-188,1.8273022236,3.53818353,-6.281667755
51,760,2005,3043,2176,-692,12828,360,867,-332,392,197586,15.416181164,11.023861391,-3.505750038,-143,1.8238005978,4.392319773,-1.68194944
51,760,2006,3120,2049,-449,13133,372,1071,-77,894,198480,15.754949933,10.346760388,-2.267298885,-100,1.8784747997,5.4081895442,-0.388824085
51,760,2007,3028,2215,488,13153,331,813,819,1511,199991,15.198094717,11.117496631,2.4493626889,-121,1.6613505123,4.0805980862,4.1107132012
51,760,2008,3183,2302,937,13153,335,881,1272,2011,202002,15.836096648,11.452935748,4.6617727174,-142,1.6666956887,4.3831609008,6.3284684062
51,770,2001,1399,1260,-497,2674,186,139,-311,-256,94541,14.777804772,13.309531103,-5.249870602,-84,1.9647403057,1.4682736693,-3.285130296
51,770,2002,1025,1292,-1119,2616,179,-267,-940,-1265,93276,10.91487991,13.758073018,-11.91585426,-58,1.9061107354,-2.843193108,-10.00974353
51,770,2003,1273,1209,-717,2558,151,64,-566,-578,92698,13.690085711,13.001817458,-7.710755267,-76,1.6238829084,0.6882682526,-6.086872359
51,770,2004,1112,1199,-371,2565,157,-87,-214,-380,92318,12.020582004,12.961041207,-4.01046396,-79,1.6971505167,-0.940459204,-2.313313443
51,770,2005,1065,1233,102,2691,155,-168,257,23,92341,11.534774909,13.354345036,1.1047390054,-66,1.6787700572,-1.819570127,2.7835090627
51,770,2006,1345,1231,-160,2757,160,114,0,67,92408,14.56029532,13.326188504,-1.732079741,-47,1.7320797406,1.2341068152,0
51,770,2007,1290,1233,112,2644,147,57,259,255,92663,13.940595771,13.324615958,1.2103462995,-61,1.5885795181,0.6159798132,2.7989258177
51,770,2008,1171,1246,311,2644,148,-75,459,304,92967,12.616495179,13.424554221,3.3507514949,-80,1.5945698432,-0.808059042,4.9453213381
51,775,2001,226,373,-9,1737,20,-147,11,-163,24641,9.1414703206,15.087470927,-0.364040853,-27,0.8089796744,-5.946000607,0.4449388209
51,775,2002,245,297,202,1738,18,-52,220,150,24791,9.912607218,12.016507525,8.1728435022,-18,0.7282731834,-2.103900307,8.9011166855
51,775,2003,243,291,44,1844,14,-48,58,-23,24768,9.8064932706,11.743578361,1.775661333,-33,0.5649831514,-1.93708509,2.3406444844
51,775,2004,224,305,-177,1838,20,-81,-157,-261,24507,9.0918315576,12.37950279,-7.184170472,-23,0.8117706748,-3.287671233,-6.372399797
51,775,2005,229,263,303,1959,18,-34,321,264,24771,9.2942083688,10.674134502,12.297577012,-23,0.7305491294,-1.379926133,13.028126141
51,775,2006,211,324,393,1972,20,-113,413,287,25058,8.4689638564,13.004475306,15.773946898,-13,0.8027453892,-4.535511449,16.576692288
51,775,2007,226,283,108,1946,15,-57,123,63,25121,9.007752247,11.279618964,4.3045895693,-3,0.5978596624,-2.271866717,4.9024492318
51,775,2008,260,286,338,1946,15,-26,353,328,25449,10.28277635,11.311053985,13.367609254,1,0.5932370971,-1.028277635,13.960846352
51,790,2001,249,291,-150,2467,4,-42,-146,-209,23634,10.489289551,12.258567306,-6.318849127,-21,0.1685026434,-1.769277756,-6.150346484
51,790,2002,227,298,327,2605,4,-71,331,242,23876,9.555882972,12.544727426,13.765523048,-18,0.168385603,-2.988844454,13.933908651
51,790,2003,277,297,-618,1836,2,-20,-616,-619,23257,11.7539728,12.602635096,-26.22366495,17,0.0848662296,-0.848662296,-26.13879872
51,790,2004,278,325,-29,1804,5,-47,-24,-91,23166,11.976821834,14.001680202,-1.249380695,-20,0.2154104646,-2.024858368,-1.03397023
51,790,2005,256,282,278,1801,3,-26,281,237,23403,10.99443836,12.111061006,11.939272907,-18,0.1288410745,-1.116622646,12.068113981
51,790,2006,271,296,-52,1599,4,-25,-48,-85,23318,11.600779093,12.670961666,-2.225979752,-12,0.1712292117,-1.070182573,-2.05475054
51,790,2007,280,311,484,1571,3,-31,487,448,23766,11.893636904,13.210432419,20.559000935,-8,0.127431824,-1.316795514,20.686432758
51,790,2008,306,300,209,1571,3,6,212,201,23967,12.821318585,12.569920181,8.7570443928,-17,0.1256992018,0.2513984036,8.8827435946
51,800,2001,979,627,1867,1077,23,352,1890,2219,66414,14.99130994,9.6011760292,28.589147762,-23,0.3521962499,5.3901339111,28.941344012
51,800,2002,999,624,2533,1073,-53,375,2480,2866,69280,14.724306159,9.1971642077,37.334001503,11,-0.781169396,5.5271419517,36.552832108
51,800,2003,1080,651,3194,1120,-197,429,2997,3564,72844,15.197996116,9.1610143255,44.946666291,138,-2.772227069,6.0369817905,42.174439222
51,800,2004,1159,662,2378,1072,120,497,2498,2871,75715,15.603228347,8.9122840084,32.014216574,-124,1.6155197598,6.6909443386,33.629736334
51,800,2005,1156,652,1725,1109,2,504,1727,2168,77883,15.052279327,8.4896938762,22.461229964,-63,0.0260420058,6.5625854503,22.48727197
51,800,2006,1199,687,1727,1203,67,512,1794,2261,80144,15.174622058,8.6947167256,21.857024433,-45,0.8479563619,6.4799053326,22.704980794
51,800,2007,1214,672,447,1199,5,542,452,975,81119,15.056150512,8.3342118155,5.5437391094,-19,0.0620105046,6.7219386964,5.605749614
51,800,2008,1261,703,592,1199,27,558,619,1183,82302,15.432533151,8.603545444,7.2450909002,6,0.330434889,6.8289877066,7.5755257892
51,810,2001,6332,2434,-2868,7780,432,3898,-2436,1090,427578,14.827893863,5.6997936928,-6.716108591,-372,1.0116314196,9.1281001702,-5.704477172
51,810,2002,6163,2478,941,7647,-1235,3685,-294,2947,430525,14.364242987,5.7755304433,2.193209906,-444,-2.878442332,8.5887125438,-0.685232425
51,810,2003,6405,2638,6131,8182,-4392,3767,1739,5320,435845,14.785830534,6.0897768852,14.153306324,-186,-10.13885522,8.6960536491,4.0144511006
51,810,2004,6601,2565,-2941,7385,2579,4036,-362,3296,439141,15.088241412,5.8629509501,-6.722393273,-378,5.8949514621,9.2252904618,-0.82744181
51,810,2005,6422,2638,-5014,7120,45,3784,-4969,-1550,437591,14.649858794,6.0178024756,-11.43793086,-365,0.1026539467,8.6320563182,-11.33527691
51,810,2006,6527,2507,-4994,8674,1480,4020,-3514,317,437908,14.910353981,5.7270196768,-11.40835112,-189,3.3809290473,9.1833343042,-8.027422076
51,810,2007,6441,2723,-6931,8757,86,3718,-6845,-2904,435004,14.757501329,6.2388877688,-15.88018036,223,0.1970416262,8.5186135601,-15.68313874
51,810,2008,6370,2762,-5653,8757,569,3608,-5084,-1258,433746,14.664748201,6.3585611511,-13.01410072,218,1.3099280576,8.3061870504,-11.70417266
51,820,2001,298,269,175,265,22,29,197,205,19808,15.122681485,13.651011139,8.8807693284,-21,1.1164395727,1.4716703458,9.9972089011
51,820,2002,258,245,375,265,19,13,394,394,20202,12.896775806,12.246938265,18.745313672,-13,0.9497625594,0.6498375406,19.695076231
51,820,2003,293,227,222,265,10,66,232,279,20481,14.404050832,11.159452351,10.913649436,-19,0.4916058304,3.2445984809,11.405255266
51,820,2004,303,198,205,265,20,105,225,310,20791,14.683078116,9.5948827292,9.934095755,-20,0.9691800737,5.0881953867,10.903275829
51,820,2005,303,231,236,265,19,72,255,310,21101,14.465769121,11.028358636,11.267067698,-17,0.9070944333,3.4374104841,12.174162131
51,820,2006,277,229,244,265,21,48,265,301,21402,13.034374044,10.77570995,11.481542479,-12,0.9881655413,2.2586640943,12.469708021
51,820,2007,287,253,158,265,15,34,173,190,21592,13.350700098,11.769084058,7.3498627715,-17,0.6977717821,1.5816160394,8.0476345537
51,820,2008,311,231,273,265,15,80,288,361,21953,14.284073946,10.609714089,12.538753014,-7,0.6889424733,3.6743598576,13.227695487
51,830,2001,72,129,-38,4550,28,-57,-10,-81,11908,6.0258609867,10.796334268,-3.180315521,-14,2.3433903837,-4.770473281,-0.836925137
51,830,2002,107,147,-262,4528,25,-40,-237,-281,11627,9.0928404504,12.492033142,-22.26471213,-4,2.1244954323,-3.399192692,-20.1402167
51,830,2003,161,117,-163,4495,13,44,-150,-109,11518,13.912292072,10.110174984,-14.08511558,-3,1.123352776,3.8021170879,-12.9617628
51,830,2004,185,118,47,4495,24,67,71,130,11648,15.971682638,10.187343521,4.0576707243,-8,2.072002072,5.7843391177,6.1296727963
51,830,2005,191,105,146,4491,20,86,166,243,11891,16.228386932,8.9213645439,12.404944985,-9,1.6993075322,7.3070223884,14.104252517
51,830,2006,229,108,148,4592,22,121,170,285,12176,19.030207338,8.9749449454,12.298998629,-6,1.8282295259,10.055262392,14.127228155
51,830,2007,196,113,133,4596,19,83,152,221,12397,15.952468156,9.1970862329,10.824889106,-14,1.5464127294,6.7553819232,12.371301835
51,830,2008,226,123,-21,4596,19,103,-2,84,12481,18.168663076,9.8882546829,-1.688238604,-17,1.5274539754,8.280408393,-0.160784629
51,840,2001,350,268,334,714,141,82,475,530,24223,14.608898906,11.186242591,13.941063528,-27,5.8852992737,3.4226563152,19.826362802
51,840,2002,381,253,156,723,131,128,287,383,24606,15.60548035,10.362694301,6.3896454976,-32,5.3656638473,5.2427860493,11.755309345
51,840,2003,372,288,-123,724,107,84,-16,48,24654,15.103532278,11.693057247,-4.993909866,-20,4.3442955745,3.4104750305,-0.649614292
51,840,2004,407,213,244,724,104,194,348,520,25174,16.336196516,8.5494099703,9.7936902946,-22,4.1743597977,7.7867865457,13.968050092
51,840,2005,439,245,106,809,107,194,213,387,25561,17.305607569,9.6580270031,4.1785749483,-20,4.2179954666,7.6475805657,8.3965704149
51,840,2006,399,269,-42,787,107,130,65,182,25743,15.554342741,10.486511773,-1.637299236,-13,4.1712147201,5.0678309683,2.5339154842
51,840,2007,444,281,-307,845,96,163,-211,-65,25678,17.269209078,10.929386826,-11.94064682,-17,3.7338830439,6.3398222516,-8.206763774
51,840,2008,416,276,11,845,96,140,107,219,25897,16.131846825,10.702859913,0.4265632574,-28,3.7227338827,5.4289869123,4.1492971401
53,0,2001,80647,44434,16751,139498,25129,36213,41880,76077,5987181,13.556071316,7.4689755708,2.8156999097,-2016,4.2239700932,6.0870957453,7.0396700029
53,0,2002,78953,44739,14763,141706,21335,34214,36098,68432,6055613,13.112073494,7.4300033696,2.4517566272,-1880,3.5431976998,5.6820701243,5.994954327
53,0,2003,79570,45169,9318,141855,13773,34401,23091,54589,6110202,13.080915664,7.4255608852,1.5318332557,-2903,2.2642132895,5.6553547789,3.7960465452
53,0,2004,81796,45789,14793,142126,22101,36007,36894,69443,6179645,13.311150253,7.4515166869,2.4073529963,-3458,3.5966273624,5.8596335658,6.0039803587
53,0,2005,81743,46190,23579,139627,19615,35553,43194,74934,6254579,13.148066176,7.4294945949,3.7925969486,-3813,3.1550018723,5.7185715811,6.9475988208
53,0,2006,84845,45421,47614,142724,21301,39424,68915,105950,6360529,13.45133153,7.2010481401,7.5487264952,-2389,3.3770618531,6.2502833904,10.925788348
53,0,2007,86858,46840,31774,143454,17501,40018,49275,88982,6449511,13.560925649,7.3130138548,4.9607963753,-311,2.7323880331,6.2479117942,7.6931844085
53,0,2008,87302,47278,40588,143662,18456,40024,59044,99713,6549224,13.432383997,7.2742463017,6.2449153706,645,2.8396609362,6.1581376957,9.0845763068
53,1,2001,302,95,-623,245,152,207,-471,-270,16173,18.518518519,5.8253617856,-38.20210939,-6,9.320578857,12.693156733,-28.88153054
53,1,2002,353,108,-269,245,146,245,-123,113,16286,21.750516036,6.6545488154,-16.57475585,-9,8.9959641394,15.09596722,-7.578791706
53,1,2003,351,108,-285,245,133,243,-152,84,16370,21.496815287,6.6144047036,-17.45467908,-7,8.1455169035,14.882410583,-9.309162175
53,1,2004,367,115,-370,245,121,252,-249,-20,16350,22.432762836,7.0293398533,-22.61613692,-23,7.3960880196,15.403422983,-15.2200489
53,1,2005,402,120,-231,245,129,282,-102,166,16516,24.462970851,7.3023793586,-14.05708027,-14,7.8500578105,17.160591493,-6.207022455
53,1,2006,425,88,-412,245,125,337,-287,43,16559,25.699168556,5.321239607,-24.91307634,-7,7.5585789872,20.377928949,-17.35449735
53,1,2007,375,101,-62,245,114,274,52,328,16887,22.424206183,6.0395861986,-3.707468756,2,6.8169586797,16.384619984,3.1094899241
53,1,2008,417,99,-37,245,113,318,76,398,17285,24.405946389,5.794217488,-2.165515627,4,6.6136017792,18.611728901,4.4480861524
53,3,2001,230,186,-114,342,2,44,-112,-85,20470,11.212675198,9.0676416819,-5.557586837,-17,0.0975015235,2.1450335161,-5.460085314
53,3,2002,238,196,25,342,1,42,26,47,20517,11.613438407,9.5640081001,1.2198989924,-21,0.0487959597,2.0494303072,1.2686949521
53,3,2003,266,214,-32,342,-3,52,-35,-10,20507,12.968018721,10.432917317,-1.560062402,-27,-0.14625585,2.5351014041,-1.706318253
53,3,2004,280,200,230,342,2,80,232,291,20798,13.557680668,9.6840576201,11.136666263,-21,0.0968405762,3.8736230481,11.233506839
53,3,2005,246,223,108,342,0,23,108,112,20910,11.796298072,10.693392155,5.1788625683,-19,0,1.1029059173,5.1788625683
53,3,2006,247,188,90,342,2,59,92,141,21051,11.772836682,8.9607016039,4.2896975763,-10,0.0953266128,2.8121350778,4.3850241891
53,3,2007,252,227,6,342,0,25,6,34,21085,11.961268274,10.774634517,0.2847921018,3,0,1.1866337574,0.2847921018
53,3,2008,276,211,251,342,2,65,253,335,21420,12.986707446,9.928243736,11.81037525,17,0.0941065757,3.0584637102,11.904481826
53,5,2001,2116,999,961,823,539,1117,1500,2489,145574,14.66089746,6.9216618917,6.6583754534,-128,3.7345102699,7.7392355686,10.392885723
53,5,2002,2188,1000,2475,823,511,1188,2986,4097,149671,14.82158885,6.7740351234,16.76573693,-77,3.461531948,8.0475537266,20.227268878
53,5,2003,2148,987,1381,823,439,1161,1820,2842,152513,14.216503852,6.5324438091,9.1401265454,-139,2.905514521,7.6840600429,12.045641066
53,5,2004,2220,1020,258,823,403,1200,661,1763,154276,14.472487605,6.6495213323,1.6819377487,-98,2.6272128401,7.8229662732,4.3091505888
53,5,2005,2147,1068,290,823,419,1079,709,1654,155930,13.842414396,6.8857468908,1.8697252793,-134,2.7014306622,6.9566675048,4.5711559415
53,5,2006,2249,1029,-442,823,418,1220,-24,1119,157049,14.371571256,6.5755210413,-2.824470651,-77,2.6711057291,7.7960502142,-0.153364922
53,5,2007,2333,1069,97,823,392,1264,489,1732,158781,14.773770699,6.7694645854,0.614254504,-21,2.4823480987,8.004306114,3.0966026027
53,5,2008,2300,1066,2600,823,395,1234,2995,4277,163058,14.292860716,6.6244302275,16.157146896,48,2.4546434708,7.6684304885,18.611790367
53,7,2001,981,567,-699,1082,311,414,-388,-22,66656,14.714926425,8.5049574752,-10.48494758,-48,4.6649766751,6.2099689502,-5.8199709
53,7,2002,932,579,-389,1082,291,353,-98,200,66856,13.961291869,8.6733776739,-5.827191563,-55,4.3591587273,5.287914195,-1.468032836
53,7,2003,912,577,-89,1082,262,335,173,421,67277,13.598443336,8.6034011019,-1.327041071,-87,3.9065703444,4.9950422342,2.5795292732
53,7,2004,916,611,247,1082,238,305,485,744,68021,13.540481012,9.0319147364,3.6511995743,-46,3.5181599137,4.5085662759,7.1693594879
53,7,2005,895,547,317,1082,250,348,567,871,68892,13.073995895,7.9904757035,4.6306778757,-44,3.6519541607,5.0835201917,8.2826320364
53,7,2006,961,578,344,1082,247,383,591,933,69825,13.855547626,8.3335135564,4.959738172,-41,3.5612073502,5.5220340694,8.5209455222
53,7,2007,951,619,403,1082,224,332,627,869,70694,13.53553612,8.8101964859,5.7358791338,-90,3.1881809577,4.7253396338,8.9240600915
53,7,2008,972,638,398,1082,226,334,624,846,71540,13.66761815,8.9711320781,5.5964115472,-112,3.1778618333,4.6964860722,8.7742733805
53,9,2001,649,736,577,1522,73,-87,650,505,64791,10.056013077,11.404045647,8.9403999163,-58,1.1311077884,-1.34803257,10.071507705
53,9,2002,589,810,1221,1523,59,-221,1280,1020,65811,9.0197699882,12.404097946,18.698029127,-39,0.9035083689,-3.384327958,19.601537496
53,9,2003,589,835,790,1494,19,-246,809,514,66325,8.9150572138,12.638493673,11.957377248,-49,0.2875824908,-3.723436459,12.244959738
53,9,2004,635,831,1292,1523,70,-196,1362,1084,67409,9.4964631283,12.427654897,19.321937578,-82,1.0468542031,-2.931191769,20.368791781
53,9,2005,579,842,1556,1494,54,-263,1610,1292,68701,8.5078245537,12.372345897,22.863860113,-55,0.7934758651,-3.864521343,23.657335978
53,9,2006,650,852,1055,1500,62,-202,1117,878,69579,9.4012149262,12.322823257,15.258894996,-37,0.8967312699,-2.921608331,16.155626266
53,9,2007,669,860,898,1513,43,-191,941,738,70317,9.5642477269,12.294847601,12.838108309,-12,0.6147423801,-2.730599874,13.452850689
53,9,2008,696,872,839,1512,49,-176,888,704,71021,9.8487314098,12.339215215,11.872249501,-8,0.693373332,-2.490483805,12.565622833
53,11,2001,5408,2341,6610,3047,1539,3067,8149,10989,358515,15.319223671,6.631342939,18.724125086,-227,4.3595201978,8.6878807321,23.083645284
53,11,2002,5257,2362,6102,3040,1418,2895,7520,10185,368700,14.457897596,6.4960156212,16.781832058,-230,3.8998095474,7.9618819744,20.681641605
53,11,2003,5329,2477,4815,3041,1198,2852,6013,8574,377274,14.287361222,6.6409821254,12.909297107,-291,3.2119081898,7.6463790963,16.121205297
53,11,2004,5475,2605,8370,3017,1200,2870,9570,11955,389229,14.285658373,6.7971032077,21.839444855,-485,3.1311032051,7.4885551655,24.97054806
53,11,2005,5562,2641,6567,3012,1223,2921,7790,10431,399660,14.100843084,6.6954920147,16.648730049,-280,3.1005629436,7.4053510697,19.749292993
53,11,2006,5733,2719,4403,3012,1233,3014,5636,8411,408071,14.195319977,6.7324393889,10.902144402,-239,3.0529966041,7.4628805877,13.955141006
53,11,2007,5851,2695,4407,3022,1107,3156,5514,8422,416493,14.191742545,6.5367879267,10.689285489,-248,2.6850553747,7.6549546184,13.374340864
53,11,2008,5998,2811,4205,3018,1121,3187,5326,8240,424733,14.260139368,6.6831029949,9.9973134449,-273,2.6651577578,7.5770363731,12.662471203
53,13,2001,35,56,-8,78,8,-21,0,-25,4046,8.6238758162,13.798201306,-1.971171615,-4,1.9711716151,-5.17432549,0
53,13,2002,38,47,-22,78,7,-9,-15,-28,4018,9.4246031746,11.656746032,-5.456349206,-4,1.7361111111,-2.232142857,-3.720238095
53,13,2003,36,45,25,78,5,-9,30,15,4033,8.9429884486,11.178735561,6.2104086449,-6,1.242081729,-2.235747112,7.4524903739
53,13,2004,40,54,46,78,6,-14,52,34,4067,9.8765432099,13.333333333,11.358024691,-4,1.4814814815,-3.456790123,12.839506173
53,13,2005,31,45,-36,78,6,-14,-30,-47,4020,7.6666254483,11.128972425,-8.90317794,-3,1.48386299,-3.462346977,-7.41931495
53,13,2006,35,53,-57,78,6,-18,-51,-70,3950,8.78293601,13.299874529,-14.30363864,-1,1.5056461731,-4.516938519,-12.79799247
53,13,2007,37,33,7,78,6,4,13,14,3964,9.3505180692,8.3396512509,1.769016932,-3,1.5163002274,1.0108668183,3.2853171595
53,13,2008,33,38,29,78,6,-5,35,26,3990,8.2977118431,9.5549409102,7.2919285894,-4,1.5086748806,-1.257229067,8.80060347
53,15,2001,1247,901,206,1420,149,346,355,599,93598,13.365702557,9.6571756245,2.2079669019,-102,1.5970246038,3.7085269324,3.8049915058
53,15,2002,1253,927,304,1420,138,326,442,672,94270,13.339153022,9.8686311666,3.2363148594,-96,1.4691166138,3.4705218558,4.7054314732
53,15,2003,1152,959,-82,1420,107,193,25,85,94355,12.21471173,10.168323393,-0.869449967,-133,1.1345261763,2.0463883366,0.2650762094
53,15,2004,1199,969,700,1420,120,230,820,973,95328,12.642145053,10.217046335,7.3807352267,-77,1.265268896,2.4250987173,8.6460041227
53,15,2005,1261,1009,613,1420,117,252,730,903,96231,13.165656534,10.534613357,6.4001169353,-79,1.2215557609,2.6310431773,7.6216726961
53,15,2006,1283,1020,2125,1420,121,263,2246,2454,98685,13.164645283,10.466046913,21.804264401,-55,1.2415604671,2.6985983706,23.045824868
53,15,2007,1327,989,1096,1420,105,338,1201,1531,100216,13.343321552,9.9446458288,11.020557966,-8,1.05580163,3.3986757231,12.076359596
53,15,2008,1362,970,532,1420,108,392,640,1038,101254,13.520623418,9.6292251948,5.2811833027,6,1.0721199186,3.8913982231,6.3533032213
53,17,2001,432,219,-252,293,155,213,-97,89,32772,13.199908334,6.6916201971,-7.699946528,-27,4.7360782217,6.5082881369,-2.963868306
53,17,2002,426,231,-103,293,150,195,47,213,32985,12.956795474,7.0258679684,-3.132746324,-29,4.5622519276,5.9309275058,1.429505604
53,17,2003,455,275,99,293,128,180,227,360,33345,13.719282376,8.2918739635,2.9850746269,-47,3.8594904267,5.4274084125,6.8445650535
53,17,2004,436,272,293,293,117,164,410,543,33888,12.969821367,8.0912647063,8.7159579373,-31,3.4804337156,4.8785566612,12.196391653
53,17,2005,507,271,124,293,125,236,249,455,34343,14.861280063,7.9436033475,3.6347114948,-30,3.6640236842,6.9176767159,7.298735179
53,17,2006,486,255,464,293,124,231,588,799,35142,13.98863064,7.3397136073,13.355400446,-20,3.5691156365,6.6489170325,16.924516083
53,17,2007,574,276,484,293,112,298,596,893,36035,16.128805654,7.7553142167,13.599898844,-1,3.14708403,8.3734914368,16.746982874
53,17,2008,559,272,225,293,114,287,339,618,36653,15.380805635,7.4840413823,6.1908430552,-8,3.1366938147,7.8967642527,9.3275368699
53,19,2001,78,54,-21,220,5,24,-16,2,7278,10.718702762,7.4206403738,-2.88580459,-6,0.6870963309,3.2980623883,-2.198708259
53,19,2002,59,47,-22,220,5,12,-17,-12,7266,8.1133113311,6.4631463146,-3.02530253,-7,0.6875687569,1.6501650165,-2.337733773
53,19,2003,78,48,100,220,4,30,104,130,7396,10.639749011,6.547537853,13.64070386,-4,0.5456281544,4.0922111581,14.186332015
53,19,2004,74,75,56,220,3,-1,59,51,7447,9.9710301152,10.105773765,7.5456444115,-7,0.4042309506,-0.13474365,7.9498753621
53,19,2005,83,100,27,220,4,-17,31,8,7455,11.13944437,13.421017313,3.6236746745,-6,0.5368406925,-2.281572943,4.1605153671
53,19,2006,74,69,16,220,3,5,19,19,7474,9.9135909974,9.2437537678,2.1434791346,-5,0.4019023377,0.6698372296,2.5453814723
53,19,2007,62,54,-140,220,2,8,-138,-130,7344,8.3682008368,7.2884329869,-18.89593737,0,0.2699419625,1.0797678499,-18.62599541
53,19,2008,75,62,-2,220,1,13,-1,9,7353,10.206164523,8.437096006,-0.272164387,-3,0.1360821936,1.7690685174,-0.136082194
53,21,2001,1143,299,-263,908,632,844,369,1165,50771,22.774141487,5.9575400739,-5.240244279,-48,12.592526176,16.816601413,7.3522818972
53,21,2002,1175,297,600,994,588,878,1188,2032,52803,22.689091857,5.7350300268,11.585919246,-34,11.354200861,16.95406183,22.940120107
53,21,2003,1286,283,1688,1018,523,1003,2211,3266,56069,23.624072305,5.1987655228,31.008891175,52,9.6076126093,18.425306782,40.616503784
53,21,2004,1291,273,1552,1009,471,1018,2023,2952,59021,22.434616387,4.7441133026,26.970197237,-89,8.1848987749,17.690503085,35.155096012
53,21,2005,1441,288,1815,995,492,1153,2307,3406,62427,23.730320796,4.7427705685,29.889335353,-54,8.1022330545,18.987550227,37.991568408
53,21,2006,1492,283,1734,994,487,1209,2221,3388,65815,23.268507977,4.4135306686,27.042622542,-42,7.5950156735,18.854977309,34.637638215
53,21,2007,1616,306,1549,1005,448,1310,1997,3309,69124,23.951563299,4.5353826544,22.958521999,2,6.6400373502,19.416180645,29.598559349
53,21,2008,1724,310,1799,1019,447,1414,2246,3659,72783,24.29760336,4.3690586088,25.354633669,-1,6.2999006392,19.928544751,31.654534308
53,23,2001,27,30,-83,37,0,-3,-83,-87,2302,11.511404818,12.790449797,-35.38691111,-1,0,-1.27904498,-35.38691111
53,23,2002,13,29,-20,37,0,-16,-20,-37,2265,5.6930151084,12.699802934,-8.758484782,-1,0,-7.006787826,-8.758484782
53,23,2003,17,20,11,37,-1,-3,10,3,2268,7.5005515111,8.8241782484,4.8532980366,-4,-0.441208912,-1.323626737,4.4120891242
53,23,2004,13,29,-45,37,0,-16,-45,-63,2205,5.8126537,12.966689023,-20.12072435,-2,0,-7.154035323,-20.12072435
53,23,2005,15,27,-2,37,0,-12,-2,-14,2191,6.8243858053,12.283894449,-0.909918107,0,0,-5.459508644,-0.909918107
53,23,2006,16,23,-66,37,0,-7,-66,-74,2117,7.4280408542,10.677808728,-30.64066852,-1,0,-3.249767874,-30.64066852
53,23,2007,14,21,-62,37,0,-7,-62,-73,2044,6.7291516462,10.093727469,-29.80052872,-4,0,-3.364575823,-29.80052872
53,23,2008,14,11,24,37,0,3,24,16,2060,6.8226120858,5.3606237817,11.695906433,-11,0,1.4619883041,11.695906433
53,25,2001,1396,509,-374,1093,728,887,354,1175,76141,18.476973271,6.7369479905,-4.950134673,-66,9.6355562615,11.74002528,4.6854215887
53,25,2002,1331,519,-529,1073,681,812,152,905,77046,17.3774537,6.7760319087,-6.90659129,-59,8.8910938918,10.601421792,1.9845026014
53,25,2003,1393,603,-342,1053,603,790,261,956,78002,17.96862907,7.7782364171,-4.411537072,-95,7.7782364171,10.190392653,3.3666993447
53,25,2004,1449,562,-593,1034,540,887,-53,765,78767,18.485797575,7.1697848427,-7.565271195,-69,6.8891171086,11.316012732,-0.676154087
53,25,2005,1424,591,-570,1052,574,833,4,764,79531,17.99138334,7.4669294622,-7.201607095,-73,7.2521446891,10.524453878,0.0505375937
53,25,2006,1536,569,-180,1013,569,967,389,1314,80845,19.154985783,7.0958248117,-2.244724896,-42,7.0958248117,12.059160972,4.8510999152
53,25,2007,1538,590,63,1013,514,948,577,1516,82361,18.847346299,7.2301263434,0.7720304401,-9,6.2987880348,11.617219955,7.0708184748
53,25,2008,1565,578,833,1083,516,987,1349,2336,84697,18.736007854,6.9197524213,9.9725843719,0,6.1774952412,11.816255432,16.150079613
53,27,2001,772,870,896,1796,99,-98,995,850,67997,11.42485053,12.87515539,13.259930149,-47,1.4651038892,-1.45030486,14.725034038
53,27,2002,763,789,299,2047,93,-26,392,303,68300,11.196137846,11.577657615,4.3874773473,-63,1.3646668672,-0.381519769,5.7521442145
53,27,2003,856,753,597,2554,76,103,673,720,69020,12.467229828,10.967084183,8.6950189339,-56,1.1069035829,1.5001456452,9.8019225167
53,27,2004,800,779,552,2591,78,21,630,586,69606,11.541846407,11.238872939,7.9638740207,-65,1.1253300247,0.3029734682,9.0892040454
53,27,2005,872,820,430,2574,82,52,512,503,70109,12.48255377,11.738181298,6.1553877536,-61,1.1738181298,0.7443724725,7.3292058834
53,27,2006,860,713,423,2568,82,147,505,618,70727,12.212786503,10.125252066,6.00698685,-34,1.1644749922,2.0875344372,7.1714618421
53,27,2007,897,759,237,2577,68,138,305,454,71181,12.641993404,10.697071342,3.3401922372,11,0.958367393,1.9449220622,4.2985596302
53,27,2008,927,760,-120,2459,70,167,-50,161,71342,13.00842671,10.664945307,-1.683938733,44,0.9822975941,2.343481403,-0.701641139
53,29,2001,931,554,1929,1479,11,377,1940,2296,74143,12.75429824,7.5895609288,26.426467566,-21,0.1506952531,5.1647373108,26.577162819
53,29,2002,915,576,1423,1631,-298,339,1125,1423,75566,12.223714005,7.6949281606,19.010213147,-41,-3.981056583,4.5287858445,15.029156564
53,29,2003,962,574,1572,1531,-919,388,653,1030,76596,12.644418449,7.5445906337,20.662188983,-11,-12.07923135,5.0998278151,8.5829576373
53,29,2004,963,611,1970,2736,450,352,2420,2674,79270,12.356767993,7.8400677505,25.278123516,-98,5.7741906509,4.5167002425,31.052314167
53,29,2005,986,598,-34,1882,-18,388,-52,333,79603,12.412430054,7.5280255298,-0.428014829,-3,-0.226596086,4.8844045244,-0.654610916
53,29,2006,963,596,616,2015,218,367,834,1144,80747,12.011225444,7.4337386966,7.6831930153,-57,2.7190520736,4.5774867477,10.402245089
53,29,2007,936,676,233,1723,-53,260,180,228,80975,11.575419547,8.3600252285,2.8814879856,-212,-0.655445765,3.2153943186,2.2260422206
53,29,2008,924,737,510,1723,68,187,578,449,81424,11.379380415,9.076410569,6.2808268524,-316,0.8374435803,2.3029698459,7.1182704327
53,31,2001,197,253,457,530,22,-56,479,408,26827,7.3996168726,9.5030612628,17.165608684,-15,0.8263531533,-2.10344439,17.991961838
53,31,2002,213,261,380,560,19,-48,399,339,27166,7.8899116552,9.6679199155,14.075898728,-12,0.7037949364,-1.77800826,14.779693664
53,31,2003,208,291,429,561,11,-83,440,353,27519,7.6072049008,10.642772241,15.689860108,-4,0.4023041053,-3.03556734,16.092164213
53,31,2004,215,310,445,557,24,-95,469,341,27860,7.7646761408,11.195579552,16.071073873,-33,0.8667545459,-3.430903411,16.937828419
53,31,2005,192,294,644,544,20,-102,664,541,28401,6.8253319351,10.451289526,22.893300866,-21,0.7109720766,-3.625957591,23.604272942
53,31,2006,213,314,694,550,23,-101,717,600,29001,7.421344204,10.940385352,24.180342148,-16,0.8013658061,-3.519041148,24.981707954
53,31,2007,233,305,223,536,17,-72,240,158,29159,8.0123796424,10.488308116,7.6685006878,-10,0.5845942228,-2.475928473,8.2530949106
53,31,2008,238,336,463,554,20,-98,483,383,29542,8.1088908196,11.447845863,15.774859031,-2,0.6814193966,-3.338955043,16.456278428
53,33,2001,22182,11679,-6868,38909,12286,10503,5418,17351,1756766,12.689274383,6.6810042157,-3.928858374,1430,7.0282402427,6.0082701668,3.0993818684
53,33,2002,21847,11532,-17254,38623,11512,10315,-5742,5927,1762693,12.414976279,6.5532799217,-9.80491604,1354,6.5419145386,5.8616963573,-3.263001501
53,33,2003,22014,11537,-16494,38154,9954,10477,-6540,5158,1767851,12.470599432,6.5355367331,-9.343602572,1221,5.6387910758,5.9350626986,-3.704811496
53,33,2004,22757,11560,-8794,37574,9321,11197,527,12054,1779905,12.828954415,6.5167954053,-4.957499896,330,5.254589098,6.3121590098,0.2970892023
53,33,2005,22817,11477,-1739,37280,9708,11340,7969,19180,1799085,12.750524589,6.4135412505,-0.971782542,-129,5.4249942023,6.3369833389,4.4532116603
53,33,2006,23432,11314,6599,37697,9715,12118,16314,28448,1827533,12.922232228,6.2394219628,3.6392032467,16,5.3576086591,6.6828102657,8.9968119057
53,33,2007,23622,11827,2443,37914,8790,11795,11233,23181,1850714,12.844161906,6.4307807496,1.3283501625,153,4.7794506459,6.4133811568,6.1078008084
53,33,2008,23073,11864,3975,37245,8829,11209,12804,24805,1875519,12.384088703,6.3678250931,2.1335219778,792,4.7388340987,6.0162636099,6.8723560765
53,35,2001,2973,1786,-106,7453,123,1187,17,964,233304,12.769411825,7.6710963741,-0.455283435,-240,0.5283005902,5.0983154513,0.0730171547
53,35,2002,2976,1818,2732,8571,-416,1158,2316,3319,236623,12.665797028,7.7373719748,11.627337863,-155,-1.770487757,4.9284250533,9.8568501065
53,35,2003,3024,1750,2633,9124,-1482,1274,1151,2261,238884,12.719055661,7.3605646184,11.074495223,-164,-6.233346723,5.3584910422,4.8411485004
53,35,2004,2969,1812,-1499,7733,846,1157,-653,295,239179,12.420957071,7.5805908426,-6.271139996,-209,3.5392824795,4.8403662279,-2.731857517
53,35,2005,2932,1797,-4173,5670,55,1135,-4118,-3155,236024,12.339989436,7.5630835664,-17.56302044,-172,0.2314800201,4.7769058697,-17.33154042
53,35,2006,3016,1716,2115,7989,456,1300,2571,3747,239771,12.677728854,7.2131905548,8.8903834635,-124,1.9167918957,5.4645382991,10.807175359
53,35,2007,2965,1796,-2836,8370,-16,1169,-2852,-1611,238160,12.407648803,7.515729258,-11.86782192,72,-0.066955272,4.8919195449,-11.9347772
53,35,2008,2885,1798,242,8435,190,1087,432,1609,239769,12.072922966,7.5241301532,1.0127027236,90,0.7950971797,4.5487928123,1.8077999033
53,37,2001,384,255,199,2308,81,129,280,380,33888,11.395335035,7.5672146715,5.9053949789,-29,2.4037034839,3.8281203632,8.3090984628
53,37,2002,343,250,720,2513,78,93,798,876,34764,9.9924255666,7.2831090136,20.975353959,-15,2.2723300122,2.7093165531,23.247683971
53,37,2003,379,246,460,2620,59,133,519,635,35399,10.803414905,7.0122429201,13.112324159,-17,1.6817980987,3.7911719852,14.794122258
53,37,2004,351,250,1004,3045,57,101,1061,1107,36506,9.7628815799,6.9536193589,27.925735345,-55,1.5854252138,2.809262221,29.511160559
53,37,2005,346,243,323,2808,59,103,382,449,36955,9.4199643348,6.6157552987,8.7937817345,-36,1.6062944964,2.8042090361,10.400076231
53,37,2006,352,247,742,2977,60,105,802,889,37844,9.4118905333,6.6043663685,19.839837431,-18,1.6042995227,2.8075241648,21.444136954
53,37,2007,398,260,129,2773,49,138,178,319,38163,10.472719618,6.8414751273,3.3944241978,3,1.2893549278,3.6312444906,4.6837791256
53,37,2008,435,248,540,2735,51,187,591,788,38951,11.281998081,6.4320356874,14.005238997,10,1.3227170164,4.8499623933,15.327956013
53,39,2001,249,179,-102,209,46,70,-56,-3,19211,12.960312297,9.3168510085,-5.309043591,-17,2.3942745608,3.6434612882,-2.914769031
53,39,2002,203,164,-140,209,46,39,-94,-72,19139,10.586701434,8.5528031291,-7.301173403,-17,2.3989569752,2.0338983051,-4.902216428
53,39,2003,245,156,93,209,32,89,125,190,19329,12.73786004,8.1106374129,4.8351876885,-24,1.663720495,4.6272226266,6.4989081834
53,39,2004,230,169,-66,209,30,61,-36,12,19341,11.895526248,8.7406258081,-3.413498836,-13,1.5515903801,3.1549004396,-1.861908456
53,39,2005,215,173,4,209,32,42,36,60,19401,11.099065614,8.9308760518,0.206494244,-18,1.6519539518,2.1681895617,1.8584481958
53,39,2006,198,161,320,209,31,37,351,379,19780,10.106939588,8.218269059,16.334447819,-9,1.5823996325,1.8886705291,17.916847452
53,39,2007,236,172,176,209,26,64,202,274,20054,11.849174072,8.6358387307,8.8366721896,8,1.3054174826,3.2133353417,10.142089672
53,39,2008,243,181,225,209,25,62,250,323,20377,12.020479335,8.9535257599,11.130073458,11,1.2366748287,3.0669535752,12.366748287
53,41,2001,912,754,61,1028,123,158,184,275,68891,13.264779248,10.966714422,0.8872275593,-67,1.7889998327,2.2980648258,2.6762273921
53,41,2002,843,771,314,1037,117,72,431,443,69334,12.197504069,11.155724362,4.5433170555,-60,1.6928920239,1.041779707,6.2362090794
53,41,2003,849,718,627,1026,92,131,719,778,70112,12.176756594,10.297893091,8.992728368,-72,1.3195071927,1.8788635027,10.312235561
53,41,2004,855,843,513,1024,92,12,605,561,70673,12.146180346,11.975707639,7.2877082076,-56,1.3069574173,0.1704727066,8.5946656249
53,41,2005,898,802,793,1025,94,96,887,924,71597,12.623884164,11.274337527,11.14781753,-59,1.3214310817,1.3495466367,12.469248612
53,41,2006,898,727,834,1021,98,171,932,1065,72662,12.44982982,10.079093852,11.562536826,-38,1.3586673968,2.3707359679,12.921204223
53,41,2007,950,764,583,1026,88,186,671,851,73513,12.998118693,10.453223875,7.9767402087,-6,1.2040362579,2.5448948179,9.1807764666
53,41,2008,975,804,357,1012,90,171,447,619,74132,13.207355481,10.89098852,4.8359240069,1,1.2191405059,2.3163669613,6.0550645129
53,43,2001,99,126,-19,125,1,-27,-18,-56,10119,9.756578299,12.41746329,-1.872474623,-11,0.0985512959,-2.660884991,-1.773923327
53,43,2002,89,106,-40,125,0,-17,-40,-66,10053,8.8241126314,10.509617291,-3.965893317,-9,0,-1.68550466,-3.965893317
53,43,2003,83,95,97,125,-5,-12,92,71,10124,8.227189374,9.4166625366,9.6149080636,-9,-0.495613818,-1.189473163,9.1192942459
53,43,2004,85,105,225,125,2,-20,227,194,10318,8.316211721,10.27296742,22.013501614,-13,0.1956755699,-1.956755699,22.209177184
53,43,2005,105,123,-105,125,-1,-18,-106,-132,10186,10.241904019,11.997658993,-10.24190402,-8,-0.097541943,-1.755754975,-10.33944596
53,43,2006,93,119,46,125,1,-26,47,16,10202,9.1230135374,11.673533451,4.5124583088,-5,0.0980969198,-2.550519914,4.6105552286
53,43,2007,112,117,51,125,-1,-5,50,42,10244,10.955688154,11.444781375,4.9887508559,-3,-0.097818644,-0.489093221,4.8909322117
53,43,2008,105,113,113,125,1,-8,114,100,10344,10.200116573,10.977268312,10.977268312,-6,0.0971439674,-0.777151739,11.074412279
53,45,2001,549,507,368,2195,67,42,435,438,49989,11.03074141,10.186859554,7.3940124573,-39,1.3461924854,0.8438818565,8.7402049427
53,45,2002,535,516,656,2230,57,19,713,700,50689,10.62794255,10.250501599,13.031645444,-32,1.1323228511,0.3774409504,14.163968295
53,45,2003,542,497,794,2141,23,45,817,846,51535,10.604163406,9.7237439349,15.534512443,-16,0.449992174,0.880419471,15.984504617
53,45,2004,587,528,1151,2148,53,59,1204,1192,52727,11.260094761,10.128330552,22.078993305,-71,1.016669544,1.1317642094,23.095662849
53,45,2005,559,576,1116,2288,44,-17,1160,1095,53822,10.492824897,10.811926907,20.948108382,-48,0.8259110832,-0.319102009,21.774019465
53,45,2006,651,572,1347,2142,50,79,1397,1446,55268,11.935099459,10.486754056,24.695205793,-30,0.9166743056,1.4483454029,25.611880099
53,45,2007,655,578,1441,2332,38,77,1479,1591,56859,11.683180679,10.309738065,25.702997494,35,0.6778028486,1.3734426142,26.380800342
53,45,2008,694,551,759,2368,42,143,801,987,57846,12.100605902,9.6072533891,13.233947953,43,0.7323133255,2.493352513,13.966261279
53,47,2001,513,353,-718,851,146,160,-572,-435,39115,13.042649209,8.9747664145,-18.25462404,-23,3.7119430496,4.0678827941,-14.54268099
53,47,2002,499,386,-500,851,142,113,-358,-270,38845,12.801436634,9.9025141098,-12.82709082,-25,3.6428937917,2.8989225244,-9.184197024
53,47,2003,462,412,-471,851,117,50,-354,-331,38514,11.944311586,10.651637172,-12.17699298,-27,3.024858129,1.2926744141,-9.152134852
53,47,2004,488,365,46,851,104,123,150,244,38758,12.630707113,9.4471477379,1.1905994409,-29,2.6917900404,3.1835593747,3.8823894813
53,47,2005,547,361,-14,851,110,186,96,244,39002,14.068930041,9.2849794239,-0.360082305,-38,2.829218107,4.7839506173,2.4691358025
53,47,2006,549,365,-162,851,111,184,-51,114,39116,14.055659387,9.3448372974,-4.147571622,-19,2.8418546302,4.7108220897,-1.305716992
53,47,2007,574,366,79,851,94,208,173,378,39494,14.603739982,9.3117923928,2.0099224017,-3,2.3915532375,5.2919475894,4.4014756392
53,47,2008,562,378,263,851,95,184,358,539,40033,14.133564701,9.5062054397,6.6141059011,-3,2.3891257057,4.6273592616,9.0032316069
53,49,2001,209,323,-177,345,27,-114,-150,-283,20649,10.052668286,15.535941897,-8.513503764,-19,1.2986700657,-5.483273611,-7.214833698
53,49,2002,178,314,25,347,24,-136,49,-106,20543,8.6424548456,15.245678773,1.2138279278,-19,1.1652748106,-6.603223927,2.3791027384
53,49,2003,174,290,460,358,10,-116,470,365,20908,8.3954548744,13.992424791,22.194880703,11,0.4824974066,-5.596969916,22.677378109
53,49,2004,192,294,165,359,23,-102,188,65,20973,9.1688355101,14.039779375,7.8794680165,-21,1.0983500872,-4.870943865,8.9778181037
53,49,2005,204,290,346,331,19,-86,365,257,21230,9.6675591783,13.743098832,16.396938606,-22,0.9004099235,-4.075539654,17.29734853
53,49,2006,219,284,166,304,20,-65,186,111,21341,10.288694181,13.342416199,7.7987362289,-10,0.9396067746,-3.053722017,8.7383430035
53,49,2007,213,286,133,304,17,-73,150,76,21417,9.9630478507,13.377613546,6.2210580476,-1,0.7951728332,-3.414565695,7.0162308808
53,49,2008,236,297,-105,295,19,-61,-86,-146,21271,11.056971514,13.914917541,-4.919415292,1,0.89017991,-2.857946027,-4.029235382
53,51,2001,114,109,125,100,3,5,128,125,11863,9.6606076014,9.2368967417,10.592771493,-8,0.2542265158,0.4237108597,10.846998009
53,51,2002,125,118,113,100,3,7,116,110,11973,10.488336969,9.900990099,9.4814566202,-13,0.2517200873,0.5873468703,9.7331767075
53,51,2003,98,123,108,100,2,-25,110,76,12049,8.1591874115,10.240612772,8.9917575556,-9,0.1665140288,-2.08142536,9.1582715844
53,51,2004,113,140,239,100,1,-27,240,199,12248,9.3015598634,11.524056468,19.673210684,-14,0.0823146891,-2.222496605,19.755525374
53,51,2005,113,139,130,100,2,-26,132,95,12343,9.1903541946,11.304948965,10.572973852,-11,0.1626611362,-2.11459477,10.735634988
53,51,2006,133,117,281,100,1,16,282,290,12633,10.650224215,9.3689942345,22.501601537,-8,0.0800768738,1.2812299808,22.581678411
53,51,2007,141,137,83,100,2,4,85,93,12726,11.120312315,10.804842462,6.5459994479,4,0.1577349265,0.3154698529,6.7037343744
53,51,2008,128,127,132,100,1,1,133,133,12859,10.00586281,9.927692007,10.318546023,-1,0.0781708032,0.0781708032,10.396716826
53,53,2001,10168,5332,6272,21091,1688,4836,7960,12242,716210,14.319331802,7.5089178962,8.8326956198,-554,2.3771668059,6.8104139059,11.209862426
53,53,2002,10099,5482,7389,21205,735,4617,8124,12233,728443,13.981212097,7.5893657508,10.229446102,-508,1.0175453898,6.3918463465,11.246991492
53,53,2003,10013,5450,5032,21443,-1113,4563,3919,7750,736193,13.673021829,7.4421221382,6.8713318531,-732,-1.519831549,6.2308996911,5.3515003045
53,53,2004,10262,5384,-1734,21757,2437,4878,703,5049,741242,13.891643287,7.2883070998,-2.347311388,-532,3.2989606988,6.6033361874,0.9516493111
53,53,2005,10144,5413,2681,22670,1240,4731,3921,7960,749202,13.612051174,7.2636073546,3.5975856859,-692,1.6639337003,6.3484438194,5.2615193862
53,53,2006,10930,5365,7425,23648,1888,5565,9313,14485,763687,14.449176377,7.0923907835,9.8156573285,-393,2.4958870082,7.3567855937,12.311544337
53,53,2007,11003,5651,2935,24103,1048,5352,3983,9418,773105,14.319439456,7.3542808656,3.8196450788,83,1.3638800827,6.9651585901,5.1835251615
53,53,2008,10872,5726,5667,24330,1375,5146,7042,12534,785639,13.94969283,7.3469408703,7.2712388949,346,1.764240953,6.6027519593,9.0354798479
53,55,2001,109,121,198,119,21,-12,219,198,14345,7.6512705321,8.493612242,13.898638214,-9,1.4740979924,-0.84234171,15.372736207
53,55,2002,84,119,292,119,21,-35,313,274,14619,5.8003038254,8.217097086,20.162960917,-4,1.4500759564,-2.416793261,21.613036873
53,55,2003,90,117,151,119,16,-27,167,126,14745,6.129955047,7.9689415611,10.284702357,-14,1.0897697861,-1.838986514,11.374472143
53,55,2004,97,109,280,119,13,-12,293,261,15006,6.5207892172,7.3274847904,18.822896709,-20,0.8739202044,-0.806695573,19.696816914
53,55,2005,99,113,75,119,16,-14,91,67,15073,6.5826656471,7.5135476578,4.9868679145,-10,1.0638651551,-0.930882011,6.0507330696
53,55,2006,105,114,44,119,15,-9,59,43,15116,6.9561760906,7.5524197555,2.9149690285,-7,0.9937394415,-0.596243665,3.90870847
53,55,2007,100,122,88,119,13,-22,101,66,15182,6.6010957819,8.0533368539,5.8089642881,-13,0.8581424516,-1.452241072,6.6671067397
53,55,2008,111,132,141,119,12,-21,153,112,15294,7.2844205276,8.662554141,9.2531828324,-20,0.7875049219,-1.378133613,10.040687754
53,57,2001,1435,942,555,1841,404,493,959,1362,104828,13.7786014,9.0449076786,5.3290061164,-90,3.8791323802,4.7336937214,9.2081384965
53,57,2002,1400,962,591,1841,365,438,956,1298,106126,13.273035828,9.1204717616,5.6031172673,-96,3.4604700551,4.1525640661,9.0635873224
53,57,2003,1325,1040,1584,1841,261,285,1845,2079,108205,12.36405373,9.7046157579,14.780876308,-51,2.4354853008,2.6594379721,17.216361609
53,57,2004,1395,1034,1276,1841,337,361,1613,1871,110076,12.781689657,9.4740265987,11.691351973,-103,3.0877630211,3.3076630582,14.779114994
53,57,2005,1467,965,1153,1841,324,502,1477,1887,111963,13.213894856,8.6921666914,10.385562897,-92,2.9184062259,4.5217281649,13.303969123
53,57,2006,1440,1059,1515,1841,342,381,1857,2173,114136,12.737783007,9.3675779194,13.401209205,-65,3.0252234641,3.3702050872,16.426432669
53,57,2007,1558,1042,1001,1841,280,516,1281,1762,115898,13.545823661,9.0595303303,8.7030612866,-35,2.4344227375,4.4862933306,11.137484024
53,57,2008,1579,1059,1331,1841,292,520,1623,2102,118000,13.501611814,9.0552292025,11.381029338,-41,2.4968148509,4.4463826112,13.877844188
53,59,2001,101,76,-84,64,8,25,-76,-61,9832,10.240811153,7.7059569075,-8.517110266,-10,0.8111533587,2.5348542459,-7.705956907
53,59,2002,102,73,29,64,7,29,36,56,9888,10.344827586,7.4036511156,2.9411764706,-9,0.7099391481,2.9411764706,3.6511156187
53,59,2003,109,56,101,64,2,53,103,151,10039,10.939930747,5.6205148793,10.13700005,-5,0.2007326743,5.3194158679,10.337732724
53,59,2004,101,67,162,64,3,34,165,186,10225,9.968416897,6.612712199,15.988945914,-13,0.296091591,3.355704698,16.285037505
53,59,2005,87,85,64,64,3,2,67,59,10284,8.4840801599,8.2890438344,6.2411624165,-10,0.2925544883,0.1950363255,6.5337169048
53,59,2006,99,80,207,64,3,19,210,223,10507,9.5233514501,7.6956375355,19.912462123,-6,0.2885864076,1.8277139147,20.201048531
53,59,2007,105,68,152,64,2,37,154,191,10698,9.9033246876,6.4135817024,14.336241452,0,0.188634756,3.4897429851,14.524876208
53,59,2008,106,74,62,64,3,32,65,96,10794,9.8641354923,6.8862832682,5.7695886842,-1,0.279173646,2.9778522241,6.0487623302
53,61,2001,8654,3877,5558,9430,2270,4777,7828,12071,621183,14.068170642,6.3025534526,9.0352313876,-534,3.6901718693,7.7656171894,12.725403257
53,61,2002,8460,3984,2688,9555,1895,4476,4583,8492,629675,13.526715263,6.370027613,4.2978499558,-567,3.0299202627,7.1566876496,7.3277702185
53,61,2003,8464,4093,-1469,9334,1188,4371,-281,3246,632921,13.407297346,6.4834673957,-2.326951772,-844,1.8818371039,6.9238299504,-0.445114669
53,61,2004,8751,4138,259,9677,2004,4613,2263,6469,639390,13.756070646,6.5046989297,0.4071331616,-407,3.1501731888,7.2513717165,3.5573063504
53,61,2005,8679,4332,4183,9718,1757,4347,5940,9693,649083,13.471760759,6.7242386918,6.4929571671,-594,2.7272593217,6.7475220668,9.2202164888
53,61,2006,8996,4119,7228,9821,1910,4877,9138,13674,662757,13.715087206,6.2797292353,11.019636541,-341,2.9119404805,7.4353579705,13.931577022
53,61,2007,9262,4217,4903,9413,1571,5045,6474,11649,674406,13.853210117,6.3073836174,7.3334365369,130,2.3497509279,7.5458264998,9.6831874648
53,61,2008,9472,4296,2227,9525,1662,5176,3889,9249,683655,13.949299774,6.3266672116,3.2796759498,184,2.4476072872,7.6226325622,5.7272832369
53,63,2001,5550,3730,1732,15076,831,1820,2563,3974,422780,13.189382903,8.8642158971,4.116038052,-409,1.9748427374,4.3251670061,6.0908807894
53,63,2002,5469,3662,2260,15442,616,1807,2876,4303,427083,12.870309685,8.6178595844,5.3185042766,-380,1.4496454134,4.2524501008,6.76814969
53,63,2003,5506,3617,2295,15704,232,1889,2527,3908,430991,12.833391992,8.4305083245,5.3491889977,-508,0.540745903,4.4028836674,5.8899349007
53,63,2004,5496,3722,1945,15570,831,1774,2776,4234,435225,12.689675554,8.593699493,4.4907967528,-316,1.9186900265,4.0959760614,6.4094867793
53,63,2005,5490,3726,3169,15440,635,1764,3804,5206,440431,12.539170633,8.5101912166,7.2380021378,-362,1.4503412299,4.0289794166,8.6883433677
53,63,2006,5738,3645,3884,15283,760,2093,4644,6501,446932,12.932700597,8.2153526798,8.7540273823,-236,1.7129404764,4.7173479174,10.466967859
53,63,2007,6143,3733,6155,15678,561,2410,6716,9072,456004,13.606722957,8.2685816049,13.633302914,-54,1.242612987,5.3381413522,14.875915901
53,63,2008,6219,3758,3629,15487,621,2461,4250,6673,462677,13.538975988,8.181294704,7.900457286,-38,1.351938268,5.3576812844,9.2523955541
53,65,2001,421,365,-177,362,15,56,-162,-139,40041,10.496004787,9.0998616322,-4.412809613,-33,0.3739669164,1.3961431545,-4.038842697
53,65,2002,469,349,-114,362,14,120,-100,-17,40024,11.715481172,8.7179166927,-2.847686255,-37,0.3497158559,2.9975644789,-2.497970399
53,65,2003,415,410,135,362,3,5,138,85,40109,10.35778019,10.232987658,3.3693983752,-58,0.0748755194,0.1247925324,3.4442738947
53,65,2004,500,401,198,362,11,99,209,278,40387,12.422977539,9.9632279865,4.9194991055,-30,0.2733055059,2.4597495528,5.1928046114
53,65,2005,469,402,381,362,8,67,389,417,40804,11.553004643,9.9025754086,9.3852766932,-39,0.1970661773,1.6504292348,9.5823428705
53,65,2006,449,377,368,362,10,72,378,430,41234,10.946146908,9.1908627709,8.9714522538,-20,0.2437894634,1.7552841366,9.2152417173
53,65,2007,527,427,386,362,5,100,391,507,41741,12.702621271,10.292256704,9.3040072311,16,0.1205182284,2.4103645676,9.4245254595
53,65,2008,545,398,139,362,7,147,146,309,42050,13.008557005,9.4998269504,3.3177787591,16,0.1670823835,3.5087300545,3.4848611426
53,67,2001,2676,1575,2958,3445,329,1101,3287,4226,212509,12.718872982,7.485883762,14.059202646,-162,1.5637179414,5.2329892203,15.622920588
53,67,2002,2384,1635,3234,3487,211,749,3445,4040,216549,11.112716696,7.6213472304,15.074884981,-154,0.9835500096,3.4913694652,16.05843499
53,67,2003,2558,1617,2696,3505,-22,941,2674,3444,219993,11.719376372,7.4082218893,12.351617943,-171,-0.100792135,4.3111544823,12.250825808
53,67,2004,2645,1695,2285,3524,389,950,2674,3424,223417,11.930267698,7.6452944228,10.306488352,-200,1.7545837938,4.2849732753,12.061072145
53,67,2005,2584,1714,3094,3554,253,870,3347,4059,227476,11.461699339,7.6026906605,13.72387684,-158,1.1222174662,3.8590086783,14.846094306
53,67,2006,2682,1765,4276,3523,328,917,4604,5386,232862,11.652307652,7.6682785258,18.577653811,-135,1.425039862,3.9840291264,20.002693673
53,67,2007,2874,1795,4127,3559,219,1079,4346,5304,238166,12.203096207,7.621627589,17.523374407,-121,0.9298810262,4.5814686176,18.453255433
53,67,2008,2942,1784,5750,3598,258,1158,6008,7015,245181,12.173448889,7.3818602371,23.792430697,-151,1.0675560208,4.7915886516,24.859986718
53,69,2001,30,51,-32,59,1,-21,-31,-57,3780,7.8771169752,13.391098858,-8.402258107,-5,0.2625705658,-5.513981883,-8.139687541
53,69,2002,25,51,41,59,1,-26,42,12,3792,6.6032752245,13.470681458,10.829371368,-4,0.264131009,-6.867406233,11.093502377
53,69,2003,17,56,-91,59,1,-39,-90,-128,3664,4.5600858369,15.021459227,-24.40987124,1,0.2682403433,-10.46137339,-24.1416309
53,69,2004,31,49,97,59,0,-18,97,73,3737,8.3772463181,13.241453858,26.212673963,-6,0,-4.86420754,26.212673963
53,69,2005,37,42,98,59,1,-5,99,93,3830,9.7793048764,11.100832562,25.901942646,-1,0.2643055372,-1.321527686,26.166248183
53,69,2006,28,46,132,59,0,-18,132,111,3941,7.2062797581,11.838888174,33.972461717,-3,0,-4.632608416,33.972461717
53,69,2007,36,39,105,59,1,-3,106,97,4038,9.0236871788,9.7756611104,26.319087605,-6,0.2506579772,-0.751973932,26.569745582
53,69,2008,41,61,127,59,0,-20,127,95,4133,10.035491372,14.930853017,31.085546445,-12,0,-4.895361645,31.085546445
53,71,2001,705,538,-322,5187,179,167,-143,-26,55198,12.769194545,9.7444349858,-5.832171125,-50,3.242107551,3.0247595588,-2.590063574
53,71,2002,691,502,355,5149,172,189,527,668,55866,12.443275949,9.0398328891,6.3927105093,-48,3.0973132608,3.4034430599,9.4900237701
53,71,2003,699,553,280,5157,151,146,431,498,56364,12.456562416,9.8547625412,4.9897531854,-79,2.6909026107,2.6017998753,7.6806557961
53,71,2004,710,491,284,5075,139,219,423,599,56963,12.530111977,8.6651901136,5.0120447907,-43,2.4530782603,3.8649218633,7.465123051
53,71,2005,699,577,-249,4884,146,122,-103,-30,56933,12.274355552,10.132050291,-4.372409918,-49,2.5637423615,2.1423052609,-1.808667556
53,71,2006,717,539,-307,4589,144,178,-163,-10,56923,12.594856661,9.4681000562,-5.392776841,-25,2.5295109612,3.1267566048,-2.86326588
53,71,2007,735,536,-133,4759,130,199,-3,206,57129,12.888857714,9.3992214078,-2.332269491,10,2.2796619086,3.4896363062,-0.052607583
53,71,2008,765,517,255,4883,132,248,387,659,57788,13.31395703,8.997798411,4.4379856766,24,2.2973102326,4.3161586188,6.7352959092
53,73,2001,1990,1241,2216,5148,648,749,2864,3470,171196,11.743114935,7.3232189117,13.076755124,-143,3.8238886824,4.4198960233,16.900643806
53,73,2002,1942,1218,2489,5055,602,724,3091,3692,174888,11.222708938,7.0387535974,14.383791218,-123,3.4789241918,4.1839553403,17.86271541
53,73,2003,2043,1356,1771,5039,524,687,2295,2811,177699,11.588629189,7.6917186397,10.045747574,-171,2.9723160525,3.8969105497,13.018063627
53,73,2004,2070,1312,2810,5046,501,758,3311,3876,181575,11.523238531,7.3036178516,15.642657136,-193,2.7889577314,4.2196206795,18.431614868
53,73,2005,2077,1337,2491,5080,518,740,3009,3605,185180,11.326362285,7.2909708116,13.584000218,-144,2.8247740317,4.0353914739,16.40877425
53,73,2006,2171,1310,1834,5057,517,861,2351,3109,188289,11.626132289,7.0153078301,9.8214309621,-103,2.7686367543,4.6108244593,12.590067716
53,73,2007,2266,1361,2736,5054,468,905,3204,4064,192353,11.906200577,7.1510763394,14.375712612,-45,2.4590034731,4.7551242375,16.834716085
53,73,2008,2401,1372,2725,5155,472,1029,3197,4176,196529,12.34821874,7.0561249942,14.014533972,-50,2.4274715724,5.2920937457,16.442005544
53,75,2001,404,229,-549,5473,236,175,-313,-170,40551,9.9419234177,5.6353971848,-13.51018801,-32,5.8076582341,4.3065262329,-7.702529777
53,75,2002,375,214,94,5589,225,161,319,442,40993,9.1974884725,5.2487000883,2.3055037771,-38,5.5184930835,3.9487883842,7.8239968606
53,75,2003,428,226,-714,4978,190,202,-524,-334,40659,10.483515407,5.5356880419,-17.48885514,-12,4.6538970264,4.9478273649,-12.83495811
53,75,2004,403,204,119,5083,178,199,297,466,41125,9.8552284065,4.9887508559,2.9101046659,-30,4.3529296684,4.8664775506,7.2630343343
53,75,2005,409,215,60,5267,190,194,250,408,41533,9.896198795,5.2021582908,1.4517651044,-36,4.597256164,4.6940405042,6.0490212684
53,75,2006,423,218,-693,4961,191,205,-502,-314,41219,10.223317865,5.2687548337,-16.74883991,-17,4.6162026295,4.9545630317,-12.13263728
53,75,2007,414,220,-839,4714,175,194,-664,-453,40766,10.099408428,5.3668353967,-20.46715863,17,4.269073611,4.7325730317,-16.19808502
53,75,2008,441,213,498,5169,177,228,675,898,41664,10.699987868,5.1680213514,12.082979498,-5,4.294552954,5.531966517,16.377532452
53,77,2001,4276,1617,-3536,3765,1171,2659,-2365,153,222879,19.19188519,7.2575487259,-15.87055801,-141,5.2557758553,11.934336464,-10.61478215
53,77,2002,4072,1735,-2686,3765,1099,2337,-1587,606,223485,18.245198986,7.7739244204,-12.03502075,-144,4.924232241,10.471274565,-7.110788504
53,77,2003,3995,1705,-1437,3750,953,2290,-484,1561,225046,17.813707414,7.6025960302,-6.407583868,-245,4.2494275758,10.211111384,-2.158156292
53,77,2004,4335,1801,-1175,3774,886,2534,-289,2061,227107,19.174925302,7.9663299812,-5.197355762,-184,3.9190274089,11.208595321,-1.278328353
53,77,2005,4123,1804,-1920,3789,925,2319,-995,1115,228222,18.109982013,7.923940711,-8.433462398,-209,4.0629962071,10.186041302,-4.37046619
53,77,2006,4303,1813,-1394,3790,930,2490,-464,1917,230139,18.77559391,7.9107952029,-6.082541927,-109,4.0579368664,10.864798707,-2.02460506
53,77,2007,4304,1746,-1563,3796,842,2558,-721,1882,232021,18.625584213,7.5558248226,-6.763891293,45,3.6437597369,11.069759391,-3.120131556
53,77,2008,4392,1756,-1013,3787,846,2636,-167,2543,234564,18.826151719,7.5270315162,-4.342188454,74,3.6263488968,11.299120203,-0.715839558
54,0,2001,20624,21220,-7062,43718,671,-596,-6391,-8437,1798540,11.440245601,11.770850061,-3.917330025,-1450,0.37220737,-0.33060446,-3.545122655
54,0,2002,20599,20839,1998,44087,561,-240,2559,852,1799392,11.450466546,11.583876516,1.1106379998,-1467,0.3118458048,-0.13340997,1.4224838046
54,0,2003,20702,20760,4423,44939,349,-58,4772,2895,1802287,11.495749621,11.527956822,2.4560767353,-1819,0.1937985034,-0.032207201,2.6498752387
54,0,2004,21154,21514,2294,45106,602,-360,2896,1025,1803312,11.733972635,11.933662063,1.2724654073,-1511,0.3339250982,-0.199689427,1.6063905054
54,0,2005,20667,21174,2283,45532,502,-507,2785,708,1804020,11.458329868,11.73942404,1.2657554115,-1570,0.2783220397,-0.281094172,1.5440774511
54,0,2006,20908,20515,2614,45552,592,393,3206,2740,1806760,11.580877262,11.363195764,1.4478866062,-859,0.3279069896,0.2176814982,1.7757935958
54,0,2007,20871,20650,2449,45554,482,221,2931,3076,1809836,11.541792337,11.419577968,1.3543121764,-76,0.2665489869,0.1222143695,1.6208611634
54,0,2008,20980,20558,3788,45554,450,422,4238,4632,1814468,11.577395274,11.344522976,2.0903323783,-28,0.2483235402,0.2328722977,2.3386559185
54,1,2001,160,206,-132,426,1,-46,-131,-190,15358,10.353976574,13.330744839,-8.542030674,-13,0.0647123536,-2.976768265,-8.47731832
54,1,2002,144,176,101,390,-1,-32,100,54,15412,9.3597660058,11.439714007,6.5648358791,-14,-0.064998375,-2.079948001,6.4998375041
54,1,2003,176,193,29,392,-2,-17,27,-8,15404,11.422637591,12.52596054,1.8821391485,-18,-0.1298027,-1.103322949,1.7523364486
54,1,2004,164,181,-51,409,2,-17,-49,-78,15326,10.673608851,11.780019525,-3.319232021,-12,0.1301659616,-1.106410674,-3.189066059
54,1,2005,180,191,41,401,0,-11,41,16,15342,11.73862006,12.455980175,2.6737967914,-14,0,-0.717360115,2.6737967914
54,1,2006,180,199,126,401,2,-19,128,102,15444,11.693626973,12.927954265,8.1855388813,-7,0.1299291886,-1.234327292,8.3154680699
54,1,2007,163,198,70,401,0,-35,70,40,15484,10.54061045,12.803931712,4.5266425246,5,0,-2.263321262,4.5266425246
54,1,2008,183,192,119,401,0,-9,119,116,15600,11.77454639,12.353622442,7.656672243,6,0,-0.579076052,7.656672243
54,3,2001,1048,676,1805,1236,18,372,1823,2160,78573,13.52380215,8.7233685623,23.292426413,-35,0.2322790446,4.8004335875,23.524705457
54,3,2002,1099,661,2086,1213,9,438,2095,2513,81086,13.766840579,8.2801470634,26.130691035,-20,0.1127402777,5.4866935156,26.243431313
54,3,2003,1170,674,3121,1272,-5,496,3116,3722,84808,14.1053926,8.1256706089,37.626436158,110,-0.060279456,5.9797219912,37.566156702
54,3,2004,1237,780,3495,1254,25,457,3520,3811,88619,14.265368138,8.9951391652,40.305142798,-166,0.2883057425,5.2702289724,40.59344854
54,3,2005,1237,746,3491,1237,13,491,3504,3919,92538,13.656662453,8.2359500323,38.54115491,-76,0.1435219175,5.4207124207,38.684676827
54,3,2006,1352,730,3597,1270,23,622,3620,4185,96723,14.287148435,7.7142147616,38.011000682,-57,0.2430506021,6.5729336736,38.254051284
54,3,2007,1352,740,2162,1282,15,612,2177,2808,99531,13.778063122,7.5412475669,22.032671946,19,0.1528631264,6.2368155554,22.185535072
54,3,2008,1395,772,1851,1282,16,623,1867,2513,102044,13.841002108,7.6596800198,18.36537269,23,0.158749845,6.1813220886,18.524122535
54,5,2001,361,311,-133,107,6,50,-127,-100,25391,14.189693801,12.22436225,-5.227781927,-23,0.2358397862,1.9653315514,-4.991942141
54,5,2002,325,293,116,107,5,32,121,132,25523,12.766626075,11.509604431,4.5567034607,-21,0.1964096319,1.2570216443,4.7531130927
54,5,2003,342,296,14,107,5,46,19,28,25551,13.392332694,11.591024788,0.5482241454,-37,0.1957943376,1.8013079062,0.744018483
54,5,2004,322,309,-88,107,6,13,-82,-88,25463,12.623985573,12.114321559,-3.450033324,-19,0.2352295448,0.5096640138,-3.214803779
54,5,2005,319,293,-154,107,5,26,-149,-145,25318,12.56375416,11.539749119,-6.065260629,-22,0.1969240464,1.0240050413,-5.868336583
54,5,2006,312,318,-166,107,6,-6,-160,-176,25142,12.366230678,12.604042806,-6.579468886,-10,0.2378121284,-0.237812128,-6.341656758
54,5,2007,316,325,47,107,6,-9,53,44,25186,12.557622,12.915275791,1.8677475759,0,0.2384358608,-0.357653791,2.1061834367
54,5,2008,307,302,-215,107,5,5,-210,-209,24977,12.240097283,12.040747164,-8.5720551,-4,0.1993501186,0.1993501186,-8.372704982
54,7,2001,146,154,18,531,0,-8,18,-7,14713,9.9208371556,10.464444671,1.2231169096,-17,0,-0.543607515,1.2231169096
54,7,2002,159,185,8,531,-2,-26,6,-34,14679,10.81927055,12.588459445,0.5443658138,-14,-0.136091453,-1.769188895,0.4082743604
54,7,2003,164,191,8,531,-3,-27,5,-44,14635,11.189192877,13.031316095,0.5458142867,-22,-0.204680358,-1.842123218,0.3411339292
54,7,2004,141,192,120,531,1,-51,121,58,14693,9.6153846154,13.093289689,8.1833060556,-12,0.0681942171,-3.477905074,8.2515002728
54,7,2005,140,134,-11,531,-1,6,-12,-21,14672,9.5351609058,9.1265111527,-0.749191214,-15,-0.068108292,0.4086497531,-0.817299506
54,7,2006,149,164,-50,531,1,-15,-49,-71,14601,10.180029379,11.204864551,-3.416117241,-7,0.0683223448,-1.024835172,-3.347794896
54,7,2007,154,186,93,531,-1,-32,92,51,14652,10.528834649,12.716644447,6.3583222234,-9,-0.068369056,-2.187809797,6.2899531672
54,7,2008,142,179,87,531,-1,-37,86,48,14700,9.675660943,12.196783865,5.928045789,-1,-0.068138457,-2.521122922,5.8599073317
54,9,2001,246,305,-141,871,0,-59,-141,-220,25153,9.7375608598,12.072992123,-5.581284883,-20,0,-2.335431263,-5.581284883
54,9,2002,225,341,-32,871,-1,-116,-33,-174,24979,8.9763025612,13.604085215,-1.276629698,-25,-0.039894678,-4.627782654,-1.316524376
54,9,2003,227,311,-45,884,-4,-84,-49,-166,24813,9.1179305913,12.491966581,-1.80751928,-33,-0.16066838,-3.37403599,-1.968187661
54,9,2004,227,330,-185,884,3,-103,-182,-305,24508,9.2050039537,13.381723809,-7.501875469,-20,0.1216520346,-4.176719856,-7.380223434
54,9,2005,233,328,-148,884,0,-95,-148,-264,24244,9.558582212,13.455858221,-6.071545783,-21,0,-3.897276009,-6.071545783
54,9,2006,219,321,-257,884,2,-102,-255,-367,23877,9.1020552358,13.341368633,-10.68140729,-10,0.0831237921,-4.239313397,-10.59828349
54,9,2007,219,323,-141,884,0,-104,-141,-240,23637,9.2183356484,13.59599276,-5.935092815,5,0,-4.377657112,-5.935092815
54,9,2008,218,313,-19,884,0,-95,-19,-117,23520,9.2457111351,13.274805437,-0.80581886,-3,0,-4.029094302,-0.80581886
54,11,2001,1210,1171,-790,3299,50,39,-740,-776,95934,12.562031519,12.157139594,-8.201656942,-75,0.5190922115,0.404891925,-7.682564731
54,11,2002,1156,1117,-388,3335,45,39,-343,-387,95547,12.074305022,11.666953901,-4.052621409,-83,0.4700205242,0.407351121,-3.582600885
54,11,2003,1128,1221,-126,3609,33,-93,-93,-316,95231,11.825262871,12.800218054,-1.320907023,-130,0.3459518393,-0.974955184,-0.974955184
54,11,2004,1169,1232,-304,3517,42,-63,-262,-393,94838,12.300796027,12.963713178,-3.198838317,-68,0.4419447674,-0.662917151,-2.756893549
54,11,2005,1134,1261,-359,3590,39,-127,-320,-534,94304,11.990990896,13.333897284,-3.79608971,-87,0.4123885758,-1.342906388,-3.383701135
54,11,2006,1170,1129,-17,3590,41,41,24,23,94327,12.405172002,11.970460847,-0.180246089,-42,0.4347111556,0.4347111556,0.2544650667
54,11,2007,1187,1139,-19,3590,37,48,18,83,94410,12.578349767,12.069705463,-0.20133837,17,0.3920799843,0.508644304,0.190741614
54,11,2008,1158,1165,132,3590,37,-7,169,221,94631,12.251310562,12.325368571,1.3965224475,59,0.3914494739,-0.074058009,1.7879719214
54,13,2001,82,99,-142,31,1,-17,-141,-163,7418,10.934062271,13.200880059,-18.93459564,-5,0.1333422228,-2.266817788,-18.80125342
54,13,2002,72,94,-54,31,1,-22,-53,-84,7334,9.7613882863,12.744034707,-7.321041215,-9,0.1355748373,-2.982646421,-7.185466377
54,13,2003,76,82,-74,31,1,-6,-73,-87,7247,10.424525067,11.247513888,-10.15019546,-8,0.1371648035,-0.822988821,-10.01303066
54,13,2004,65,93,-11,31,0,-28,-11,-43,7204,8.9959172376,12.871081586,-1.522385994,-4,0,-3.875164348,-1.522385994
54,13,2005,75,95,71,31,1,-20,72,47,7251,10.377032169,13.144240747,9.8235904531,-5,0.1383604289,-2.767208578,9.961950882
54,13,2006,85,93,-4,31,0,-8,-4,-16,7235,11.735468728,12.839983432,-0.552257352,-4,0,-1.104514704,-0.552257352
54,13,2007,78,83,-32,31,1,-5,-31,-38,7197,10.809312639,11.502217295,-4.4345898,-2,0.1385809313,-0.692904656,-4.296008869
54,13,2008,73,81,29,31,0,-8,29,15,7212,10.132556041,11.242973142,4.025261989,-6,0,-1.1104171,4.025261989
54,15,2001,121,114,-91,70,1,7,-90,-93,10222,11.78361007,11.101913619,-8.862053854,-10,0.0973852072,0.6816964503,-8.764668647
54,15,2002,138,129,69,70,1,9,70,71,10293,13.453570558,12.576163783,6.7267852791,-8,0.0974896417,0.8774067755,6.8242749208
54,15,2003,149,103,-93,70,1,46,-92,-56,10237,14.5153434,10.034096444,-9.059912323,-10,0.0974184121,4.4812469557,-8.962493911
54,15,2004,141,123,42,70,0,18,42,52,10289,13.738672903,11.984799766,4.0923706519,-8,0,1.7538731365,4.0923706519
54,15,2005,120,112,-152,70,1,8,-151,-151,10138,11.749155529,10.965878494,-14.88226367,-8,0.0979096294,0.7832770353,-14.78435404
54,15,2006,136,146,-65,70,0,-10,-65,-81,10057,13.468680366,14.459024511,-6.43723694,-6,0,-0.990344145,-6.43723694
54,15,2007,124,123,49,70,1,1,50,53,10110,12.2973174,12.198145485,4.8594238112,2,0.0991719145,0.0991719145,4.9585957257
54,15,2008,130,117,-53,70,0,13,-53,-35,10075,12.880852118,11.592766906,-5.251424325,5,0,1.2880852118,-5.251424325
54,17,2001,65,84,114,109,0,-19,114,90,7498,8.7213202737,11.270629277,15.295854019,-5,0,-2.549309003,15.295854019
54,17,2002,74,89,-42,109,-1,-15,-43,-65,7433,9.9122630768,11.921505592,-5.625879044,-7,-0.133949501,-2.009242516,-5.759828545
54,17,2003,64,64,15,109,-1,0,14,5,7438,8.6073566001,8.6073566001,2.0173492031,-9,-0.134489947,0,1.8828592563
54,17,2004,75,91,-147,109,0,-16,-147,-173,7265,10.201999592,12.378426172,-19.9959192,-10,0,-2.17642658,-19.9959192
54,17,2005,78,92,52,109,0,-14,52,32,7297,10.712814174,12.635626974,7.1418761159,-6,0,-1.9228128,7.1418761159
54,17,2006,72,76,-72,109,0,-4,-72,-79,7218,9.9207716156,10.471925594,-9.920771616,-3,0,-0.551153979,-9.920771616
54,17,2007,59,72,40,109,0,-13,40,26,7244,8.1593140644,9.9571290278,5.5317383488,-1,0,-1.797814963,5.5317383488
54,17,2008,72,87,-29,109,-1,-15,-30,-43,7201,9.968847352,12.04569055,-4.015230183,2,-0.138456213,-2.076843198,-4.153686397
54,19,2001,566,656,-291,2099,19,-90,-272,-400,47098,11.966679352,13.869508224,-6.15248002,-38,0.4017083175,-1.902828872,-5.750771703
54,19,2002,558,632,-7,2116,18,-74,11,-107,46991,11.861110225,13.434089001,-0.14879529,-44,0.3826164589,-1.572978775,0.2338211693
54,19,2003,561,580,178,2162,8,-19,186,112,47103,11.924245967,12.328097434,3.783450592,-55,0.1700427232,-0.403851468,3.9534933152
54,19,2004,581,614,-249,2117,15,-33,-234,-306,46797,12.37486688,13.077742279,-5.303514377,-39,0.3194888179,-0.702875399,-4.984025559
54,19,2005,567,612,-417,2069,12,-45,-405,-491,46306,12.180058645,13.146729966,-8.957820908,-41,0.2577790189,-0.966671321,-8.700041889
54,19,2006,581,594,10,2069,15,-13,25,-9,46297,12.548189583,12.828958025,0.2159757243,-21,0.3239635865,-0.280768442,0.5399393108
54,19,2007,567,572,-21,2069,8,-5,-13,-22,46275,12.249924383,12.357948408,-0.453700903,-4,0.1728384393,-0.108024025,-0.280862464
54,19,2008,580,573,52,2069,8,7,60,66,46341,12.524833722,12.373671936,1.1229161268,-1,0.1727563272,0.1511617863,1.295672454
54,21,2001,52,82,-49,435,2,-30,-47,-84,7085,7.2961975586,11.505542304,-6.875263084,-7,0.280622983,-4.209344745,-6.594640101
54,21,2002,68,66,-85,435,2,2,-83,-86,6999,9.6563476285,9.3723374041,-12.07043454,-5,0.2840102244,0.2840102244,-11.78642431
54,21,2003,48,88,57,424,1,-40,58,10,7009,6.8532267276,12.564249001,8.138206739,-8,0.1427755568,-5.711022273,8.2809822958
54,21,2004,69,80,-18,443,0,-11,-18,-34,6975,9.8684210526,11.441647597,-2.574370709,-5,0,-1.573226545,-2.574370709
54,21,2005,68,89,-23,443,1,-21,-22,-49,6926,9.7834688152,12.804834185,-3.309114452,-6,0.1438745414,-3.021365369,-3.165239911
54,21,2006,78,84,-18,443,0,-6,-18,-26,6900,11.283089831,12.151019818,-2.603789961,-2,0,-0.867929987,-2.603789961
54,21,2007,66,93,21,443,1,-27,22,-6,6894,9.5693779904,13.484123532,3.0448020879,-1,0.1449905756,-3.914745542,3.1897926635
54,21,2008,72,85,-3,443,0,-13,-3,-21,6873,10.459795162,12.348369289,-0.435824798,-5,0,-1.888574127,-0.435824798
54,23,2001,126,136,52,144,1,-10,53,33,11320,11.14698987,12.031671606,4.6003450259,-10,0.0884681736,-0.884681736,4.6888131995
54,23,2002,121,114,-27,144,1,7,-26,-30,11290,10.70322866,10.084033613,-2.388323751,-11,0.0884564352,0.6191950464,-2.299867315
54,23,2003,131,109,69,144,1,22,70,77,11367,11.563755131,9.6217504524,6.0908328552,-15,0.0882729399,1.9420046785,6.1791057951
54,23,2004,135,116,131,144,0,19,131,140,11507,11.803794701,10.142519892,11.454052636,-10,0,1.6612748098,11.454052636
54,23,2005,121,122,77,144,1,-1,78,74,11581,10.481635482,10.568260568,6.6701316701,-3,0.0866250866,-0.086625087,6.7567567568
54,23,2006,135,136,201,144,0,-1,201,193,11774,11.560693642,11.646328409,17.212588311,-7,0,-0.085634768,17.212588311
54,23,2007,117,118,144,144,1,-1,145,125,11899,9.8846787479,9.9691631817,12.165758459,-19,0.0844844337,-0.084484434,12.250242893
54,23,2008,129,131,173,144,0,-2,173,148,12047,10.774242045,10.941284557,14.449177316,-23,0,-0.167042512,14.449177316
54,25,2001,387,440,28,661,4,-53,32,-54,34369,11.251308292,12.792185138,0.8140481451,-33,0.1162925922,-1.540876846,0.9303407373
54,25,2002,386,468,188,673,3,-82,191,79,34448,11.218158304,13.601290379,5.4637662206,-30,0.0871877588,-2.383132075,5.5509539794
54,25,2003,355,412,194,684,1,-57,195,102,34550,10.290153338,11.942375141,5.6233514015,-36,0.0289863474,-1.652221804,5.6523377489
54,25,2004,355,449,124,664,4,-94,128,8,34558,10.273774382,12.994154078,3.5885859814,-26,0.1157608381,-2.720379696,3.7043468195
54,25,2005,402,480,90,667,2,-78,92,-16,34542,11.635311143,13.892908828,2.6049204052,-30,0.0578871201,-2.257597685,2.6628075253
54,25,2006,347,448,85,667,3,-101,88,-31,34511,10.050251256,12.975540527,2.4618771089,-18,0.0868897803,-2.925289271,2.5487668892
54,25,2007,401,431,72,667,3,-30,75,26,34537,11.61510833,12.484069053,2.0855057351,-19,0.0868960723,-0.868960723,2.1724018074
54,25,2008,379,420,96,667,2,-41,98,30,34567,10.9689743,12.155591572,2.7784209308,-27,0.0578837694,-1.186617273,2.8363047002
54,27,2001,224,200,254,421,4,24,258,269,20560,10.966683802,9.7916819662,12.435436097,-13,0.1958336393,1.1750018359,12.631269736
54,27,2002,209,199,241,421,3,10,244,241,20801,10.106138633,9.62259133,11.653490003,-13,0.1450641909,0.483547303,11.798554194
54,27,2003,248,204,236,421,1,44,237,272,21073,11.845058986,9.7435162631,11.271910971,-9,0.0477623346,2.1015427234,11.319673306
54,27,2004,226,233,228,421,4,-7,232,202,21275,10.67346746,11.004061585,10.767922924,-23,0.1889109285,-0.330594125,10.956833853
54,27,2005,224,203,443,421,2,21,445,445,21720,10.419816258,9.4429584835,20.607047331,-21,0.0930340737,0.9768577742,20.700081405
54,27,2006,251,203,458,421,3,48,461,498,22218,11.425190041,9.2402931403,20.847557923,-11,0.1365560563,2.1848969002,20.984113979
54,27,2007,252,217,278,421,2,35,280,324,22542,11.260053619,9.6961572833,12.421805183,9,0.0893655049,1.563896336,12.511170688
54,27,2008,261,228,-14,421,1,33,-13,32,22574,11.570174661,10.107279014,-0.620622396,12,0.0443301711,1.4628956468,-0.576292224
54,29,2001,335,438,-196,351,0,-103,-196,-327,32294,10.321189247,13.494569822,-6.038665948,-28,0,-3.173380575,-6.038665948
54,29,2002,343,439,-221,351,-1,-96,-222,-345,31949,10.678206186,13.666858646,-6.880127018,-27,-0.031131796,-2.98865246,-6.911258814
54,29,2003,351,426,-258,351,-3,-75,-261,-369,31580,11.050071621,13.411198036,-8.122274867,-33,-0.094445057,-2.361126415,-8.216719923
54,29,2004,334,437,-295,351,3,-103,-292,-422,31158,10.647454493,13.930950939,-9.404188849,-27,0.0956358188,-3.283496446,-9.30855303
54,29,2005,373,478,-65,351,0,-105,-65,-194,30964,12.008628183,15.389073114,-2.092656386,-24,0,-3.380444931,-2.092656386
54,29,2006,324,395,-254,351,2,-71,-252,-337,30627,10.521017681,12.826549334,-8.247958306,-14,0.0649445536,-2.305531652,-8.183013752
54,29,2007,299,409,-330,351,0,-110,-330,-469,30158,9.8379534425,13.457267418,-10.85794193,-29,0,-3.619313975,-10.85794193
54,29,2008,317,411,-12,351,0,-94,-12,-150,30008,10.537512881,13.662201243,-0.398896387,-44,0,-3.124688362,-0.398896387
54,31,2001,156,123,71,75,3,33,74,97,12792,12.2415349,9.6519794405,5.5714678071,-10,0.2354141327,2.5895554596,5.8068819398
54,31,2002,137,162,71,75,3,-25,74,38,12830,10.6939349,12.645382874,5.5421122473,-11,0.2341737569,-1.951447974,5.7762860042
54,31,2003,138,140,225,75,2,-2,227,220,13050,10.664605873,10.819165379,17.387944359,-5,0.1545595054,-0.154559505,17.542503864
54,31,2004,153,144,154,75,1,9,155,152,13202,11.656254762,10.970592717,11.732439433,-12,0.0761846716,0.6856620448,11.808624105
54,31,2005,143,136,164,75,2,7,166,162,13364,10.765640292,10.238650907,12.346608447,-11,0.1505683957,0.5269893849,12.497176843
54,31,2006,148,153,111,75,1,-5,112,99,13463,11.033660119,11.406418906,8.2752450889,-8,0.0745517576,-0.372758788,8.3497968465
54,31,2007,166,127,140,75,2,39,142,180,13643,12.248210728,9.3706190511,10.329816277,-1,0.147568804,2.8775916771,10.477385081
54,31,2008,162,143,-67,75,1,19,-66,-52,13591,11.896893589,10.501578909,-4.920320188,-5,0.0734376147,1.3953146802,-4.846882573
54,33,2001,812,895,-604,1092,34,-83,-570,-703,67861,11.903976544,13.120762324,-8.85468206,-50,0.4984423676,-1.21678578,-8.356239692
54,33,2002,792,859,52,1012,31,-67,83,-48,67813,11.675044592,12.662706193,0.7665433318,-64,0.4569777555,-0.987661601,1.2235210873
54,33,2003,774,892,92,1015,22,-118,114,-99,67714,11.422078257,13.163428689,1.3576630487,-95,0.3246585551,-1.741350432,1.6823216038
54,33,2004,825,885,330,1117,29,-60,359,246,67960,12.161504784,13.045977859,4.8646019134,-53,0.4274953197,-0.884473075,5.2920972331
54,33,2005,865,822,127,1200,26,43,153,134,68094,12.715539418,12.083437459,1.8669057874,-62,0.3822011848,0.6321019595,2.2491069722
54,33,2006,812,850,274,1200,28,-38,302,230,68324,11.904587371,12.461698603,4.0170651967,-34,0.4105030128,-0.557111232,4.4275682095
54,33,2007,854,825,-131,1200,22,29,-109,-70,68254,12.505674413,12.081008654,-1.918317738,10,0.3221602308,0.4246657588,-1.596157507
54,33,2008,851,831,534,1200,22,20,556,599,68853,12.413662322,12.121919377,7.7895366393,23,0.3209172398,0.2917429453,8.1104538791
54,35,2001,321,301,-61,328,4,20,-57,-63,27978,11.460397365,10.746353916,-2.177832521,-26,0.1428086899,0.7140434495,-2.035023831
54,35,2002,327,313,73,328,3,14,76,65,28043,11.674193606,11.174381036,2.6061655451,-25,0.1071026936,0.4998125703,2.7132682387
54,35,2003,319,292,-17,328,1,27,-16,-30,28013,11.381475667,10.418153275,-0.606536321,-41,0.0356786071,0.9633223919,-0.570857714
54,35,2004,306,293,211,328,4,13,215,202,28215,10.884256954,10.421853881,7.5051575727,-26,0.1422778687,0.4624030732,7.6474354414
54,35,2005,318,287,-185,328,3,31,-182,-170,28045,11.30465695,10.202630643,-6.576608603,-19,0.1066477071,1.1020263064,-6.469960896
54,35,2006,339,317,70,328,5,22,75,83,28128,12.069855625,11.286561159,2.4923005714,-14,0.1780214694,0.7832944653,2.6703220408
54,35,2007,308,321,75,328,2,-13,77,42,28170,10.941774131,11.403602259,2.6643930513,-22,0.0710504814,-0.461828129,2.7354435326
54,35,2008,326,319,15,328,2,7,17,-13,28157,11.575265858,11.326717205,0.5326042573,-37,0.071013901,0.2485486534,0.6036181583
54,37,2001,566,391,688,1161,21,175,709,853,43292,13.204091869,9.1215546302,16.050203544,-31,0.4899044686,4.0825372386,16.540108012
54,37,2002,630,377,1134,1098,16,253,1150,1393,44685,14.321925049,8.5704218148,25.779465087,-10,0.3637314298,5.7515032338,26.143196517
54,37,2003,577,371,1047,1102,10,206,1057,1269,45954,12.731826256,8.1863215614,23.102637937,6,0.2206555677,4.5455046944,23.323293505
54,37,2004,634,438,916,1108,20,196,936,1075,47029,13.636901369,9.4210769711,19.702526268,-57,0.4301861631,4.215824398,20.132712431
54,37,2005,651,406,1260,1123,16,245,1276,1478,48507,13.628370457,8.4994138335,26.377491208,-43,0.3349522693,5.1289566237,26.712443477
54,37,2006,616,349,898,1123,20,267,918,1159,49666,12.549275259,7.1098978334,18.294235686,-26,0.4074440019,5.4393774256,18.701679688
54,37,2007,673,399,815,1123,15,274,830,1122,50788,13.399167778,7.9439345372,16.226332451,18,0.2986441555,5.4552332411,16.524976606
54,37,2008,659,399,529,1123,15,260,544,827,51615,12.870716678,7.7927404471,10.331728563,23,0.2929601672,5.0779762312,10.62468873
54,39,2001,2365,2553,-1747,3166,71,-188,-1676,-2016,197698,11.902005979,12.848127384,-8.791883486,-152,0.3573118074,-0.946121405,-8.434571679
54,39,2002,2371,2496,-1455,3202,57,-125,-1398,-1673,196025,12.044000477,12.678964653,-7.390983001,-150,0.2895436639,-0.634964175,-7.101439337
54,39,2003,2354,2439,-395,3301,25,-85,-370,-732,195293,12.031135803,12.46556509,-2.018818455,-277,0.1277733199,-0.434429288,-1.891045135
54,39,2004,2445,2524,-605,3422,70,-79,-535,-750,194543,12.54373634,12.949034979,-3.103869319,-136,0.3591253758,-0.405298638,-2.744743944
54,39,2005,2320,2519,-1374,3425,51,-199,-1323,-1702,192841,11.977779155,13.005183487,-7.093736448,-180,0.263304628,-1.027404333,-6.83043182
54,39,2006,2374,2397,-1050,3425,67,-23,-983,-1089,191752,12.345518509,12.46512547,-5.46031779,-83,0.3484202781,-0.119606961,-5.111897512
54,39,2007,2288,2408,-511,3425,52,-120,-459,-572,191180,11.949902333,12.576645462,-2.668881159,7,0.2715886894,-0.626743129,-2.39729247
54,39,2008,2260,2368,-141,3425,54,-108,-87,-162,191018,11.826330855,12.391482949,-0.737837456,33,0.282576047,-0.565152094,-0.455261409
54,41,2001,218,217,92,226,1,1,93,77,16939,12.899026656,12.839856809,5.4436259282,-17,0.059169847,0.059169847,5.5027957753
54,41,2002,180,206,25,226,0,-26,25,-19,16920,10.632328185,12.168108922,1.4767122479,-18,0,-1.535780738,1.4767122479
54,41,2003,190,238,215,226,-3,-48,212,156,17076,11.177785622,14.001647253,12.648546888,-8,-0.176491352,-2.823861631,12.472055536
54,41,2004,174,243,59,226,4,-69,63,-19,17057,10.195412065,14.238420297,3.4570650104,-13,0.2343772888,-4.043008233,3.6914422992
54,41,2005,192,218,109,226,1,-26,110,68,17125,11.233982798,12.755251302,6.3776256509,-16,0.0585103271,-1.521268504,6.436135978
54,41,2006,205,217,-11,226,3,-12,-8,-28,17097,11.980597277,12.681900532,-0.642861317,-8,0.1753258138,-0.701303255,-0.467535503
54,41,2007,187,245,52,226,1,-58,53,1,17098,10.937271531,14.329580348,3.0413803188,6,0.0584880831,-3.392308817,3.0998684018
54,41,2008,197,228,206,226,1,-31,207,183,17281,11.460484598,13.263911109,11.984060037,7,0.0581750487,-1.80342651,12.042235085
54,43,2001,263,272,15,70,1,-9,16,-15,22118,11.886737023,12.293507491,0.6779507808,-22,0.0451967187,-0.406770468,0.7231474995
54,43,2002,307,255,44,70,1,52,45,76,22194,13.856291749,11.509297707,1.9859180357,-21,0.0451345008,2.3469940422,2.0310525366
54,43,2003,311,250,93,70,1,61,94,124,22318,13.973759885,11.232925953,4.1786484543,-31,0.0449317038,2.7408339324,4.2235801582
54,43,2004,295,282,-13,70,0,13,-13,-14,22304,13.222177401,12.639505177,-0.582672224,-14,0,0.5826722245,-0.582672224
54,43,2005,286,283,32,70,1,3,33,18,22322,12.817639941,12.683189172,1.4341415318,-18,0.0448169229,0.1344507686,1.4789584547
54,43,2006,268,226,-51,70,0,42,-51,-19,22303,12.011204482,10.128851541,-2.285714286,-10,0,1.8823529412,-2.285714286
54,43,2007,296,257,-32,70,1,39,-31,5,22308,13.270269664,11.521821972,-1.434623748,-3,0.0448319921,1.7484476923,-1.389791755
54,43,2008,277,255,56,70,0,22,56,78,22386,12.39539983,11.410927641,2.5059292075,0,0,0.9844721887,2.5059292075
54,45,2001,498,499,-676,552,5,-1,-671,-693,36867,13.382240316,13.409112285,-18.16545071,-21,0.1343598425,-0.026871969,-18.03109087
54,45,2002,444,504,30,552,5,-60,35,-60,36807,12.053098787,13.68189592,0.8143985667,-35,0.1357330944,-1.628797133,0.9501316611
54,45,2003,465,450,-280,552,2,15,-278,-303,36504,12.685681548,12.276466015,-7.638689965,-40,0.0545620712,0.4092155338,-7.584127893
54,45,2004,439,499,-405,552,2,-60,-403,-495,36009,12.108173707,13.763049384,-11.17041082,-32,0.0551625226,-1.654875677,-11.1152483
54,45,2005,408,490,-135,552,2,-82,-133,-247,35762,11.369494643,13.654540135,-3.761965139,-32,0.0557328169,-2.285045492,-3.706232322
54,45,2006,422,528,19,552,2,-106,21,-101,35661,11.81692172,14.785153242,0.5320414992,-16,0.0560043683,-2.968231522,0.5880458676
54,45,2007,430,492,-27,552,2,-62,-25,-95,35566,12.074073034,13.81498589,-0.75813947,-8,0.0561584792,-1.740912856,-0.70198099
54,45,2008,416,459,12,552,1,-43,13,-41,35525,11.703309842,12.913026965,0.3375954762,-11,0.0281329564,-1.209717123,0.3657284326
54,47,2001,299,433,-632,303,2,-134,-630,-782,26345,11.1834231,16.195391981,-23.6385398,-18,0.0748055057,-5.011968881,-23.56373429
54,47,2002,280,389,-435,303,2,-109,-433,-561,25784,10.742580905,14.924514186,-16.68936676,-19,0.0767327208,-4.181933281,-16.61263404
54,47,2003,297,362,-687,303,2,-65,-685,-746,25038,11.687851718,14.245799063,-27.03553579,4,0.0787060722,-2.557947346,-26.95682972
54,47,2004,307,372,-620,303,1,-65,-619,-714,24324,12.438718042,15.072322839,-25.12053807,-30,0.0405169969,-2.633604797,-25.08002107
54,47,2005,284,397,-426,303,2,-113,-424,-552,23772,11.809713906,16.508649368,-17.71457086,-15,0.0831669993,-4.698935462,-17.63140386
54,47,2006,264,341,-339,303,1,-77,-338,-425,23347,11.205670749,14.473991384,-14.38909994,-10,0.0424457225,-3.268320635,-14.34665422
54,47,2007,306,356,-313,303,2,-50,-311,-369,22978,13.211009174,15.369670804,-13.5132218,-8,0.0863464652,-2.15866163,-13.42687534
54,47,2008,267,340,-174,303,1,-73,-173,-271,22707,11.688738098,14.884535405,-7.617379884,-25,0.0437780453,-3.195797308,-7.573601839
54,49,2001,600,788,-118,1247,19,-188,-99,-341,56163,10.650856063,13.988124295,-2.094668359,-54,0.3372771086,-3.337268233,-1.75739125
54,49,2002,601,744,168,1254,18,-143,186,-5,56158,10.701471675,13.247745301,2.9914263584,-48,0.320509967,-2.546273626,3.3119363254
54,49,2003,640,729,254,1274,9,-89,263,108,56266,11.385469295,12.968761119,4.5186081264,-66,0.160108162,-1.583291824,4.6787162883
54,49,2004,646,776,94,1386,10,-130,104,-65,56201,11.487814203,13.799603439,1.6716014475,-39,0.1778299412,-2.311789236,1.8494313888
54,49,2005,596,684,288,1501,9,-88,297,156,56357,10.590095773,12.153734075,5.1173617157,-53,0.1599175536,-1.563638302,5.2772792694
54,49,2006,606,680,158,1501,10,-74,168,67,56424,10.746490987,12.058768764,2.8018903893,-27,0.1773348348,-1.312277777,2.9792252241
54,49,2007,629,665,240,1501,9,-36,249,229,56653,11.1251625,11.761896761,4.2448950715,16,0.1591835652,-0.636734261,4.4040786367
54,49,2008,655,702,-148,1501,8,-47,-140,-157,56496,11.577654244,12.40841722,-2.616019585,30,0.141406464,-0.830762976,-2.474613121
54,51,2001,359,364,-200,888,2,-5,-198,-234,35161,10.17631385,10.318045241,-5.669255627,-31,0.0566925563,-0.141731391,-5.61256307
54,51,2002,359,374,-289,916,1,-15,-288,-334,34827,10.258901526,10.687546437,-8.25855861,-31,0.0285763274,-0.428644911,-8.229982283
54,51,2003,325,369,-128,921,0,-44,-128,-218,34609,9.3611383144,10.628492425,-3.686848321,-46,0,-1.26735411,-3.686848321
54,51,2004,353,418,-177,919,1,-65,-176,-268,34341,10.239303843,12.124728064,-5.134155185,-27,0.0290065265,-1.88542422,-5.105148658
54,51,2005,329,410,-353,918,0,-81,-353,-458,33883,9.6446998124,12.019230769,-10.34826454,-24,0,-2.374530957,-10.34826454
54,51,2006,328,393,-324,918,1,-65,-323,-402,33481,9.7381390654,11.667953209,-9.619381272,-14,0.0296894484,-1.929814144,-9.589691824
54,51,2007,304,365,-282,918,1,-61,-281,-369,33112,9.1300887481,10.962113135,-8.469358641,-27,0.0300331867,-1.832024387,-8.439325455
54,51,2008,315,379,-249,918,0,-64,-249,-346,32766,9.5631318498,11.506117368,-7.559428034,-33,0,-1.942985519,-7.559428034
54,53,2001,290,306,109,293,0,-16,109,71,26036,11.153631661,11.769004442,4.1922270726,-22,0,-0.615372781,4.1922270726
54,53,2002,292,269,-102,293,-1,23,-103,-102,25934,11.237252261,10.352126227,-3.925341543,-22,-0.038483741,0.8851260343,-3.963825284
54,53,2003,252,282,28,293,-2,-30,26,-40,25894,9.7244732577,10.882148646,1.0804970286,-36,-0.077178359,-1.157675388,1.0033186694
54,53,2004,335,305,-189,293,1,30,-188,-178,25716,12.981980236,11.819414842,-7.324161984,-20,0.0387521798,1.1625653943,-7.285409804
54,53,2005,286,317,-100,308,-1,-31,-101,-155,25561,11.155098777,12.364217875,-3.900384188,-23,-0.039003842,-1.209119098,-3.93938803
54,53,2006,311,321,3,308,0,-10,3,-19,25542,12.171496781,12.562863237,0.1174099368,-12,0,-0.391366456,0.1174099368
54,53,2007,296,311,12,308,0,-15,12,-11,25531,11.591251738,12.178646251,0.469915611,-8,0,-0.587394514,0.469915611
54,53,2008,293,303,171,308,-1,-10,170,147,25678,11.443300982,11.83385733,6.6785135425,-13,-0.039055635,-0.390556348,6.6394579078
54,55,2001,720,819,-950,1097,13,-99,-937,-1077,61850,11.54058841,13.127419316,-15.22716526,-41,0.2083717352,-1.586830906,-15.01879353
54,55,2002,772,821,231,1084,11,-49,242,139,61989,12.467800935,13.259150994,3.7306502798,-54,0.1776500133,-0.791350059,3.9083002931
54,55,2003,735,827,21,1046,7,-92,28,-153,61836,11.871592974,13.357561074,0.3391883707,-89,0.1130627902,-1.4859681,0.4522511609
54,55,2004,729,854,-61,1033,13,-125,-48,-215,61621,11.809779923,13.834776481,-0.98819832,-42,0.210599642,-2.024996558,-0.777598678
54,55,2005,702,814,-273,1033,11,-112,-262,-430,61191,11.432107612,13.256033612,-4.445819627,-56,0.1791355894,-1.823926001,-4.266684037
54,55,2006,663,796,-33,1033,13,-133,-20,-182,61009,10.85106383,13.027823241,-0.5400982,-29,0.2127659574,-2.176759411,-0.327332242
54,55,2007,748,804,291,1033,10,-56,301,252,61261,12.235217142,13.151222704,4.7599574712,7,0.1635724217,-0.916005561,4.9235298929
54,55,2008,708,780,287,1033,10,-72,297,239,61500,11.534607897,12.707618869,4.6757520711,14,0.1629181906,-1.173010973,4.8386702617
54,57,2001,327,311,-39,517,7,16,-32,-42,26996,12.103490395,11.511270681,-1.443535552,-26,0.2590961247,0.5922197135,-1.184439427
54,57,2002,292,319,160,517,6,-27,166,119,27115,10.792629964,11.790578625,5.9137698435,-20,0.2217663691,-0.997948661,6.1355362126
54,57,2003,301,303,73,530,4,-2,77,41,27156,11.09248033,11.166184518,2.6902028708,-34,0.1474083765,-0.073704188,2.8376112473
54,57,2004,276,317,-143,505,4,-41,-139,-200,26956,10.201064459,11.716439976,-5.285334122,-20,0.1478415139,-1.515375517,-5.137492608
54,57,2005,329,330,-112,502,4,-1,-108,-126,26830,12.233666753,12.270851151,-4.164652512,-17,0.1487375897,-0.037184397,-4.015914922
54,57,2006,275,315,-99,502,5,-40,-94,-148,26682,10.278068471,11.773060248,-3.700104649,-14,0.1868739722,-1.494991778,-3.513230677
54,57,2007,292,288,40,502,4,4,44,17,26699,10.940222176,10.790356119,1.4986605721,-31,0.1498660572,0.1498660572,1.6485266293
54,57,2008,302,272,117,502,3,30,120,96,26795,11.290985905,10.169364789,4.3743223539,-54,0.1121621116,1.1216211164,4.4864844655
54,59,2001,350,327,-592,127,2,23,-590,-580,27441,12.621254192,11.791857488,-21.34794995,-13,0.0721214525,0.829396704,-21.2758285
54,59,2002,381,325,-4,127,1,56,-3,25,27466,13.878011911,11.838199137,-0.145700912,-28,0.0364252281,2.0398127743,-0.109275684
54,59,2003,389,338,-205,127,-1,51,-206,-181,27285,14.209786123,12.346806451,-7.4884477,-26,-0.036529013,1.8629796716,-7.524976713
54,59,2004,381,360,-332,127,2,21,-330,-334,26951,14.049708681,13.275315289,-12.24279077,-25,0.0737517516,0.7743933918,-12.16903901
54,59,2005,367,368,-164,127,0,-1,-164,-189,26762,13.66522071,13.702455644,-6.106529146,-24,0,-0.037234934,-6.106529146
54,59,2006,358,359,-110,127,1,-1,-109,-121,26641,13.407486471,13.44493755,-4.119618748,-11,0.0374510795,-0.03745108,-4.082167668
54,59,2007,326,340,56,127,1,-14,57,35,26676,12.228745053,12.753905884,2.100643322,-8,0.0375114879,-0.525160831,2.1381548099
54,59,2008,349,332,-335,127,0,17,-335,-324,26352,13.162857358,12.521686656,-12.63483443,-6,0,0.6411707023,-12.63483443
54,61,2001,900,667,452,6222,238,233,690,853,82767,10.930222673,8.1005094698,5.4894007202,-70,2.8904366624,2.8297132031,8.3798373826
54,61,2002,816,638,257,6564,223,178,480,582,83349,9.8244600159,7.6813792771,3.0942233138,-76,2.6848708132,2.1430807388,5.779094127
54,61,2003,922,631,841,6944,195,291,1036,1272,84621,10.97815086,7.513246413,10.013692921,-55,2.3218431863,3.4649044472,12.335536108
54,61,2004,954,600,173,7065,187,354,360,657,85278,11.230201473,7.0630197941,2.0365040406,-57,2.2013078358,4.1671816785,4.2378118765
54,61,2005,870,647,508,7416,198,223,706,851,86129,10.151277369,7.5492832848,5.9274125327,-78,2.3102907116,2.6019940843,8.2377032443
54,61,2006,912,613,62,7416,201,299,263,520,86649,10.556899605,7.0958108092,0.7176839644,-42,2.3266851104,3.461088796,3.0443690748
54,61,2007,955,604,158,7416,173,351,331,665,87314,10.979346183,6.9440053345,1.8164782166,-17,1.9889286802,4.0353408483,3.8054068969
54,61,2008,988,603,361,7416,173,385,534,907,88221,11.257014271,6.8704247016,4.1131398297,-12,1.9711168713,4.386589569,6.0842567009
54,63,2001,145,147,96,78,0,-2,96,84,13284,10.950007552,11.101042139,7.2496601722,-10,0,-0.151034587,7.2496601722
54,63,2002,137,131,38,78,-1,6,37,30,13314,10.301526431,9.8503646891,2.8573576961,-13,-0.075193624,0.4511617415,2.7821640725
54,63,2003,121,145,139,78,-2,-24,137,106,13420,9.0521433381,10.847609785,10.398743173,-7,-0.149622204,-1.795466447,10.24912097
54,63,2004,120,167,83,78,1,-47,84,25,13445,8.9335566723,12.432533036,6.179043365,-12,0.0744463056,-3.498976363,6.2534896706
54,63,2005,120,158,80,78,-1,-38,79,29,13474,8.9156357963,11.738920465,5.9437571975,-12,-0.074296965,-2.823284669,5.8694602325
54,63,2006,149,156,14,78,0,-7,14,0,13474,11.05833457,11.577853644,1.0390381475,-7,0,-0.519519074,1.0390381475
54,63,2007,120,152,90,78,0,-32,90,64,13538,8.8849400267,11.254257367,6.66370502,6,0,-2.36931734,6.66370502
54,63,2008,125,147,213,78,-1,-22,212,201,13739,9.1652307805,10.778311398,15.61755325,11,-0.073321846,-1.613080617,15.544231404
54,65,2001,147,148,142,171,10,-1,152,140,15152,9.7467179419,9.8130221456,9.4151969235,-11,0.6630420369,-0.066304204,10.07823896
54,65,2002,151,195,126,171,9,-44,135,80,15232,9.9394418115,12.835703002,8.2938388626,-11,0.5924170616,-2.89626119,8.8862559242
54,65,2003,151,172,207,171,6,-21,213,185,15417,9.8535025613,11.223857222,13.507781657,-7,0.3915299031,-1.370354661,13.89931156
54,65,2004,159,164,236,171,9,-5,245,222,15639,10.239567233,10.561566203,15.198351365,-18,0.5795981453,-0.32199897,15.777949511
54,65,2005,163,203,259,171,7,-40,266,214,15853,10.351835387,12.892163089,16.448621872,-12,0.4445573479,-2.540327702,16.89317922
54,65,2006,154,169,330,171,8,-15,338,314,16167,9.6189881324,10.555902561,20.612117427,-9,0.4996876952,-0.936914428,21.111805122
54,65,2007,155,193,214,171,6,-38,220,179,16346,9.5346476794,11.872174207,13.163965183,-3,0.369083136,-2.337526528,13.533048319
54,65,2008,154,193,31,171,5,-39,36,-21,16325,9.4273208656,11.814759267,1.897707447,-18,0.3060818463,-2.387438401,2.2037892933
54,67,2001,261,277,-345,193,1,-16,-344,-380,26168,9.9021170043,10.509143334,-13.08900524,-20,0.0379391456,-0.60702633,-13.05106609
54,67,2002,277,288,1,193,0,-11,1,-35,26133,10.592531692,11.013173744,0.0382401866,-25,0,-0.420642053,0.0382401866
54,67,2003,280,297,-80,193,0,-17,-80,-129,26004,10.740932543,11.39306059,-3.068837869,-32,0,-0.652128047,-3.068837869
54,67,2004,284,294,36,193,1,-10,37,10,26014,10.919297166,11.303779461,1.3841362605,-17,0.0384482295,-0.384482295,1.42258449
54,67,2005,279,306,130,193,1,-27,131,78,26092,10.70893947,11.74528845,4.9898284267,-26,0.0383832956,-1.036348981,5.0282117223
54,67,2006,323,322,81,193,1,1,82,72,26164,12.362216779,12.323943662,3.100122474,-11,0.038273117,0.038273117,3.1383955909
54,67,2007,297,318,-33,193,1,-21,-32,-43,26121,11.36081094,12.164100602,-1.262312327,10,0.0382518887,-0.803289662,-1.224060438
54,67,2008,301,320,21,193,0,-19,21,16,26137,11.519767308,12.2469287,0.8037046959,14,0,-0.727161392,0.8037046959
54,69,2001,474,615,-592,2611,26,-141,-566,-742,46588,10.09391171,13.096531016,-12.60674205,-35,0.553674482,-3.002619306,-12.05306757
54,69,2002,471,598,-276,2599,25,-127,-251,-412,46176,10.154801432,12.892932603,-5.950584278,-34,0.5390021991,-2.738131172,-5.411582079
54,69,2003,458,599,-449,2505,18,-141,-431,-605,45571,9.9839776777,13.057647662,-9.787785977,-33,0.3923834022,-3.073669984,-9.395402574
54,69,2004,487,630,-165,2503,20,-143,-145,-322,45249,10.72451002,13.873596124,-3.63356089,-34,0.440431623,-3.149086104,-3.193129267
54,69,2005,479,589,-222,2422,18,-110,-204,-358,44891,10.627912137,13.068560018,-4.925671178,-44,0.3993787442,-2.440647881,-4.526292434
54,69,2006,511,531,-248,2422,20,-20,-228,-267,44624,11.417080936,11.863933419,-5.540970787,-19,0.4468524828,-0.446852483,-5.094118304
54,69,2007,457,564,-188,2422,19,-107,-169,-264,44360,10.271509485,12.676436213,-4.225478738,12,0.4270430639,-2.404926728,-3.798435674
54,69,2008,479,565,-214,2422,18,-86,-196,-254,44106,10.829019058,12.773268826,-4.838016865,28,0.406935998,-1.944249768,-4.431080867
54,71,2001,82,86,-86,168,3,-4,-83,-94,8073,10.098522167,10.591133005,-10.591133,-7,0.3694581281,-0.492610837,-10.22167488
54,71,2002,82,83,-102,168,-5,-1,-107,-112,7961,10.228264937,10.352999875,-12.7229637,-4,-0.623674691,-0.124734938,-13.34663839
54,71,2003,114,85,20,168,-16,29,4,22,7983,14.300050176,10.662318113,2.5087807326,-11,-2.007024586,3.6377320622,0.5017561465
54,71,2004,86,86,-81,177,12,0,-69,-77,7906,10.825099125,10.825099125,-10.1957329,-8,1.5104789477,0,-8.685253949
54,71,2005,68,109,-80,182,0,-41,-80,-128,7778,8.6712573323,13.89951543,-10.20147921,-7,0,-5.228258097,-10.20147921
54,71,2006,75,87,-32,169,8,-12,-24,-40,7738,9.6674400619,11.214230472,-4.124774426,-4,1.0311936066,-1.54679041,-3.09358082
54,71,2007,79,93,-117,159,1,-14,-116,-124,7614,10.291818656,12.115685253,-15.24231371,6,0.1302761855,-1.823866597,-15.11203752
54,71,2008,78,88,-27,159,2,-10,-25,-32,7582,10.265859437,11.581995262,-3.553566728,3,0.263227165,-1.316135825,-3.290339563
54,73,2001,79,92,54,256,3,-13,57,37,7537,10.507415043,12.236483341,7.1822837002,-7,0.3990157611,-1.729068298,7.5812994613
54,73,2002,78,85,-17,256,3,-7,-14,-27,7510,10.367515119,11.297933143,-2.259586629,-6,0.3987505815,-0.930418024,-1.860836047
54,73,2003,67,97,-90,256,2,-30,-88,-122,7388,8.9944959055,13.021882132,-12.08215868,-4,0.2684924151,-4.027386226,-11.81366626
54,73,2004,69,92,-1,256,1,-23,0,-29,7359,9.357835492,12.477113989,-0.135620804,-6,0.1356208042,-3.119278497,0
54,73,2005,58,83,-52,256,2,-25,-50,-81,7278,7.925121268,11.341121815,-7.105281137,-6,0.2732800437,-3.416000547,-6.832001093
54,73,2006,68,86,-27,256,1,-18,-26,-46,7232,9.3728463129,11.853893866,-3.72157133,-2,0.1378359752,-2.481047553,-3.583735355
54,73,2007,65,83,-19,256,2,-18,-17,-36,7196,9.010257832,11.505406155,-2.633767674,-1,0.2772387025,-2.495148323,-2.356528971
54,73,2008,60,94,-18,256,1,-34,-17,-46,7150,8.3647009619,13.104698174,-2.509410289,5,0.1394116827,-4.739997212,-2.369998606
54,75,2001,78,112,-143,304,1,-34,-142,-182,8928,8.6484089145,12.418228185,-15.85541634,-6,0.1108770374,-3.76981927,-15.74453931
54,75,2002,85,116,47,305,1,-31,48,10,8938,9.5152804209,12.985559163,5.2613903504,-7,0.1119444755,-3.470278742,5.3733348259
54,75,2003,83,116,26,306,1,-33,27,-17,8921,9.2950333165,12.990648973,2.9116971835,-11,0.1119883532,-3.695615656,3.0236855367
54,75,2004,95,136,62,307,0,-41,62,13,8934,10.641276953,15.233828059,6.94483338,-8,0,-4.592551106,6.94483338
54,75,2005,82,135,-87,305,1,-53,-86,-145,8789,9.253512385,15.234441122,-9.817750945,-6,0.112847712,-5.980928737,-9.704903233
54,75,2006,78,115,-67,305,1,-37,-66,-108,8681,8.929593589,13.165426445,-7.670291929,-5,0.1144819691,-4.235832856,-7.55580996
54,75,2007,94,121,-87,305,2,-27,-85,-113,8568,10.899182561,14.029798829,-10.08754131,-1,0.2318975013,-3.130616268,-9.855643805
54,75,2008,82,112,-58,305,1,-30,-57,-96,8472,9.6244131455,13.145539906,-6.807511737,-9,0.117370892,-3.521126761,-6.690140845
54,77,2001,266,346,-8,429,2,-80,-6,-114,29173,9.10023948,11.837153609,-0.273691413,-28,0.0684228532,-2.736914129,-0.20526856
54,77,2002,328,319,269,429,1,9,270,258,29431,11.193775169,10.886628899,9.1802607331,-21,0.0341273633,0.3071462699,9.2143880964
54,77,2003,306,349,95,429,-1,-43,94,17,29448,10.394198271,11.854820904,3.2269569796,-34,-0.033967968,-1.460622633,3.1929890114
54,77,2004,351,323,133,429,2,28,135,138,29586,11.891452383,10.942846495,4.5058779686,-25,0.0677575634,0.9486058881,4.5736355321
54,77,2005,301,321,251,429,0,-20,251,203,29789,10.138947368,10.812631579,8.4547368421,-28,0,-0.673684211,8.4547368421
54,77,2006,314,288,310,429,1,26,311,321,30110,10.484315264,9.6161872485,10.350757108,-16,0.0333895391,0.8681280155,10.384146647
54,77,2007,342,338,109,429,1,4,110,123,30233,11.335200437,11.202624994,3.6126808412,9,0.0331438609,0.1325754437,3.6458247021
54,77,2008,331,335,42,429,0,-4,42,52,30285,10.938894213,11.071086288,1.3880167884,14,0,-0.132192075,1.3880167884
54,79,2001,614,417,-301,301,5,197,-296,-144,51590,11.884944447,8.0716967984,-5.826332701,-45,0.0967829352,3.8132476482,-5.729549766
54,79,2002,596,438,382,301,0,158,382,498,52088,11.497135361,8.4492370609,7.3689693088,-42,0,3.0478983005,7.3689693088
54,79,2003,648,466,546,301,-7,182,539,675,52763,12.360397135,8.8888041125,10.414779067,-46,-0.133522809,3.4715930225,10.281256259
54,79,2004,685,484,416,301,10,201,426,579,53342,12.911738372,9.1230384996,7.8412892889,-48,0.188492531,3.7886998728,8.0297818199
54,79,2005,636,447,375,301,3,189,378,516,53858,11.865671642,8.3395522388,6.9962686567,-51,0.0559701493,3.526119403,7.052238806
54,79,2006,638,466,333,301,8,172,341,488,54346,11.792540017,8.6133599497,6.1550404791,-25,0.1478688403,3.1791800673,6.3029093194
54,79,2007,649,505,367,301,5,144,372,526,54872,11.884487905,9.247559926,6.7205039462,10,0.0915599993,2.6369279789,6.8120639455
54,79,2008,697,499,387,301,5,198,392,616,55488,12.631388184,9.0431315694,7.013410656,26,0.0906125408,3.5882566147,7.1040231968
54,81,2001,830,948,-572,3674,36,-118,-536,-720,78328,10.547986987,12.047580317,-7.269215128,-66,0.45750305,-1.499593331,-6.811712078
54,81,2002,895,918,578,3679,27,-23,605,526,78854,11.388072426,11.680726801,7.3545316894,-56,0.3435507883,-0.292654375,7.6980824776
54,81,2003,838,972,-15,3695,12,-134,-3,-250,78604,10.64410827,12.346149449,-0.190526998,-113,0.1524215981,-1.702041179,-0.0381054
54,81,2004,937,927,30,3731,40,10,70,27,78631,11.91846599,11.791267847,0.3815944287,-53,0.5087925716,0.1271981429,0.8903870003
54,81,2005,896,878,-31,3718,28,18,-3,-56,78575,11.399056016,11.170057123,-0.394386983,-71,0.3562205005,0.2289988932,-0.038166482
54,81,2006,906,890,58,3718,37,16,95,74,78649,11.524958022,11.321426754,0.7378008447,-37,0.4706660561,0.2035312675,1.2084669007
54,81,2007,886,926,422,3718,28,-40,450,418,79067,11.235385123,11.742625986,5.3513911081,8,0.3550686043,-0.507240863,5.7064597124
54,81,2008,898,939,276,3718,29,-41,305,290,79357,11.336666162,11.854264505,3.4843205575,26,0.3661061455,-0.517598344,3.850426703
54,83,2001,323,359,89,1601,6,-36,95,34,28240,11.444566488,12.720121886,3.1534564008,-25,0.2125925663,-1.275555398,3.3660489672
54,83,2002,296,333,120,1627,5,-37,125,64,28304,10.469722694,11.778438031,4.2444821732,-24,0.1768534239,-1.308715337,4.4213355971
54,83,2003,316,357,-99,1595,5,-41,-94,-167,28137,11.197533708,12.650378271,-3.508088092,-32,0.1771761663,-1.452844563,-3.330911926
54,83,2004,322,354,210,1582,6,-32,216,160,28297,11.411560407,12.545628522,7.4423220045,-24,0.2126377716,-1.134068115,7.654959776
54,83,2005,347,357,96,1591,5,-10,101,67,28364,12.248283652,12.601260126,3.3885741515,-24,0.1764882371,-0.352976474,3.5650623886
54,83,2006,315,324,-40,1591,6,-9,-34,-56,28308,11.116600791,11.434217956,-1.411631846,-13,0.211744777,-0.317617165,-1.199887069
54,83,2007,333,341,-56,1591,6,-8,-50,-53,28255,11.774481552,12.057351979,-1.980092994,5,0.2121528207,-0.282870428,-1.767940173
54,83,2008,326,337,-5,1591,5,-11,0,9,28264,11.535943665,11.925193298,-0.176931651,20,0.1769316513,-0.389249633,0
54,85,2001,108,126,-16,76,1,-18,-15,-42,10293,10.471204188,12.216404887,-1.551289509,-9,0.0969555943,-1.745200698,-1.454333915
54,85,2002,131,114,-3,76,1,17,-2,5,10298,12.724005634,11.072798796,-0.291389442,-10,0.097129814,1.6512068379,-0.194259628
54,85,2003,120,122,38,76,1,-2,39,21,10319,11.640878886,11.834893534,3.686278314,-16,0.0970073241,-0.194014648,3.7832856381
54,85,2004,121,142,-24,76,0,-21,-24,-52,10267,11.755562032,13.795783542,-2.331681725,-7,0,-2.04022151,-2.331681725
54,85,2005,126,123,55,76,1,3,56,51,10318,12.241923731,11.950449356,5.3436968667,-8,0.0971581248,0.2914743745,5.4408549915
54,85,2006,91,121,87,76,0,-30,87,51,10369,8.7977957171,11.698167932,8.4110794219,-6,0,-2.900372214,8.4110794219
54,85,2007,112,134,-18,76,1,-22,-17,-40,10329,10.822301672,12.948110929,-1.739298483,-1,0.0966276935,-2.125809257,-1.642670789
54,85,2008,119,121,-26,76,0,-2,-26,-21,10308,11.532684014,11.726510636,-2.519746087,7,0,-0.193826622,-2.519746087
54,87,2001,161,195,0,112,5,-34,5,-45,15413,10.430501118,12.633215639,0,-16,0.3239286061,-2.202714522,0.3239286061
54,87,2002,154,177,-91,112,4,-23,-87,-127,15286,10.032900094,11.531320238,-5.928531874,-17,0.2605948076,-1.498420144,-5.667937066
54,87,2003,173,171,75,112,3,2,78,66,15352,11.29316535,11.162608525,4.8958809322,-14,0.1958352373,0.1305568249,5.0917161695
54,87,2004,191,205,-55,112,6,-14,-49,-73,15279,12.471026085,13.385132709,-3.591133166,-10,0.3917599817,-0.914106624,-3.199373184
54,87,2005,168,157,52,112,4,11,56,54,15333,10.976087809,10.257415393,3.3973605122,-13,0.261335424,0.718672416,3.6586959362
54,87,2006,147,166,77,112,5,-19,82,55,15388,9.5700009765,10.806939878,5.0128576544,-8,0.3255102373,-1.236938902,5.3383678917
54,87,2007,167,188,-134,112,4,-21,-130,-146,15242,10.904342148,12.275546849,-8.749591903,5,0.2611818479,-1.371204701,-8.488410056
54,87,2008,171,170,-73,112,3,1,-70,-73,15169,11.245930749,11.180165072,-4.800894413,-4,0.1972970307,0.0657656769,-4.603597383
54,89,2001,126,160,-117,1546,1,-34,-116,-164,14160,8.8470720404,11.234377194,-8.215138323,-14,0.0702148575,-2.387305154,-8.144923466
54,89,2002,101,170,-169,1565,0,-69,-169,-248,13912,7.1957822742,12.111712739,-12.04046737,-10,0,-4.915930465,-12.04046737
54,89,2003,132,178,-39,1565,0,-46,-39,-105,13807,9.524153108,12.843176161,-2.813954327,-20,0,-3.319023053,-2.813954327
54,89,2004,122,158,-142,1565,1,-36,-141,-190,13617,8.8973162194,11.522753792,-10.35589265,-13,0.0729288215,-2.625437573,-10.28296383
54,89,2005,113,169,-79,1565,1,-56,-78,-141,13476,8.3416380615,12.475547189,-5.831764662,-7,0.0738198059,-4.133909128,-5.757944857
54,89,2006,98,143,-106,1565,1,-45,-105,-158,13318,7.3150705382,10.6740315,-7.912219154,-8,0.0746435769,-3.358960961,-7.837575577
54,89,2007,120,152,-85,1565,0,-32,-85,-131,13187,9.0548953028,11.46953405,-6.413884173,-14,0,-2.414638747,-6.413884173
54,89,2008,113,157,-107,1565,-1,-44,-108,-170,13017,8.6246374599,11.982903374,-8.166692108,-18,-0.076324225,-3.358265914,-8.243016333
54,91,2001,154,200,15,502,1,-46,16,-44,16037,9.5896382091,12.454075596,0.9340556697,-14,0.062270378,-2.864437387,0.9963260477
54,91,2002,156,208,21,529,0,-52,21,-49,15988,9.7423887588,12.989851678,1.3114754098,-18,0,-3.24746292,1.3114754098
54,91,2003,165,192,46,539,-1,-27,45,-4,15984,10.32153134,12.010509196,2.8775178281,-22,-0.062554735,-1.688977856,2.8149630927
54,91,2004,158,173,44,512,2,-15,46,21,16005,9.8783956985,10.816218075,2.7509456376,-10,0.1250429835,-0.937822376,2.8759886211
54,91,2005,146,190,64,541,0,-44,64,5,16010,9.1207246603,11.869436202,3.9981258785,-15,0,-2.748711541,3.9981258785
54,91,2006,151,181,127,541,1,-30,128,89,16099,9.4054626429,11.274097605,7.9105546731,-9,0.0622878321,-1.868634962,7.9728425052
54,91,2007,162,170,10,541,1,-8,11,0,16099,10.062736816,10.559662091,0.6211565936,-3,0.0621156594,-0.496925275,0.6832722529
54,91,2008,161,178,72,541,0,-17,72,59,16158,9.9823294169,11.0363642,4.4641473169,4,0,-1.054034783,4.4641473169
54,93,2001,62,79,-55,134,1,-17,-54,-78,7216,8.5458304618,10.88904204,-7.580978635,-7,0.1378359752,-2.343211578,-7.44314266
54,93,2002,61,77,33,134,1,-16,34,11,7227,8.446998546,10.662604722,4.569687738,-7,0.138475386,-2.215606176,4.708163124
54,93,2003,74,105,-39,134,1,-31,-38,-77,7150,10.294219935,14.606663421,-5.425332128,-8,0.1391110802,-4.312443486,-5.286221048
54,93,2004,61,84,-74,134,0,-23,-74,-103,7047,8.5933647954,11.833485948,-10.42473762,-6,0,-3.240121152,-10.42473762
54,93,2005,58,97,-37,134,1,-39,-36,-82,6965,8.2786183271,13.845275478,-5.281187554,-7,0.1427347987,-5.566657151,-5.138452755
54,93,2006,68,74,-58,134,0,-6,-58,-67,6898,9.8102863738,10.675899877,-8.367597201,-3,0,-0.865613504,-8.367597201
54,93,2007,57,92,1,134,1,-35,2,-31,6867,8.2818743189,13.367235743,0.1452960407,2,0.1452960407,-5.085361424,0.2905920814
54,93,2008,62,95,38,134,0,-33,38,10,6877,9.0221187427,13.824214203,5.529685681,5,0,-4.80209546,5.529685681
54,95,2001,88,108,-73,107,1,-20,-72,-100,9486,9.2281879195,11.325503356,-7.655201342,-8,0.1048657718,-2.097315436,-7.55033557
54,95,2002,102,121,-105,107,1,-19,-104,-131,9355,10.827450772,12.844328857,-11.14590521,-8,0.1061514782,-2.016878085,-11.03975373
54,95,2003,73,115,-5,107,0,-42,-5,-60,9295,7.8284182306,12.332439678,-0.536193029,-13,0,-4.504021448,-0.536193029
54,95,2004,81,119,21,107,1,-38,22,-22,9273,8.7246876346,12.817750969,2.2619560534,-6,0.107712193,-4.093063335,2.3696682464
54,95,2005,99,111,-35,107,1,-12,-34,-52,9221,10.706174976,12.003893155,-3.785011355,-6,0.1081431816,-1.297718179,-3.676868173
54,95,2006,84,109,-105,107,1,-25,-104,-134,9087,9.1763163644,11.907362901,-11.47039546,-5,0.1092418615,-2.731046537,-11.36115359
54,95,2007,90,103,-121,107,1,-13,-120,-138,8949,9.9800399202,11.421601242,-13.41760923,-5,0.1108893324,-1.441561322,-13.30671989
54,95,2008,87,120,-64,107,0,-33,-64,-108,8841,9.7807757167,13.490725126,-7.195053401,-11,0,-3.70994941,-7.195053401
54,97,2001,283,286,-66,1381,5,-3,-61,-86,23326,12.110060336,12.238435534,-2.824254354,-22,0.2139586632,-0.128375198,-2.610295691
54,97,2002,279,263,4,1381,4,16,8,1,23327,11.960645618,11.274730457,0.1714787902,-23,0.1714787902,0.6859151609,0.3429575804
54,97,2003,297,260,253,1451,3,37,256,274,23601,12.657688374,11.080804637,10.782475281,-19,0.1278554381,1.5768837368,10.910330719
54,97,2004,280,240,-24,1310,5,40,-19,5,23606,11.862647489,10.167983562,-1.016798356,-16,0.2118329909,1.694663927,-0.804965365
54,97,2005,265,266,-208,1210,4,-1,-204,-225,23381,11.279715666,11.322280631,-8.853512674,-20,0.1702598591,-0.042564965,-8.683252815
54,97,2006,287,276,71,1210,5,11,76,75,23456,12.255268271,11.785554156,3.0317911053,-12,0.2135064159,0.4697141149,3.2452975212
54,97,2007,284,257,9,1210,4,27,13,47,23503,12.095657914,10.945718606,0.3833131029,7,0.1703613791,1.1499393088,0.553674482
54,97,2008,273,256,48,1210,3,17,51,79,23582,11.596049697,10.873951365,2.0388658809,11,0.1274291176,0.7220983328,2.1662949984
54,99,2001,504,456,-221,195,9,48,-212,-201,42699,11.775838503,10.654330074,-5.163611724,-37,0.2102828304,1.1215084288,-4.953328894
54,99,2002,508,501,-271,195,8,7,-263,-296,42403,11.938614839,11.774106366,-6.368827995,-40,0.1880096825,0.1645084722,-6.180818312
54,99,2003,468,455,-26,195,7,13,-19,-66,42337,11.045551097,10.738730234,-0.613641728,-60,0.1652112344,0.3068208638,-0.448430493
54,99,2004,437,446,-127,195,8,-9,-119,-155,42182,10.3408701,10.553839965,-3.005241425,-27,0.1893065465,-0.212969865,-2.815934879
54,99,2005,453,501,-211,195,7,-48,-204,-280,41902,10.774939346,11.916654774,-5.018790733,-28,0.1665001665,-1.141715427,-4.852290567
54,99,2006,452,471,-380,195,9,-19,-371,-409,41493,10.839978416,11.295641225,-9.11325619,-19,0.2158402782,-0.45566281,-8.897415912
54,99,2007,449,476,-218,195,8,-27,-210,-276,41217,10.857211945,11.510095514,-5.271430299,-39,0.1934469834,-0.652883569,-5.077983315
54,99,2008,441,458,-64,195,7,-17,-57,-135,41082,10.717019648,11.130147389,-1.555304439,-61,0.170111423,-0.413127742,-1.385193016
54,101,2001,108,124,-9,60,2,-16,-7,-33,9655,11.166830378,12.821175619,-0.930569198,-10,0.2067931551,-1.654345241,-0.723776043
54,101,2002,84,119,56,60,1,-35,57,14,9669,8.6938522045,12.316290623,5.7959014697,-8,0.1034982405,-3.622438419,5.8993997102
54,101,2003,94,105,37,60,0,-11,37,15,9684,9.7142561877,10.851030848,3.8236965845,-11,0,-1.13677466,3.8236965845
54,101,2004,94,127,87,60,2,-33,89,48,9732,9.6827358879,13.081994232,8.9616810878,-8,0.2060156572,-3.399258344,9.167696745
54,101,2005,96,123,-90,60,1,-27,-89,-123,9609,9.927097875,12.719094152,-9.306654258,-7,0.1034072695,-2.791996277,-9.203246988
54,101,2006,100,102,-54,60,2,-2,-52,-60,9549,10.43950308,10.648293141,-5.637331663,-6,0.2087900616,-0.208790062,-5.428541601
54,101,2007,98,128,-96,60,1,-30,-95,-128,9421,10.332103321,13.494992093,-10.12124407,-3,0.1054296257,-3.162888772,-10.01581444
54,101,2008,96,115,7,60,0,-19,7,-27,9394,10.20462397,12.224289131,0.7440871645,-15,0,-2.019665161,0.7440871645
54,103,2001,180,235,-306,170,1,-55,-305,-371,17301,10.293655105,13.43893861,-17.49921368,-11,0.0571869728,-3.145283504,-17.44202671
54,103,2002,188,198,-96,170,1,-10,-95,-118,17183,10.90360747,11.483586591,-5.567799559,-13,0.0579979121,-0.579979121,-5.509801647
54,103,2003,178,204,-88,170,1,-26,-87,-134,17049,10.399626081,11.918672587,-5.141388175,-21,0.0584248656,-1.519046506,-5.082963309
54,103,2004,217,226,-23,170,0,-9,-23,-44,17005,12.744464674,13.273036941,-1.350795795,-12,0,-0.528572268,-1.350795795
54,103,2005,186,209,-93,170,1,-23,-92,-128,16877,10.979281034,12.336934065,-5.489640517,-13,0.0590283927,-1.357653031,-5.430612124
54,103,2006,225,214,-245,170,0,11,-245,-241,16636,13.427625101,12.771163429,-14.62119178,-7,0,0.6564616716,-14.62119178
54,103,2007,185,199,-201,170,1,-14,-200,-220,16416,11.194481423,12.041631369,-12.16265279,-6,0.0605107104,-0.847149946,-12.10214208
54,103,2008,191,187,-72,170,0,4,-72,-87,16329,11.665903191,11.421591083,-4.397617957,-19,0,0.2443121087,-4.397617957
54,105,2001,49,48,-23,24,1,1,-22,-29,5852,8.3525100145,8.1820506264,-3.920565925,-8,0.1704593881,0.1704593881,-3.750106537
54,105,2002,52,47,-55,24,1,5,-54,-54,5798,8.9270386266,8.0686695279,-9.442060086,-5,0.1716738197,0.8583690987,-9.270386266
54,105,2003,61,69,-43,24,1,-8,-42,-57,5741,10.572839934,11.959441893,-7.452985527,-7,0.1733252448,-1.386601959,-7.279660283
54,105,2004,54,54,32,24,0,0,32,27,5768,9.3839603788,9.3839603788,5.5608654097,-5,0,0,5.5608654097
54,105,2005,62,61,12,24,1,1,13,9,5777,10.740580338,10.567345171,2.0788220009,-5,0.1732351667,0.1732351667,2.2520571676
54,105,2006,59,72,11,24,1,-13,12,-4,5773,10.216450216,12.467532468,1.9047619048,-3,0.1731601732,-2.251082251,2.0779220779
54,105,2007,55,54,20,24,2,1,22,22,5795,9.5089903181,9.3360995851,3.4578146611,-1,0.3457814661,0.1728907331,3.8035961272
54,105,2008,63,71,-32,24,1,-8,-31,-38,5757,10.907202216,12.292243767,-5.540166205,1,0.1731301939,-1.385041551,-5.367036011
54,107,2001,1067,1027,-164,1351,18,40,-146,-186,87688,12.155249997,11.699570522,-1.868285848,-80,0.2050557638,0.4556794751,-1.663230084
54,107,2002,1042,1023,-56,1391,14,19,-42,-107,87581,11.890294348,11.673484758,-0.639017738,-84,0.1597544346,0.2168095898,-0.479263304
54,107,2003,981,983,-402,1392,7,-2,-395,-497,87084,11.232931612,11.255832594,-4.603097358,-100,0.0801534366,-0.022900982,-4.522943921
54,107,2004,1009,989,-309,1413,20,20,-289,-334,86750,11.608776189,11.378671606,-3.5551158,-65,0.2301045825,0.2301045825,-3.325011218
54,107,2005,984,905,-151,1411,14,79,-137,-141,86609,11.35216516,10.440761656,-1.742049735,-83,0.161514545,0.9114035037,-1.58053519
54,107,2006,1044,975,-480,1411,19,69,-461,-429,86180,12.084102576,11.285440624,-5.55590923,-37,0.219921407,0.7986619519,-5.335987823
54,107,2007,955,934,-233,1411,15,21,-218,-174,86006,11.092655617,10.848733346,-2.706375664,23,0.1742301929,0.2439222701,-2.532145471
54,107,2008,983,948,111,1411,15,35,126,198,86204,11.41629406,11.0098136,1.2891237443,37,0.1742059114,0.4064804599,1.4633296557
54,109,2001,262,291,-475,119,2,-29,-473,-520,25063,10.346325475,11.49152944,-18.75765115,-18,0.0789795838,-1.145203965,-18.67867156
54,109,2002,287,263,-349,119,1,24,-348,-342,24721,11.529808774,10.56564358,-14.02056886,-18,0.0401735497,0.9641651936,-13.98039531
54,109,2003,325,279,-186,119,0,46,-186,-166,24555,13.191005763,11.323971102,-7.549314068,-26,0,1.8670346619,-7.549314068
54,109,2004,241,324,-255,119,1,-83,-254,-358,24197,9.8867738759,13.291762389,-10.46110929,-21,0.041023958,-3.404988513,-10.42008533
54,109,2005,265,312,-17,119,1,-47,-16,-84,24113,10.970813496,12.916580418,-0.703788036,-21,0.0413992962,-1.945766922,-0.662388739
54,109,2006,279,286,-195,119,1,-7,-194,-212,23901,11.621610364,11.913191986,-8.122630899,-11,0.0416545174,-0.291581622,-8.080976382
54,109,2007,248,293,-203,119,1,-45,-202,-253,23648,10.431344508,12.324128793,-8.538560222,-6,0.042061873,-1.892784286,-8.496498349
54,109,2008,248,284,-66,119,0,-36,-66,-114,23534,10.512483574,12.038489254,-2.79767708,-12,0,-1.52600568,-2.79767708
55,0,2001,68813,47011,872,155378,8808,21802,9680,33928,5408061,12.76419252,8.720117631,0.1617481563,2446,1.6338047711,4.0440748887,1.7955529274
55,0,2002,68521,46607,5042,158164,8239,21914,13281,36577,5444638,12.627457925,8.5890155066,0.9291697853,1382,1.5183319836,4.0384424188,2.4475017689
55,0,2003,69165,46719,602,158625,6839,22446,7441,29722,5474360,12.668744879,8.5573786166,0.1102665281,-165,1.2526790462,4.1113662627,1.3629455743
55,0,2004,70753,46500,1700,160250,6668,24253,8368,34429,5508789,12.883918811,8.4675169207,0.3095651347,1808,1.2142237167,4.4164018898,1.5237888514
55,0,2005,70356,46275,-2042,162326,6848,24081,4806,30017,5538806,12.736889794,8.3773889249,-0.369673218,1130,1.2397268365,4.3595008687,0.870053618
55,0,2006,71021,45979,-5560,160939,7198,25042,1638,29699,5568505,12.788153676,8.2790515184,-1.001142401,3019,1.2960832734,4.509102158,0.2949408727
55,0,2007,74051,45336,-4995,162409,6339,28715,1344,30388,5598893,13.26199711,8.1193488403,-0.894568278,329,1.1352689319,5.1426482695,0.2407006538
55,0,2008,74308,45327,-7022,163132,6314,28981,-708,29074,5627967,13.237539259,8.0747421808,-1.250928577,801,1.1248024826,5.1627970777,-0.126126094
55,1,2001,167,254,299,1481,4,-87,303,205,20206,8.307011217,12.634615863,14.873032059,-11,0.1989703285,-4.327604646,15.072002388
55,1,2002,161,221,214,1496,4,-60,218,143,20349,7.9398347923,10.898779435,10.553569227,-15,0.1972629762,-2.958944643,10.750832203
55,1,2003,148,230,40,1423,3,-82,43,-55,20294,7.2829269493,11.318062151,1.9683586349,-16,0.1476268976,-4.035135202,2.1159855326
55,1,2004,169,250,123,1439,2,-81,125,23,20317,8.3228681884,12.31193519,6.0574721135,-21,0.0984954815,-3.989067002,6.155967595
55,1,2005,160,234,430,1679,3,-74,433,345,20662,7.8088777179,11.420483662,20.986358867,-14,0.1464164572,-3.611605945,21.132775324
55,1,2006,165,215,-13,1644,2,-50,-11,-70,20592,7.9992243176,10.423231687,-0.630241916,-9,0.0969602948,-2.424007369,-0.533281621
55,1,2007,161,225,-1,1517,2,-64,1,-78,20514,7.8334063154,10.947306962,-0.048654698,-15,0.0973093952,-3.113900647,0.0486546976
55,1,2008,164,230,-94,1517,1,-66,-93,-189,20325,8.0315384804,11.263742991,-4.603442788,-30,0.0489727956,-3.23220451,-4.554469992
55,3,2001,203,209,-24,808,4,-6,-20,-42,16812,12.059644745,12.416087447,-1.425770807,-16,0.2376284679,-0.356442702,-1.188142339
55,3,2002,200,209,4,842,4,-9,8,-16,16796,11.901928112,12.437514877,0.2380385622,-15,0.2380385622,-0.535586765,0.4760771245
55,3,2003,212,204,-103,801,1,8,-102,-111,16685,12.663898928,12.186015949,-6.152743347,-17,0.0597353723,0.4778829784,-6.093007975
55,3,2004,186,201,-71,777,2,-15,-69,-98,16587,11.180572253,12.082231306,-4.267852849,-14,0.120221207,-0.901659053,-4.147631642
55,3,2005,205,210,-119,733,2,-5,-117,-137,16450,12.410327814,12.713018737,-7.204043951,-15,0.1210763689,-0.302690922,-7.082967582
55,3,2006,204,177,-30,760,2,27,-28,-8,16442,12.404232032,10.76249544,-1.824151769,-7,0.121610118,1.6417365925,-1.702541651
55,3,2007,204,189,-191,742,2,15,-189,-171,16271,12.472105891,11.555039281,-11.67731483,3,0.1222755479,0.9170666096,-11.55503928
55,3,2008,212,190,-4,776,1,22,-3,24,16295,13.019713812,11.668611435,-0.245654978,5,0.0614137444,1.3511023767,-0.184241233
55,5,2001,457,453,191,699,19,4,210,170,45198,10.130117704,10.041451466,4.2338128699,-44,0.421164631,0.0886662381,4.6549775009
55,5,2002,490,492,266,733,18,-2,284,243,45441,10.812122817,10.85625393,5.8694381006,-39,0.3971800218,-0.044131114,6.2666181224
55,5,2003,546,494,5,660,14,52,19,2,45443,12.015316227,10.871000396,0.1100303684,-69,0.3080850315,1.1443158312,0.4181153999
55,5,2004,520,433,93,661,16,87,109,167,45610,11.421919102,9.5109441754,2.0427663009,-29,0.3514436647,1.9109749267,2.3942099656
55,5,2005,528,489,-54,704,14,39,-40,-41,45569,11.581614187,10.726154049,-1.184483269,-40,0.307088255,0.8554601388,-0.877395014
55,5,2006,546,488,45,694,15,58,60,96,45665,11.969222001,10.697766184,0.9864743407,-22,0.3288247802,1.2714558169,1.3152991209
55,5,2007,566,460,-260,704,14,106,-246,-128,45537,12.412008509,10.087498081,-5.70162935,12,0.3070108112,2.3245104274,-5.394618539
55,5,2008,567,477,-77,704,13,90,-64,53,45590,12.444171321,10.468906032,-1.689949192,27,0.2853160973,1.9752652891,-1.404633094
55,7,2001,116,173,85,122,5,-57,90,18,15050,7.7122531747,11.501894821,5.6512199987,-15,0.3324247058,-3.789641646,5.9836447045
55,7,2002,159,150,21,116,4,9,25,18,15068,10.558470018,9.9608207716,1.394514908,-16,0.2656218872,0.5976492463,1.6601367953
55,7,2003,141,149,15,121,1,-8,16,-8,15060,9.3600637281,9.8911311737,0.9957514604,-16,0.0663834307,-0.531067446,1.0621348911
55,7,2004,117,134,-3,113,2,-17,-1,-29,15031,7.7764115516,8.9063175036,-0.199395168,-11,0.132930112,-1.129905952,-0.066465056
55,7,2005,131,144,-14,117,1,-13,-13,-39,14992,8.7266429071,9.5926456383,-0.932618326,-13,0.0666155947,-0.866002731,-0.866002731
55,7,2006,127,150,34,153,2,-23,36,6,14998,8.4694898299,10.003334445,2.2674224742,-7,0.1333777926,-1.533844615,2.4008002668
55,7,2007,133,137,76,148,2,-4,78,62,15060,8.8495575221,9.1157096281,5.0568900126,-12,0.133076053,-0.266152106,5.1899660656
55,7,2008,135,153,-98,144,1,-18,-97,-134,14926,9.0042019609,10.204762222,-6.536383646,-19,0.0666977923,-1.200560261,-6.469685853
55,9,2001,3195,1569,262,7721,504,1626,766,2163,229483,13.988524594,6.8694820305,1.1471027992,-229,2.2066404993,7.1190425632,3.3537432985
55,9,2002,3247,1605,618,7667,474,1642,1092,2519,232002,14.071963336,6.9558057142,2.6783102376,-215,2.0542379492,7.1161576216,4.7325481868
55,9,2003,3304,1561,154,7641,412,1743,566,1948,233950,14.181718289,6.7002609711,0.6610122931,-361,1.7684224985,7.4814573175,2.4294347916
55,9,2004,3386,1615,848,7932,394,1771,1242,2843,236793,14.38576888,6.8614934263,3.6028151242,-170,1.6739494799,7.5242754539,5.276764604
55,9,2005,3233,1546,8,7952,406,1687,414,1886,238679,13.59911835,6.5030117441,0.0336507723,-215,1.7077766935,7.0961066056,1.7414274658
55,9,2006,3379,1640,-315,7860,420,1739,105,1725,240404,14.106115224,6.8464128345,-1.315012221,-119,1.7533496284,7.2597023898,0.4383374071
55,9,2007,3526,1619,501,8090,381,1907,882,2762,243166,14.583204086,6.6960315983,2.0720888393,-27,1.5757801352,7.887172488,3.6478689745
55,9,2008,3533,1580,-550,7928,382,1953,-168,1852,245018,14.474050768,6.4729692083,-2.253248775,67,1.5649836947,8.0010815594,-0.68826508
55,11,2001,163,108,-5,171,1,55,-4,38,13845,11.789382323,7.8113698828,-0.361637495,-13,0.0723274989,3.9780124403,-0.289309996
55,11,2002,154,134,-109,161,1,20,-108,-100,13745,11.163465024,9.7136643711,-7.901413556,-12,0.0724900326,1.4498006524,-7.828923523
55,11,2003,142,156,42,164,-1,-14,41,10,13755,10.327272727,11.345454545,3.0545454545,-17,-0.072727273,-1.018181818,2.9818181818
55,11,2004,162,115,-77,138,0,47,-77,-40,13715,11.794685111,8.3727702949,-5.606115763,-10,0,3.4219148162,-5.606115763
55,11,2005,152,119,137,142,0,33,137,156,13871,11.020082651,8.6275647067,9.9325744943,-14,0,2.3925179439,9.9325744943
55,11,2006,144,120,-77,145,0,24,-77,-58,13813,10.403120936,8.6692674469,-5.562779945,-5,0,1.7338534894,-5.562779945
55,11,2007,153,115,-21,179,0,38,-21,14,13827,11.070911722,8.3212735166,-1.519536903,-3,0,2.7496382055,-1.519536903
55,11,2008,156,127,-125,179,-1,29,-126,-86,13741,11.31746953,9.2135809634,-9.0684852,11,-0.072547882,2.1038885665,-9.141033082
55,13,2001,128,195,210,253,9,-67,219,142,15856,8.1089642065,12.353500158,13.303769401,-10,0.5701615458,-4.244535952,13.873930947
55,13,2002,183,209,176,264,9,-26,185,149,16005,11.487398387,13.119487775,11.047989705,-10,0.564954019,-1.632089388,11.612943724
55,13,2003,154,193,222,271,1,-39,223,180,16185,9.5681888785,11.991301646,13.793103448,-4,0.0621310966,-2.423112768,13.855234545
55,13,2004,129,186,216,263,2,-57,218,142,16327,7.9355314961,11.441929134,13.287401575,-19,0.1230314961,-3.506397638,13.410433071
55,13,2005,163,175,11,274,2,-12,13,-11,16316,9.9868271911,10.722053733,0.6739576632,-12,0.1225377569,-0.735226542,0.7964954202
55,13,2006,153,182,-31,269,2,-29,-29,-67,16249,9.3965914325,11.177644711,-1.903884539,-9,0.1228312606,-1.781053278,-1.781053278
55,13,2007,159,175,57,262,1,-16,58,36,16285,9.7743898691,10.757976271,3.5040265568,-6,0.0614741501,-0.983586402,3.565500707
55,13,2008,145,175,-49,262,0,-30,-49,-89,16196,8.9282965426,10.77553031,-3.017148487,-10,0,-1.847233767,-3.017148487
55,15,2001,558,235,401,345,35,323,436,726,41454,13.579615974,5.719013896,9.7588279672,-33,0.8517680271,7.8606020783,10.610595994
55,15,2002,571,247,729,355,34,324,763,1069,42523,13.59896162,5.8825630827,17.36189671,-18,0.8097455256,7.7163985377,18.171642235
55,15,2003,603,242,445,346,29,361,474,814,43337,14.046121593,5.6370836245,10.365711624,-21,0.6755182856,8.4090379688,11.041229909
55,15,2004,673,252,-22,347,28,421,6,398,43735,15.45847115,5.7883131202,-0.505328923,-29,0.6431459022,9.6701580301,0.1378169791
55,15,2005,683,275,-88,343,29,408,-59,309,44044,15.561808633,6.2657355404,-2.005035373,-40,0.6607502934,9.2960730927,-1.34428508
55,15,2006,637,265,-224,344,28,372,-196,155,44199,14.4374058,6.0061421303,-5.076889952,-21,0.634611244,8.4312636696,-4.442278708
55,15,2007,705,274,-417,333,28,431,-389,33,44232,15.9446348,6.1969218939,-9.43108186,-9,0.6332620913,9.7477129061,-8.797819769
55,15,2008,682,263,65,333,27,419,92,495,44727,15.33290617,5.9128362504,1.4613473623,-16,0.607021212,9.4200699199,2.0683685743
55,17,2001,672,540,253,1053,18,132,271,355,55681,12.107344582,9.7291161819,4.5582711,-48,0.3243038727,2.3782284,4.8825749727
55,17,2002,678,504,268,1047,17,174,285,413,56094,12.131514203,9.0181167524,4.7953477969,-46,0.3041825095,3.1133974502,5.0995303064
55,17,2003,688,571,578,1335,9,117,587,667,56761,12.192636569,10.119179478,10.243232466,-37,0.1594966993,2.073457091,10.402729166
55,17,2004,691,442,1403,2494,16,249,1419,1582,58343,12.006533222,7.6800111204,24.37795385,-86,0.2780094523,4.3265221018,24.655963303
55,17,2005,743,525,657,2767,13,218,670,835,59178,12.644548634,8.9345733954,11.180980421,-53,0.2212370555,3.7099752385,11.402217476
55,17,2006,754,452,-41,2539,15,302,-26,246,59424,12.714794017,7.6221311614,-0.691388004,-30,0.2529468306,5.0926628556,-0.438441173
55,17,2007,822,500,232,2575,12,322,244,576,60000,13.76607717,8.3735262594,3.8853161844,10,0.2009646302,5.392550911,4.0862808146
55,17,2008,795,518,138,2575,12,277,150,456,60456,13.199840606,8.6006508601,2.2912930863,29,0.1992428771,4.5991897456,2.4905359633
55,19,2001,485,296,-194,617,15,189,-179,-17,33612,14.425722402,8.8041522286,-5.770288961,-27,0.4461563629,5.621570173,-5.324132598
55,19,2002,493,332,-196,622,14,161,-182,-48,33564,14.677861141,9.8844825533,-5.835417411,-27,0.4168155294,4.7933785876,-5.418601882
55,19,2003,550,350,-110,652,2,200,-108,50,33614,16.374408288,10.420078002,-3.274881658,-42,0.0595433029,5.9543302867,-3.215338355
55,19,2004,548,378,-116,674,5,170,-111,33,33647,16.29473246,11.239797208,-3.449249937,-26,0.1486745662,5.0549352522,-3.300575371
55,19,2005,576,333,-278,647,3,243,-275,-64,33583,17.135207497,9.906291834,-8.270117507,-32,0.0892458724,7.2289156627,-8.180871635
55,19,2006,580,310,-327,642,4,270,-323,-67,33516,17.287888046,9.2400780936,-9.746792054,-14,0.1192268141,8.0478099525,-9.627565239
55,19,2007,561,306,-360,635,3,255,-357,-86,33430,16.759776536,9.1416962925,-10.75493681,16,0.0896244735,7.6180802438,-10.66531234
55,19,2008,574,309,-166,635,2,265,-164,123,33553,17.138676978,9.2262215786,-4.956481495,22,0.0597166445,7.9124553991,-4.896764851
55,21,2001,588,539,335,1600,25,49,360,364,52983,11.136152724,10.208139997,6.3445768073,-45,0.4734758811,0.928012727,6.8180526884
55,21,2002,655,532,69,1570,22,123,91,165,53148,12.343236189,10.025346035,1.3002798428,-49,0.4145819789,2.3178901546,1.7148618217
55,21,2003,626,497,409,1584,11,129,420,501,53649,11.723175745,9.3073775481,7.6593911814,-48,0.2059982958,2.4157981966,7.8653894772
55,21,2004,674,504,574,1604,22,170,596,714,54363,12.480094804,9.3322964115,10.628448691,-52,0.4073621449,3.1477983928,11.035810836
55,21,2005,662,506,84,1547,17,156,101,205,54568,12.154483113,9.2902846756,1.5422606971,-52,0.3121241887,2.8641984375,1.8543848858
55,21,2006,636,476,112,1515,20,160,132,264,54832,11.627056673,8.7020109689,2.0475319927,-28,0.365630713,2.9250457038,2.4131627057
55,21,2007,678,477,104,1510,16,201,120,314,55146,12.329738675,8.6744621652,1.8912873484,-7,0.2909672844,3.6552765098,2.1822546327
55,21,2008,700,490,-179,1510,16,210,-163,50,55196,12.687825126,8.8814775879,-3.244458139,3,0.2900074314,3.8063475377,-2.954450708
55,23,2001,206,184,-236,665,1,22,-235,-224,17022,12.022878487,10.738881756,-13.77378312,-11,0.0583634878,1.2839967316,-13.71541963
55,23,2002,185,161,-48,669,0,24,-48,-39,16983,10.88075283,9.4691957065,-2.823114248,-15,0,1.411557124,-2.823114248
55,23,2003,196,187,-101,652,-2,9,-103,-112,16871,11.579133928,11.047439003,-5.966798606,-18,-0.118154428,0.5316949253,-6.084953034
55,23,2004,209,160,72,746,1,49,73,109,16980,12.348231958,9.4531919293,4.2539363682,-13,0.0590824496,2.8950400284,4.3130188178
55,23,2005,173,177,-75,775,-1,-4,-76,-96,16884,10.217339948,10.453579022,-4.429482636,-16,-0.059059768,-0.236239074,-4.488542405
55,23,2006,209,178,38,774,0,31,38,60,16944,12.356627646,10.523826416,2.246659572,-9,0,1.8328012298,2.246659572
55,23,2007,186,166,-17,861,0,20,-17,4,16948,10.976041544,9.7958220229,-1.003186593,1,0,1.1802195208,-1.003186593
55,23,2008,197,168,-97,861,-1,29,-98,-63,16885,11.64543493,9.9311323264,-5.734046641,6,-0.059113883,1.714302604,-5.793160524
55,25,2001,5526,2626,2801,15831,1887,2900,4688,7207,435807,12.7856438,6.0758415885,6.4807434461,-381,4.3659988871,6.7098022112,10.846742333
55,25,2002,5573,2654,3144,15804,1760,2919,4904,7482,443289,12.678933814,6.038020876,7.1528024243,-341,4.0041133164,6.6409129378,11.156915741
55,25,2003,5624,2692,2255,15782,1521,2932,3776,6170,449459,12.599300138,6.0308172071,5.0518175342,-538,3.4074565275,6.5684829314,8.4592740617
55,25,2004,5892,2679,2073,15817,1423,3213,3496,6362,455821,13.016967126,5.9186108165,4.5797985154,-347,3.1437787204,7.0983563097,7.7235772358
55,25,2005,6107,2644,1590,15828,1484,3463,3074,6111,461932,13.308591745,5.7618988987,3.4649845874,-426,3.2339856149,7.5466928466,6.6989702022
55,25,2006,6003,2557,1480,15786,1506,3446,2986,6196,468128,12.908844591,5.4985699847,3.1825903705,-236,3.2385007419,7.4102746059,6.4210911124
55,25,2007,6250,2666,2498,16198,1353,3584,3851,7473,475601,13.245327843,5.6499270447,5.2938926323,38,2.8673485715,7.5954007983,8.1612412038
55,25,2008,6333,2674,1901,16110,1356,3659,3257,7104,482705,13.217072626,5.5806809099,3.9674175055,188,2.8299937598,7.6363917162,6.7974112653
55,27,2001,980,855,183,5569,39,125,222,260,86265,11.377488826,9.9262785163,2.124571893,-87,0.4527776165,1.4512103094,2.5773495095
55,27,2002,931,875,328,5752,35,56,363,340,86605,10.77109967,10.123213976,3.7947590675,-79,0.404928559,0.6478856945,4.1996876265
55,27,2003,959,922,284,5920,27,37,311,229,86834,11.058643096,10.63198012,3.2749266313,-119,0.3113486586,0.4266629766,3.5862752899
55,27,2004,988,862,409,6014,30,126,439,499,87333,11.345432832,9.8985456487,4.6966417289,-66,0.3444969483,1.446887183,5.0411386772
55,27,2005,937,861,-174,5971,29,76,-145,-152,87181,10.738393481,9.8674031883,-1.994109355,-83,0.3323515592,0.870990293,-1.661757796
55,27,2006,930,826,577,6025,31,104,608,670,87851,10.626628274,9.4382741442,6.5930801225,-42,0.3542209425,1.1883541295,6.9473010649
55,27,2007,996,863,-304,6169,26,133,-278,-122,87729,11.345255724,9.8302767969,-3.462808976,23,0.296161294,1.514978927,-3.166647682
55,27,2008,990,842,-39,6187,26,148,-13,183,87912,11.272994346,9.5877386259,-0.444087656,48,0.2960584374,1.6852557205,-0.148029219
55,29,2001,245,325,215,375,7,-80,222,117,28145,8.7230520001,11.57139551,7.6549231837,-25,0.2492300571,-2.84834351,7.9041532409
55,29,2002,254,307,148,378,6,-53,154,75,28220,9.012685177,10.89328484,5.2514858511,-26,0.212898075,-1.880599663,5.4643839262
55,29,2003,238,309,139,395,1,-71,140,34,28254,8.4286574353,10.943088855,4.9226192584,-35,0.035414527,-2.51443142,4.9580337855
55,29,2004,243,310,-43,386,4,-67,-39,-126,28128,8.6197722677,10.996417296,-1.525309496,-20,0.1418892554,-2.376645029,-1.383420241
55,29,2005,235,290,-13,385,2,-55,-11,-91,28037,8.3682008368,10.326715926,-0.462921748,-25,0.0712187305,-1.958515089,-0.391703018
55,29,2006,282,298,-6,387,3,-16,-3,-33,28004,10.064060242,10.635070752,-0.214128941,-14,0.1070644707,-0.57101051,-0.107064471
55,29,2007,234,278,-200,366,3,-44,-197,-253,27751,8.393866021,9.9721998027,-7.174244462,-12,0.1076136669,-1.578333782,-7.066630795
55,29,2008,260,300,61,366,2,-40,63,20,27771,9.3656568567,10.806527142,2.1973271856,-3,0.0720435143,-1.440870286,2.2693706999
55,31,2001,499,417,84,1297,29,82,113,155,43536,11.482218668,9.5953610916,1.9328784933,-40,0.6673032893,1.8868575768,2.6001817826
55,31,2002,480,442,70,1330,25,38,95,92,43628,11.013721261,10.141801661,1.6061676839,-41,0.5736313157,0.8719195998,2.1797989996
55,31,2003,492,461,188,1329,17,31,205,187,43815,11.253044841,10.544011528,4.2999439635,-49,0.3888247201,0.7090333131,4.6887686836
55,31,2004,503,453,12,1323,29,50,41,63,43878,11.471839257,10.331497383,0.2736820499,-28,0.6613982872,1.1403418745,0.9350803371
55,31,2005,469,443,27,1379,24,26,51,33,43911,10.684709929,10.092380594,0.6151112326,-44,0.5467655401,0.5923293351,1.1618767727
55,31,2006,500,417,-213,1363,27,83,-186,-124,43787,11.402768592,9.5099090059,-4.85757942,-21,0.615749504,1.8928595863,-4.241829916
55,31,2007,487,451,-145,1365,23,36,-122,-73,43714,11.131301357,10.308453618,-3.314247837,13,0.5257082776,0.8228477389,-2.78853956
55,31,2008,514,424,-64,1360,23,90,-41,60,43774,11.750182882,9.6927578639,-1.463057791,11,0.5257863936,2.0574250183,-0.937271397
55,33,2001,460,264,383,3119,36,196,419,583,40536,11.43013331,6.5599025954,9.5168283865,-32,0.8945321721,4.8702307148,10.411360559
55,33,2002,455,276,84,3092,35,179,119,260,40796,11.188708012,6.7869965081,2.0656076329,-38,0.860669847,4.4017115035,2.92627748
55,33,2003,469,280,13,3047,24,189,37,166,40962,11.472883388,6.8494826194,0.318011693,-60,0.5870985102,4.6234007681,0.9051102033
55,33,2004,477,257,173,2963,27,220,200,388,41350,11.590047624,6.2445329964,4.2035183205,-32,0.6560404315,5.3455146273,4.8595587521
55,33,2005,463,280,45,2908,26,183,71,215,41565,11.16806368,6.7539046011,1.0854489537,-39,0.6271482844,4.4141590786,1.7125972381
55,33,2006,522,268,432,3176,28,254,460,694,42259,12.454666921,6.3943500668,10.307310555,-20,0.6680664249,6.0603168544,10.97537698
55,33,2007,501,293,52,3316,25,208,77,283,42542,11.815898397,6.9102958692,1.2264006321,-2,0.5896156885,4.9056025283,1.8160163206
55,33,2008,500,285,-112,3229,25,215,-87,146,42688,11.732957879,6.6877859908,-2.628182565,18,0.5866478939,5.0451718878,-2.041534671
55,35,2001,1105,697,269,5251,63,408,332,653,94016,11.794277907,7.4394676031,2.8711862055,-87,0.672433944,4.3548103042,3.5436201495
55,35,2002,1150,717,337,5472,59,433,396,743,94759,12.183816713,7.596344855,3.5703880281,-86,0.6250827705,4.587471858,4.1954707986
55,35,2003,1092,691,-125,5417,52,401,-73,193,94952,11.512247577,7.2847647211,-1.317793908,-135,0.5482022656,4.2274828555,-0.769591642
55,35,2004,1101,726,-253,5178,54,375,-199,109,95061,11.588680774,7.641582418,-2.662975691,-67,0.5683821633,3.9470983564,-2.094593528
55,35,2005,1161,700,67,5324,54,461,121,499,95560,12.181239213,7.3444164074,0.7029655704,-83,0.5665692657,4.8368228055,1.2695348361
55,35,2006,1171,729,579,5438,56,442,635,1026,96586,12.188648215,7.5879799736,6.0266672218,-51,0.582890094,4.6006682419,6.6095573158
55,35,2007,1212,743,465,5291,49,469,514,963,97549,12.486156541,7.6544672522,4.790480851,-20,0.5048033585,4.8316892884,5.2952842094
55,35,2008,1255,705,123,5233,49,550,172,737,98286,12.816912196,7.1999387239,1.256159522,15,0.500421273,5.6169734726,1.7565807951
55,37,2001,36,49,-20,67,1,-13,-19,-36,5052,7.100591716,9.6646942801,-3.944773176,-4,0.1972386588,-2.564102564,-3.747534517
55,37,2002,40,51,65,83,1,-11,66,51,5103,7.8778926637,10.044313146,12.801575579,-4,0.1969473166,-2.166420483,12.998522895
55,37,2003,32,54,-85,83,1,-22,-84,-107,4996,6.337261115,10.694128131,-16.83334984,-1,0.1980394098,-4.356867017,-16.63531043
55,37,2004,35,45,-49,84,0,-10,-49,-63,4933,7.0500553933,9.0643569342,-9.870077551,-4,0,-2.014301541,-9.870077551
55,37,2005,35,65,-38,74,1,-30,-37,-71,4862,7.146503318,13.272077591,-7.759060745,-4,0.2041858091,-6.125574273,-7.554874936
55,37,2006,35,49,-5,72,0,-14,-5,-22,4840,7.215007215,10.101010101,-1.030715316,-3,0,-2.886002886,-1.030715316
55,37,2007,31,37,-81,62,1,-6,-80,-96,4744,6.469115192,7.7212020033,-16.90317195,-10,0.2086811352,-1.252086811,-16.69449082
55,37,2008,35,38,-80,62,0,-3,-80,-92,4652,7.4499787143,8.0885483184,-17.02852278,-9,0,-0.638569604,-17.02852278
55,39,2001,1135,902,108,4445,110,233,218,346,97729,11.634343352,9.2459715445,1.1070564599,-105,1.1275575054,2.388371807,2.2346139653
55,39,2002,1105,921,-148,4426,105,184,-43,52,97781,11.303769628,9.4215129661,-1.513989054,-89,1.0741138561,1.8822566621,-0.439875198
55,39,2003,1140,854,-58,4544,87,286,29,175,97956,11.648283155,8.7259945744,-0.59263195,-140,0.888947925,2.9222885811,0.296315975
55,39,2004,1178,915,-19,4482,89,263,70,267,98223,12.009440358,9.3282155582,-0.193700651,-66,0.9073346281,2.6812247998,0.7136339771
55,39,2005,1144,942,-26,4468,89,202,63,169,98392,11.636955471,9.5821783689,-0.264476261,-96,0.9053225847,2.0547771025,0.640846324
55,39,2006,1195,972,7,4445,91,223,98,275,98667,12.128347348,9.8650657925,0.0710447125,-46,0.9235812625,2.2632815553,0.994625975
55,39,2007,1248,912,-51,4437,83,336,32,376,99043,12.62455111,9.2256335036,-0.515907137,8,0.8396135754,3.3989176066,0.3237064387
55,39,2008,1274,898,-103,4474,83,376,-20,410,99453,12.836530711,9.0480412704,-1.037804288,54,0.8362888925,3.7884894406,-0.201515396
55,41,2001,86,125,-90,322,0,-39,-90,-140,9900,8.6258776329,12.537612839,-9.027081244,-11,0,-3.911735206,-9.027081244
55,41,2002,110,99,-21,325,0,11,-21,-21,9879,11.122908135,10.010617321,-2.12346428,-11,0,1.1122908135,-2.12346428
55,41,2003,129,113,17,337,-1,16,16,24,9903,13.042159539,11.424527348,1.7187342028,-8,-0.101102012,1.6176321909,1.6176321909
55,41,2004,89,98,107,368,0,-9,107,87,9990,8.9478711104,9.8527120092,10.757552908,-11,0,-0.904840899,10.757552908
55,41,2005,124,109,-108,348,0,15,-108,-100,9890,12.474849095,10.965794769,-10.86519115,-7,0,1.509054326,-10.86519115
55,41,2006,108,130,-16,356,0,-22,-16,-43,9847,10.943912449,13.173227948,-1.621320363,-5,0,-2.229315499,-1.621320363
55,41,2007,111,104,-56,356,0,7,-56,-55,9792,11.304037884,10.59117063,-5.702938031,-6,0,0.7128672539,-5.702938031
55,41,2008,120,111,58,356,-1,9,57,54,9846,12.221203789,11.304613504,5.9069151645,-12,-0.101843365,0.9165902841,5.8050717996
55,43,2001,552,513,-32,3485,16,39,-16,-27,49507,11.146898759,10.359346129,-0.64619703,-50,0.3230985148,0.7875526297,-0.323098515
55,43,2002,541,514,-297,3456,15,27,-282,-294,49213,10.960291734,10.413290113,-6.017017828,-39,0.3038897893,0.5470016207,-5.713128039
55,43,2003,547,467,17,3657,6,80,23,30,49243,11.111562525,9.486471114,0.3453319249,-73,0.1218818559,1.6250914114,0.4672137808
55,43,2004,590,513,-43,3759,9,77,-34,8,49251,11.980425204,10.416878185,-0.873149633,-35,0.1827522489,1.5635470181,-0.690397385
55,43,2005,600,506,-170,3789,8,94,-162,-113,49138,12.196485379,10.28570267,-3.455670858,-45,0.1626198051,1.9107827094,-3.293051052
55,43,2006,573,478,-490,3499,10,95,-480,-405,48733,11.709290801,9.7679598655,-10.01318062,-20,0.2043506248,1.9413309356,-9.80882999
55,43,2007,603,530,304,3925,7,73,311,391,49124,12.324105583,10.832132602,6.2131477564,7,0.1430659023,1.491972981,6.3562136587
55,43,2008,605,496,-37,4007,7,109,-30,114,49238,12.301498546,10.085195502,-0.752323052,35,0.1423313881,2.2163030439,-0.609991663
55,45,2001,406,346,71,512,14,60,85,113,33836,12.019124025,10.2428988,2.1018665167,-32,0.4144525526,1.7762252254,2.5163190693
55,45,2002,394,308,127,527,12,86,139,193,34029,11.611287114,9.0768437339,3.7427245266,-32,0.3536432624,2.5344433802,4.096367789
55,45,2003,361,362,77,523,8,-1,85,31,34060,10.603768597,10.633141917,2.2617456564,-53,0.2349865617,-0.02937332,2.4967322181
55,45,2004,423,318,338,514,11,105,349,425,34485,12.342256912,9.2785761179,9.8621343643,-29,0.3209570355,3.0636807936,10.1830914
55,45,2005,418,310,224,493,9,108,233,312,34797,12.066626252,8.9489333449,6.4663260298,-29,0.2598077423,3.1176929072,6.7261337721
55,45,2006,429,315,439,498,10,114,449,543,35340,12.233200736,8.9824201206,12.51835693,-20,0.2851561943,3.2507806151,12.803513124
55,45,2007,478,305,205,509,10,173,215,378,35718,13.453798306,8.5845365758,5.7699344198,-10,0.2814602156,4.8692617299,6.0513946354
55,45,2008,475,333,231,509,9,142,240,372,36090,13.229723708,9.2747326203,6.4338235294,-10,0.2506684492,3.9549910873,6.6844919786
55,47,2001,251,237,62,352,9,14,71,68,19144,13.134484563,12.40188383,3.2443746729,-17,0.4709576138,0.7326007326,3.7153322868
55,47,2002,208,246,45,373,8,-38,53,-6,19138,10.866725876,12.851993104,2.3509743483,-21,0.4179509952,-1.985267227,2.7689253435
55,47,2003,234,231,-91,359,0,3,-91,-108,19030,12.261580381,12.104380633,-4.768392371,-20,0,0.1571997485,-4.768392371
55,47,2004,237,249,-60,361,3,-12,-57,-84,18946,12.481567306,13.113545397,-3.159890457,-15,0.1579945229,-0.631978091,-3.001895934
55,47,2005,217,244,-73,390,2,-27,-71,-115,18831,11.488471821,12.917913016,-3.864785451,-17,0.1058845329,-1.429441194,-3.758900919
55,47,2006,210,239,-21,380,4,-29,-17,-55,18776,11.168133592,12.71039966,-1.116813359,-9,0.2127263541,-1.542266067,-0.904087005
55,47,2007,223,192,-124,380,1,31,-123,-95,18681,11.906986678,10.251755346,-6.620925328,-3,0.0533945591,1.6552313319,-6.567530769
55,47,2008,231,215,-138,380,1,16,-137,-115,18566,12.403683518,11.544553924,-7.409992751,6,0.0536955996,0.8591295943,-7.356297151
55,49,2001,279,184,45,315,1,95,46,118,22919,12.204724409,8.0489938758,1.968503937,-23,0.0437445319,4.1557305337,2.0122484689
55,49,2002,313,194,-11,295,0,119,-11,83,23002,13.632107315,8.4492933516,-0.479083644,-25,0,5.1828139631,-0.479083644
55,49,2003,310,204,60,307,-1,106,59,136,23138,13.437364543,8.8426527958,2.6007802341,-29,-0.043346337,4.5947117469,2.5574338968
55,49,2004,310,198,-71,318,0,112,-71,25,23163,13.390639511,8.5527310425,-3.066888404,-16,0,4.8379084685,-3.066888404
55,49,2005,314,193,101,312,-1,121,100,202,23365,13.497248968,8.2960797799,4.3414718019,-19,-0.042984869,5.2011691884,4.2984869326
55,49,2006,315,179,31,325,0,136,31,155,23520,13.437133412,7.6357043831,1.322384558,-12,0,5.8014290285,1.322384558
55,49,2007,318,190,-122,316,0,128,-122,0,23520,13.520408163,8.0782312925,-5.18707483,-6,0,5.4421768707,-5.18707483
55,49,2008,323,191,-42,316,-1,132,-43,84,23604,13.708513709,8.1062728122,-1.782531194,-5,-0.042441219,5.6022408964,-1.824972413
55,51,2001,49,89,-2,115,2,-40,0,-47,6798,7.1831708568,13.046983801,-0.293190647,-7,0.2931906472,-5.863812944,0
55,51,2002,43,87,0,114,1,-44,1,-50,6748,6.3487376347,12.845120331,0,-7,0.1476450613,-6.496382696,0.1476450613
55,51,2003,37,90,-30,126,-1,-53,-31,-94,6654,5.5215639457,13.430831219,-4.47694374,-10,-0.149231458,-7.909267274,-4.626175198
55,51,2004,44,89,-27,126,0,-45,-27,-77,6577,6.6510467841,13.453253722,-4.081324163,-5,0,-6.802206938,-4.081324163
55,51,2005,29,93,-25,118,-1,-64,-26,-92,6485,4.4403613535,14.239779513,-3.827897719,-2,-0.153115909,-9.79941816,-3.981013627
55,51,2006,48,104,-63,116,0,-56,-63,-123,6362,7.4725616876,16.190550323,-9.807737215,-4,0,-8.717988635,-9.807737215
55,51,2007,41,79,-21,116,0,-38,-21,-74,6288,6.4822134387,12.490118577,-3.320158103,-15,0,-6.007905138,-3.320158103
55,51,2008,39,93,-18,116,-1,-54,-19,-91,6197,6.2474969964,14.897877453,-2.883460152,-18,-0.160192231,-8.650380457,-3.043652383
55,53,2001,208,216,172,1443,10,-8,182,160,19291,10.82713029,11.243558378,8.9532038936,-14,0.5205351101,-0.416428088,9.4737390037
55,53,2002,191,187,1,1435,9,4,10,-6,19285,9.9025300705,9.6951472418,0.0518457072,-20,0.4666113646,0.2073828287,0.5184570718
55,53,2003,256,221,183,1447,1,35,184,201,19486,13.205746563,11.4002734,9.4400453948,-18,0.0515849475,1.8054731629,9.4916303423
55,53,2004,231,209,-77,1355,5,22,-72,-65,19421,11.87446989,10.743567995,-3.95815663,-15,0.2570231578,1.1309018943,-3.701133472
55,53,2005,228,201,166,1408,3,27,169,179,19600,11.686015223,10.302144999,8.5082391533,-17,0.1537633582,1.3838702237,8.6620025115
55,53,2006,256,187,-22,1390,5,69,-17,43,19643,13.046912825,9.5303621028,-1.121219071,-9,0.2548225161,3.5165507224,-0.866396555
55,53,2007,252,182,86,1407,0,70,86,160,19803,12.776960909,9.2278051006,4.3603914212,4,0,3.5491558079,4.3603914212
55,53,2008,260,189,21,1407,0,71,21,101,19904,13.09592767,9.5197320372,1.0577480041,9,0,3.576195633,1.0577480041
55,55,2001,954,607,27,3859,114,347,141,409,76347,12.529139442,7.9718948025,0.3545982861,-79,1.4971927636,4.55724464,1.8517910497
55,55,2002,917,546,-66,3687,108,371,42,333,76680,11.984813138,7.1359956086,-0.862592876,-80,1.4115156149,4.8488175289,0.5489227391
55,55,2003,919,630,138,3711,85,289,223,411,77091,11.952838962,8.1940027704,1.7948767973,-101,1.1055400563,3.7588361915,2.9004168536
55,55,2004,1037,598,415,3712,86,439,501,880,77971,13.375295043,7.7130438147,5.3526976306,-60,1.1092337259,5.6622512285,6.4619313565
55,55,2005,1015,604,255,3636,85,411,340,675,78646,12.961555898,7.7130835095,3.2563514816,-76,1.0854504939,5.2484723881,4.3418019755
55,55,2006,1049,580,162,3606,87,469,249,680,79326,13.280834578,7.3430734561,2.0509963791,-38,1.1014610184,5.9377611222,3.1524573975
55,55,2007,1050,574,205,3649,67,476,272,748,80074,13.174404015,7.2020075282,2.5721455458,0,0.8406524467,5.9723964868,3.4127979925
55,55,2008,1066,589,161,3745,67,477,228,718,80792,13.253266694,7.3228649932,2.0016659829,13,0.8329914339,5.9304017008,2.8346574167
55,57,2001,254,270,183,372,8,-16,191,155,24513,10.394712611,11.049497657,7.4891039676,-20,0.3273925232,-0.654785046,7.8164964908
55,57,2002,303,272,396,600,6,31,402,420,24933,12.2557942,11.001901064,16.017473608,-13,0.2426889941,1.2538931359,16.260162602
55,57,2003,272,294,144,579,-4,-22,140,91,25024,10.889364854,11.770122305,5.7649578638,-27,-0.160137718,-0.880757451,5.6048201453
55,57,2004,290,283,196,587,6,7,202,189,25213,11.545275395,11.266596333,7.803013715,-20,0.2388677668,0.2786790612,8.0418814818
55,57,2005,282,280,1234,1717,1,2,1235,1212,26425,10.922189086,10.844726752,47.794260041,-25,0.038731167,0.0774623339,47.832991208
55,57,2006,297,278,74,1693,4,19,78,85,26510,11.221309153,10.503447624,2.7958817418,-12,0.1511287428,0.7178615283,2.9470104846
55,57,2007,303,272,5,1753,0,31,5,42,26552,11.420602314,10.252157853,0.1884587841,6,0,1.1684444612,0.1884587841
55,57,2008,308,280,48,1753,0,28,48,81,26633,11.58221303,10.529284573,1.8050202125,5,0,1.0529284573,1.8050202125
55,59,2001,2171,1278,865,4077,239,893,1104,1867,151941,14.376769366,8.4631558035,5.7281923083,-130,1.5827028459,5.9136135622,7.3108951542
55,59,2002,2044,1194,949,4187,216,850,1165,1889,153830,13.36948239,7.8097661322,6.2072596813,-126,1.4128220139,5.5597162582,7.6200816951
55,59,2003,2181,1314,1026,4286,167,867,1193,1893,155723,14.091286468,8.4896608981,6.628913304,-167,1.0789751674,5.6016255698,7.7078884714
55,59,2004,2136,1277,1043,4457,201,859,1244,1975,157698,13.630228989,8.1487839041,6.6555846609,-128,1.2826198627,5.481445085,7.9382045236
55,59,2005,2134,1265,1064,4567,191,869,1255,1981,159679,13.447729357,7.9715921444,6.7049597167,-143,1.203615889,5.4761372122,7.9085756057
55,59,2006,2172,1292,591,4571,205,880,796,1594,161273,13.534734166,8.0510481318,3.6827936888,-82,1.2774495875,5.483686034,4.9602432763
55,59,2007,2202,1213,450,4607,174,989,624,1623,162896,13.585506325,7.4837507596,2.7763296305,10,1.0735141238,6.1017555658,3.8498437543
55,59,2008,2201,1221,371,4675,176,980,547,1569,164465,13.44692862,7.459654632,2.2666108669,42,1.0752655325,5.987273988,3.3418763994
55,61,2001,246,202,22,242,14,44,36,60,20258,12.16136049,9.9861578011,1.0876013447,-20,0.6921099466,2.1752026893,1.7797112913
55,61,2002,228,200,84,241,14,28,98,110,20368,11.224339093,9.8459114853,4.1352828238,-16,0.689213804,1.3784276079,4.8244966278
55,61,2003,235,165,-136,238,6,70,-130,-80,20288,11.560409288,8.1168831169,-6.690279418,-20,0.2951593861,3.4435261708,-6.395120031
55,61,2004,265,185,73,253,5,80,78,143,20431,13.01603674,9.0866671578,3.5855497434,-15,0.2455855989,3.9293695818,3.8311353422
55,61,2005,222,181,18,268,6,41,24,47,20478,10.853357452,8.8489085531,0.8800019556,-18,0.2933339852,2.0044488988,1.1733359407
55,61,2006,245,177,9,260,5,68,14,72,20550,11.943063274,8.6282538754,0.4387247733,-10,0.2437359852,3.3148093985,0.6824607585
55,61,2007,207,192,-111,254,3,15,-108,-87,20463,10.094360325,9.3628849389,-5.412917855,6,0.1462950772,0.7314753859,-5.266622778
55,61,2008,228,184,-132,254,2,44,-130,-75,20388,11.162517441,9.0083474089,-6.462510098,11,0.0979168197,2.1541700326,-6.364593278
55,63,2001,1238,950,168,5275,71,288,239,426,107706,11.517029016,8.837784786,1.5628924674,-101,0.6605081261,2.6792442299,2.2234005935
55,63,2002,1230,917,378,5373,67,313,445,650,108356,11.385620794,8.488304283,3.4989956587,-108,0.6201923522,2.897316511,4.1191880108
55,63,2003,1262,895,226,5323,55,367,281,489,108845,11.620572649,8.241214359,2.0810217264,-159,0.5064433405,3.3793582902,2.5874650669
55,63,2004,1286,876,-104,5257,60,410,-44,290,109135,11.799247637,8.037434627,-0.954215983,-76,0.550509221,3.7618130104,-0.403706762
55,63,2005,1259,860,125,5307,59,399,184,488,109623,11.51043619,7.8625695975,1.1428153485,-95,0.5394088445,3.6478665923,1.6822241929
55,63,2006,1225,894,272,5316,61,331,333,610,110233,11.143657667,8.1325958809,2.4743468452,-54,0.5549086675,3.0110617859,3.0292555127
55,63,2007,1407,869,724,5533,49,538,773,1302,111535,12.688936186,7.8370188666,6.5293459832,-9,0.4419032502,4.851917319,6.9712492334
55,63,2008,1358,893,573,5534,49,465,622,1092,112627,12.116237364,7.9674521105,5.1123740866,5,0.4371838224,4.1487852535,5.549557909
55,65,2001,185,136,-52,156,2,49,-50,-19,16108,11.478206918,8.4380331937,-3.226306809,-18,0.1240887234,3.0401737242,-3.102218086
55,65,2002,208,134,-28,152,1,74,-27,29,16137,12.901224996,8.3113661033,-1.736703365,-18,0.0620251202,4.5898588929,-1.674678245
55,65,2003,174,158,-27,162,1,16,-26,-32,16105,10.793375101,9.8008808387,-1.674834067,-22,0.0620308914,0.9924942621,-1.612803176
55,65,2004,200,152,-48,168,2,48,-46,-11,16094,12.422746048,9.4412869965,-2.981459052,-13,0.1242274605,2.9814590515,-2.857231591
55,65,2005,220,137,-110,156,1,83,-109,-35,16059,13.684570647,8.5217553572,-6.842285323,-9,0.0622025938,5.1628152894,-6.780082729
55,65,2006,209,121,-124,156,2,88,-122,-44,16015,13.032362661,7.5450520671,-7.732119474,-10,0.1247116044,5.4873105943,-7.607407869
55,65,2007,201,142,-268,154,1,59,-267,-217,15798,12.636343633,8.9271681388,-16.84845818,-9,0.0628673813,3.7091754943,-16.7855908
55,65,2008,210,137,19,154,0,73,19,73,15871,13.262180681,8.6519940636,1.1999115855,-19,0,4.6101866178,1.1999115855
55,67,2001,203,217,116,303,3,-14,119,88,20821,9.7704192136,10.444241228,5.5830966935,-17,0.1443904317,-0.673822015,5.7274871252
55,67,2002,236,249,-69,306,3,-13,-66,-99,20722,11.36172159,11.987579135,-3.321859278,-20,0.1444286643,-0.625857545,-3.177430614
55,67,2003,216,251,-16,302,2,-35,-14,-77,20645,10.443106824,12.135276912,-0.773563468,-28,0.0966954336,-1.692170087,-0.676868035
55,67,2004,218,230,39,298,1,-12,40,12,20657,10.556389521,11.137475183,1.8885284006,-16,0.0484238051,-0.581085662,1.9369522057
55,67,2005,215,240,-193,292,2,-25,-191,-232,20425,10.466871136,11.683949175,-9.395842461,-16,0.0973662431,-1.217078039,-9.298476218
55,67,2006,212,220,-86,294,1,-8,-85,-103,20322,10.405674037,10.798340982,-4.221169657,-10,0.0490833681,-0.392666945,-4.172086289
55,67,2007,220,240,-15,296,2,-20,-13,-44,20278,10.837438424,11.822660099,-0.738916256,-11,0.0985221675,-0.985221675,-0.640394089
55,67,2008,220,231,-87,296,1,-11,-86,-113,20165,10.879509433,11.423484905,-4.302351458,-16,0.0494523156,-0.543975472,-4.252899142
55,69,2001,322,329,-42,839,19,-7,-23,-57,29645,10.851433097,11.087333816,-1.415404317,-27,0.6403019529,-0.235900719,-0.775102364
55,69,2002,327,332,156,849,18,-5,174,144,29789,11.003802537,11.172056399,5.2495204765,-25,0.6057139011,-0.168253861,5.8552343776
55,69,2003,288,325,62,838,14,-37,76,-5,29784,9.6688096957,10.910983164,2.081479865,-44,0.4700115824,-1.242173468,2.5514914475
55,69,2004,317,285,85,837,15,32,100,111,29895,10.623502405,9.5510983763,2.8485732,-21,0.5026893882,1.0724040282,3.3512625882
55,69,2005,290,302,12,875,15,-12,27,-14,29881,9.7028907923,10.104389722,0.4014989293,-29,0.5018736617,-0.401498929,0.903372591
55,69,2006,312,314,-177,879,15,-2,-162,-177,29704,10.472434338,10.539565327,-5.941092557,-13,0.5034824201,-0.067130989,-5.437610137
55,69,2007,335,293,-137,867,14,42,-123,-85,29619,11.294101782,9.878124842,-4.618781923,-4,0.4719923133,1.4159769398,-4.146789609
55,69,2008,307,299,-143,867,13,8,-130,-120,29499,10.386007646,10.115362495,-4.837782063,2,0.4397983694,0.2706451504,-4.397983694
55,71,2001,886,822,-367,1385,97,64,-270,-282,82643,10.702551218,9.9294549671,-4.433223811,-76,1.1717240046,0.7730962505,-3.261499807
55,71,2002,855,846,-634,1363,96,9,-538,-592,82051,10.382891909,10.27359831,-7.699126866,-63,1.1657983897,0.109293599,-6.533328476
55,71,2003,859,776,-589,1334,73,83,-516,-516,81535,10.502121208,9.4873644444,-7.201105229,-83,0.8924969129,1.014756764,-6.308608316
55,71,2004,913,746,-487,1341,71,167,-416,-316,81219,11.219386313,9.1672094081,-5.984491933,-67,0.8724823967,2.052176905,-5.112009536
55,71,2005,869,793,-273,1329,74,76,-199,-199,81020,10.712590684,9.7757012802,-3.365405359,-76,0.9122344196,0.9368894039,-2.453170939
55,71,2006,827,730,-305,1304,75,97,-230,-171,80849,10.21813936,9.019639338,-3.768479449,-38,0.9266752745,1.1985000216,-2.841804175
55,71,2007,915,805,-269,1297,61,110,-208,-81,80768,11.323066262,9.961823323,-3.328857732,17,0.7548710841,1.3612429386,-2.573986647
55,71,2008,934,766,-380,1297,61,168,-319,-127,80641,11.573084524,9.4914162159,-4.70853546,24,0.7558438501,2.0816683085,-3.95269161
55,73,2001,1566,908,-428,1628,110,658,-318,226,126135,12.426401739,7.2050911746,-3.396232404,-114,0.8728634683,5.2213105648,-2.523368936
55,73,2002,1515,996,-332,1667,104,519,-228,178,126313,12.002471796,7.8907339333,-2.630244644,-113,0.8239320573,4.1117378628,-1.806312587
55,73,2003,1561,993,-382,1704,87,568,-295,105,126418,12.353055225,7.8581574876,-3.022976999,-168,0.6884790548,4.4948977371,-2.334497944
55,73,2004,1522,937,-261,1735,81,585,-180,319,126737,12.024253916,7.4025794474,-2.06197784,-86,0.6399241571,4.6216744682,-1.422053683
55,73,2005,1482,958,343,1748,88,524,431,831,127568,11.655295806,7.5342600421,2.6975482197,-124,0.6920823421,4.1210357641,3.3896305617
55,73,2006,1582,933,559,1813,89,649,648,1235,128803,12.341489482,7.2785143405,4.3608676488,-62,0.6943062983,5.0629751415,5.0551739471
55,73,2007,1791,985,84,1831,73,806,157,980,129783,13.85225805,7.6183552087,0.6496871447,17,0.5646090662,6.2339028408,1.2142962109
55,73,2008,1717,996,342,1972,73,721,415,1179,130962,13.16995532,7.6396479319,2.6232526031,43,0.5599340352,5.5303073884,3.1831866383
55,75,2001,441,521,-116,1434,13,-80,-103,-220,43217,10.178410691,12.024834399,-2.677314377,-37,0.3000438526,-1.846423708,-2.377270524
55,75,2002,369,522,169,1416,11,-153,180,-12,43205,8.5394922589,12.080257342,3.9110411701,-39,0.2545648099,-3.540765083,4.16560598
55,75,2003,432,505,-44,1407,4,-73,-40,-169,43036,10.018436706,11.711366983,-1.020396331,-56,0.0927633028,-1.692930277,-0.927633028
55,75,2004,440,500,-193,1382,14,-60,-179,-269,42767,10.256051653,11.654604151,-4.498677202,-30,0.3263289162,-1.398552498,-4.172348286
55,75,2005,457,477,253,1474,9,-20,262,199,42966,10.66100568,11.12757048,5.9020447202,-43,0.20995416,-0.4665648,6.1119988802
55,75,2006,416,528,-267,1346,13,-112,-254,-383,42583,9.7254205192,12.343802967,-6.242036727,-17,0.3039193912,-2.618382447,-5.938117336
55,75,2007,445,483,-120,1333,6,-38,-114,-136,42447,10.466894037,11.360696225,-2.822533224,16,0.1411266612,-0.893802187,-2.681406562
55,75,2008,462,484,-176,1313,6,-22,-170,-159,42288,10.904584882,11.423850829,-4.154127574,33,0.1416179855,-0.519265947,-4.012509589
55,77,2001,149,176,-6,160,2,-27,-4,-48,14563,10.214574621,12.065537808,-0.411325153,-17,0.1371083842,-1.850963186,-0.274216768
55,77,2002,153,157,116,175,1,-4,117,102,14665,10.469412892,10.743123033,7.9375940879,-11,0.0684275352,-0.273710141,8.0060216231
55,77,2003,156,177,77,169,-1,-21,76,42,14707,10.622361433,12.052294702,5.2430886559,-13,-0.06809206,-1.42993327,5.1749965954
55,77,2004,162,171,173,170,0,-9,173,149,14856,10.959645503,11.568514697,11.703818963,-15,0,-0.608869195,11.703818963
55,77,2005,166,171,167,173,-1,-5,166,146,15002,11.119298011,11.454216625,11.186281734,-15,-0.066983723,-0.334918615,11.119298011
55,77,2006,158,179,39,173,0,-21,39,12,15014,10.52771855,11.926972281,2.5986140725,-6,0,-1.399253731,2.5986140725
55,77,2007,178,177,-67,174,0,1,-67,-64,14950,11.880923775,11.814177012,-4.472033106,2,0,0.0667467628,-4.472033106
55,77,2008,178,173,106,174,-1,5,105,110,15060,11.862712429,11.52949017,7.064311896,0,-0.066644452,0.3332222592,6.9976674442
55,78,2001,88,36,-51,53,1,52,-50,-2,4580,19.209779524,7.858546169,-11.13294041,-4,0.2182929491,11.351233355,-10.91464746
55,78,2002,94,36,-5,69,1,58,-4,48,4628,20.417028671,7.819287576,-1.086012163,-6,0.2172024327,12.597741095,-0.868809731
55,78,2003,93,33,-79,57,1,60,-78,-21,4607,20.140768814,7.146724418,-17.10882512,-3,0.2165674066,12.994044396,-16.89225772
55,78,2004,103,34,-100,55,0,69,-100,-36,4571,22.444977119,7.4090215733,-21.79123992,-5,0,15.035955546,-21.79123992
55,78,2005,84,42,-59,53,1,42,-58,-17,4554,18.410958904,9.2054794521,-12.93150685,-1,0.2191780822,9.2054794521,-12.71232877
55,78,2006,108,43,-34,54,0,65,-34,28,4582,23.642732049,9.4133099825,-7.443082312,-3,0,14.229422067,-7.443082312
55,78,2007,122,17,-80,54,1,105,-79,17,4599,26.57662564,3.7033002941,-17.4272955,-9,0.2178411938,22.873325346,-17.20945431
55,78,2008,108,13,-108,54,0,95,-108,-28,4571,23.555070883,2.8353326063,-23.55507088,-15,0,20.719738277,-23.55507088
55,79,2001,14833,9132,-10586,23764,3057,5701,-7529,4029,943749,15.750723797,9.6970005877,-11.24096016,5857,3.2461378446,6.0537232097,-7.99482232
55,79,2002,14563,8947,-10202,24621,2857,5616,-7345,2958,946707,15.406864799,9.4654411422,-10.79316313,4687,3.0225511728,5.9414236565,-7.770611958
55,79,2003,14437,8757,-10340,24685,2499,5680,-7841,2502,949209,15.229577682,9.2377510396,-10.90765625,4663,2.6361927427,5.9918266421,-8.271463504
55,79,2004,14917,8798,-12045,24794,2303,6119,-9742,1029,950238,15.706676733,9.2637488701,-12.68263868,4652,2.4249163046,6.4429278627,-10.25772238
55,79,2005,14631,8511,-14209,24585,2425,6120,-11784,-987,949251,15.405195818,8.9613575019,-14.96086579,4677,2.5533182872,6.4438383165,-12.4075475
55,79,2006,15035,8304,-11955,24003,2613,6731,-9342,2083,951334,15.82144445,8.7383621359,-12.58033711,4694,2.7496797039,7.0830823141,-9.830657403
55,79,2007,15528,7991,-9673,23882,2347,7537,-7326,-3,951331,16.322368888,8.3997971267,-10.16784352,-214,2.4670659312,7.9225717612,-7.700777594
55,79,2008,15401,8135,-7382,24483,2350,7266,-5032,1997,953328,16.171923688,8.542211493,-7.751518776,-237,2.4676333139,7.6297121952,-5.283885462
55,81,2001,594,430,9,855,35,164,44,168,41168,14.458183234,10.466361601,0.2190633823,-40,0.8519131535,3.9918216337,1.0709765359
55,81,2002,575,379,82,859,17,196,99,257,41425,13.923698134,9.177533205,1.9856404296,-38,0.4116571622,4.7461649292,2.3972975918
55,81,2003,586,419,-93,818,-20,167,-113,-3,41422,14.14655932,10.115031323,-2.245102418,-57,-0.482817724,4.0315279974,-2.727920142
55,81,2004,606,401,218,857,44,205,262,429,41851,14.554537485,9.6309728243,5.2357907125,-38,1.0567650979,4.9235646608,6.2925558104
55,81,2005,617,426,124,826,18,191,142,293,42144,14.691350676,10.14346092,2.9525566998,-40,0.4285969403,4.5478897553,3.3811536401
55,81,2006,631,374,150,817,35,257,185,421,42565,14.89806278,8.830230554,3.5415363185,-21,0.8263584743,6.0678322256,4.3678947928
55,81,2007,642,392,181,807,19,250,200,449,43014,15.00368081,9.1611259772,4.2300096986,-1,0.4440341673,5.8425548324,4.6740438659
55,81,2008,681,402,32,807,22,279,54,336,43350,15.770459914,9.3094344866,0.7410495114,3,0.5094715391,6.4610254273,1.2505210504
55,83,2001,382,362,299,336,2,20,301,291,36092,10.626903871,10.070521469,8.3179169043,-30,0.0556382402,0.5563824016,8.3735551445
55,83,2002,402,353,226,299,2,49,228,247,36339,11.100219519,9.7472076873,6.2404219188,-30,0.0552249727,1.353011832,6.2956468915
55,83,2003,360,311,330,312,1,49,331,353,36692,9.8588270734,8.5169311662,9.0372581506,-27,0.0273856308,1.3418959072,9.0646437814
55,83,2004,405,330,362,288,2,75,364,401,37093,10.977841025,8.9449075015,9.8122924714,-38,0.0542115606,2.0329335231,9.866504032
55,83,2005,390,314,91,315,2,76,93,134,37227,10.495156082,8.4499461787,2.4488697524,-35,0.0538213132,2.0452099031,2.5026910657
55,83,2006,407,325,59,319,2,82,61,126,37353,10.914454277,8.7154733172,1.5821936176,-17,0.053633682,2.19898096,1.6358272995
55,83,2007,395,324,2,320,2,71,4,74,37427,10.564322011,8.6654185611,0.053490238,-1,0.053490238,1.8989034501,0.1069804761
55,83,2008,415,316,8,320,1,99,9,102,37529,11.073162922,8.4316132131,0.2134585624,-6,0.0266823203,2.6415497092,0.2401408827
55,85,2001,296,389,203,932,11,-93,214,90,36896,8.0323464764,10.556022903,5.5086700497,-31,0.2984993623,-2.523676427,5.807169412
55,85,2002,300,404,48,924,10,-104,58,-80,36816,8.1397872802,10.961580204,1.3023659648,-34,0.2713262427,-2.821792924,1.5736922075
55,85,2003,323,357,313,905,5,-34,318,260,37076,8.7424890381,9.6627510421,8.4718237428,-24,0.1353326476,-0.920262004,8.6071563904
55,85,2004,310,394,-152,892,8,-84,-144,-256,36820,8.3901699686,10.663635379,-4.113889791,-28,0.2165205153,-2.273465411,-3.897369276
55,85,2005,364,425,-96,897,6,-61,-90,-183,36637,9.9105599194,11.57139551,-2.613774045,-32,0.1633608778,-1.660835591,-2.450413167
55,85,2006,307,414,-151,893,7,-107,-144,-269,36368,8.4103828505,11.341688925,-4.136702966,-18,0.1917676871,-2.931306075,-3.944935278
55,85,2007,306,430,-79,883,5,-124,-74,-205,36163,8.4377714357,11.856999076,-2.1783789,-7,0.1378720823,-3.419227641,-2.040506818
55,85,2008,328,395,-49,883,4,-67,-45,-132,36031,9.0866276976,10.942737624,-1.357453528,-20,0.1108125329,-1.856109926,-1.246640995
55,87,2001,2296,1109,858,3385,201,1187,1059,2092,163873,14.100855509,6.8109097386,5.2693963532,-154,1.2344390058,7.2899457707,6.503835359
55,87,2002,2276,1095,500,3473,192,1181,692,1716,165589,13.816464418,6.6472005876,3.0352514099,-157,1.1655365414,7.1692638301,4.2007879513
55,87,2003,2327,1155,213,3464,164,1172,377,1300,166889,13.997918659,6.947828127,1.2812877845,-249,0.9865314397,7.0500905323,2.2678192241
55,87,2004,2322,1142,313,3501,153,1180,466,1537,168426,13.849663749,6.8115055992,1.8669012719,-109,0.9125747432,7.0381581498,2.7794760151
55,87,2005,2240,1176,573,3518,163,1064,736,1650,170076,13.234781478,6.9482602762,3.3855043693,-150,0.9630666879,6.2865212022,4.3485710572
55,87,2006,2267,1132,634,3557,166,1135,800,1850,171926,13.257232414,6.6198443284,3.7075806574,-85,0.970754557,6.6373880854,4.6783352144
55,87,2007,2323,1163,377,3562,142,1160,519,1682,173608,13.445854822,6.7316096245,2.1821296891,3,0.8219162224,6.7142451973,3.0040459115
55,87,2008,2368,1159,-31,3525,142,1209,111,1385,174993,13.585732686,6.649435888,-0.177853764,65,0.8146849837,6.9362967978,0.6368312196
55,89,2001,857,577,159,1674,79,280,238,442,82970,10.356620624,6.9728939323,1.9214733713,-76,0.9546943165,3.3837266916,2.8761676878
55,89,2002,920,598,275,1680,76,322,351,583,83553,11.04952469,7.1821910487,3.3028470542,-90,0.9127868222,3.8673336416,4.2156338764
55,89,2003,867,599,398,1715,60,268,458,611,84164,10.338844601,7.1429849091,4.7460901399,-115,0.7154909759,3.1958596922,5.4615811158
55,89,2004,896,635,484,1755,64,261,548,741,84905,10.599222803,7.5117259817,5.7254730317,-68,0.757087343,3.0874968208,6.4825603748
55,89,2005,880,638,-137,1721,63,242,-74,90,84995,10.359034726,7.5103001766,-1.612713361,-78,0.7416127134,2.8487345497,-0.871100647
55,89,2006,825,624,-116,1730,64,201,-52,109,85104,9.7002333935,7.3369038031,-1.363911604,-40,0.7525029542,2.3633295904,-0.61140865
55,89,2007,869,675,6,1685,60,194,66,274,85378,10.194624652,7.9187245574,0.0703886627,14,0.7038866273,2.275900095,0.7742752901
55,89,2008,878,638,166,1695,60,240,226,496,85874,10.253894845,7.4510078714,1.9386634901,30,0.7007217434,2.8028869736,2.6393852335
55,91,2001,85,85,48,120,2,0,50,44,7243,11.771222822,11.771222822,6.6472787703,-6,0.2769699488,0,6.924248719
55,91,2002,94,57,48,128,2,37,50,79,7322,12.907655338,7.8269824923,6.5911431514,-8,0.2746309646,5.0806728459,6.865774116
55,91,2003,72,96,38,134,1,-24,39,5,7327,9.8300225271,13.106696703,5.1880674449,-10,0.1365280907,-3.276674176,5.3245955355
55,91,2004,89,77,65,133,0,12,65,71,7398,12.088285229,10.458404075,8.8285229202,-6,0,1.6298811545,8.8285229202
55,91,2005,92,71,-2,139,1,21,-1,12,7410,12.425715829,9.5894111291,-0.270124257,-8,0.1350621286,2.8363047002,-0.135062129
55,91,2006,95,70,-85,136,0,25,-85,-63,7347,12.875245646,9.4870231077,-11.51995663,-3,0,3.3882225385,-11.51995663
55,91,2007,91,67,-9,141,1,24,-8,17,7364,12.37169465,9.1088301271,-1.223574196,1,0.1359526885,3.2628645231,-1.087621508
55,91,2008,95,76,-28,141,0,19,-28,-7,7357,12.90673188,10.325385504,-3.804089396,2,0,2.5813463759,-3.804089396
55,93,2001,395,226,151,2401,10,169,161,296,37214,10.656666487,6.0972319646,4.0738142772,-34,0.269789025,4.5594345222,4.3436033022
55,93,2002,397,242,135,2357,8,155,143,264,37478,10.630321855,6.4799443046,3.6148449633,-34,0.2142130349,4.1503775505,3.8290579982
55,93,2003,437,247,293,2336,2,190,295,454,37932,11.589974804,6.5508553242,7.7708526721,-31,0.0530433629,5.0391194802,7.823896035
55,93,2004,501,239,385,2413,9,262,394,620,38552,13.100779248,6.2496731343,10.067465091,-36,0.2353433398,6.8511061137,10.302808431
55,93,2005,464,236,248,2385,6,228,254,445,38997,11.966627552,6.0864743581,6.3959561052,-37,0.1547408735,5.8801531935,6.5506969787
55,93,2006,419,213,329,2501,8,206,337,524,39521,10.67271199,5.4255075269,8.3802440205,-19,0.2037749306,5.2472044627,8.5840189511
55,93,2007,466,220,20,2579,5,246,25,273,39794,11.750614638,5.5475004728,0.5043182248,2,0.1260795562,6.203114165,0.630397781
55,93,2008,479,241,204,2617,5,238,209,460,40254,11.967819308,6.0213871677,5.0969418349,13,0.124925045,5.9464321407,5.2218668799
55,95,2001,500,375,634,584,20,125,654,751,42197,11.95557309,8.9666798178,15.159666679,-28,0.4782229236,2.9888932726,15.637889602
55,95,2002,435,441,358,570,19,-6,377,342,42539,10.267182779,10.408799094,8.4497734139,-29,0.4484516616,-0.141616314,8.8982250755
55,95,2003,479,410,377,602,5,69,382,415,42954,11.20559578,9.591428538,8.8194355093,-36,0.1169686407,1.6141672418,8.93640415
55,95,2004,495,419,492,615,9,76,501,533,43487,11.452898509,9.6944736873,11.383487003,-44,0.2082345183,1.7584248216,11.591721521
55,95,2005,522,399,308,632,7,123,315,396,43883,11.949181641,9.1335698752,7.0504749914,-42,0.160238068,2.8156117661,7.2107130594
55,95,2006,510,401,237,631,9,109,246,335,44218,11.577621139,9.1031883861,5.3801886471,-20,0.2043109613,2.4744327533,5.5844996084
55,95,2007,544,402,-168,632,4,142,-164,-9,44209,12.303934319,9.0922455811,-3.799744422,13,0.0904701053,3.2116887376,-3.709274317
55,95,2008,532,418,-80,632,4,114,-76,61,44270,12.025452367,9.4485697171,-1.808338702,23,0.0904169351,2.5768826501,-1.717921767
55,97,2001,794,409,-290,3581,53,385,-237,88,67340,11.798621018,6.0776271992,-4.309320019,-60,0.7875653828,5.7209938184,-3.521754636
55,97,2002,705,436,-112,3619,52,269,-60,147,67487,10.45784598,6.4675473014,-1.661388298,-62,0.7713588525,3.990298679,-0.890029445
55,97,2003,745,467,-284,3582,41,278,-243,-48,67439,11.043090287,6.9223129716,-4.209714955,-83,0.6077405393,4.120777315,-3.601974416
55,97,2004,746,455,-307,3334,39,291,-268,-30,67409,11.064309445,6.7483388704,-4.553274798,-53,0.578429046,4.3159705743,-3.974845752
55,97,2005,715,502,-28,3522,41,213,13,168,67577,10.593691198,7.4378083653,-0.414857837,-58,0.6074704043,3.1558828323,0.1926125672
55,97,2006,729,456,-31,3542,43,273,12,252,67829,10.767617388,6.7352997652,-0.457882221,-33,0.6351269515,4.0323176226,0.1772447307
55,97,2007,787,450,134,3586,35,337,169,489,68318,11.561033295,6.610501884,1.968460561,-17,0.5141501465,4.9505314109,2.4826107075
55,97,2008,815,467,58,3669,34,348,92,426,68744,11.892428244,6.8144343436,0.8463323168,-14,0.4961258409,5.0779939006,1.3424581576
55,99,2001,144,199,-191,257,1,-55,-190,-255,15554,9.1827950132,12.690112553,-12.17995727,-10,0.0637694098,-3.50731754,-12.11618786
55,99,2002,121,187,-86,245,0,-66,-86,-164,15390,7.8205791107,12.086349535,-5.558428128,-12,0,-4.265770424,-5.558428128
55,99,2003,149,180,-14,241,0,-31,-14,-65,15325,9.7020999512,11.720657659,-0.911606707,-20,0,-2.018557708,-0.911606707
55,99,2004,109,215,-63,238,1,-106,-62,-180,15145,7.1545782737,14.112241549,-4.135214966,-12,0.0656383328,-6.957663275,-4.069576633
55,99,2005,145,220,-71,242,1,-75,-70,-158,14987,9.6243196602,14.602416036,-4.712597903,-13,0.0663746183,-4.978096376,-4.646223284
55,99,2006,124,184,-166,251,1,-60,-165,-232,14755,8.3383767063,12.373075113,-11.16266559,-7,0.0672449734,-4.034698406,-11.09542062
55,99,2007,116,183,-254,218,0,-67,-254,-334,14421,7.9517411571,12.54455717,-17.41157115,-13,0,-4.592816013,-17.41157115
55,99,2008,131,179,-80,218,-1,-48,-81,-143,14278,9.1292379525,12.47430224,-5.575107147,-14,-0.069688839,-3.345064288,-5.644795986
55,101,2001,2624,1656,-830,5384,286,968,-544,964,189938,13.850181573,8.7408158095,-4.380964446,540,1.5095853391,5.109365763,-2.871379106
55,101,2002,2579,1506,-318,5334,267,1073,-51,1424,191362,13.527406242,7.8992918961,-1.66797797,402,1.4004720692,5.6281143457,-0.267505901
55,101,2003,2536,1529,39,5346,225,1007,264,1605,192967,13.197026506,7.9567245771,0.2029511174,334,1.1708718312,5.2403019288,1.3738229486
55,101,2004,2533,1500,-41,5291,216,1033,175,1734,194701,13.067882828,7.7385804348,-0.211521199,526,1.1143555826,5.3293023928,0.9028343841
55,101,2005,2594,1548,368,5374,226,1046,594,2097,196798,13.251630272,7.9080661764,1.8799537164,457,1.1545367932,5.3435640959,3.0344905096
55,101,2006,2596,1536,-490,5379,239,1060,-251,1285,198083,13.14826492,7.7795589051,-2.481760328,476,1.2104912619,5.3687060152,-1.271269066
55,101,2007,2694,1521,-921,5426,209,1173,-712,935,199018,13.568336519,7.6605196159,-4.638618387,474,1.0526289282,5.907816903,-3.585989459
55,101,2008,2666,1460,-939,5426,209,1206,-730,492,199510,13.379235587,7.3269632247,-4.712341416,16,1.0488598041,6.0522723623,-3.663481612
55,103,2001,214,177,-56,217,5,37,-51,-31,17945,11.915035773,9.8549594944,-3.117953286,-17,0.2783886863,2.0600762785,-2.8395646
55,103,2002,204,209,-97,226,5,-5,-92,-110,17835,11.403018446,11.682504192,-5.422023477,-13,0.2794857462,-0.279485746,-5.142537731
55,103,2003,197,183,85,217,3,14,88,84,17919,11.019746042,10.236616882,4.7547127594,-18,0.1678133915,0.7831291604,4.9225261509
55,103,2004,233,157,122,213,2,76,124,183,18102,12.936897921,8.7171372255,6.7738263791,-17,0.1110463341,4.2197606952,6.8848727131
55,103,2005,213,178,-127,209,3,35,-124,-106,17996,11.801207823,9.8620422184,-7.036400909,-17,0.1662141947,1.9391656047,-6.870186714
55,103,2006,249,163,-68,218,2,86,-66,12,18008,13.831796467,9.0545494945,-3.777358071,-8,0.1110987668,4.7772469726,-3.666259305
55,103,2007,215,174,104,337,2,41,106,152,18160,11.888962619,9.6217650962,5.7509400575,5,0.1105950011,2.2671975227,5.8615350586
55,103,2008,227,184,-235,337,1,43,-234,-178,17982,12.561562725,10.182059654,-13.00426097,13,0.0553372807,2.3795030712,-12.94892369
55,105,2001,2071,1328,-218,3440,281,743,63,660,153156,13.551359062,8.689620876,-1.426458849,-146,1.8386923691,4.8617381859,0.4122335205
55,105,2002,1980,1328,-420,3366,270,652,-150,366,153522,12.912566275,8.6605495014,-2.73902921,-136,1.760804492,4.2520167733,-0.978224718
55,105,2003,2041,1293,-312,3281,239,748,-73,467,153989,13.274321894,8.4094552715,-2.029195704,-208,1.5544159396,4.8648666227,-0.474779764
55,105,2004,2040,1334,585,3379,217,706,802,1393,155382,13.1880493,8.6239498854,3.7818670787,-115,1.4028464206,4.5640994146,5.1847134993
55,105,2005,1977,1355,312,3398,228,622,540,1012,156394,12.682182079,8.6921379452,2.0014369291,-150,1.4625885251,3.9900441343,3.4640254542
55,105,2006,2099,1433,835,3426,228,666,1063,1652,158046,13.350718738,9.114616461,5.3110291312,-77,1.4501971759,4.2361022771,6.7612263071
55,105,2007,2198,1273,219,3390,209,925,428,1352,159398,13.848111793,8.020312244,1.3797709202,-1,1.3167676819,5.8277995489,2.6965386021
55,105,2008,2198,1259,-368,3348,208,939,-160,815,160213,13.754219974,7.8783270914,-2.30279934,36,1.3015822359,5.8758928823,-1.001217105
55,107,2001,167,188,-144,381,4,-21,-140,-173,15176,10.941850942,12.317772318,-9.434889435,-12,0.2620802621,-1.375921376,-9.172809173
55,107,2002,163,204,11,343,3,-41,14,-42,15134,10.755526229,13.460903992,0.7258330584,-15,0.1979544705,-2.705377763,0.9237875289
55,107,2003,178,164,-293,206,0,14,-293,-281,14853,11.871811118,10.938073165,-19.54180145,-2,0,0.9337379531,-19.54180145
55,107,2004,159,188,11,213,1,-29,12,-28,14825,10.71500775,12.669317339,0.7412898443,-11,0.0673899858,-1.95430959,0.8086798302
55,107,2005,150,187,-88,196,1,-37,-87,-136,14689,10.164667615,12.671952294,-5.963271668,-12,0.0677644508,-2.507284678,-5.895507217
55,107,2006,148,175,-147,175,1,-27,-146,-179,14510,10.13733347,11.986711874,-10.06883797,-6,0.0684954964,-1.849378403,-10.00034248
55,107,2007,163,156,-81,158,0,7,-81,-79,14431,11.264296327,10.78055354,-5.597595107,-5,0,0.483742787,-5.597595107
55,107,2008,176,162,-56,158,-1,14,-57,-42,14389,12.213740458,11.242192922,-3.886190146,1,-0.069396253,0.9715475364,-3.955586398
55,109,2001,829,471,1657,934,26,358,1683,2004,65650,12.823289197,7.2856082168,25.631110011,-37,0.4021779483,5.5376809801,26.033287959
55,109,2002,940,445,1970,921,25,495,1995,2478,68128,14.053132802,6.6528128691,29.451778319,-12,0.373753532,7.400319933,29.825531851
55,109,2003,1016,461,2077,916,15,555,2092,2695,70823,14.62386021,6.6354326345,29.895430763,48,0.215903448,7.9884275752,30.111334211
55,109,2004,1046,447,2323,906,19,599,2342,2822,73645,14.480715453,6.1882216131,32.159370933,-119,0.2630340283,8.2924938395,32.422404962
55,109,2005,1237,403,2164,930,18,834,2182,2954,76599,16.466547749,5.3646069061,28.806474801,-62,0.239610234,11.101940843,29.046085035
55,109,2006,1165,425,1754,921,20,740,1774,2468,79067,14.967944188,5.460408824,22.535428417,-46,0.2569604152,9.5075353642,22.792388833
55,109,2007,1231,470,1170,896,15,761,1185,1925,80992,15.381827951,5.8728343923,14.619609019,-21,0.1874308849,9.5089935586,14.807039904
55,109,2008,1252,468,717,896,15,784,732,1495,82487,15.316952024,5.7255060283,8.771768851,-21,0.1835098086,9.5914459961,8.9552786596
55,111,2001,567,497,9,902,40,70,49,64,55404,10.239832406,8.975655566,0.1625370223,-55,0.7223867659,1.2641768403,0.8849237882
55,111,2002,750,552,205,898,37,198,242,388,55792,13.489693874,9.9284146912,3.6871829922,-52,0.6654915644,3.5612791827,4.3526745566
55,111,2003,699,483,284,891,18,216,302,456,56248,12.477686541,8.6219207426,5.0696179936,-62,0.3213138165,3.8557657979,5.3909318101
55,111,2004,767,498,396,918,22,269,418,640,56888,13.55890256,8.8035638524,7.0004242681,-47,0.3889124593,4.7553387074,7.3893367275
55,111,2005,755,518,313,960,20,237,333,514,57402,13.21200455,9.0646600752,5.4772946015,-56,0.3499868755,4.1473444746,5.8272814769
55,111,2006,757,525,216,949,22,232,238,442,57844,13.137115388,9.1109452823,3.7485032018,-28,0.3817919928,4.0261701057,4.1302951946
55,111,2007,857,543,211,959,16,314,227,555,58399,14.744973891,9.3424980429,3.6303261272,14,0.2752853935,5.402475848,3.9056115207
55,111,2008,821,535,274,959,16,286,290,614,59013,13.984941914,9.11320819,4.667325316,38,0.272544544,4.871733724,4.93986986
55,113,2001,188,212,83,297,3,-24,86,48,16290,11.557850732,13.033321038,5.1026681421,-14,0.1844337883,-1.475470306,5.2871019304
55,113,2002,174,200,207,336,3,-26,210,175,16465,10.624332163,12.211876049,12.639291711,-9,0.1831781407,-1.587543886,12.822469852
55,113,2003,160,197,203,331,0,-37,203,157,16622,9.6714721794,11.908000121,12.270680328,-9,0,-2.236527941,12.270680328
55,113,2004,185,174,90,313,1,11,91,89,16711,11.100111001,10.440104401,5.4000540005,-13,0.0600006,0.6600066001,5.4600546005
55,113,2005,174,172,145,360,1,2,146,131,16842,10.371650821,10.252436444,8.6430423509,-17,0.0596071886,0.1192143773,8.7026495395
55,113,2006,217,195,50,352,1,22,51,65,16907,12.859640286,11.555897953,2.9630507571,-8,0.0592610151,1.3037423331,3.0223117722
55,113,2007,223,182,106,356,1,41,107,156,17063,13.129231675,10.715337062,6.2408007065,8,0.0588754784,2.4138946129,6.2996761849
55,113,2008,205,173,11,356,0,32,11,54,17117,11.9953189,10.122878877,0.643651258,11,0,1.8724400234,0.643651258
55,115,2001,448,432,6,908,15,16,21,-5,40760,10.990493714,10.597976081,0.1471941122,-42,0.3679852806,0.3925176326,0.5151793928
55,115,2002,457,453,44,916,14,4,58,23,40783,11.208810076,11.110702329,1.0791852152,-39,0.3433771139,0.0981077468,1.4225623291
55,115,2003,482,456,-22,872,10,26,-12,-45,40738,11.825173882,11.187301432,-0.539738227,-59,0.2453355577,0.63787245,-0.294402669
55,115,2004,459,445,119,904,11,14,130,114,40852,11.251378845,10.908199534,2.9170241451,-30,0.2696408874,0.3431793112,3.1866650325
55,115,2005,487,454,42,893,10,33,52,46,40898,11.914373089,11.107033639,1.0275229358,-39,0.244648318,0.8073394495,1.2721712538
55,115,2006,502,423,-44,843,12,79,-32,27,40925,12.270388522,10.339391125,-1.075492221,-20,0.2933160603,1.9309973968,-0.782176161
55,115,2007,510,403,-57,849,10,107,-47,48,40973,12.454516594,9.8415101712,-1.391975384,-12,0.2442062077,2.6130064226,-1.147769176
55,115,2008,510,407,-103,849,9,103,-94,-1,40972,12.447373238,9.9334919763,-2.513881262,-10,0.2196595277,2.5138812618,-2.294221734
55,117,2001,1106,1068,33,3511,170,38,203,127,112872,9.8042257454,9.4673716963,0.2925311479,-114,1.5069786408,0.3368540491,1.7995097887
55,117,2002,1389,1053,-317,3511,164,336,-153,82,112954,12.30150647,9.3257640839,-2.807471239,-101,1.4524456883,2.9757423857,-1.355025551
55,117,2003,1366,1035,-332,3547,146,331,-186,0,112954,12.09341856,9.1630221152,-2.939249606,-145,1.2925615737,2.9303964446,-1.646688032
55,117,2004,1365,1050,-101,3580,133,315,32,272,113226,12.070032717,9.2846405518,-0.893093996,-75,1.1760544699,2.7853921655,0.282960474
55,117,2005,1442,1041,6,3602,142,401,148,437,113663,12.711061356,9.1762932535,0.0528892983,-112,1.2517133929,3.5347681025,1.3046026912
55,117,2006,1448,1097,-206,3590,143,351,-63,235,113898,12.726258014,9.6413708852,-1.810503557,-53,1.2568058674,3.0848871292,-0.55369769
55,117,2007,1442,1032,-235,3545,125,410,-110,308,114206,12.643355662,9.0485041911,-2.060463648,8,1.0959913022,3.5948514713,-0.964472346
55,117,2008,1466,984,-300,3545,124,482,-176,355,114561,12.816533853,8.6026393667,-2.622755904,49,1.0840724405,4.2138944865,-1.538683464
55,119,2001,240,189,-138,265,12,51,-126,-93,19627,12.199151142,9.6068315246,-7.014511907,-18,0.6099575571,2.5923196178,-6.40455435
55,119,2002,245,203,-71,269,11,42,-60,-36,19591,12.494262838,10.352389209,-3.620786374,-18,0.560966903,2.1418736295,-3.059819471
55,119,2003,216,178,-198,274,5,38,-193,-169,19422,11.073232,9.1251634071,-10.15046267,-14,0.2563248148,1.9480685925,-9.894137851
55,119,2004,248,171,11,268,6,77,17,81,19503,12.742453436,8.7861271676,0.5651894669,-13,0.3082851638,3.9563262685,0.8734746307
55,119,2005,258,182,-94,272,5,76,-89,-30,19473,13.238916256,9.3390804598,-4.823481117,-17,0.2565681445,3.8998357964,-4.566912972
55,119,2006,211,151,-195,270,6,60,-189,-138,19335,10.874046588,7.781900639,-10.04947434,-9,0.3092145949,3.0921459493,-9.74025974
55,119,2007,261,175,-130,279,2,86,-128,-44,19291,13.514213224,9.0612540776,-6.731217315,-2,0.1035571895,4.4529591467,-6.627660125
55,119,2008,260,189,-53,279,1,71,-52,17,19308,13.471851602,9.7929998186,-2.746185134,-2,0.0518148139,3.6788517837,-2.69437032
55,121,2001,325,296,-57,642,6,29,-51,-48,27030,12.013011015,10.941080801,-2.106897316,-26,0.2217786649,1.0719302136,-1.885118652
55,121,2002,304,318,68,635,6,-14,74,34,27064,11.239693866,11.757311347,2.514142049,-26,0.2218360631,-0.517617481,2.7359781122
55,121,2003,299,302,91,634,2,-3,93,55,27119,11.036672019,11.147407859,3.3589871362,-35,0.0738238931,-0.11073584,3.4328110293
55,121,2004,368,295,110,616,3,73,113,166,27285,13.528417028,10.844790824,4.0438203073,-20,0.1102860084,2.683626204,4.1541063157
55,121,2005,367,261,204,643,3,106,207,286,27571,13.380487093,9.5158232463,7.4376549511,-27,0.1093772787,3.8646638472,7.5470322298
55,121,2006,289,304,144,650,3,-15,147,118,27689,10.459645313,11.002533478,5.2117263844,-14,0.108577633,-0.542888165,5.3203040174
55,121,2007,378,296,16,648,1,82,17,98,27787,13.627514601,10.671281275,0.5768260149,-1,0.0360516259,2.9562333261,0.6128776408
55,121,2008,381,296,-90,648,0,85,-90,3,27790,13.710707667,10.651888371,-3.238749843,8,0,3.0588192958,-3.238749843
55,123,2001,391,350,56,460,0,41,56,66,28131,13.91558118,12.456402591,1.9930244145,-31,0,1.4591785892,1.9930244145
55,123,2002,363,321,64,459,-1,42,63,80,28211,12.885591566,11.394696674,2.2718398353,-25,-0.035497497,1.4908948919,2.2363423379
55,123,2003,393,305,5,441,-3,88,2,50,28261,13.91840204,10.801813288,0.1770789064,-40,-0.106247344,3.1165887519,0.0708315625
55,123,2004,425,264,69,438,1,161,70,211,28472,14.982461707,9.3067526836,2.4324467241,-20,0.0352528511,5.675709023,2.4676995752
55,123,2005,429,304,163,448,-1,125,162,258,28730,14.999475543,10.628998986,5.69910143,-29,-0.034963812,4.3704765568,5.6641376176
55,123,2006,403,296,1,447,1,107,2,95,28825,14.003996178,10.28581357,0.0347493702,-14,0.0347493702,3.7181826079,0.0694987403
55,123,2007,437,296,-14,449,-1,141,-15,130,28955,15.126341295,10.245759778,-0.484596746,4,-0.034614053,4.8805815161,-0.5192108
55,123,2008,444,291,-28,449,-1,153,-29,135,29090,15.298475321,10.02670342,-0.964768714,11,-0.034456025,5.2717719011,-0.999224739
55,125,2001,168,274,417,294,10,-106,427,310,21455,7.8873239437,12.863849765,19.577464789,-11,0.4694835681,-4.976525822,20.046948357
55,125,2002,203,252,340,322,10,-49,350,291,21746,9.3979306035,11.666396611,15.74037638,-10,0.4629522465,-2.268466008,16.203328627
55,125,2003,190,263,289,348,6,-73,295,220,21966,8.6932650073,12.033308931,13.222913616,-2,0.2745241581,-3.340043924,13.497437775
55,125,2004,187,223,114,343,5,-36,119,62,22028,8.501159249,10.137746056,5.1825248898,-21,0.2273037232,-1.636586807,5.409828613
55,125,2005,169,225,95,343,6,-56,101,31,22059,7.6666591059,10.207090526,4.3096604441,-14,0.2721890807,-2.54043142,4.5818495248
55,125,2006,175,251,125,348,5,-76,130,43,22102,7.9255451643,11.367496207,5.6611036888,-11,0.2264441476,-3.441951043,5.8875478363
55,125,2007,216,287,24,338,6,-71,30,-55,22047,9.7850460939,13.001426986,1.0872273438,-14,0.2718068359,-3.216380892,1.3590341797
55,125,2008,194,264,-32,338,5,-70,-27,-128,21919,8.8250011372,12.009279898,-1.455670291,-31,0.2274484829,-3.184278761,-1.228221808
55,127,2001,1097,871,625,3314,212,226,837,983,93403,11.806934556,9.3745123047,6.7268314471,-80,2.2817412269,2.4324222513,9.008572674
55,127,2002,1121,756,1230,3413,201,365,1431,1727,95130,11.891817348,8.0198161595,13.048113593,-69,2.1322527091,3.8720011881,15.180366302
55,127,2003,1219,799,982,3493,158,420,1140,1474,96604,12.715532978,8.3344633711,10.243357986,-86,1.6481166616,4.3810696069,11.891474647
55,127,2004,1150,899,522,3476,154,251,676,854,97458,11.851882388,9.2650802321,5.3797240057,-73,1.5871216415,2.586802156,6.9668456473
55,127,2005,1191,857,1095,3349,156,334,1251,1496,98954,12.12756858,8.7265543857,11.150031566,-89,1.5884976478,3.4010141947,12.738529214
55,127,2006,1193,822,566,3281,161,371,727,1048,100002,11.992601379,8.2631335572,5.6897002352,-50,1.6184483001,3.729467822,7.3081485354
55,127,2007,1280,832,-303,3229,141,448,-162,297,100299,12.780764949,8.3074972167,-3.025446703,11,1.4078811389,4.4732677321,-1.617565564
55,127,2008,1258,798,-212,3190,141,460,-71,450,100749,12.514424416,7.9384027695,-2.108949107,61,1.4026501134,4.5760216466,-0.706298993
55,129,2001,162,201,166,243,1,-39,167,114,16200,10.035309422,12.451217246,10.28309484,-14,0.0619463545,-2.415907824,10.345041194
55,129,2002,150,182,220,241,0,-32,220,179,16379,9.20838577,11.172841401,13.505632463,-9,0,-1.964455631,13.505632463
55,129,2003,171,180,54,232,-2,-9,52,24,16403,10.432554451,10.981636264,3.2944908791,-19,-0.122018181,-0.549081813,3.1724726984
55,129,2004,179,180,78,229,1,-1,79,63,16466,10.891721683,10.95256929,4.7461133591,-15,0.0608476072,-0.060847607,4.8069609663
55,129,2005,175,169,45,221,-1,6,44,34,16500,10.616999333,10.252987927,2.7300855427,-16,-0.060668568,0.3640114057,2.6694169751
55,129,2006,182,180,127,220,0,2,127,121,16621,10.99000634,10.86923704,7.6688505782,-8,0,0.1207693004,7.6688505782
55,129,2007,197,184,26,222,0,13,26,40,16661,11.838230876,11.057027823,1.5624061054,1,0,0.7812030527,1.5624061054
55,129,2008,197,164,7,222,-1,33,6,51,16712,11.805950918,9.8283043179,0.4195007941,12,-0.059928685,1.9776466005,0.3595721092
55,131,2001,1492,812,702,1340,78,680,780,1350,119309,12.576495777,6.8445808116,5.9173592731,-110,0.6574843637,5.7319149654,6.5748436367
55,131,2002,1505,815,548,1320,73,690,621,1208,120517,12.550765972,6.7965941975,4.5699799021,-103,0.608774695,5.7541717745,5.1787545971
55,131,2003,1518,894,643,1310,58,624,701,1177,121694,12.534525682,7.3819933859,5.3094202988,-148,0.4789212711,5.1525322962,5.78834157
55,131,2004,1488,906,1251,1309,60,582,1311,1782,123476,12.138516132,7.390790064,10.205163764,-111,0.4894562956,4.7477260676,10.69462006
55,131,2005,1442,852,976,1316,63,590,1039,1516,124992,11.607128483,6.8580259832,7.8561424409,-113,0.5071075551,4.7491025001,8.363249996
55,131,2006,1505,921,872,1326,66,584,938,1458,126450,11.970951551,7.3257451023,6.9359931913,-64,0.5249719617,4.6452064492,7.460965153
55,131,2007,1559,851,792,1315,53,708,845,1564,128014,12.25320674,6.6885689135,6.2248490946,11,0.4165618712,5.564637827,6.6414109658
55,131,2008,1574,905,696,1315,53,669,749,1463,129477,12.225670023,7.0293719004,5.4060141908,45,0.4116648737,5.196298123,5.8176790645
55,133,2001,4446,2792,1106,5653,349,1654,1455,2737,364791,12.233694942,7.6825182811,3.0432898348,-372,0.9603147851,4.5511766608,4.00360462
55,133,2002,4278,2756,2240,5613,328,1522,2568,3750,368541,11.667293941,7.5163773025,6.1091020165,-340,0.894547081,4.150916638,7.0036490975
55,133,2003,4356,2771,1433,5711,275,1585,1708,2803,371344,11.774802841,7.4903532306,3.8735749475,-490,0.7433587652,4.2844496104,4.6169337127
55,133,2004,4348,2843,270,5589,252,1505,522,1793,373137,11.680620459,7.6375354106,0.725337517,-234,0.6769816825,4.0430850485,1.4023191995
55,133,2005,4170,2767,467,5632,268,1403,735,1787,374924,11.148823425,7.397792426,1.2485612804,-351,0.7165191074,3.7510309988,1.9650803878
55,133,2006,4157,2996,-352,5559,274,1161,-78,909,375833,11.074155819,7.9812775638,-0.937720194,-174,0.7299299241,3.0928782549,-0.20779027
55,133,2007,4168,2692,1031,5566,241,1476,1272,2822,378655,11.048552131,7.1359650518,2.7329791859,74,0.6388438252,3.9125870789,3.3718230111
55,133,2008,4264,2766,77,5551,241,1498,318,1974,380629,11.231634013,7.2858113697,0.2028226592,158,0.6348085828,3.9458226434,0.8376312421
55,135,2001,580,651,160,1888,7,-71,167,36,51986,11.160714286,12.526939655,3.078817734,-60,0.1346982759,-1.366225369,3.2135160099
55,135,2002,593,667,318,1869,6,-74,324,195,52181,11.385563566,12.80635902,6.1055804621,-55,0.1151996314,-1.420795453,6.2207800935
55,135,2003,594,648,192,1887,1,-54,193,67,52248,11.376150303,12.410345785,3.6771394919,-72,0.0191517682,-1.034195482,3.6962912601
55,135,2004,585,716,106,1847,5,-131,111,-52,52196,11.202175328,13.710696641,2.0297958715,-32,0.0957450883,-2.508521313,2.1255409597
55,135,2005,543,667,-35,1849,3,-124,-32,-195,52001,10.422564949,12.802671862,-0.671804371,-39,0.0575832318,-2.380106913,-0.614221139
55,135,2006,507,704,152,1824,5,-197,157,-68,51933,9.7561914292,13.54705871,2.9249331306,-28,0.0962149056,-3.790867281,3.0211480363
55,135,2007,630,672,60,1798,3,-42,63,3,51936,12.130664587,12.93937556,1.1553013892,-18,0.0577650695,-0.808710972,1.2130664587
55,135,2008,599,648,-18,1798,3,-49,-15,-78,51858,11.542092992,12.486270883,-0.346840858,-14,0.0578068096,-0.944177891,-0.289034048
55,137,2001,236,244,275,438,18,-8,293,267,23372,10.155560815,10.499817114,11.833810272,-18,0.7745766723,-0.344256299,12.608386944
55,137,2002,229,286,975,1397,18,-57,993,946,24318,9.6036905012,11.994128748,40.889075278,10,0.7548752359,-2.390438247,41.643950514
55,137,2003,242,269,217,1402,9,-27,226,186,24504,9.9135635574,11.019622301,8.8894350907,-13,0.368686248,-1.106058744,9.2581213387
55,137,2004,266,283,96,1369,10,-17,106,68,24572,10.840329285,11.533132285,3.9122992909,-21,0.4075311761,-0.692802999,4.319830467
55,137,2005,238,257,29,1388,10,-19,39,4,24576,9.6850329617,10.458207862,1.1801090584,-16,0.4069341581,-0.7731749,1.5870432164
55,137,2006,229,227,112,1372,10,2,122,110,24686,9.2972270716,9.2160285819,4.5471154237,-14,0.4059924485,0.0811984897,4.9531078722
55,137,2007,273,274,33,1383,5,-1,38,14,24700,11.055764792,11.096262099,1.3364111287,-23,0.2024865346,-0.040497307,1.5388976633
55,137,2008,275,258,72,1383,4,17,76,60,24760,11.120097048,10.432672867,2.9114435908,-33,0.1617468662,0.6874241812,3.0731904569
55,139,2001,1952,1243,-50,7950,187,709,137,686,157762,12.400027951,7.896124356,-0.317623667,-160,1.1879125137,4.5039035949,0.870288847
55,139,2002,1827,1258,19,8260,179,569,198,610,158372,11.558389797,7.9586504457,0.1202021927,-157,1.1324311842,3.599739351,1.252633377
55,139,2003,1801,1299,-598,8214,153,502,-445,-150,158222,11.377347644,8.2060936088,-3.77770899,-207,0.9665375844,3.1712540351,-2.811171406
55,139,2004,1762,1302,-195,8495,151,460,-44,313,158535,11.125247429,8.2208127997,-1.231227723,-103,0.9534122371,2.9044346297,-0.277815486
55,139,2005,1850,1294,350,8441,155,556,505,913,159448,11.635842168,8.1387998729,2.2013755452,-148,0.9748948843,3.4970422947,3.1762704296
55,139,2006,1861,1258,113,8132,160,603,273,799,160247,11.642346612,7.8700010948,0.7069237867,-77,1.0009540343,3.7723455168,1.707877821
55,139,2007,1934,1274,258,8206,144,660,402,1061,161308,12.029046353,7.92399434,1.6047021505,-1,0.8956477119,4.1050520129,2.5003498624
55,139,2008,1959,1245,-55,8277,144,714,89,803,162111,12.114316104,7.6989910921,-0.340116072,0,0.8904857167,4.4153250118,0.5503696443
55,141,2001,876,714,-369,1212,70,162,-299,-205,75348,11.610261032,9.4631579645,-4.890623654,-68,0.9277605848,2.1471030676,-3.962863069
55,141,2002,836,629,-464,1251,67,207,-397,-250,75098,11.113622163,8.3618042354,-6.168326177,-60,0.8906850298,2.751817928,-5.277641147
55,141,2003,831,711,-308,1245,51,120,-257,-221,74877,11.081846974,9.4815802634,-4.107351225,-84,0.6801133522,1.6002667111,-3.427237873
55,141,2004,870,655,-329,1246,50,215,-279,-124,74753,11.628684087,8.7549288244,-4.397513868,-60,0.6683151774,2.873755263,-3.72919869
55,141,2005,850,742,-401,1250,50,108,-351,-308,74445,11.394254615,9.9465140283,-5.375407177,-65,0.6702502715,1.4477405863,-4.705156906
55,141,2006,856,710,-623,1217,53,146,-570,-456,73989,11.533745638,9.5665413584,-8.394303192,-32,0.7141221014,1.9672042793,-7.680181091
55,141,2007,903,722,-451,1194,44,181,-407,-193,73796,12.220455391,9.7709510437,-6.103461109,33,0.5954596204,2.4495043475,-5.508001489
55,141,2008,888,705,-325,1194,44,183,-281,-40,73756,12.036434613,9.5559531555,-4.405226632,58,0.5963999133,2.4804814574,-3.808826719
56,0,2001,6198,4003,-3173,13865,351,2195,-2822,-1039,492924,12.560708571,8.1123776076,-6.430320797,-412,0.7113276393,4.4483309639,-5.718993157
56,0,2002,6258,4129,2136,13926,165,2129,2301,4045,496969,12.643790794,8.3423157856,4.3156179506,-385,0.3333693642,4.3014750079,4.6489873148
56,0,2003,6671,4049,148,14044,-227,2622,-79,2087,499056,13.395246103,8.1303180141,0.2971812957,-456,-0.455811852,5.2649280892,-0.158630556
56,0,2004,6734,4137,1050,14068,513,2597,1563,3760,502816,13.442835013,8.2585400131,2.0960761455,-400,1.0240829168,5.1842949998,3.1201590622
56,0,2005,7112,4079,325,14146,263,3033,588,3191,506007,14.099599236,8.086651474,0.6443152069,-430,0.5213996905,6.0129477619,1.1657148975
56,0,2006,7345,4136,3207,14441,408,3209,3615,6566,512573,14.422038524,8.1211097803,6.2970017083,-258,0.8011152781,6.3009287439,7.0981169864
56,0,2007,7874,4067,6638,14636,224,3807,6862,10679,523252,15.203340333,7.8526778172,12.816836821,10,0.4325054908,7.3506625154,13.249342312
56,0,2008,7907,4081,5390,14636,302,3826,5692,9416,532668,14.976513372,7.729752254,10.209106751,-102,0.5720130313,7.2467611183,10.781119782
56,1,2001,397,190,47,2521,66,207,113,288,32201,12.38419066,5.9269426334,1.4661384409,-32,2.0588327042,6.457248027,3.5249711451
56,1,2002,359,191,-154,2503,64,168,-90,48,32249,11.140418929,5.9270752521,-4.778898371,-30,1.9860356866,5.2133436773,-2.792862684
56,1,2003,394,195,-18,2467,53,199,35,187,32436,12.182113318,6.0292185205,-0.556543248,-47,1.6387106748,6.1528947979,1.0821674268
56,1,2004,388,167,-13,2381,59,221,46,245,32681,11.917010919,5.1292289264,-0.399281294,-22,1.8121227944,6.7877819924,1.4128415007
56,1,2005,404,179,-433,2404,57,225,-376,-174,32507,12.39491931,5.4918083083,-13.28465362,-23,1.7487881205,6.903111002,-11.5358655
56,1,2006,413,171,-180,2560,59,242,-121,106,32613,12.684275184,5.2518427518,-5.528255528,-15,1.812039312,7.4324324324,-3.716216216
56,1,2007,404,174,-607,2493,52,230,-555,-325,32288,12.449731129,5.362012912,-18.70541286,0,1.6024406404,7.087718217,-17.10297222
56,1,2008,424,167,182,2493,54,257,236,470,32758,13.036927713,5.1348276604,5.5960397257,-23,1.6603634351,7.9021000523,7.2564031608
56,3,2001,138,139,-191,247,11,-1,-180,-187,11224,12.193505633,12.281864369,-16.87651867,-6,0.9719461012,-0.088358736,-15.90457256
56,3,2002,120,133,-50,247,11,-13,-39,-61,11163,10.720507437,11.881895743,-4.466878099,-9,0.9827131818,-1.161388306,-3.484164917
56,3,2003,137,122,-115,247,2,15,-113,-108,11055,12.332343145,10.982086596,-10.35196687,-10,0.1800342065,1.3502565487,-10.17193267
56,3,2004,142,121,114,247,5,21,119,129,11184,12.770358379,10.881784253,10.252259544,-11,0.4496605063,1.8885741265,10.70192005
56,3,2005,163,133,-101,247,3,30,-98,-77,11107,14.624736441,11.933067157,-9.061953255,-9,0.2691669284,2.6916692836,-8.792786326
56,3,2006,144,133,-19,247,4,11,-15,-8,11099,12.969467711,11.978744483,-1.711249212,-4,0.360262992,0.990723228,-1.35098622
56,3,2007,139,150,132,247,2,-11,134,116,11215,12.458546204,13.444474321,11.831137403,-7,0.1792596576,-0.985928117,12.01039706
56,3,2008,158,127,73,247,4,31,77,107,11322,14.021387052,11.270355416,6.47823579,-1,0.3549718241,2.7510316369,6.8332076141
56,5,2001,516,145,222,321,18,371,240,581,34519,15.075156668,4.2362358853,6.4858232175,-30,0.5258775582,10.838920782,7.0117007757
56,5,2002,501,188,1005,321,18,313,1023,1335,35854,14.238415301,5.3429582368,28.562090575,-1,0.5115598312,8.8954570645,29.073650406
56,5,2003,546,170,-139,321,15,376,-124,207,36061,15.184592922,4.7278036571,-3.865674755,-45,0.4171591462,10.456789265,-3.448515609
56,5,2004,563,172,-209,321,11,391,-198,163,36224,15.577229024,4.7589403057,-5.782665837,-30,0.3043508335,10.818288718,-5.478315003
56,5,2005,624,158,349,321,15,466,364,797,37021,17.038705714,4.3142876647,9.5296607277,-33,0.409584272,12.724418049,9.9392449997
56,5,2006,658,196,979,321,15,462,994,1435,38456,17.435775137,5.1936351471,25.941677597,-21,0.3974720776,12.24213999,26.339149675
56,5,2007,705,192,1428,321,13,513,1441,1977,40433,17.873214263,4.867598778,36.202765912,23,0.3295770006,13.005615485,36.532342912
56,5,2008,722,199,499,321,12,523,511,1040,41473,17.629966059,4.8592288721,12.184699534,6,0.2930188265,12.770737187,12.47771836
56,7,2001,186,154,-426,735,9,32,-417,-391,15189,12.090090676,10.010075076,-27.69020768,-6,0.5850043875,2.0800156001,-27.10520329
56,7,2002,166,136,20,788,9,30,29,44,15233,10.913154954,8.9408980343,1.3148379462,-15,0.5916770758,1.9722569193,1.906515022
56,7,2003,188,149,-66,814,7,39,-59,-36,15197,12.356227407,9.7929674663,-4.337824515,-16,0.4600722971,2.5632599408,-3.877752218
56,7,2004,200,127,-60,849,5,73,-55,5,15202,13.158327577,8.3555380111,-3.947498273,-13,0.3289581894,4.8027895654,-3.618540084
56,7,2005,189,142,-208,838,7,47,-201,-166,15036,12.500826774,9.3921555658,-13.75752365,-12,0.4629935842,3.1086712084,-13.29453006
56,7,2006,197,129,-47,748,6,68,-41,20,15056,13.093180912,8.5737072976,-3.123753822,-7,0.3987770836,4.5194736142,-2.724976738
56,7,2007,220,140,285,780,4,80,289,364,15420,14.437590235,9.1875574222,18.703241895,-5,0.2625016406,5.2500328127,18.965743536
56,7,2008,224,120,117,780,3,104,120,204,15624,14.431130009,7.7309625048,7.5376884422,-20,0.1932740626,6.7001675042,7.7309625048
56,9,2001,129,77,-167,94,4,52,-163,-119,11979,10.715620717,6.3961456992,-13.87216015,-8,0.3322673091,4.3194750177,-13.53989284
56,9,2002,126,94,146,94,3,32,149,174,12153,10.442565888,7.7904856622,12.100116029,-7,0.2486325211,2.6520802254,12.34874855
56,9,2003,155,82,-65,94,2,73,-63,-4,12149,12.756151757,6.7484157682,-5.349353963,-14,0.1645955065,6.0077359888,-5.184758456
56,9,2004,131,95,61,94,3,36,64,91,12240,10.74254787,7.7903973103,5.002255115,-9,0.2460125466,2.9521505597,5.2482676617
56,9,2005,173,90,133,94,3,83,136,207,12447,14.015473731,7.2912869121,10.77490177,-12,0.2430428971,6.724186819,11.017944667
56,9,2006,150,70,93,94,3,80,96,172,12619,11.968403415,5.585254927,7.4204101173,-4,0.2393680683,6.383148488,7.6597781856
56,9,2007,174,97,170,94,3,77,173,251,12870,13.652948331,7.6111263682,13.339087449,1,0.2353956609,6.0418219624,13.57448311
56,9,2008,171,97,312,94,4,74,316,397,13267,13.084898802,7.4224279757,23.874201324,7,0.3060795042,5.6624708268,24.180280828
56,11,2001,46,57,-139,100,5,-11,-134,-150,5747,7.9010649261,9.7904500172,-23.87495706,-5,0.858811405,-1.889385091,-23.01614565
56,11,2002,66,53,102,100,5,13,107,118,5865,11.36755081,9.1284877713,17.568033069,-2,0.8611780916,2.2390630382,18.429211161
56,11,2003,66,54,12,100,4,12,16,22,5887,11.232130701,9.1899251191,2.042205582,-6,0.680735194,2.042205582,2.722940776
56,11,2004,67,54,29,100,3,13,32,40,5927,11.34247503,9.1416962925,4.9094294904,-5,0.5078720163,2.2007787371,5.4173015067
56,11,2005,71,49,64,100,4,22,68,86,6013,11.89279732,8.2077051926,10.720268007,-4,0.6700167504,3.6850921273,11.390284757
56,11,2006,80,51,33,100,3,29,36,62,6075,13.236267373,8.43812045,5.4599602912,-3,0.4963600265,4.7981469226,5.9563203177
56,11,2007,101,30,170,100,4,71,174,238,6313,16.30610268,4.8433968356,27.445915402,-7,0.6457862448,11.462705844,28.091701647
56,11,2008,99,53,104,100,3,46,107,144,6457,15.505090055,8.3007047768,16.288175411,-9,0.4698512138,7.204385278,16.758026625
56,13,2001,472,370,-293,815,8,102,-285,-211,35607,13.216660833,10.360518026,-8.204410221,-28,0.2240112006,2.8561428071,-7.98039902
56,13,2002,480,389,126,808,7,91,133,193,35800,13.444060106,10.895290378,3.5290657779,-31,0.1960592099,2.5487697285,3.7251249877
56,13,2003,518,377,-99,852,2,141,-97,-3,35797,14.469880023,10.531167507,-2.765479001,-47,0.0558682626,3.9387125159,-2.709610738
56,13,2004,507,361,15,840,7,146,22,144,35941,14.134768184,10.064401015,0.4181884078,-24,0.1951545903,4.0703671694,0.6133429981
56,13,2005,579,334,115,896,4,245,119,332,36273,16.035671753,9.2502838785,3.1849779821,-32,0.1107818429,6.7853878749,3.295759825
56,13,2006,594,361,277,885,6,233,283,497,36770,16.264392207,9.88458853,7.5845734704,-19,0.16428679,6.3798036773,7.7488602604
56,13,2007,642,388,423,904,4,254,427,691,37461,17.297355552,10.453853511,11.396855761,10,0.1077716857,6.8435020409,11.504627447
56,13,2008,645,360,365,904,6,285,371,652,38113,17.069362479,9.5270860349,9.6594066743,-4,0.1587847672,7.5422764443,9.8181914415
56,15,2001,143,128,-161,495,-1,15,-162,-155,12389,11.470741587,10.267516945,-12.91461116,-8,-0.080214976,1.203224642,-12.99482613
56,15,2002,131,147,-145,490,-2,-16,-147,-170,12219,10.646944083,11.9473342,-11.78478544,-7,-0.162548765,-1.300390117,-11.9473342
56,15,2003,157,134,-93,481,-4,23,-97,-84,12135,12.893159235,11.004352468,-7.637349101,-10,-0.328488133,1.8888067669,-7.965837234
56,15,2004,124,137,44,476,2,-13,46,22,12157,10.209122345,11.279433558,3.6225917998,-11,0.1646632636,-1.070311214,3.7872550634
56,15,2005,136,144,-65,451,-1,-8,-66,-84,12073,11.225753199,11.886091622,-5.36524969,-10,-0.082542303,-0.660338423,-5.447791993
56,15,2006,116,121,-53,457,1,-5,-52,-63,12010,9.6333513267,10.048581987,-4.401445003,-6,0.0830461321,-0.415230661,-4.318398871
56,15,2007,140,111,-10,500,-1,29,-11,10,12020,11.65210154,9.2384519351,-0.832292967,-8,-0.083229297,2.4136496047,-0.915522264
56,15,2008,135,121,47,500,1,14,48,52,12072,11.207039681,10.044828159,3.9017101112,-10,0.0830151087,1.1622115225,3.98472522
56,17,2001,44,76,-75,145,2,-32,-73,-111,4754,9.1485601414,15.802058426,-15.5941366,-6,0.4158436428,-6.653498285,-15.17829296
56,17,2002,47,49,-38,145,2,-2,-36,-40,4714,9.9281791297,10.350654837,-8.027038445,-2,0.4224757076,-0.422475708,-7.604562738
56,17,2003,37,74,-97,145,2,-37,-95,-134,4580,7.9621261029,15.924252206,-20.87368195,-2,0.4303851947,-7.962126103,-20.44329675
56,17,2004,36,69,13,145,1,-33,14,-23,4557,7.8800481558,15.103425632,2.8455729452,-4,0.2188902266,-7.223377476,3.0644631717
56,17,2005,44,62,-28,145,2,-18,-26,-47,4510,9.7055255321,13.675967795,-6.17624352,-3,0.4411602515,-3.970442263,-5.735083269
56,17,2006,45,54,29,145,1,-9,30,19,4529,9.9568536343,11.948224361,6.4166390087,-2,0.2212634141,-1.991370727,6.6379024228
56,17,2007,53,49,22,145,2,4,24,29,4558,11.665015957,10.784637394,4.8420820953,1,0.4401892814,0.8803785628,5.2822713767
56,17,2008,43,60,77,145,1,-17,78,64,4622,9.3681917211,13.071895425,16.775599129,3,0.2178649237,-3.703703704,16.993464052
56,19,2001,64,78,74,95,0,-14,74,54,7156,8.9774161874,10.941225978,10.380137467,-6,0,-1.963809791,10.380137467
56,19,2002,62,61,201,95,-1,1,200,199,7355,8.5452415409,8.4074150644,27.70312177,-2,-0.137826476,0.1378264765,27.565295293
56,19,2003,57,69,133,95,-3,-12,130,117,7472,7.6886760639,9.307344709,17.940244149,-1,-0.404667161,-1.618668645,17.535576988
56,19,2004,76,89,68,95,2,-13,70,50,7522,10.137388289,11.871415233,9.0702947846,-7,0.266773376,-1.734026944,9.3370681606
56,19,2005,87,77,118,95,0,10,118,123,7645,11.472275335,10.153622997,15.56009758,-5,0,1.3186523373,15.56009758
56,19,2006,89,90,166,95,2,-1,168,163,7808,11.518798939,11.648223646,21.484501391,-4,0.2588494144,-0.129424707,21.743350806
56,19,2007,98,67,299,95,0,31,299,331,8139,12.290712987,8.4028343889,37.499216154,1,0,3.8878785979,37.499216154
56,19,2008,100,74,303,95,2,26,305,325,8464,12.04601578,8.9140516774,36.499427814,-6,0.2409203156,3.1319641029,36.74034813
56,21,2001,1154,667,200,3286,27,487,227,632,82380,14.06219536,8.1278026906,2.4371222461,-82,0.3290115032,5.9343926691,2.7661337493
56,21,2002,1150,681,485,3361,-134,469,351,755,83135,13.896021509,8.2288614325,5.8604960276,-65,-1.619188593,5.6671600761,4.2413074344
56,21,2003,1192,638,1088,3392,-450,554,638,1154,84289,14.239296636,7.6213685015,12.996941896,-38,-5.375573394,6.6179281346,7.6213685015
56,21,2004,1261,703,173,3370,250,558,423,921,85210,14.87914383,8.295034189,2.0413099782,-60,2.9498699107,6.5841096408,4.991179889
56,21,2005,1271,707,-409,3330,14,564,-395,94,85304,14.907866803,8.2925742168,-4.797260049,-75,0.1642093904,6.6152925859,-4.633050659
56,21,2006,1330,691,-154,3418,144,639,-10,586,85890,15.537927731,8.0727128287,-1.799128474,-43,1.6823019498,7.4652149024,-0.116826524
56,21,2007,1334,718,-13,3392,-3,616,-16,590,86480,15.478331496,8.3309160527,-0.150838313,-10,-0.034808841,7.1474154435,-0.185647154
56,21,2008,1339,694,377,3392,54,645,431,1062,87542,15.38885888,7.9760030341,4.3327855099,-14,0.6206111871,7.4128558458,4.953396697
56,23,2001,172,103,-79,76,0,69,-79,-26,14588,11.780015067,7.0543113485,-5.410588316,-16,0,4.7257037189,-5.410588316
56,23,2002,200,116,-13,76,-1,84,-14,55,14643,13.684102494,7.9367794465,-0.889466662,-15,-0.068420512,5.7473230474,-0.957887175
56,23,2003,221,121,61,76,-1,100,60,145,14788,15.018178112,8.2226224049,4.145288981,-15,-0.067955557,6.7955557066,4.0773334239
56,23,2004,213,114,223,76,0,99,223,305,15093,14.256550986,7.6302667247,14.925872628,-17,0,6.6262842609,14.925872628
56,23,2005,243,130,154,76,0,113,154,255,15348,15.965309944,8.5411123156,10.117933051,-12,0,7.4241976282,10.117933051
56,23,2006,265,103,240,76,0,162,240,393,15741,17.047830422,6.6261378623,15.439544533,-9,0,10.42169256,15.439544533
56,23,2007,289,108,258,76,0,181,258,431,16172,18.111741297,6.7684015918,16.168959358,-8,0,11.343339705,16.168959358
56,23,2008,292,130,313,76,1,162,314,459,16631,17.803249703,7.9261043197,19.083620401,-17,0.0609700332,9.877145383,19.144590434
56,25,2001,889,588,32,1583,41,301,73,306,66863,13.32633788,8.814270724,0.4796882027,-68,0.6146005097,4.5120671563,1.0942887123
56,25,2002,920,593,185,1581,37,327,222,490,67353,13.709244799,8.8365023544,2.7567503129,-59,0.5513500626,4.872742445,3.3081003755
56,25,2003,903,586,320,1607,26,317,346,586,67939,13.348904592,8.6627442864,4.7305088254,-77,0.3843538421,4.6861603051,5.1148626674
56,25,2004,994,543,266,1596,34,451,300,698,68637,14.555998126,7.9516166823,3.895267104,-53,0.497891284,6.6043814433,4.393158388
56,25,2005,1001,592,394,1620,31,409,425,771,69408,14.502517295,8.5769133254,5.7082835307,-63,0.4491289072,5.9256039697,6.157412438
56,25,2006,983,627,456,1675,35,356,491,812,70220,14.080270433,8.9810066749,6.5316412181,-35,0.501332111,5.099263758,7.0329733291
56,25,2007,1100,598,1022,1681,30,502,1052,1564,71784,15.492521337,8.4222979634,14.393960734,10,0.4225233092,7.070223374,14.816484043
56,25,2008,1102,578,798,1681,32,524,830,1345,73129,15.209125475,7.9772001132,11.013504655,-9,0.4416442969,7.2319253621,11.455148951
56,27,2001,22,25,-58,71,1,-3,-57,-63,2324,9.3398429208,10.613457865,-24.62322225,-3,0.4245383146,-1.273614944,-24.19868393
56,27,2002,15,22,-73,63,1,-7,-72,-79,2245,6.5659881812,9.6301159991,-31.95447582,0,0.4377325454,-3.064127818,-31.51674327
56,27,2003,21,37,-3,89,1,-16,-2,-22,2223,9.400179051,16.562220233,-1.342882722,-4,0.4476275739,-7.162041182,-0.895255148
56,27,2004,15,25,35,93,0,-10,35,22,2245,6.7144136079,11.190689346,15.666965085,-3,0,-4.476275739,15.666965085
56,27,2005,11,21,-9,87,1,-10,-8,-20,2225,4.9217002237,9.3959731544,-4.026845638,-2,0.4474272931,-4.474272931,-3.579418345
56,27,2006,23,30,19,118,0,-7,19,10,2235,10.313901345,13.452914798,8.5201793722,-2,0,-3.139013453,8.5201793722
56,27,2007,17,27,122,194,1,-10,123,117,2352,7.4122520166,11.772400262,53.193808589,4,0.4360148245,-4.360148245,53.629823414
56,27,2008,20,19,72,194,0,1,72,76,2428,8.3682008368,7.949790795,30.125523013,3,0,0.4184100418,30.125523013
56,29,2001,246,215,-146,799,7,31,-139,-131,25675,9.5569239137,8.3525961034,-5.671995493,-23,0.2719449894,1.2043278103,-5.400050504
56,29,2002,261,226,46,772,6,35,52,60,25735,10.153666602,8.7920638008,1.7895351099,-27,0.233417623,1.361602801,2.0229527329
56,29,2003,265,241,218,801,4,24,222,215,25950,10.254425849,9.3257231305,8.4357163587,-31,0.1547837864,0.9287027184,8.5905001451
56,29,2004,249,250,121,846,7,-1,128,107,26057,9.5756340493,9.6140904109,4.6532197589,-20,0.2691945315,-0.038456362,4.9224142904
56,29,2005,297,236,255,891,6,61,261,298,26355,11.333282454,9.0055712432,9.7305960467,-24,0.2289552011,2.3277112112,9.9595512478
56,29,2006,332,238,324,930,8,94,332,412,26767,12.499529385,8.960506005,12.198335906,-14,0.3011934792,3.5390233801,12.499529385
56,29,2007,326,250,326,969,5,76,331,414,27181,12.085712167,9.2681841774,12.085712167,7,0.1853636835,2.8175279899,12.271075851
56,29,2008,333,237,269,969,7,96,276,393,27574,12.16327276,8.6567436764,9.8255867044,21,0.2556844124,3.5065290841,10.081271117
56,31,2001,90,97,-1,93,8,-7,7,-10,8738,10.293949445,11.094589958,-0.114377216,-10,0.9150177285,-0.800640512,0.8006405124
56,31,2002,89,102,-21,93,7,-13,-14,-36,8702,10.206422018,11.697247706,-2.408256881,-9,0.8027522936,-1.490825688,-1.605504587
56,31,2003,89,93,-115,93,3,-4,-112,-124,8578,10.300925926,10.763888889,-13.31018519,-8,0.3472222222,-0.462962963,-12.96296296
56,31,2004,89,104,8,93,5,-15,13,-8,8570,10.380219268,12.129694425,0.9330534173,-6,0.5831583858,-1.749475157,1.5162118031
56,31,2005,86,84,-99,93,4,2,-95,-98,8472,10.092712123,9.8579978876,-11.61835465,-5,0.4694284708,0.2347142354,-11.14892618
56,31,2006,81,101,-17,93,5,-20,-12,-35,8437,9.5806966704,11.946300787,-2.010763499,-3,0.591401029,-2.365604116,-1.41936247
56,31,2007,84,77,-50,93,2,7,-48,-50,8387,9.9857346648,9.1535901094,-5.943889681,-9,0.2377555873,0.8321445554,-5.706134094
56,31,2008,82,95,-74,93,4,-13,-70,-93,8294,9.8315448714,11.390204424,-8.872369762,-10,0.4795875547,-1.558659553,-8.392782207
56,33,2001,280,274,67,732,10,6,77,56,26647,10.518802359,10.293399452,2.516999136,-27,0.3756715128,0.2254029077,2.8926706488
56,33,2002,275,311,270,702,10,-36,280,225,26872,10.276724154,11.622040771,10.089874624,-19,0.3736990601,-1.345316617,10.463573684
56,33,2003,336,282,73,693,7,54,80,97,26969,12.481194629,10.475288349,2.7116881187,-37,0.2600248881,2.0059062796,2.9717130068
56,33,2004,336,305,6,734,10,31,16,28,26997,12.452284772,11.30341326,0.2223622281,-19,0.3706037134,1.1488715117,0.5929659415
56,33,2005,338,266,87,723,8,72,95,143,27140,12.486838946,9.8269205904,3.2140680126,-24,0.2955464839,2.6599183553,3.5096144966
56,33,2006,308,297,331,763,9,11,340,337,27477,11.278539649,10.875734661,12.120768259,-14,0.329567717,0.4028049875,12.450335976
56,33,2007,387,286,449,782,8,101,457,560,28037,13.942428937,10.303707173,16.176099723,2,0.2882155853,3.6387217639,16.464315308
56,33,2008,387,277,500,782,10,110,510,625,28662,13.65103441,9.7708954303,17.636995361,5,0.3527399072,3.8801389795,17.989735269
56,35,2001,41,48,-37,72,1,-7,-36,-49,5897,6.9239213037,8.1060542092,-6.248416786,-6,0.1688761294,-1.182132906,-6.079540657
56,35,2002,75,40,213,72,0,35,213,248,6145,12.456402591,6.6434147152,35.376183358,0,0,5.8129878758,35.376183358
56,35,2003,79,44,135,72,0,35,135,173,6318,12.677525475,7.0609002648,21.664125812,3,0,5.6166252106,21.664125812
56,35,2004,79,54,242,72,1,25,243,255,6573,12.256613141,8.3779380963,37.545574432,-13,0.1551470018,3.8786750446,37.700721434
56,35,2005,80,52,280,72,1,28,281,303,6876,11.896795301,7.7329169455,41.638783553,-6,0.1487099413,4.1638783553,41.787493494
56,35,2006,81,62,347,72,1,19,348,362,7238,11.477965141,8.7856029474,49.171035851,-5,0.1417032733,2.6923621936,49.312739124
56,35,2007,124,36,610,72,1,88,611,710,7948,16.330831029,4.7412090083,80.337152641,11,0.1317002502,11.58962202,80.468852891
56,35,2008,127,57,435,72,2,70,437,508,8456,15.484028286,6.9495245062,53.035844916,1,0.2438429651,8.5345037796,53.279687881
56,37,2001,510,245,-1190,598,18,265,-1172,-915,36568,13.774290692,6.6170612146,-32.14001161,-8,0.4861514362,7.157229477,-31.65386018
56,37,2002,569,249,-28,629,16,320,-12,270,36838,15.502819933,6.7841865788,-0.762880418,-38,0.4359316677,8.7186333542,-0.326948751
56,37,2003,587,235,-614,617,10,352,-604,-262,36576,15.991500259,6.4020486556,-16.72705479,-10,0.2724276024,9.5894516032,-16.45462718
56,37,2004,574,303,46,642,16,271,62,307,36883,15.627765148,8.2494997209,1.2523992976,-26,0.435617147,7.378265427,1.6880164445
56,37,2005,622,274,98,667,13,348,111,425,37308,16.76753245,7.3863406613,2.6418298715,-34,0.3504468197,9.3811917888,2.9922766912
56,37,2006,661,250,286,652,15,411,301,693,38001,17.554342774,6.6393126983,7.5953737269,-19,0.3983587619,10.915030076,7.9937324888
56,37,2007,729,243,872,665,13,486,885,1375,39376,18.842808587,6.2809361955,22.538997376,4,0.3360171627,12.561872391,22.875014539
56,37,2008,692,252,120,665,15,440,135,568,39944,17.44831064,6.3540090772,3.0257186082,-7,0.378214826,11.094301563,3.4039334342
56,39,2001,187,75,24,136,96,112,120,213,18578,10.123704085,4.0603091249,1.29929892,-19,5.1971956798,6.0633949598,6.4964945998
56,39,2002,213,75,-87,136,89,138,2,121,18699,11.427958258,4.0239289642,-4.667757599,-19,4.7750623709,7.4040292942,0.1073047724
56,39,2003,228,83,-47,136,81,145,34,153,18852,12.143484861,4.4206545764,-2.50326223,-26,4.3141327794,7.7228302841,1.8108705494
56,39,2004,225,79,126,136,76,146,202,332,19184,11.830897045,4.1539594069,6.6253023451,-16,3.9962141129,7.676937638,10.621516458
56,39,2005,263,67,-175,136,76,196,-99,80,19264,13.680815647,3.4852267998,-9.103204328,-17,3.9533915938,10.195588847,-5.149812734
56,39,2006,300,82,40,136,76,218,116,324,19588,15.443220426,4.2211469165,2.0590960568,-10,3.912282508,11.22207351,5.9713785648
56,39,2007,290,48,67,136,71,242,138,370,19958,14.666464371,2.4275527234,3.3884590098,-10,3.59075507,12.238911647,6.9792140798
56,39,2008,284,78,150,136,73,206,223,418,20376,14.082411861,3.867704666,7.4378935885,-11,3.6197748798,10.214707195,11.057668468
56,41,2001,292,108,-443,356,12,184,-431,-257,19405,14.948677912,5.5289630635,-22.67898738,-10,0.6143292293,9.4197148488,-22.06465815
56,41,2002,300,112,-21,355,12,188,-9,160,19565,15.396458814,5.7480112907,-1.077752117,-19,0.6158583526,9.6484475237,-0.461893764
56,41,2003,321,121,-331,357,8,200,-323,-126,19439,16.459850272,6.204491847,-16.97261819,-3,0.410214337,10.255358425,-16.56240386
56,41,2004,317,125,-205,355,12,192,-193,-21,19418,16.316236457,6.4338471833,-10.55150938,-20,0.6176493296,9.8823892735,-9.933860051
56,41,2005,275,114,-146,365,10,161,-136,11,19429,14.158107447,5.8691790872,-7.516667954,-14,0.5148402708,8.28892836,-7.001827683
56,41,2006,310,126,75,361,11,184,86,259,19688,15.849886239,6.4422118261,3.8346498965,-11,0.5624153181,9.4076744127,4.3970652146
56,41,2007,340,132,256,346,9,208,265,467,20155,17.066987928,6.6260070778,12.850437969,-6,0.4517732098,10.44098085,13.302211179
56,41,2008,345,129,244,346,11,216,255,462,20617,16.923378789,6.3278720691,11.968998332,-9,0.5395859904,10.59550672,12.508584323
56,43,2001,105,84,-259,198,7,21,-252,-232,8023,12.90084777,10.320678216,-31.82209117,-1,0.860056518,2.580169554,-30.96203465
56,43,2002,78,86,-125,198,6,-8,-119,-132,7891,9.8026894558,10.808093503,-15.70943823,-5,0.7540530351,-1.005404047,-14.9553852
56,43,2003,109,79,-100,198,5,30,-95,-70,7821,13.874745418,10.056008147,-12.72912424,-5,0.6364562118,3.8187372709,-12.09266802
56,43,2004,75,85,-54,198,4,-10,-50,-67,7754,9.6308186196,10.914927769,-6.934189406,-7,0.5136436597,-1.284109149,-6.420545746
56,43,2005,100,101,11,198,5,-1,16,8,7762,12.889920082,13.018819283,1.4178912091,-7,0.6444960041,-0.128899201,2.0623872132
56,43,2006,115,86,-116,198,4,29,-112,-87,7675,14.899267992,11.142061281,-15.02882684,-4,0.5182354084,3.7572067111,-14.51059144
56,43,2007,106,65,98,198,4,41,102,141,7816,13.685365696,8.3919695307,12.652507908,-2,0.5164288942,5.2933961655,13.168936802
56,43,2008,101,81,-17,198,3,20,-14,5,7821,12.918078915,10.360043487,-2.174330114,-1,0.3837053143,2.5580354288,-1.7906248
56,45,2001,75,60,-174,297,1,15,-173,-162,6473,11.443393348,9.1547146781,-26.54867257,-4,0.152578578,2.2886786695,-26.39609399
56,45,2002,55,75,92,297,0,-20,92,68,6541,8.4524358383,11.52604887,14.138619948,-4,0,-3.073613032,14.138619948
56,45,2003,65,63,10,297,-1,2,9,4,6545,9.9342809109,9.628610729,1.5283509094,-7,-0.152835091,0.3056701819,1.3755158184
56,45,2004,73,55,1,309,0,18,1,15,6560,11.14078596,8.3937428462,0.1526135063,-4,0,2.7470431133,0.1526135063
56,45,2005,55,67,-60,297,0,-12,-60,-76,6484,8.4329960135,10.272922416,-9.199632015,-4,0,-1.839926403,-9.199632015
56,45,2006,70,67,98,297,0,3,98,97,6581,10.715652507,10.256410256,15.001913509,-4,0,0.4592422503,15.001913509
56,45,2007,72,81,309,353,0,-9,309,308,6889,10.690423163,12.026726058,45.879732739,8,0,-1.336302895,45.879732739
56,45,2008,82,76,124,353,0,6,124,133,7022,11.789231543,10.926604845,17.827618431,3,0,0.8626266983,17.827618431
